,Match ID,Innings,Over,Ball,Runs From Ball,Wicket,current score
0,211028,1,1,1,0,0,0
1,211028,1,1,2,1,0,1
2,211028,1,1,3,0,0,1
3,211028,1,1,4,0,0,1
4,211028,1,1,5,0,0,1
5,211028,1,1,6,3,0,4
6,211028,1,2,1,0,0,4
7,211028,1,2,2,0,0,4
8,211028,1,2,3,1,0,5
9,211028,1,2,4,0,0,5
10,211028,1,2,5,0,0,5
11,211028,1,2,6,1,0,6
12,211028,1,3,1,4,0,10
13,211028,1,3,2,1,0,11
14,211028,1,3,3,0,0,11
15,211028,1,3,4,4,0,15
16,211028,1,3,5,4,0,19
17,211028,1,3,6,1,0,20
18,211028,1,4,1,0,0,20
19,211028,1,4,2,4,0,24
20,211028,1,4,3,4,0,28
21,211028,1,4,4,0,0,28
22,211028,1,4,5,0,1,28
23,211028,1,4,6,1,0,29
24,211028,1,5,1,1,0,30
25,211028,1,5,2,6,0,36
26,211028,1,5,3,1,0,37
27,211028,1,5,4,2,0,39
28,211028,1,5,5,1,0,40
29,211028,1,5,6,3,0,43
30,211028,1,6,1,1,0,44
31,211028,1,6,2,0,0,44
32,211028,1,6,3,4,0,48
33,211028,1,6,4,1,0,49
34,211028,1,6,5,0,1,49
35,211028,1,6,6,1,0,50
36,211028,1,7,1,1,0,51
37,211028,1,7,2,0,0,51
38,211028,1,7,3,1,0,52
39,211028,1,7,4,0,0,52
40,211028,1,7,5,4,0,56
41,211028,1,7,6,2,0,58
42,211028,1,8,1,1,0,59
43,211028,1,8,2,4,0,63
44,211028,1,8,3,2,0,65
45,211028,1,8,4,1,0,66
46,211028,1,8,5,1,0,67
47,211028,1,8,6,1,0,68
48,211028,1,9,1,1,0,69
49,211028,1,9,2,1,0,70
50,211028,1,9,3,1,0,71
51,211028,1,9,4,4,0,75
52,211028,1,9,5,1,0,76
53,211028,1,9,6,6,0,82
54,211028,1,10,1,1,0,83
55,211028,1,10,2,2,0,85
56,211028,1,10,3,4,0,89
57,211028,1,10,4,1,0,90
58,211028,1,10,5,1,0,91
59,211028,1,10,6,2,0,93
60,211028,1,11,1,1,0,94
61,211028,1,11,2,1,0,95
62,211028,1,11,3,4,0,99
63,211028,1,11,4,1,0,100
64,211028,1,11,5,0,1,100
65,211028,1,11,6,1,0,101
66,211028,1,12,1,1,0,102
67,211028,1,12,2,0,1,102
68,211028,1,12,3,0,0,102
69,211028,1,12,4,1,0,103
70,211028,1,12,5,1,0,104
71,211028,1,12,6,1,0,105
72,211028,1,13,1,1,0,106
73,211028,1,13,2,0,0,106
74,211028,1,13,3,1,0,107
75,211028,1,13,4,0,0,107
76,211028,1,13,5,1,0,108
77,211028,1,13,6,1,0,109
78,211028,1,14,1,0,1,109
79,211028,1,14,2,0,0,109
80,211028,1,14,3,1,0,110
81,211028,1,14,4,0,0,110
82,211028,1,14,5,1,0,111
83,211028,1,14,6,0,0,111
84,211028,1,15,1,3,0,114
85,211028,1,15,2,2,0,116
86,211028,1,15,3,1,0,117
87,211028,1,15,4,0,0,117
88,211028,1,15,5,1,0,118
89,211028,1,15,6,6,0,124
90,211028,1,16,1,1,0,125
91,211028,1,16,2,1,0,126
92,211028,1,16,3,0,0,126
93,211028,1,16,4,1,0,127
94,211028,1,16,5,4,0,131
95,211028,1,16,6,1,0,132
96,211028,1,17,1,1,0,133
97,211028,1,17,2,0,0,133
98,211028,1,17,3,4,0,137
99,211028,1,17,4,2,0,139
100,211028,1,17,5,4,0,143
101,211028,1,17,6,6,0,149
102,211028,1,18,1,2,0,151
103,211028,1,18,2,1,0,152
104,211028,1,18,3,1,0,153
105,211028,1,18,4,2,0,155
106,211028,1,18,5,1,0,156
107,211028,1,18,6,1,0,157
108,211028,1,19,1,1,0,158
109,211028,1,19,2,0,1,158
110,211028,1,19,3,1,0,159
111,211028,1,19,4,0,0,159
112,211028,1,19,5,4,0,163
113,211028,1,19,6,4,0,167
114,211028,1,20,1,2,0,169
115,211028,1,20,2,4,0,173
116,211028,1,20,3,2,0,175
117,211028,1,20,4,0,1,175
118,211028,1,20,5,4,0,179
119,211028,1,20,6,0,1,179
207,211048,1,1,1,2,0,2
208,211048,1,1,2,0,0,2
209,211048,1,1,3,1,0,3
210,211048,1,1,4,1,0,4
211,211048,1,1,5,6,0,10
212,211048,1,1,6,0,1,10
213,211048,1,2,1,0,0,10
214,211048,1,2,2,4,0,14
215,211048,1,2,3,6,0,20
216,211048,1,2,4,1,0,21
217,211048,1,2,5,0,1,21
218,211048,1,2,6,1,0,22
219,211048,1,3,1,0,0,22
220,211048,1,3,2,0,0,22
221,211048,1,3,3,1,0,23
222,211048,1,3,4,2,0,25
223,211048,1,3,5,0,0,25
224,211048,1,3,6,1,0,26
225,211048,1,4,1,4,0,30
226,211048,1,4,2,7,0,37
227,211048,1,4,3,4,0,41
228,211048,1,4,4,4,0,45
229,211048,1,4,5,0,0,45
230,211048,1,4,6,1,1,46
231,211048,1,5,1,4,0,50
232,211048,1,5,2,1,0,51
233,211048,1,5,3,0,0,51
234,211048,1,5,4,0,0,51
235,211048,1,5,5,2,0,53
236,211048,1,5,6,1,0,54
237,211048,1,6,1,0,1,54
238,211048,1,6,2,1,0,55
239,211048,1,6,3,1,0,56
240,211048,1,6,4,1,0,57
241,211048,1,6,5,0,0,57
242,211048,1,6,6,1,0,58
243,211048,1,7,1,1,0,59
244,211048,1,7,2,1,0,60
245,211048,1,7,3,1,0,61
246,211048,1,7,4,1,0,62
247,211048,1,7,5,1,0,63
248,211048,1,7,6,1,0,64
249,211048,1,8,1,0,0,64
250,211048,1,8,2,1,0,65
251,211048,1,8,3,4,0,69
252,211048,1,8,4,1,0,70
253,211048,1,8,5,1,0,71
254,211048,1,8,6,1,0,72
255,211048,1,9,1,1,0,73
256,211048,1,9,2,0,0,73
257,211048,1,9,3,1,0,74
258,211048,1,9,4,4,0,78
259,211048,1,9,5,0,0,78
260,211048,1,9,6,1,0,79
261,211048,1,10,1,4,0,83
262,211048,1,10,2,1,0,84
263,211048,1,10,3,1,0,85
264,211048,1,10,4,1,0,86
265,211048,1,10,5,1,0,87
266,211048,1,10,6,2,0,89
267,211048,1,11,1,1,0,90
268,211048,1,11,2,1,0,91
269,211048,1,11,3,1,0,92
270,211048,1,11,4,0,0,92
271,211048,1,11,5,0,0,92
272,211048,1,11,6,2,0,94
273,211048,1,12,1,6,0,100
274,211048,1,12,2,0,0,100
275,211048,1,12,3,4,0,104
276,211048,1,12,4,4,0,108
277,211048,1,12,5,0,0,108
278,211048,1,12,6,1,0,109
279,211048,1,13,1,0,0,109
280,211048,1,13,2,1,0,110
281,211048,1,13,3,4,0,114
282,211048,1,13,4,1,0,115
283,211048,1,13,5,1,0,116
284,211048,1,13,6,1,0,117
285,211048,1,14,1,2,0,119
286,211048,1,14,2,4,0,123
287,211048,1,14,3,4,0,127
288,211048,1,14,4,0,0,127
289,211048,1,14,5,6,0,133
290,211048,1,14,6,1,0,134
291,211048,1,15,1,1,0,135
292,211048,1,15,2,2,0,137
293,211048,1,15,3,0,1,137
294,211048,1,15,4,1,0,138
295,211048,1,15,5,2,0,140
296,211048,1,15,6,1,0,141
297,211048,1,16,1,1,0,142
298,211048,1,16,2,2,0,144
299,211048,1,16,3,0,0,144
300,211048,1,16,4,1,0,145
301,211048,1,16,5,1,0,146
302,211048,1,16,6,1,0,147
303,211048,1,17,1,1,0,148
304,211048,1,17,2,1,0,149
305,211048,1,17,3,1,0,150
306,211048,1,17,4,0,0,150
307,211048,1,17,5,1,0,151
308,211048,1,17,6,4,0,155
309,211048,1,18,1,1,0,156
310,211048,1,18,2,1,0,157
311,211048,1,18,3,1,0,158
312,211048,1,18,4,0,0,158
313,211048,1,18,5,6,0,164
314,211048,1,18,6,6,0,170
315,211048,1,19,1,6,0,176
316,211048,1,19,2,2,0,178
317,211048,1,19,3,6,0,184
318,211048,1,19,4,6,0,190
319,211048,1,19,5,4,0,194
320,211048,1,19,6,6,0,200
321,211048,1,20,1,1,0,201
322,211048,1,20,2,4,0,205
323,211048,1,20,3,2,0,207
324,211048,1,20,4,1,0,208
325,211048,1,20,5,6,0,214
326,211048,1,20,6,0,0,214
447,222678,1,1,1,0,0,0
448,222678,1,1,2,0,0,0
449,222678,1,1,3,4,0,4
450,222678,1,1,4,4,0,8
451,222678,1,1,5,0,0,8
452,222678,1,1,6,4,0,12
453,222678,1,2,1,0,0,12
454,222678,1,2,2,1,0,13
455,222678,1,2,3,0,0,13
456,222678,1,2,4,2,0,15
457,222678,1,2,5,6,0,21
458,222678,1,2,6,3,0,24
459,222678,1,3,1,2,0,26
460,222678,1,3,2,0,0,26
461,222678,1,3,3,0,0,26
462,222678,1,3,4,0,0,26
463,222678,1,3,5,1,0,27
464,222678,1,3,6,4,0,31
465,222678,1,4,1,1,0,32
466,222678,1,4,2,0,0,32
467,222678,1,4,3,0,0,32
468,222678,1,4,4,1,0,33
469,222678,1,4,5,0,0,33
470,222678,1,4,6,1,0,34
471,222678,1,5,1,1,0,35
472,222678,1,5,2,0,0,35
473,222678,1,5,3,4,0,39
474,222678,1,5,4,4,0,43
475,222678,1,5,5,4,0,47
476,222678,1,5,6,1,0,48
477,222678,1,6,1,0,0,48
478,222678,1,6,2,4,0,52
479,222678,1,6,3,0,0,52
480,222678,1,6,4,4,0,56
481,222678,1,6,5,1,0,57
482,222678,1,6,6,2,0,59
483,222678,1,7,1,0,0,59
484,222678,1,7,2,0,0,59
485,222678,1,7,3,0,0,59
486,222678,1,7,4,6,0,65
487,222678,1,7,5,1,0,66
488,222678,1,7,6,0,0,66
489,222678,1,8,1,4,0,70
490,222678,1,8,2,1,0,71
491,222678,1,8,3,0,0,71
492,222678,1,8,4,0,0,71
493,222678,1,8,5,6,0,77
494,222678,1,8,6,1,0,78
495,222678,1,9,1,1,0,79
496,222678,1,9,2,0,0,79
497,222678,1,9,3,0,0,79
498,222678,1,9,4,1,0,80
499,222678,1,9,5,1,0,81
500,222678,1,9,6,1,0,82
501,222678,1,10,1,1,0,83
502,222678,1,10,2,1,0,84
503,222678,1,10,3,0,0,84
504,222678,1,10,4,0,1,84
505,222678,1,10,5,4,0,88
506,222678,1,10,6,0,0,88
507,222678,1,11,1,1,0,89
508,222678,1,11,2,1,0,90
509,222678,1,11,3,0,1,90
510,222678,1,11,4,0,0,90
511,222678,1,11,5,0,0,90
512,222678,1,11,6,0,0,90
513,222678,1,12,1,2,0,92
514,222678,1,12,2,1,0,93
515,222678,1,12,3,0,0,93
516,222678,1,12,4,1,0,94
517,222678,1,12,5,1,0,95
518,222678,1,12,6,4,0,99
519,222678,1,13,1,0,1,99
520,222678,1,13,2,1,0,100
521,222678,1,13,3,1,0,101
522,222678,1,13,4,1,0,102
523,222678,1,13,5,0,0,102
524,222678,1,13,6,1,0,103
525,222678,1,14,1,1,0,104
526,222678,1,14,2,0,0,104
527,222678,1,14,3,1,0,105
528,222678,1,14,4,0,1,105
529,222678,1,14,5,1,0,106
530,222678,1,14,6,0,0,106
531,222678,1,15,1,0,1,106
532,222678,1,15,2,1,0,107
533,222678,1,15,3,0,0,107
534,222678,1,15,4,1,0,108
535,222678,1,15,5,0,0,108
536,222678,1,15,6,1,0,109
537,222678,1,16,1,1,0,110
538,222678,1,16,2,0,1,110
539,222678,1,16,3,0,0,110
540,222678,1,16,4,1,0,111
541,222678,1,16,5,1,0,112
542,222678,1,16,6,0,0,112
543,222678,1,17,1,1,0,113
544,222678,1,17,2,0,0,113
545,222678,1,17,3,2,0,115
546,222678,1,17,4,0,0,115
547,222678,1,17,5,3,1,118
548,222678,1,17,6,1,0,119
549,222678,1,18,1,0,0,119
550,222678,1,18,2,1,0,120
551,222678,1,18,3,1,0,121
552,222678,1,18,4,0,1,121
553,222678,1,18,5,0,0,121
554,222678,1,18,6,0,0,121
555,222678,1,19,1,1,0,122
556,222678,1,19,2,1,0,123
557,222678,1,19,3,6,0,129
558,222678,1,19,4,0,1,129
559,222678,1,19,5,0,0,129
560,222678,1,19,6,0,0,129
561,222678,1,20,1,0,0,129
562,222678,1,20,2,4,0,133
563,222678,1,20,3,0,1,133
672,225263,1,1,1,1,0,1
673,225263,1,1,2,0,0,1
674,225263,1,1,3,1,0,2
675,225263,1,1,4,1,0,3
676,225263,1,1,5,0,0,3
677,225263,1,1,6,0,0,3
678,225263,1,2,1,1,0,4
679,225263,1,2,2,0,0,4
680,225263,1,2,3,0,0,4
681,225263,1,2,4,1,0,5
682,225263,1,2,5,4,0,9
683,225263,1,2,6,0,0,9
684,225263,1,3,1,0,0,9
685,225263,1,3,2,1,0,10
686,225263,1,3,3,0,0,10
687,225263,1,3,4,4,0,14
688,225263,1,3,5,4,0,18
689,225263,1,3,6,4,0,22
690,225263,1,4,1,1,0,23
691,225263,1,4,2,1,0,24
692,225263,1,4,3,4,0,28
693,225263,1,4,4,1,0,29
694,225263,1,4,5,0,0,29
695,225263,1,4,6,4,0,33
696,225263,1,5,1,0,0,33
697,225263,1,5,2,4,0,37
698,225263,1,5,3,0,0,37
699,225263,1,5,4,1,0,38
700,225263,1,5,5,1,0,39
701,225263,1,5,6,0,1,39
702,225263,1,6,1,1,0,40
703,225263,1,6,2,0,1,40
704,225263,1,6,3,0,0,40
705,225263,1,6,4,0,1,40
706,225263,1,6,5,0,0,40
707,225263,1,6,6,0,0,40
708,225263,1,7,1,1,0,41
709,225263,1,7,2,0,0,41
710,225263,1,7,3,0,0,41
711,225263,1,7,4,0,0,41
712,225263,1,7,5,0,0,41
713,225263,1,7,6,3,0,44
714,225263,1,8,1,0,0,44
715,225263,1,8,2,0,0,44
716,225263,1,8,3,1,0,45
717,225263,1,8,4,0,0,45
718,225263,1,8,5,1,0,46
719,225263,1,8,6,4,0,50
720,225263,1,9,1,0,1,50
721,225263,1,9,2,1,0,51
722,225263,1,9,3,1,0,52
723,225263,1,9,4,1,0,53
724,225263,1,9,5,4,0,57
725,225263,1,9,6,0,0,57
726,225263,1,10,1,1,0,58
727,225263,1,10,2,0,0,58
728,225263,1,10,3,1,0,59
729,225263,1,10,4,0,0,59
730,225263,1,10,5,0,0,59
731,225263,1,10,6,1,0,60
732,225263,1,11,1,0,0,60
733,225263,1,11,2,1,0,61
734,225263,1,11,3,1,0,62
735,225263,1,11,4,2,0,64
736,225263,1,11,5,2,0,66
737,225263,1,11,6,4,0,70
738,225263,1,12,1,1,0,71
739,225263,1,12,2,1,0,72
740,225263,1,12,3,4,0,76
741,225263,1,12,4,4,0,80
742,225263,1,12,5,0,0,80
743,225263,1,12,6,2,0,82
744,225263,1,13,1,1,0,83
745,225263,1,13,2,0,0,83
746,225263,1,13,3,1,0,84
747,225263,1,13,4,1,0,85
748,225263,1,13,5,1,0,86
749,225263,1,13,6,1,0,87
750,225263,1,14,1,1,0,88
751,225263,1,14,2,4,0,92
752,225263,1,14,3,1,0,93
753,225263,1,14,4,0,0,93
754,225263,1,14,5,1,0,94
755,225263,1,14,6,2,0,96
756,225263,1,15,1,1,0,97
757,225263,1,15,2,0,1,97
758,225263,1,15,3,1,0,98
759,225263,1,15,4,1,0,99
760,225263,1,15,5,1,0,100
761,225263,1,15,6,1,0,101
762,225263,1,16,1,1,0,102
763,225263,1,16,2,1,0,103
764,225263,1,16,3,1,0,104
765,225263,1,16,4,1,0,105
766,225263,1,16,5,1,0,106
767,225263,1,16,6,0,0,106
768,225263,1,17,1,1,0,107
769,225263,1,17,2,4,0,111
770,225263,1,17,3,1,0,112
771,225263,1,17,4,1,0,113
772,225263,1,17,5,1,0,114
773,225263,1,17,6,0,1,114
774,225263,1,18,1,0,0,114
775,225263,1,18,2,1,0,115
776,225263,1,18,3,1,0,116
777,225263,1,18,4,0,0,116
778,225263,1,18,5,2,0,118
779,225263,1,18,6,1,0,119
780,225263,1,19,1,0,0,119
781,225263,1,19,2,4,0,123
782,225263,1,19,3,1,0,124
783,225263,1,19,4,1,0,125
784,225263,1,19,5,4,0,129
785,225263,1,19,6,1,0,130
786,225263,1,20,1,0,1,130
787,225263,1,20,2,1,0,131
788,225263,1,20,3,1,0,132
789,225263,1,20,4,6,0,138
790,225263,1,20,5,4,0,142
791,225263,1,20,6,2,0,144
899,225271,1,1,1,2,0,2
900,225271,1,1,2,3,0,5
901,225271,1,1,3,0,0,5
902,225271,1,1,4,0,0,5
903,225271,1,1,5,0,0,5
904,225271,1,1,6,0,0,5
905,225271,1,2,1,0,0,5
906,225271,1,2,2,0,0,5
907,225271,1,2,3,0,0,5
908,225271,1,2,4,1,0,6
909,225271,1,2,5,0,0,6
910,225271,1,2,6,4,0,10
911,225271,1,3,1,1,0,11
912,225271,1,3,2,4,0,15
913,225271,1,3,3,4,0,19
914,225271,1,3,4,6,0,25
915,225271,1,3,5,0,0,25
916,225271,1,3,6,0,0,25
917,225271,1,4,1,1,0,26
918,225271,1,4,2,0,0,26
919,225271,1,4,3,3,0,29
920,225271,1,4,4,1,0,30
921,225271,1,4,5,1,0,31
922,225271,1,4,6,2,0,33
923,225271,1,5,1,0,0,33
924,225271,1,5,2,4,0,37
925,225271,1,5,3,6,0,43
926,225271,1,5,4,2,0,45
927,225271,1,5,5,1,0,46
928,225271,1,5,6,0,0,46
929,225271,1,6,1,4,0,50
930,225271,1,6,2,4,0,54
931,225271,1,6,3,0,0,54
932,225271,1,6,4,2,0,56
933,225271,1,6,5,1,0,57
934,225271,1,6,6,1,0,58
935,225271,1,7,1,8,0,66
936,225271,1,7,2,0,0,66
937,225271,1,7,3,1,0,67
938,225271,1,7,4,1,0,68
939,225271,1,7,5,0,0,68
940,225271,1,7,6,0,0,68
941,225271,1,8,1,1,0,69
942,225271,1,8,2,4,0,73
943,225271,1,8,3,1,0,74
944,225271,1,8,4,1,0,75
945,225271,1,8,5,0,1,75
946,225271,1,8,6,0,0,75
947,225271,1,9,1,0,1,75
948,225271,1,9,2,1,0,76
949,225271,1,9,3,1,0,77
950,225271,1,9,4,4,0,81
951,225271,1,9,5,1,0,82
952,225271,1,9,6,0,0,82
953,225271,1,10,1,1,0,83
954,225271,1,10,2,0,0,83
955,225271,1,10,3,1,0,84
956,225271,1,10,4,0,0,84
957,225271,1,10,5,0,1,84
958,225271,1,10,6,0,0,84
959,225271,1,11,1,0,1,84
960,225271,1,11,2,1,0,85
961,225271,1,11,3,4,0,89
962,225271,1,11,4,1,0,90
963,225271,1,11,5,1,0,91
964,225271,1,11,6,4,0,95
965,225271,1,12,1,0,0,95
966,225271,1,12,2,1,0,96
967,225271,1,12,3,1,0,97
968,225271,1,12,4,2,0,99
969,225271,1,12,5,2,0,101
970,225271,1,12,6,1,1,102
971,225271,1,13,1,2,0,104
972,225271,1,13,2,4,0,108
973,225271,1,13,3,0,0,108
974,225271,1,13,4,1,0,109
975,225271,1,13,5,1,0,110
976,225271,1,13,6,1,0,111
977,225271,1,14,1,2,0,113
978,225271,1,14,2,1,0,114
979,225271,1,14,3,1,0,115
980,225271,1,14,4,2,0,117
981,225271,1,14,5,0,1,117
982,225271,1,14,6,1,0,118
983,225271,1,15,1,0,0,118
984,225271,1,15,2,0,0,118
985,225271,1,15,3,2,0,120
986,225271,1,15,4,1,0,121
987,225271,1,15,5,2,0,123
988,225271,1,15,6,3,0,126
989,225271,1,16,1,1,0,127
990,225271,1,16,2,2,0,129
991,225271,1,16,3,6,0,135
992,225271,1,16,4,1,0,136
993,225271,1,16,5,0,1,136
994,225271,1,16,6,1,0,137
995,225271,1,17,1,2,0,139
996,225271,1,17,2,1,0,140
997,225271,1,17,3,0,0,140
998,225271,1,17,4,0,0,140
999,225271,1,17,5,1,0,141
1000,225271,1,17,6,0,0,141
1001,225271,1,18,1,0,0,141
1002,225271,1,18,2,3,0,144
1003,225271,1,18,3,2,0,146
1004,225271,1,18,4,2,0,148
1005,225271,1,18,5,1,0,149
1006,225271,1,18,6,2,0,151
1007,225271,1,19,1,2,0,153
1008,225271,1,19,2,1,0,154
1009,225271,1,19,3,0,0,154
1010,225271,1,19,4,0,1,154
1011,225271,1,19,5,0,0,154
1012,225271,1,19,6,4,0,158
1013,225271,1,20,1,0,0,158
1014,225271,1,20,2,1,0,159
1015,225271,1,20,3,2,0,161
1016,225271,1,20,4,0,1,161
1017,225271,1,20,5,2,0,163
1018,225271,1,20,6,0,1,163
1139,226374,1,1,1,0,0,0
1140,226374,1,1,2,0,0,0
1141,226374,1,1,3,0,0,0
1142,226374,1,1,4,0,0,0
1143,226374,1,1,5,1,0,1
1144,226374,1,1,6,4,0,5
1145,226374,1,2,1,0,0,5
1146,226374,1,2,2,1,0,6
1147,226374,1,2,3,1,0,7
1148,226374,1,2,4,0,0,7
1149,226374,1,2,5,4,0,11
1150,226374,1,2,6,0,0,11
1151,226374,1,3,1,6,0,17
1152,226374,1,3,2,0,0,17
1153,226374,1,3,3,4,0,21
1154,226374,1,3,4,1,0,22
1155,226374,1,3,5,1,0,23
1156,226374,1,3,6,0,0,23
1157,226374,1,4,1,0,0,23
1158,226374,1,4,2,1,0,24
1159,226374,1,4,3,1,0,25
1160,226374,1,4,4,1,0,26
1161,226374,1,4,5,4,0,30
1162,226374,1,4,6,1,0,31
1163,226374,1,5,1,1,0,32
1164,226374,1,5,2,1,0,33
1165,226374,1,5,3,0,0,33
1166,226374,1,5,4,6,0,39
1167,226374,1,5,5,0,0,39
1168,226374,1,5,6,0,0,39
1169,226374,1,6,1,1,0,40
1170,226374,1,6,2,3,0,43
1171,226374,1,6,3,0,0,43
1172,226374,1,6,4,4,0,47
1173,226374,1,6,5,1,0,48
1174,226374,1,6,6,2,0,50
1175,226374,1,7,1,2,0,52
1176,226374,1,7,2,1,0,53
1177,226374,1,7,3,4,0,57
1178,226374,1,7,4,0,1,57
1179,226374,1,7,5,0,0,57
1180,226374,1,7,6,2,0,59
1181,226374,1,8,1,0,0,59
1182,226374,1,8,2,0,0,59
1183,226374,1,8,3,1,0,60
1184,226374,1,8,4,0,0,60
1185,226374,1,8,5,4,0,64
1186,226374,1,8,6,0,0,64
1187,226374,1,9,1,0,0,64
1188,226374,1,9,2,4,0,68
1189,226374,1,9,3,1,0,69
1190,226374,1,9,4,1,0,70
1191,226374,1,9,5,6,0,76
1192,226374,1,9,6,1,0,77
1193,226374,1,10,1,6,0,83
1194,226374,1,10,2,1,0,84
1195,226374,1,10,3,2,0,86
1196,226374,1,10,4,4,0,90
1197,226374,1,10,5,1,0,91
1198,226374,1,10,6,1,0,92
1199,226374,1,11,1,0,0,92
1200,226374,1,11,2,1,0,93
1201,226374,1,11,3,0,0,93
1202,226374,1,11,4,4,0,97
1203,226374,1,11,5,1,0,98
1204,226374,1,11,6,1,0,99
1205,226374,1,12,1,4,0,103
1206,226374,1,12,2,0,1,103
1207,226374,1,12,3,1,0,104
1208,226374,1,12,4,1,0,105
1209,226374,1,12,5,1,0,106
1210,226374,1,12,6,4,0,110
1211,226374,1,13,1,4,0,114
1212,226374,1,13,2,1,0,115
1213,226374,1,13,3,4,0,119
1214,226374,1,13,4,4,0,123
1215,226374,1,13,5,4,0,127
1216,226374,1,13,6,0,0,127
1217,226374,1,14,1,1,0,128
1218,226374,1,14,2,0,0,128
1219,226374,1,14,3,2,0,130
1220,226374,1,14,4,4,0,134
1221,226374,1,14,5,1,0,135
1222,226374,1,14,6,1,0,136
1223,226374,1,15,1,1,0,137
1224,226374,1,15,2,1,0,138
1225,226374,1,15,3,1,0,139
1226,226374,1,15,4,1,0,140
1227,226374,1,15,5,4,0,144
1228,226374,1,15,6,1,0,145
1229,226374,1,16,1,3,0,148
1230,226374,1,16,2,1,0,149
1231,226374,1,16,3,6,0,155
1232,226374,1,16,4,1,0,156
1233,226374,1,16,5,1,0,157
1234,226374,1,16,6,2,0,159
1235,226374,1,17,1,1,0,160
1236,226374,1,17,2,2,0,162
1237,226374,1,17,3,1,0,163
1238,226374,1,17,4,0,0,163
1239,226374,1,17,5,1,0,164
1240,226374,1,17,6,1,0,165
1241,226374,1,18,1,1,0,166
1242,226374,1,18,2,1,0,167
1243,226374,1,18,3,0,0,167
1244,226374,1,18,4,6,0,173
1245,226374,1,18,5,1,0,174
1246,226374,1,18,6,0,0,174
1247,226374,1,19,1,1,0,175
1248,226374,1,19,2,1,0,176
1249,226374,1,19,3,2,0,178
1250,226374,1,19,4,6,0,184
1251,226374,1,19,5,1,0,185
1252,226374,1,19,6,2,0,187
1253,226374,1,20,1,0,1,187
1254,226374,1,20,2,4,0,191
1255,226374,1,20,3,6,0,197
1256,226374,1,20,4,4,0,201
1257,226374,1,20,5,6,0,207
1258,226374,1,20,6,2,0,209
1370,238195,1,1,1,0,0,0
1371,238195,1,1,2,0,0,0
1372,238195,1,1,3,1,0,1
1373,238195,1,1,4,4,0,5
1374,238195,1,1,5,0,0,5
1375,238195,1,1,6,1,0,6
1376,238195,1,2,1,4,0,10
1377,238195,1,2,2,1,0,11
1378,238195,1,2,3,3,0,14
1379,238195,1,2,4,0,0,14
1380,238195,1,2,5,1,0,15
1381,238195,1,2,6,0,0,15
1382,238195,1,3,1,1,0,16
1383,238195,1,3,2,1,0,17
1384,238195,1,3,3,1,0,18
1385,238195,1,3,4,1,0,19
1386,238195,1,3,5,0,0,19
1387,238195,1,3,6,1,0,20
1388,238195,1,4,1,2,0,22
1389,238195,1,4,2,5,0,27
1390,238195,1,4,3,0,0,27
1391,238195,1,4,4,0,0,27
1392,238195,1,4,5,4,0,31
1393,238195,1,4,6,0,0,31
1394,238195,1,5,1,4,0,35
1395,238195,1,5,2,0,0,35
1396,238195,1,5,3,4,0,39
1397,238195,1,5,4,0,0,39
1398,238195,1,5,5,0,0,39
1399,238195,1,5,6,1,0,40
1400,238195,1,6,1,2,0,42
1401,238195,1,6,2,6,0,48
1402,238195,1,6,3,0,0,48
1403,238195,1,6,4,0,1,48
1404,238195,1,6,5,0,0,48
1405,238195,1,6,6,0,0,48
1406,238195,1,7,1,2,0,50
1407,238195,1,7,2,1,0,51
1408,238195,1,7,3,4,0,55
1409,238195,1,7,4,4,0,59
1410,238195,1,7,5,0,0,59
1411,238195,1,7,6,0,0,59
1412,238195,1,8,1,0,0,59
1413,238195,1,8,2,2,0,61
1414,238195,1,8,3,1,0,62
1415,238195,1,8,4,1,0,63
1416,238195,1,8,5,1,0,64
1417,238195,1,8,6,1,0,65
1418,238195,1,9,1,2,0,67
1419,238195,1,9,2,0,0,67
1420,238195,1,9,3,0,0,67
1421,238195,1,9,4,0,0,67
1422,238195,1,9,5,0,0,67
1423,238195,1,9,6,2,0,69
1424,238195,1,10,1,4,0,73
1425,238195,1,10,2,1,0,74
1426,238195,1,10,3,1,0,75
1427,238195,1,10,4,6,0,81
1428,238195,1,10,5,2,0,83
1429,238195,1,10,6,0,0,83
1430,238195,1,11,1,4,0,87
1431,238195,1,11,2,1,0,88
1432,238195,1,11,3,1,0,89
1433,238195,1,11,4,0,0,89
1434,238195,1,11,5,0,0,89
1435,238195,1,11,6,1,0,90
1436,238195,1,12,1,2,0,92
1437,238195,1,12,2,1,0,93
1438,238195,1,12,3,6,0,99
1439,238195,1,12,4,1,0,100
1440,238195,1,12,5,4,0,104
1441,238195,1,12,6,1,0,105
1442,238195,1,13,1,1,0,106
1443,238195,1,13,2,1,0,107
1444,238195,1,13,3,1,0,108
1445,238195,1,13,4,3,0,111
1446,238195,1,13,5,0,0,111
1447,238195,1,13,6,1,0,112
1448,238195,1,14,1,1,0,113
1449,238195,1,14,2,7,0,120
1450,238195,1,14,3,1,0,121
1451,238195,1,14,4,1,0,122
1452,238195,1,14,5,4,0,126
1453,238195,1,14,6,1,0,127
1454,238195,1,15,1,1,0,128
1455,238195,1,15,2,1,0,129
1456,238195,1,15,3,1,0,130
1457,238195,1,15,4,4,0,134
1458,238195,1,15,5,1,0,135
1459,238195,1,15,6,1,0,136
1460,238195,1,16,1,4,0,140
1461,238195,1,16,2,2,0,142
1462,238195,1,16,3,6,0,148
1463,238195,1,16,4,6,0,154
1464,238195,1,16,5,1,0,155
1465,238195,1,16,6,4,0,159
1466,238195,1,17,1,0,1,159
1467,238195,1,17,2,1,0,160
1468,238195,1,17,3,1,0,161
1469,238195,1,17,4,1,0,162
1470,238195,1,17,5,4,0,166
1471,238195,1,17,6,4,0,170
1472,238195,1,18,1,0,1,170
1473,238195,1,18,2,0,0,170
1474,238195,1,18,3,1,0,171
1475,238195,1,18,4,1,0,172
1476,238195,1,18,5,1,0,173
1477,238195,1,18,6,4,0,177
1478,238195,1,19,1,1,0,178
1479,238195,1,19,2,0,0,178
1480,238195,1,19,3,2,0,180
1481,238195,1,19,4,1,0,181
1482,238195,1,19,5,2,0,183
1483,238195,1,19,6,1,0,184
1484,238195,1,20,1,1,0,185
1485,238195,1,20,2,6,0,191
1486,238195,1,20,3,0,1,191
1487,238195,1,20,4,4,0,195
1488,238195,1,20,5,2,0,197
1489,238195,1,20,6,4,0,201
1610,249227,1,1,1,0,0,0
1611,249227,1,1,2,5,0,5
1612,249227,1,1,3,0,0,5
1613,249227,1,1,4,1,0,6
1614,249227,1,1,5,0,0,6
1615,249227,1,1,6,0,0,6
1616,249227,1,2,1,4,0,10
1617,249227,1,2,2,0,0,10
1618,249227,1,2,3,4,0,14
1619,249227,1,2,4,2,0,16
1620,249227,1,2,5,4,0,20
1621,249227,1,2,6,0,0,20
1622,249227,1,3,1,0,0,20
1623,249227,1,3,2,0,0,20
1624,249227,1,3,3,2,0,22
1625,249227,1,3,4,0,0,22
1626,249227,1,3,5,0,0,22
1627,249227,1,3,6,0,0,22
1628,249227,1,4,1,6,0,28
1629,249227,1,4,2,0,1,28
1630,249227,1,4,3,0,0,28
1631,249227,1,4,4,4,0,32
1632,249227,1,4,5,1,0,33
1633,249227,1,4,6,1,0,34
1634,249227,1,5,1,1,0,35
1635,249227,1,5,2,1,0,36
1636,249227,1,5,3,6,0,42
1637,249227,1,5,4,4,0,46
1638,249227,1,5,5,4,0,50
1639,249227,1,5,6,2,0,52
1640,249227,1,6,1,6,0,58
1641,249227,1,6,2,6,0,64
1642,249227,1,6,3,6,0,70
1643,249227,1,6,4,1,0,71
1644,249227,1,6,5,1,0,72
1645,249227,1,6,6,1,0,73
1646,249227,1,7,1,0,0,73
1647,249227,1,7,2,1,0,74
1648,249227,1,7,3,1,0,75
1649,249227,1,7,4,0,0,75
1650,249227,1,7,5,6,0,81
1651,249227,1,7,6,2,0,83
1652,249227,1,8,1,2,0,85
1653,249227,1,8,2,1,0,86
1654,249227,1,8,3,6,0,92
1655,249227,1,8,4,1,0,93
1656,249227,1,8,5,0,0,93
1657,249227,1,8,6,4,0,97
1658,249227,1,9,1,0,1,97
1659,249227,1,9,2,4,0,101
1660,249227,1,9,3,0,0,101
1661,249227,1,9,4,2,0,103
1662,249227,1,9,5,1,0,104
1663,249227,1,9,6,1,0,105
1664,249227,1,10,1,0,0,105
1665,249227,1,10,2,1,0,106
1666,249227,1,10,3,4,0,110
1667,249227,1,10,4,0,0,110
1668,249227,1,10,5,1,0,111
1669,249227,1,10,6,6,0,117
1670,249227,1,11,1,6,0,123
1671,249227,1,11,2,0,1,123
1672,249227,1,11,3,3,0,126
1673,249227,1,11,4,1,0,127
1674,249227,1,11,5,1,0,128
1675,249227,1,11,6,1,0,129
1676,249227,1,12,1,4,0,133
1677,249227,1,12,2,0,0,133
1678,249227,1,12,3,2,0,135
1679,249227,1,12,4,2,0,137
1680,249227,1,12,5,1,0,138
1681,249227,1,12,6,1,0,139
1682,249227,1,13,1,2,0,141
1683,249227,1,13,2,6,0,147
1684,249227,1,13,3,1,0,148
1685,249227,1,13,4,0,0,148
1686,249227,1,13,5,1,0,149
1687,249227,1,13,6,0,0,149
1688,249227,1,14,1,0,1,149
1689,249227,1,14,2,1,0,150
1690,249227,1,14,3,0,0,150
1691,249227,1,14,4,2,0,152
1692,249227,1,14,5,0,0,152
1693,249227,1,14,6,1,0,153
1694,249227,1,15,1,2,0,155
1695,249227,1,15,2,0,1,155
1696,249227,1,15,3,0,0,155
1697,249227,1,15,4,0,0,155
1698,249227,1,15,5,1,0,156
1699,249227,1,15,6,1,0,157
1700,249227,1,16,1,4,0,161
1701,249227,1,16,2,4,0,165
1702,249227,1,16,3,1,0,166
1703,249227,1,16,4,0,0,166
1704,249227,1,16,5,1,0,167
1705,249227,1,16,6,1,0,168
1706,249227,1,17,1,1,0,169
1707,249227,1,17,2,0,0,169
1708,249227,1,17,3,6,0,175
1709,249227,1,17,4,1,0,176
1710,249227,1,17,5,4,0,180
1711,249227,1,17,6,2,0,182
1712,249227,1,18,1,1,0,183
1713,249227,1,18,2,1,0,184
1714,249227,1,18,3,1,0,185
1715,249227,1,18,4,2,0,187
1716,249227,1,18,5,1,0,188
1717,249227,1,18,6,6,0,194
1718,249227,1,19,1,0,0,194
1719,249227,1,19,2,1,0,195
1720,249227,1,19,3,4,0,199
1721,249227,1,19,4,2,0,201
1722,249227,1,19,5,1,0,202
1723,249227,1,19,6,2,0,204
1724,249227,1,20,1,0,0,204
1725,249227,1,20,2,6,0,210
1726,249227,1,20,3,2,0,212
1727,249227,1,20,4,6,0,218
1728,249227,1,20,5,2,0,220
1729,249227,1,20,6,1,0,221
1850,251487,1,1,1,4,0,4
1851,251487,1,1,2,1,0,5
1852,251487,1,1,3,0,0,5
1853,251487,1,1,4,1,0,6
1854,251487,1,1,5,0,0,6
1855,251487,1,1,6,6,0,12
1856,251487,1,2,1,4,0,16
1857,251487,1,2,2,4,0,20
1858,251487,1,2,3,4,0,24
1859,251487,1,2,4,1,0,25
1860,251487,1,2,5,4,0,29
1861,251487,1,2,6,0,0,29
1862,251487,1,3,1,0,0,29
1863,251487,1,3,2,1,0,30
1864,251487,1,3,3,0,0,30
1865,251487,1,3,4,1,0,31
1866,251487,1,3,5,2,0,33
1867,251487,1,3,6,0,0,33
1868,251487,1,4,1,4,0,37
1869,251487,1,4,2,1,0,38
1870,251487,1,4,3,4,0,42
1871,251487,1,4,4,0,0,42
1872,251487,1,4,5,1,0,43
1873,251487,1,4,6,6,0,49
1874,251487,1,5,1,0,0,49
1875,251487,1,5,2,0,0,49
1876,251487,1,5,3,2,0,51
1877,251487,1,5,4,2,0,53
1878,251487,1,5,5,2,0,55
1879,251487,1,5,6,4,0,59
1880,251487,1,6,1,1,0,60
1881,251487,1,6,2,4,0,64
1882,251487,1,6,3,1,0,65
1883,251487,1,6,4,0,0,65
1884,251487,1,6,5,0,0,65
1885,251487,1,6,6,1,0,66
1886,251487,1,7,1,6,0,72
1887,251487,1,7,2,0,0,72
1888,251487,1,7,3,6,0,78
1889,251487,1,7,4,1,0,79
1890,251487,1,7,5,1,0,80
1891,251487,1,7,6,0,0,80
1892,251487,1,8,1,0,0,80
1893,251487,1,8,2,0,1,80
1894,251487,1,8,3,0,0,80
1895,251487,1,8,4,1,0,81
1896,251487,1,8,5,1,0,82
1897,251487,1,8,6,0,0,82
1898,251487,1,9,1,0,1,82
1899,251487,1,9,2,1,0,83
1900,251487,1,9,3,1,0,84
1901,251487,1,9,4,0,0,84
1902,251487,1,9,5,4,0,88
1903,251487,1,9,6,2,0,90
1904,251487,1,10,1,0,0,90
1905,251487,1,10,2,4,0,94
1906,251487,1,10,3,0,0,94
1907,251487,1,10,4,6,0,100
1908,251487,1,10,5,1,0,101
1909,251487,1,10,6,0,0,101
1910,251487,1,11,1,0,0,101
1911,251487,1,11,2,1,0,102
1912,251487,1,11,3,0,0,102
1913,251487,1,11,4,0,0,102
1914,251487,1,11,5,1,0,103
1915,251487,1,11,6,3,0,106
1916,251487,1,12,1,0,0,106
1917,251487,1,12,2,0,0,106
1918,251487,1,12,3,1,0,107
1919,251487,1,12,4,0,1,107
1920,251487,1,12,5,1,0,108
1921,251487,1,12,6,0,0,108
1922,251487,1,13,1,1,0,109
1923,251487,1,13,2,2,0,111
1924,251487,1,13,3,4,0,115
1925,251487,1,13,4,4,0,119
1926,251487,1,13,5,2,0,121
1927,251487,1,13,6,1,0,122
1928,251487,1,14,1,1,0,123
1929,251487,1,14,2,1,0,124
1930,251487,1,14,3,3,0,127
1931,251487,1,14,4,1,0,128
1932,251487,1,14,5,1,0,129
1933,251487,1,14,6,1,0,130
1934,251487,1,15,1,1,0,131
1935,251487,1,15,2,0,0,131
1936,251487,1,15,3,0,0,131
1937,251487,1,15,4,0,1,131
1938,251487,1,15,5,0,0,131
1939,251487,1,15,6,1,0,132
1940,251487,1,16,1,1,0,133
1941,251487,1,16,2,0,0,133
1942,251487,1,16,3,2,0,135
1943,251487,1,16,4,0,1,135
1944,251487,1,16,5,0,0,135
1945,251487,1,16,6,0,0,135
1946,251487,1,17,1,1,0,136
1947,251487,1,17,2,1,0,137
1948,251487,1,17,3,4,0,141
1949,251487,1,17,4,1,0,142
1950,251487,1,17,5,0,0,142
1951,251487,1,17,6,1,0,143
1952,251487,1,18,1,1,0,144
1953,251487,1,18,2,6,0,150
1954,251487,1,18,3,0,1,150
1955,251487,1,18,4,1,0,151
1956,251487,1,18,5,0,0,151
1957,251487,1,18,6,1,0,152
1958,251487,1,19,1,1,0,153
1959,251487,1,19,2,1,0,154
1960,251487,1,19,3,0,0,154
1961,251487,1,19,4,1,0,155
1962,251487,1,19,5,1,0,156
1963,251487,1,19,6,0,1,156
1964,251487,1,20,1,2,0,158
1965,251487,1,20,2,1,0,159
1966,251487,1,20,3,0,0,159
1967,251487,1,20,4,0,1,159
1968,251487,1,20,5,2,0,161
1969,251487,1,20,6,1,0,162
2005,251488,1,1,1,0,0,0
2006,251488,1,1,2,0,0,0
2007,251488,1,1,3,0,1,0
2008,251488,1,1,4,3,0,3
2009,251488,1,1,5,4,0,7
2010,251488,1,1,6,2,0,9
2011,251488,1,2,1,0,0,9
2012,251488,1,2,2,4,0,13
2013,251488,1,2,3,0,0,13
2014,251488,1,2,4,1,0,14
2015,251488,1,2,5,2,0,16
2016,251488,1,2,6,1,0,17
2017,251488,1,3,1,0,0,17
2018,251488,1,3,2,6,0,23
2019,251488,1,3,3,1,0,24
2020,251488,1,3,4,0,0,24
2021,251488,1,3,5,0,1,24
2022,251488,1,3,6,0,0,24
2023,251488,1,4,1,1,0,25
2024,251488,1,4,2,1,0,26
2025,251488,1,4,3,0,0,26
2026,251488,1,4,4,0,1,26
2027,251488,1,4,5,0,0,26
2028,251488,1,4,6,0,0,26
2029,251488,1,5,1,1,0,27
2030,251488,1,5,2,1,0,28
2031,251488,1,5,3,0,0,28
2032,251488,1,5,4,0,0,28
2033,251488,1,5,5,1,0,29
2034,251488,1,5,6,1,0,30
2035,251488,1,6,1,0,0,30
2036,251488,1,6,2,1,0,31
2037,251488,1,6,3,1,0,32
2038,251488,1,6,4,4,0,36
2039,251488,1,6,5,4,0,40
2040,251488,1,6,6,0,0,40
2041,251488,1,7,1,1,0,41
2042,251488,1,7,2,1,0,42
2043,251488,1,7,3,1,0,43
2044,251488,1,7,4,0,0,43
2045,251488,1,7,5,1,0,44
2046,251488,1,7,6,0,1,44
2047,251488,1,8,1,0,0,44
2048,251488,1,8,2,1,0,45
2049,251488,1,8,3,0,0,45
2050,251488,1,8,4,1,0,46
2051,251488,1,8,5,5,0,51
2052,251488,1,8,6,0,0,51
2053,251488,1,9,1,0,0,51
2054,251488,1,9,2,0,1,51
2055,251488,1,9,3,1,0,52
2056,251488,1,9,4,0,0,52
2057,251488,1,9,5,0,0,52
2058,251488,1,9,6,0,0,52
2059,251488,1,10,1,0,0,52
2060,251488,1,10,2,0,0,52
2061,251488,1,10,3,1,0,53
2062,251488,1,10,4,1,0,54
2063,251488,1,10,5,1,0,55
2064,251488,1,10,6,0,0,55
2065,251488,1,11,1,1,0,56
2066,251488,1,11,2,1,0,57
2067,251488,1,11,3,1,1,58
2068,251488,1,11,4,1,0,59
2069,251488,1,11,5,0,0,59
2070,251488,1,11,6,1,0,60
2071,251488,1,12,1,0,0,60
2072,251488,1,12,2,0,0,60
2073,251488,1,12,3,1,0,61
2074,251488,1,12,4,0,1,61
2075,251488,1,12,5,0,0,61
2076,251488,1,12,6,0,0,61
2077,251488,1,13,1,0,0,61
2078,251488,1,13,2,0,0,61
2079,251488,1,13,3,1,0,62
2080,251488,1,13,4,0,0,62
2081,251488,1,13,5,4,0,66
2082,251488,1,13,6,0,0,66
2083,251488,1,14,1,2,0,68
2084,251488,1,14,2,1,0,69
2085,251488,1,14,3,0,0,69
2086,251488,1,14,4,0,0,69
2087,251488,1,14,5,1,0,70
2088,251488,1,14,6,1,0,71
2089,251488,1,15,1,0,1,71
2090,251488,1,15,2,0,0,71
2091,251488,1,15,3,0,0,71
2092,251488,1,15,4,1,0,72
2093,251488,1,15,5,4,0,76
2094,251488,1,15,6,4,0,80
2095,251488,1,16,1,6,0,86
2096,251488,1,16,2,1,0,87
2097,251488,1,16,3,1,0,88
2098,251488,1,16,4,4,0,92
2099,251488,1,16,5,2,0,94
2100,251488,1,16,6,6,0,100
2101,251488,1,17,1,1,0,101
2102,251488,1,17,2,0,0,101
2103,251488,1,17,3,1,0,102
2104,251488,1,17,4,0,0,102
2105,251488,1,17,5,2,0,104
2106,251488,1,17,6,4,0,108
2107,251488,1,18,1,1,0,109
2108,251488,1,18,2,1,0,110
2109,251488,1,18,3,1,0,111
2110,251488,1,18,4,4,0,115
2111,251488,1,18,5,0,0,115
2112,251488,1,18,6,0,1,115
2113,251488,1,19,1,0,0,115
2114,251488,1,19,2,0,1,115
2226,255954,1,1,1,0,0,0
2227,255954,1,1,2,1,0,1
2228,255954,1,1,3,1,0,2
2229,255954,1,1,4,0,0,2
2230,255954,1,1,5,0,0,2
2231,255954,1,1,6,0,0,2
2232,255954,1,2,1,0,0,2
2233,255954,1,2,2,0,0,2
2234,255954,1,2,3,9,0,11
2235,255954,1,2,4,0,0,11
2236,255954,1,2,5,4,0,15
2237,255954,1,2,6,0,0,15
2238,255954,1,3,1,1,0,16
2239,255954,1,3,2,1,0,17
2240,255954,1,3,3,1,0,18
2241,255954,1,3,4,0,0,18
2242,255954,1,3,5,1,0,19
2243,255954,1,3,6,0,1,19
2244,255954,1,4,1,0,0,19
2245,255954,1,4,2,0,0,19
2246,255954,1,4,3,0,0,19
2247,255954,1,4,4,1,0,20
2248,255954,1,4,5,4,0,24
2249,255954,1,4,6,0,0,24
2250,255954,1,5,1,0,0,24
2251,255954,1,5,2,0,0,24
2252,255954,1,5,3,0,0,24
2253,255954,1,5,4,2,0,26
2254,255954,1,5,5,4,0,30
2255,255954,1,5,6,1,0,31
2256,255954,1,6,1,0,1,31
2257,255954,1,6,2,0,0,31
2258,255954,1,6,3,0,0,31
2259,255954,1,6,4,0,0,31
2260,255954,1,6,5,0,0,31
2261,255954,1,6,6,0,0,31
2262,255954,1,7,1,0,0,31
2263,255954,1,7,2,2,0,33
2264,255954,1,7,3,0,0,33
2265,255954,1,7,4,1,0,34
2266,255954,1,7,5,0,0,34
2267,255954,1,7,6,0,1,34
2268,255954,1,8,1,0,0,34
2269,255954,1,8,2,1,0,35
2270,255954,1,8,3,0,0,35
2271,255954,1,8,4,6,0,41
2272,255954,1,8,5,0,0,41
2273,255954,1,8,6,0,1,41
2274,255954,1,9,1,4,0,45
2275,255954,1,9,2,0,0,45
2276,255954,1,9,3,4,0,49
2277,255954,1,9,4,0,0,49
2278,255954,1,9,5,0,0,49
2279,255954,1,9,6,0,0,49
2280,255954,1,10,1,0,0,49
2281,255954,1,10,2,1,0,50
2282,255954,1,10,3,2,0,52
2283,255954,1,10,4,4,0,56
2284,255954,1,10,5,1,0,57
2285,255954,1,10,6,0,0,57
2286,255954,1,11,1,0,0,57
2287,255954,1,11,2,2,0,59
2288,255954,1,11,3,0,0,59
2289,255954,1,11,4,1,0,60
2290,255954,1,11,5,1,0,61
2291,255954,1,11,6,1,0,62
2292,255954,1,12,1,1,0,63
2293,255954,1,12,2,0,0,63
2294,255954,1,12,3,0,0,63
2295,255954,1,12,4,1,0,64
2296,255954,1,12,5,0,1,64
2297,255954,1,12,6,0,0,64
2298,255954,1,13,1,0,0,64
2299,255954,1,13,2,0,0,64
2300,255954,1,13,3,4,0,68
2301,255954,1,13,4,6,0,74
2302,255954,1,13,5,1,0,75
2303,255954,1,13,6,1,0,76
2304,255954,1,14,1,0,0,76
2305,255954,1,14,2,0,0,76
2306,255954,1,14,3,0,0,76
2307,255954,1,14,4,1,0,77
2308,255954,1,14,5,0,0,77
2309,255954,1,14,6,6,0,83
2310,255954,1,15,1,1,0,84
2311,255954,1,15,2,1,0,85
2312,255954,1,15,3,1,0,86
2313,255954,1,15,4,6,0,92
2314,255954,1,15,5,1,0,93
2315,255954,1,15,6,1,0,94
2316,255954,1,16,1,4,0,98
2317,255954,1,16,2,2,0,100
2318,255954,1,16,3,1,0,101
2319,255954,1,16,4,0,1,101
2320,255954,1,16,5,0,0,101
2321,255954,1,16,6,2,0,103
2322,255954,1,17,1,0,0,103
2323,255954,1,17,2,1,0,104
2324,255954,1,17,3,1,0,105
2325,255954,1,17,4,0,0,105
2326,255954,1,17,5,2,0,107
2327,255954,1,17,6,1,0,108
2328,255954,1,18,1,0,0,108
2329,255954,1,18,2,0,0,108
2330,255954,1,18,3,1,0,109
2331,255954,1,18,4,1,0,110
2332,255954,1,18,5,1,0,111
2333,255954,1,18,6,2,0,113
2334,255954,1,19,1,1,0,114
2335,255954,1,19,2,1,0,115
2336,255954,1,19,3,1,0,116
2337,255954,1,19,4,2,0,118
2338,255954,1,19,5,2,1,120
2339,255954,1,19,6,0,1,120
2340,255954,1,20,1,2,0,122
2341,255954,1,20,2,1,0,123
2342,255954,1,20,3,0,0,123
2343,255954,1,20,4,0,1,123
2344,255954,1,20,5,1,0,124
2345,255954,1,20,6,2,0,126
2465,258463,1,1,1,0,0,0
2466,258463,1,1,2,0,0,0
2467,258463,1,1,3,0,0,0
2468,258463,1,1,4,1,0,1
2469,258463,1,1,5,4,0,5
2470,258463,1,1,6,4,0,9
2471,258463,1,2,1,0,0,9
2472,258463,1,2,2,0,0,9
2473,258463,1,2,3,4,0,13
2474,258463,1,2,4,0,1,13
2475,258463,1,2,5,1,0,14
2476,258463,1,2,6,5,0,19
2477,258463,1,3,1,0,0,19
2478,258463,1,3,2,1,0,20
2479,258463,1,3,3,4,0,24
2480,258463,1,3,4,6,0,30
2481,258463,1,3,5,0,0,30
2482,258463,1,3,6,0,0,30
2483,258463,1,4,1,4,0,34
2484,258463,1,4,2,4,0,38
2485,258463,1,4,3,4,0,42
2486,258463,1,4,4,0,0,42
2487,258463,1,4,5,4,0,46
2488,258463,1,4,6,1,0,47
2489,258463,1,5,1,3,0,50
2490,258463,1,5,2,1,0,51
2491,258463,1,5,3,0,0,51
2492,258463,1,5,4,4,0,55
2493,258463,1,5,5,2,0,57
2494,258463,1,5,6,0,0,57
2495,258463,1,6,1,0,0,57
2496,258463,1,6,2,4,0,61
2497,258463,1,6,3,0,0,61
2498,258463,1,6,4,0,0,61
2499,258463,1,6,5,1,0,62
2500,258463,1,6,6,0,0,62
2501,258463,1,7,1,4,0,66
2502,258463,1,7,2,6,0,72
2503,258463,1,7,3,1,0,73
2504,258463,1,7,4,1,0,74
2505,258463,1,7,5,0,0,74
2506,258463,1,7,6,1,0,75
2507,258463,1,8,1,0,0,75
2508,258463,1,8,2,1,0,76
2509,258463,1,8,3,1,0,77
2510,258463,1,8,4,0,0,77
2511,258463,1,8,5,2,0,79
2512,258463,1,8,6,2,0,81
2513,258463,1,9,1,2,0,83
2514,258463,1,9,2,1,0,84
2515,258463,1,9,3,2,0,86
2516,258463,1,9,4,1,0,87
2517,258463,1,9,5,1,0,88
2518,258463,1,9,6,0,0,88
2519,258463,1,10,1,0,0,88
2520,258463,1,10,2,4,0,92
2521,258463,1,10,3,2,0,94
2522,258463,1,10,4,0,0,94
2523,258463,1,10,5,1,0,95
2524,258463,1,10,6,2,0,97
2525,258463,1,11,1,0,1,97
2526,258463,1,11,2,0,0,97
2527,258463,1,11,3,1,0,98
2528,258463,1,11,4,1,0,99
2529,258463,1,11,5,2,0,101
2530,258463,1,11,6,6,0,107
2531,258463,1,12,1,2,0,109
2532,258463,1,12,2,0,0,109
2533,258463,1,12,3,0,0,109
2534,258463,1,12,4,1,0,110
2535,258463,1,12,5,4,0,114
2536,258463,1,12,6,1,0,115
2537,258463,1,13,1,0,1,115
2538,258463,1,13,2,6,0,121
2539,258463,1,13,3,0,0,121
2540,258463,1,13,4,1,0,122
2541,258463,1,13,5,1,0,123
2542,258463,1,13,6,1,0,124
2543,258463,1,14,1,1,0,125
2544,258463,1,14,2,5,0,130
2545,258463,1,14,3,2,1,132
2546,258463,1,14,4,3,0,135
2547,258463,1,14,5,4,0,139
2548,258463,1,14,6,1,0,140
2549,258463,1,15,1,4,0,144
2550,258463,1,15,2,1,0,145
2551,258463,1,15,3,2,0,147
2552,258463,1,15,4,2,0,149
2553,258463,1,15,5,0,0,149
2554,258463,1,15,6,4,0,153
2555,258463,1,16,1,2,0,155
2556,258463,1,16,2,6,0,161
2557,258463,1,16,3,1,0,162
2558,258463,1,16,4,6,0,168
2559,258463,1,16,5,0,0,168
2560,258463,1,16,6,2,0,170
2561,258463,1,17,1,1,0,171
2562,258463,1,17,2,6,0,177
2563,258463,1,17,3,1,0,178
2564,258463,1,17,4,4,0,182
2565,258463,1,17,5,4,0,186
2566,258463,1,17,6,1,0,187
2567,258463,1,18,1,3,0,190
2568,258463,1,18,2,0,0,190
2569,258463,1,18,3,0,1,190
2570,258463,1,18,4,1,0,191
2571,258463,1,18,5,1,0,192
2572,258463,1,18,6,6,0,198
2573,258463,1,19,1,1,0,199
2574,258463,1,19,2,0,1,199
2575,258463,1,19,3,4,0,203
2576,258463,1,19,4,0,0,203
2577,258463,1,19,5,1,0,204
2578,258463,1,19,6,0,1,204
2579,258463,1,20,1,1,0,205
2580,258463,1,20,2,1,0,206
2581,258463,1,20,3,0,1,206
2582,258463,1,20,4,1,0,207
2583,258463,1,20,5,0,0,207
2584,258463,1,20,6,1,0,208
2705,258464,1,1,1,4,0,4
2706,258464,1,1,2,3,0,7
2707,258464,1,1,3,0,0,7
2708,258464,1,1,4,0,0,7
2709,258464,1,1,5,0,0,7
2710,258464,1,1,6,0,0,7
2711,258464,1,2,1,0,0,7
2712,258464,1,2,2,1,0,8
2713,258464,1,2,3,0,0,8
2714,258464,1,2,4,0,0,8
2715,258464,1,2,5,0,0,8
2716,258464,1,2,6,0,0,8
2717,258464,1,3,1,0,0,8
2718,258464,1,3,2,0,0,8
2719,258464,1,3,3,4,0,12
2720,258464,1,3,4,2,0,14
2721,258464,1,3,5,4,0,18
2722,258464,1,3,6,1,0,19
2723,258464,1,4,1,4,0,23
2724,258464,1,4,2,4,0,27
2725,258464,1,4,3,4,0,31
2726,258464,1,4,4,0,0,31
2727,258464,1,4,5,1,0,32
2728,258464,1,4,6,1,0,33
2729,258464,1,5,1,1,0,34
2730,258464,1,5,2,1,0,35
2731,258464,1,5,3,4,0,39
2732,258464,1,5,4,0,0,39
2733,258464,1,5,5,1,0,40
2734,258464,1,5,6,4,0,44
2735,258464,1,6,1,1,0,45
2736,258464,1,6,2,4,0,49
2737,258464,1,6,3,0,1,49
2738,258464,1,6,4,0,0,49
2739,258464,1,6,5,1,0,50
2740,258464,1,6,6,0,0,50
2741,258464,1,7,1,0,0,50
2742,258464,1,7,2,1,0,51
2743,258464,1,7,3,0,0,51
2744,258464,1,7,4,0,0,51
2745,258464,1,7,5,0,0,51
2746,258464,1,7,6,1,0,52
2747,258464,1,8,1,2,0,54
2748,258464,1,8,2,1,0,55
2749,258464,1,8,3,1,0,56
2750,258464,1,8,4,0,0,56
2751,258464,1,8,5,1,0,57
2752,258464,1,8,6,1,0,58
2753,258464,1,9,1,0,0,58
2754,258464,1,9,2,0,0,58
2755,258464,1,9,3,2,0,60
2756,258464,1,9,4,4,0,64
2757,258464,1,9,5,0,1,64
2758,258464,1,9,6,0,0,64
2759,258464,1,10,1,4,0,68
2760,258464,1,10,2,1,0,69
2761,258464,1,10,3,2,0,71
2762,258464,1,10,4,1,0,72
2763,258464,1,10,5,6,0,78
2764,258464,1,10,6,0,0,78
2765,258464,1,11,1,6,0,84
2766,258464,1,11,2,1,0,85
2767,258464,1,11,3,1,0,86
2768,258464,1,11,4,2,0,88
2769,258464,1,11,5,1,0,89
2770,258464,1,11,6,1,0,90
2771,258464,1,12,1,1,0,91
2772,258464,1,12,2,1,0,92
2773,258464,1,12,3,1,0,93
2774,258464,1,12,4,1,0,94
2775,258464,1,12,5,6,0,100
2776,258464,1,12,6,4,0,104
2777,258464,1,13,1,2,0,106
2778,258464,1,13,2,1,0,107
2779,258464,1,13,3,1,0,108
2780,258464,1,13,4,0,1,108
2781,258464,1,13,5,4,0,112
2782,258464,1,13,6,1,0,113
2783,258464,1,14,1,1,0,114
2784,258464,1,14,2,1,0,115
2785,258464,1,14,3,2,0,117
2786,258464,1,14,4,6,0,123
2787,258464,1,14,5,1,0,124
2788,258464,1,14,6,2,0,126
2789,258464,1,15,1,4,0,130
2790,258464,1,15,2,0,1,130
2791,258464,1,15,3,2,0,132
2792,258464,1,15,4,4,0,136
2793,258464,1,15,5,1,0,137
2794,258464,1,15,6,1,0,138
2795,258464,1,16,1,0,0,138
2796,258464,1,16,2,2,0,140
2797,258464,1,16,3,0,0,140
2798,258464,1,16,4,2,0,142
2799,258464,1,16,5,2,0,144
2800,258464,1,16,6,0,0,144
2801,258464,1,17,1,0,0,144
2802,258464,1,17,2,1,0,145
2803,258464,1,17,3,1,0,146
2804,258464,1,17,4,0,1,146
2805,258464,1,17,5,0,0,146
2806,258464,1,17,6,1,0,147
2807,258464,1,18,1,0,0,147
2808,258464,1,18,2,0,0,147
2809,258464,1,18,3,6,0,153
2810,258464,1,18,4,1,0,154
2811,258464,1,18,5,1,0,155
2812,258464,1,18,6,2,0,157
2813,258464,1,19,1,1,0,158
2814,258464,1,19,2,0,1,158
2815,258464,1,19,3,2,0,160
2816,258464,1,19,4,1,1,161
2817,258464,1,19,5,1,0,162
2818,258464,1,19,6,0,0,162
2819,258464,1,20,1,0,0,162
2820,258464,1,20,2,2,0,164
2821,258464,1,20,3,2,0,166
2822,258464,1,20,4,2,0,168
2823,258464,1,20,5,0,0,168
2824,258464,1,20,6,1,0,169
2943,287853,1,1,1,4,0,4
2944,287853,1,1,2,0,0,4
2945,287853,1,1,3,1,0,5
2946,287853,1,1,4,1,0,6
2947,287853,1,1,5,2,0,8
2948,287853,1,1,6,0,0,8
2949,287853,1,2,1,1,0,9
2950,287853,1,2,2,1,0,10
2951,287853,1,2,3,0,0,10
2952,287853,1,2,4,0,0,10
2953,287853,1,2,5,0,0,10
2954,287853,1,2,6,4,0,14
2955,287853,1,3,1,6,0,20
2956,287853,1,3,2,1,0,21
2957,287853,1,3,3,1,0,22
2958,287853,1,3,4,5,0,27
2959,287853,1,3,5,1,0,28
2960,287853,1,3,6,1,0,29
2961,287853,1,4,1,0,0,29
2962,287853,1,4,2,0,0,29
2963,287853,1,4,3,1,0,30
2964,287853,1,4,4,0,0,30
2965,287853,1,4,5,6,0,36
2966,287853,1,4,6,6,0,42
2967,287853,1,5,1,0,0,42
2968,287853,1,5,2,1,0,43
2969,287853,1,5,3,1,0,44
2970,287853,1,5,4,0,0,44
2971,287853,1,5,5,1,0,45
2972,287853,1,5,6,1,0,46
2973,287853,1,6,1,2,0,48
2974,287853,1,6,2,4,0,52
2975,287853,1,6,3,0,0,52
2976,287853,1,6,4,1,0,53
2977,287853,1,6,5,1,0,54
2978,287853,1,6,6,0,0,54
2979,287853,1,7,1,4,0,58
2980,287853,1,7,2,2,0,60
2981,287853,1,7,3,1,0,61
2982,287853,1,7,4,1,0,62
2983,287853,1,7,5,2,0,64
2984,287853,1,7,6,4,0,68
2985,287853,1,8,1,2,0,70
2986,287853,1,8,2,6,0,76
2987,287853,1,8,3,0,0,76
2988,287853,1,8,4,0,0,76
2989,287853,1,8,5,1,0,77
2990,287853,1,8,6,1,0,78
2991,287853,1,9,1,0,0,78
2992,287853,1,9,2,6,0,84
2993,287853,1,9,3,1,0,85
2994,287853,1,9,4,2,0,87
2995,287853,1,9,5,1,0,88
2996,287853,1,9,6,5,0,93
2997,287853,1,10,1,2,0,95
2998,287853,1,10,2,2,0,97
2999,287853,1,10,3,1,0,98
3000,287853,1,10,4,6,0,104
3001,287853,1,10,5,4,0,108
3002,287853,1,10,6,1,0,109
3003,287853,1,11,1,0,0,109
3004,287853,1,11,2,1,0,110
3005,287853,1,11,3,2,0,112
3006,287853,1,11,4,1,0,113
3007,287853,1,11,5,0,0,113
3008,287853,1,11,6,1,0,114
3009,287853,1,12,1,2,0,116
3010,287853,1,12,2,4,0,120
3011,287853,1,12,3,6,0,126
3012,287853,1,12,4,2,0,128
3013,287853,1,12,5,1,0,129
3014,287853,1,12,6,2,0,131
3015,287853,1,13,1,0,0,131
3016,287853,1,13,2,0,0,131
3017,287853,1,13,3,1,0,132
3018,287853,1,13,4,1,0,133
3019,287853,1,13,5,6,0,139
3020,287853,1,13,6,6,0,145
3021,287853,1,14,1,0,0,145
3022,287853,1,14,2,0,0,145
3023,287853,1,14,3,0,1,145
3024,287853,1,14,4,0,0,145
3025,287853,1,14,5,6,0,151
3026,287853,1,14,6,0,0,151
3027,287853,1,15,1,1,0,152
3028,287853,1,15,2,0,1,152
3029,287853,1,15,3,3,0,155
3030,287853,1,15,4,2,0,157
3031,287853,1,15,5,4,0,161
3032,287853,1,15,6,6,0,167
3033,287853,1,16,1,1,0,168
3034,287853,1,16,2,5,0,173
3035,287853,1,16,3,1,0,174
3036,287853,1,16,4,1,0,175
3037,287853,1,16,5,1,0,176
3038,287853,1,16,6,1,0,177
3039,287853,1,17,1,1,0,178
3040,287853,1,17,2,0,1,178
3041,287853,1,17,3,1,0,179
3042,287853,1,17,4,1,0,180
3043,287853,1,17,5,1,0,181
3044,287853,1,17,6,0,0,181
3045,287853,1,18,1,1,0,182
3046,287853,1,18,2,0,0,182
3047,287853,1,18,3,0,1,182
3048,287853,1,18,4,0,0,182
3049,287853,1,18,5,1,0,183
3050,287853,1,18,6,1,0,184
3051,287853,1,19,1,4,0,188
3052,287853,1,19,2,0,1,188
3053,287853,1,19,3,0,0,188
3054,287853,1,19,4,4,0,192
3055,287853,1,19,5,1,0,193
3056,287853,1,19,6,3,0,196
3057,287853,1,20,1,0,0,196
3058,287853,1,20,2,0,0,196
3059,287853,1,20,3,2,0,198
3060,287853,1,20,4,6,0,204
3061,287853,1,20,5,0,1,204
3062,287853,1,20,6,1,0,205
3169,287856,1,1,1,2,0,2
3170,287856,1,1,2,1,0,3
3171,287856,1,1,3,4,0,7
3172,287856,1,1,4,0,1,7
3173,287856,1,1,5,0,0,7
3174,287856,1,1,6,0,0,7
3175,287856,1,2,1,0,0,7
3176,287856,1,2,2,2,0,9
3177,287856,1,2,3,1,0,10
3178,287856,1,2,4,0,0,10
3179,287856,1,2,5,0,0,10
3180,287856,1,2,6,1,0,11
3181,287856,1,3,1,1,0,12
3182,287856,1,3,2,0,1,12
3183,287856,1,3,3,0,0,12
3184,287856,1,3,4,0,0,12
3185,287856,1,3,5,0,0,12
3186,287856,1,3,6,2,0,14
3187,287856,1,4,1,1,0,15
3188,287856,1,4,2,0,0,15
3189,287856,1,4,3,4,0,19
3190,287856,1,4,4,0,0,19
3191,287856,1,4,5,0,0,19
3192,287856,1,4,6,0,1,19
3193,287856,1,5,1,0,0,19
3194,287856,1,5,2,1,0,20
3195,287856,1,5,3,0,0,20
3196,287856,1,5,4,0,0,20
3197,287856,1,5,5,0,0,20
3198,287856,1,5,6,1,0,21
3199,287856,1,6,1,0,0,21
3200,287856,1,6,2,0,0,21
3201,287856,1,6,3,0,0,21
3202,287856,1,6,4,1,0,22
3203,287856,1,6,5,0,0,22
3204,287856,1,6,6,0,0,22
3205,287856,1,7,1,1,0,23
3206,287856,1,7,2,2,0,25
3207,287856,1,7,3,0,0,25
3208,287856,1,7,4,1,0,26
3209,287856,1,7,5,1,0,27
3210,287856,1,7,6,5,0,32
3211,287856,1,8,1,0,0,32
3212,287856,1,8,2,0,0,32
3213,287856,1,8,3,0,0,32
3214,287856,1,8,4,1,0,33
3215,287856,1,8,5,0,0,33
3216,287856,1,8,6,4,0,37
3217,287856,1,9,1,4,0,41
3218,287856,1,9,2,0,0,41
3219,287856,1,9,3,1,0,42
3220,287856,1,9,4,1,0,43
3221,287856,1,9,5,2,0,45
3222,287856,1,9,6,3,0,48
3223,287856,1,10,1,0,0,48
3224,287856,1,10,2,0,1,48
3225,287856,1,10,3,0,0,48
3226,287856,1,10,4,1,0,49
3227,287856,1,10,5,2,0,51
3228,287856,1,10,6,0,0,51
3229,287856,1,11,1,0,0,51
3230,287856,1,11,2,4,0,55
3231,287856,1,11,3,2,0,57
3232,287856,1,11,4,1,0,58
3233,287856,1,11,5,0,0,58
3234,287856,1,11,6,2,0,60
3235,287856,1,12,1,4,0,64
3236,287856,1,12,2,2,0,66
3237,287856,1,12,3,0,0,66
3238,287856,1,12,4,1,0,67
3239,287856,1,12,5,1,0,68
3240,287856,1,12,6,1,0,69
3241,287856,1,13,1,1,0,70
3242,287856,1,13,2,4,0,74
3243,287856,1,13,3,1,0,75
3244,287856,1,13,4,2,0,77
3245,287856,1,13,5,1,0,78
3246,287856,1,13,6,0,0,78
3247,287856,1,14,1,1,0,79
3248,287856,1,14,2,6,0,85
3249,287856,1,14,3,1,0,86
3250,287856,1,14,4,0,1,86
3251,287856,1,14,5,0,0,86
3252,287856,1,14,6,1,0,87
3253,287856,1,15,1,0,0,87
3254,287856,1,15,2,0,0,87
3255,287856,1,15,3,1,0,88
3256,287856,1,15,4,1,0,89
3257,287856,1,15,5,0,0,89
3258,287856,1,15,6,1,0,90
3259,287856,1,16,1,1,0,91
3260,287856,1,16,2,0,0,91
3261,287856,1,16,3,1,0,92
3262,287856,1,16,4,6,0,98
3263,287856,1,16,5,1,0,99
3264,287856,1,16,6,2,0,101
3265,287856,1,17,1,1,0,102
3266,287856,1,17,2,0,1,102
3267,287856,1,17,3,2,0,104
3268,287856,1,17,4,1,0,105
3269,287856,1,17,5,1,0,106
3270,287856,1,17,6,0,0,106
3271,287856,1,18,1,1,0,107
3272,287856,1,18,2,1,0,108
3273,287856,1,18,3,0,0,108
3274,287856,1,18,4,4,0,112
3275,287856,1,18,5,6,0,118
3276,287856,1,18,6,1,0,119
3277,287856,1,19,1,0,1,119
3278,287856,1,19,2,1,0,120
3279,287856,1,19,3,1,0,121
3280,287856,1,19,4,0,0,121
3281,287856,1,19,5,4,0,125
3282,287856,1,19,6,3,0,128
3283,287856,1,20,1,1,0,129
3284,287856,1,20,2,4,0,133
3285,287856,1,20,3,1,1,134
3286,287856,1,20,4,2,0,136
3287,287856,1,20,5,2,0,138
3288,287856,1,20,6,0,1,138
3408,287857,1,1,1,0,0,0
3409,287857,1,1,2,0,0,0
3410,287857,1,1,3,0,1,0
3411,287857,1,1,4,0,0,0
3412,287857,1,1,5,0,0,0
3413,287857,1,1,6,0,0,0
3414,287857,1,2,1,1,0,1
3415,287857,1,2,2,4,0,5
3416,287857,1,2,3,0,0,5
3417,287857,1,2,4,6,0,11
3418,287857,1,2,5,1,0,12
3419,287857,1,2,6,0,0,12
3420,287857,1,3,1,1,0,13
3421,287857,1,3,2,0,0,13
3422,287857,1,3,3,1,0,14
3423,287857,1,3,4,0,0,14
3424,287857,1,3,5,1,0,15
3425,287857,1,3,6,1,0,16
3426,287857,1,4,1,3,0,19
3427,287857,1,4,2,4,0,23
3428,287857,1,4,3,1,0,24
3429,287857,1,4,4,0,0,24
3430,287857,1,4,5,0,0,24
3431,287857,1,4,6,0,0,24
3432,287857,1,5,1,0,0,24
3433,287857,1,5,2,0,0,24
3434,287857,1,5,3,0,0,24
3435,287857,1,5,4,0,0,24
3436,287857,1,5,5,0,0,24
3437,287857,1,5,6,1,0,25
3438,287857,1,6,1,4,0,29
3439,287857,1,6,2,0,0,29
3440,287857,1,6,3,0,0,29
3441,287857,1,6,4,4,0,33
3442,287857,1,6,5,0,0,33
3443,287857,1,6,6,0,0,33
3444,287857,1,7,1,0,0,33
3445,287857,1,7,2,0,0,33
3446,287857,1,7,3,1,0,34
3447,287857,1,7,4,2,0,36
3448,287857,1,7,5,1,0,37
3449,287857,1,7,6,1,0,38
3450,287857,1,8,1,0,0,38
3451,287857,1,8,2,6,0,44
3452,287857,1,8,3,1,0,45
3453,287857,1,8,4,2,0,47
3454,287857,1,8,5,2,0,49
3455,287857,1,8,6,4,0,53
3456,287857,1,9,1,1,0,54
3457,287857,1,9,2,0,0,54
3458,287857,1,9,3,5,0,59
3459,287857,1,9,4,0,0,59
3460,287857,1,9,5,1,0,60
3461,287857,1,9,6,1,0,61
3462,287857,1,10,1,1,0,62
3463,287857,1,10,2,1,0,63
3464,287857,1,10,3,1,0,64
3465,287857,1,10,4,0,0,64
3466,287857,1,10,5,4,0,68
3467,287857,1,10,6,1,0,69
3468,287857,1,11,1,1,0,70
3469,287857,1,11,2,4,0,74
3470,287857,1,11,3,1,0,75
3471,287857,1,11,4,2,0,77
3472,287857,1,11,5,4,0,81
3473,287857,1,11,6,0,0,81
3474,287857,1,12,1,4,0,85
3475,287857,1,12,2,1,0,86
3476,287857,1,12,3,0,0,86
3477,287857,1,12,4,1,0,87
3478,287857,1,12,5,1,0,88
3479,287857,1,12,6,1,0,89
3480,287857,1,13,1,0,0,89
3481,287857,1,13,2,2,0,91
3482,287857,1,13,3,0,0,91
3483,287857,1,13,4,1,0,92
3484,287857,1,13,5,1,0,93
3485,287857,1,13,6,1,0,94
3486,287857,1,14,1,0,0,94
3487,287857,1,14,2,0,0,94
3488,287857,1,14,3,1,0,95
3489,287857,1,14,4,0,1,95
3490,287857,1,14,5,0,0,95
3491,287857,1,14,6,1,0,96
3492,287857,1,15,1,1,0,97
3493,287857,1,15,2,1,0,98
3494,287857,1,15,3,0,0,98
3495,287857,1,15,4,1,0,99
3496,287857,1,15,5,1,0,100
3497,287857,1,15,6,2,0,102
3498,287857,1,16,1,1,0,103
3499,287857,1,16,2,1,0,104
3500,287857,1,16,3,0,1,104
3501,287857,1,16,4,0,0,104
3502,287857,1,16,5,1,0,105
3503,287857,1,16,6,1,0,106
3504,287857,1,17,1,6,0,112
3505,287857,1,17,2,4,0,116
3506,287857,1,17,3,6,0,122
3507,287857,1,17,4,4,0,126
3508,287857,1,17,5,0,0,126
3509,287857,1,17,6,0,1,126
3510,287857,1,18,1,2,0,128
3511,287857,1,18,2,1,0,129
3512,287857,1,18,3,0,0,129
3513,287857,1,18,4,2,0,131
3514,287857,1,18,5,0,1,131
3515,287857,1,18,6,0,0,131
3516,287857,1,19,1,1,0,132
3517,287857,1,19,2,1,0,133
3518,287857,1,19,3,6,0,139
3519,287857,1,19,4,6,0,145
3520,287857,1,19,5,6,0,151
3521,287857,1,19,6,4,0,155
3522,287857,1,20,1,0,1,155
3523,287857,1,20,2,2,0,157
3524,287857,1,20,3,0,1,157
3525,287857,1,20,4,1,0,158
3526,287857,1,20,5,6,0,164
3527,287857,1,20,6,0,1,164
3636,287858,1,1,1,1,0,1
3637,287858,1,1,2,1,0,2
3638,287858,1,1,3,0,0,2
3639,287858,1,1,4,1,0,3
3640,287858,1,1,5,0,0,3
3641,287858,1,1,6,0,0,3
3642,287858,1,2,1,3,0,6
3643,287858,1,2,2,0,0,6
3644,287858,1,2,3,4,0,10
3645,287858,1,2,4,1,0,11
3646,287858,1,2,5,4,0,15
3647,287858,1,2,6,1,0,16
3648,287858,1,3,1,4,0,20
3649,287858,1,3,2,0,0,20
3650,287858,1,3,3,0,1,20
3651,287858,1,3,4,0,1,20
3652,287858,1,3,5,0,0,20
3653,287858,1,3,6,0,0,20
3654,287858,1,4,1,4,0,24
3655,287858,1,4,2,0,0,24
3656,287858,1,4,3,1,0,25
3657,287858,1,4,4,0,0,25
3658,287858,1,4,5,1,0,26
3659,287858,1,4,6,2,0,28
3660,287858,1,5,1,3,0,31
3661,287858,1,5,2,1,0,32
3662,287858,1,5,3,2,0,34
3663,287858,1,5,4,4,0,38
3664,287858,1,5,5,4,0,42
3665,287858,1,5,6,3,0,45
3666,287858,1,6,1,6,0,51
3667,287858,1,6,2,0,0,51
3668,287858,1,6,3,0,1,51
3669,287858,1,6,4,1,0,52
3670,287858,1,6,5,1,0,53
3671,287858,1,6,6,6,0,59
3672,287858,1,7,1,1,0,60
3673,287858,1,7,2,1,0,61
3674,287858,1,7,3,1,0,62
3675,287858,1,7,4,1,0,63
3676,287858,1,7,5,1,0,64
3677,287858,1,7,6,2,0,66
3678,287858,1,8,1,1,0,67
3679,287858,1,8,2,2,0,69
3680,287858,1,8,3,0,0,69
3681,287858,1,8,4,1,0,70
3682,287858,1,8,5,1,0,71
3683,287858,1,8,6,4,0,75
3684,287858,1,9,1,1,0,76
3685,287858,1,9,2,1,0,77
3686,287858,1,9,3,0,0,77
3687,287858,1,9,4,2,0,79
3688,287858,1,9,5,1,0,80
3689,287858,1,9,6,2,0,82
3690,287858,1,10,1,1,0,83
3691,287858,1,10,2,6,0,89
3692,287858,1,10,3,1,0,90
3693,287858,1,10,4,1,0,91
3694,287858,1,10,5,1,0,92
3695,287858,1,10,6,1,0,93
3696,287858,1,11,1,0,0,93
3697,287858,1,11,2,1,0,94
3698,287858,1,11,3,4,0,98
3699,287858,1,11,4,1,0,99
3700,287858,1,11,5,1,0,100
3701,287858,1,11,6,1,0,101
3702,287858,1,12,1,6,0,107
3703,287858,1,12,2,0,0,107
3704,287858,1,12,3,1,0,108
3705,287858,1,12,4,0,0,108
3706,287858,1,12,5,1,0,109
3707,287858,1,12,6,4,0,113
3708,287858,1,13,1,6,0,119
3709,287858,1,13,2,4,0,123
3710,287858,1,13,3,4,0,127
3711,287858,1,13,4,2,0,129
3712,287858,1,13,5,6,0,135
3713,287858,1,13,6,0,0,135
3714,287858,1,14,1,0,0,135
3715,287858,1,14,2,6,0,141
3716,287858,1,14,3,1,0,142
3717,287858,1,14,4,1,0,143
3718,287858,1,14,5,0,0,143
3719,287858,1,14,6,2,0,145
3720,287858,1,15,1,4,0,149
3721,287858,1,15,2,2,0,151
3722,287858,1,15,3,0,1,151
3723,287858,1,15,4,0,0,151
3724,287858,1,15,5,1,0,152
3725,287858,1,15,6,1,0,153
3726,287858,1,16,1,1,1,154
3727,287858,1,16,2,1,0,155
3728,287858,1,16,3,1,0,156
3729,287858,1,16,4,1,0,157
3730,287858,1,16,5,2,0,159
3731,287858,1,16,6,0,0,159
3732,287858,1,17,1,0,0,159
3733,287858,1,17,2,1,0,160
3734,287858,1,17,3,1,0,161
3735,287858,1,17,4,1,0,162
3736,287858,1,17,5,1,0,163
3737,287858,1,17,6,1,0,164
3738,287858,1,18,1,0,0,164
3739,287858,1,18,2,1,0,165
3740,287858,1,18,3,1,0,166
3741,287858,1,18,4,0,0,166
3742,287858,1,18,5,6,0,172
3743,287858,1,18,6,0,1,172
3744,287858,1,19,1,6,0,178
3745,287858,1,19,2,0,1,178
3746,287858,1,19,3,0,1,178
3747,287858,1,19,4,0,0,178
3748,287858,1,19,5,1,0,179
3749,287858,1,19,6,0,0,179
3750,287858,1,20,1,1,0,180
3751,287858,1,20,2,1,0,181
3752,287858,1,20,3,4,0,185
3753,287858,1,20,4,1,1,186
3754,287858,1,20,5,0,0,186
3755,287858,1,20,6,2,0,188
3876,287861,1,1,1,1,0,1
3877,287861,1,1,2,0,0,1
3878,287861,1,1,3,0,0,1
3879,287861,1,1,4,0,0,1
3880,287861,1,1,5,1,0,2
3881,287861,1,1,6,2,0,4
3882,287861,1,2,1,0,0,4
3883,287861,1,2,2,0,0,4
3884,287861,1,2,3,6,0,10
3885,287861,1,2,4,0,0,10
3886,287861,1,2,5,1,0,11
3887,287861,1,2,6,1,0,12
3888,287861,1,3,1,0,0,12
3889,287861,1,3,2,0,0,12
3890,287861,1,3,3,4,0,16
3891,287861,1,3,4,0,0,16
3892,287861,1,3,5,1,0,17
3893,287861,1,3,6,0,0,17
3894,287861,1,4,1,1,0,18
3895,287861,1,4,2,4,0,22
3896,287861,1,4,3,0,0,22
3897,287861,1,4,4,1,0,23
3898,287861,1,4,5,1,0,24
3899,287861,1,4,6,1,0,25
3900,287861,1,5,1,2,0,27
3901,287861,1,5,2,1,0,28
3902,287861,1,5,3,0,0,28
3903,287861,1,5,4,1,0,29
3904,287861,1,5,5,0,1,29
3905,287861,1,5,6,0,0,29
3906,287861,1,6,1,0,0,29
3907,287861,1,6,2,2,0,31
3908,287861,1,6,3,0,0,31
3909,287861,1,6,4,0,0,31
3910,287861,1,6,5,4,0,35
3911,287861,1,6,6,0,0,35
3912,287861,1,7,1,0,0,35
3913,287861,1,7,2,2,0,37
3914,287861,1,7,3,0,0,37
3915,287861,1,7,4,0,1,37
3916,287861,1,7,5,4,0,41
3917,287861,1,7,6,1,0,42
3918,287861,1,8,1,0,0,42
3919,287861,1,8,2,6,0,48
3920,287861,1,8,3,0,1,48
3921,287861,1,8,4,1,0,49
3922,287861,1,8,5,0,0,49
3923,287861,1,8,6,0,0,49
3924,287861,1,9,1,0,0,49
3925,287861,1,9,2,0,0,49
3926,287861,1,9,3,1,0,50
3927,287861,1,9,4,0,0,50
3928,287861,1,9,5,1,0,51
3929,287861,1,9,6,1,0,52
3930,287861,1,10,1,1,0,53
3931,287861,1,10,2,1,0,54
3932,287861,1,10,3,1,0,55
3933,287861,1,10,4,4,0,59
3934,287861,1,10,5,4,0,63
3935,287861,1,10,6,1,0,64
3936,287861,1,11,1,1,0,65
3937,287861,1,11,2,8,0,73
3938,287861,1,11,3,0,1,73
3939,287861,1,11,4,1,0,74
3940,287861,1,11,5,1,0,75
3941,287861,1,11,6,0,0,75
3942,287861,1,12,1,0,0,75
3943,287861,1,12,2,4,0,79
3944,287861,1,12,3,1,0,80
3945,287861,1,12,4,4,0,84
3946,287861,1,12,5,1,0,85
3947,287861,1,12,6,1,0,86
3948,287861,1,13,1,1,0,87
3949,287861,1,13,2,4,0,91
3950,287861,1,13,3,4,0,95
3951,287861,1,13,4,0,0,95
3952,287861,1,13,5,1,0,96
3953,287861,1,13,6,1,0,97
3954,287861,1,14,1,0,1,97
3955,287861,1,14,2,0,0,97
3956,287861,1,14,3,1,0,98
3957,287861,1,14,4,1,0,99
3958,287861,1,14,5,1,0,100
3959,287861,1,14,6,0,0,100
3960,287861,1,15,1,0,0,100
3961,287861,1,15,2,0,0,100
3962,287861,1,15,3,1,0,101
3963,287861,1,15,4,1,0,102
3964,287861,1,15,5,1,0,103
3965,287861,1,15,6,0,0,103
3966,287861,1,16,1,6,0,109
3967,287861,1,16,2,1,0,110
3968,287861,1,16,3,6,0,116
3969,287861,1,16,4,1,0,117
3970,287861,1,16,5,2,0,119
3971,287861,1,16,6,0,0,119
3972,287861,1,17,1,2,0,121
3973,287861,1,17,2,1,0,122
3974,287861,1,17,3,1,0,123
3975,287861,1,17,4,0,0,123
3976,287861,1,17,5,4,0,127
3977,287861,1,17,6,0,1,127
3978,287861,1,18,1,0,0,127
3979,287861,1,18,2,0,0,127
3980,287861,1,18,3,1,0,128
3981,287861,1,18,4,0,1,128
3982,287861,1,18,5,1,0,129
3983,287861,1,18,6,0,0,129
3984,287861,1,19,1,1,0,130
3985,287861,1,19,2,0,0,130
3986,287861,1,19,3,1,0,131
3987,287861,1,19,4,1,0,132
3988,287861,1,19,5,0,1,132
3989,287861,1,19,6,0,1,132
3990,287861,1,20,1,1,0,133
3991,287861,1,20,2,1,0,134
3992,287861,1,20,3,0,0,134
3993,287861,1,20,4,0,0,134
3994,287861,1,20,5,1,0,135
3995,287861,1,20,6,0,1,135
4085,287863,1,1,1,0,0,0
4086,287863,1,1,2,0,0,0
4087,287863,1,1,3,1,0,1
4088,287863,1,1,4,0,0,1
4089,287863,1,1,5,2,0,3
4090,287863,1,1,6,0,0,3
4091,287863,1,2,1,1,0,4
4092,287863,1,2,2,1,0,5
4093,287863,1,2,3,3,0,8
4094,287863,1,2,4,2,0,10
4095,287863,1,2,5,0,0,10
4096,287863,1,2,6,1,0,11
4097,287863,1,3,1,1,0,12
4098,287863,1,3,2,4,0,16
4099,287863,1,3,3,1,0,17
4100,287863,1,3,4,0,0,17
4101,287863,1,3,5,1,0,18
4102,287863,1,3,6,1,0,19
4103,287863,1,4,1,0,0,19
4104,287863,1,4,2,0,0,19
4105,287863,1,4,3,0,0,19
4106,287863,1,4,4,1,0,20
4107,287863,1,4,5,2,0,22
4108,287863,1,4,6,0,1,22
4109,287863,1,5,1,1,0,23
4110,287863,1,5,2,0,0,23
4111,287863,1,5,3,0,0,23
4112,287863,1,5,4,1,0,24
4113,287863,1,5,5,0,0,24
4114,287863,1,5,6,1,0,25
4115,287863,1,6,1,0,1,25
4116,287863,1,6,2,7,0,32
4117,287863,1,6,3,1,0,33
4118,287863,1,6,4,1,0,34
4119,287863,1,6,5,0,0,34
4120,287863,1,6,6,4,0,38
4121,287863,1,7,1,1,0,39
4122,287863,1,7,2,1,0,40
4123,287863,1,7,3,0,0,40
4124,287863,1,7,4,4,0,44
4125,287863,1,7,5,1,0,45
4126,287863,1,7,6,6,0,51
4127,287863,1,8,1,1,0,52
4128,287863,1,8,2,1,0,53
4129,287863,1,8,3,1,0,54
4130,287863,1,8,4,0,0,54
4131,287863,1,8,5,1,0,55
4132,287863,1,8,6,4,0,59
4133,287863,1,9,1,1,0,60
4134,287863,1,9,2,1,0,61
4135,287863,1,9,3,1,0,62
4136,287863,1,9,4,2,0,64
4137,287863,1,9,5,9,0,73
4138,287863,1,9,6,1,0,74
4139,287863,1,10,1,2,0,76
4140,287863,1,10,2,1,0,77
4141,287863,1,10,3,0,0,77
4142,287863,1,10,4,1,0,78
4143,287863,1,10,5,1,0,79
4144,287863,1,10,6,1,0,80
4145,287863,1,11,1,1,0,81
4146,287863,1,11,2,7,0,88
4147,287863,1,11,3,6,0,94
4148,287863,1,11,4,1,0,95
4149,287863,1,11,5,0,1,95
4150,287863,1,11,6,0,0,95
4151,287863,1,12,1,0,0,95
4152,287863,1,12,2,2,0,97
4153,287863,1,12,3,0,1,97
4154,287863,1,12,4,1,0,98
4155,287863,1,12,5,1,0,99
4156,287863,1,12,6,0,0,99
4157,287863,1,13,1,1,0,100
4158,287863,1,13,2,1,0,101
4159,287863,1,13,3,1,0,102
4160,287863,1,13,4,0,0,102
4161,287863,1,13,5,0,1,102
4162,287863,1,13,6,1,0,103
4163,287863,1,14,1,1,0,104
4164,287863,1,14,2,1,0,105
4165,287863,1,14,3,1,0,106
4166,287863,1,14,4,1,0,107
4167,287863,1,14,5,1,0,108
4168,287863,1,14,6,4,0,112
4169,287863,1,15,1,1,0,113
4170,287863,1,15,2,1,0,114
4171,287863,1,15,3,2,0,116
4172,287863,1,15,4,1,0,117
4173,287863,1,15,5,1,0,118
4174,287863,1,15,6,0,0,118
4175,287863,1,16,1,6,0,124
4176,287863,1,16,2,0,0,124
4177,287863,1,16,3,1,0,125
4178,287863,1,16,4,1,0,126
4179,287863,1,16,5,0,0,126
4180,287863,1,16,6,2,0,128
4181,287863,1,17,1,1,0,129
4182,287863,1,17,2,0,0,129
4183,287863,1,17,3,1,0,130
4184,287863,1,17,4,6,0,136
4185,287863,1,17,5,1,0,137
4186,287863,1,17,6,4,0,141
4187,287863,1,18,1,2,0,143
4188,287863,1,18,2,1,0,144
4189,287863,1,18,3,2,0,146
4190,287863,1,18,4,0,0,146
4191,287863,1,18,5,0,0,146
4192,287863,1,18,6,2,0,148
4193,287863,1,19,1,0,0,148
4194,287863,1,19,2,4,0,152
4195,287863,1,19,3,0,0,152
4196,287863,1,19,4,1,0,153
4197,287863,1,19,5,0,1,153
4198,287863,1,19,6,1,0,154
4199,287863,1,20,1,1,0,155
4200,287863,1,20,2,0,0,155
4201,287863,1,20,3,6,0,161
4202,287863,1,20,4,1,0,162
4203,287863,1,20,5,1,0,163
4204,287863,1,20,6,1,1,164
4318,287864,1,1,1,4,0,4
4319,287864,1,1,2,0,0,4
4320,287864,1,1,3,0,0,4
4321,287864,1,1,4,4,0,8
4322,287864,1,1,5,0,0,8
4323,287864,1,1,6,0,0,8
4324,287864,1,2,1,0,1,8
4325,287864,1,2,2,0,0,8
4326,287864,1,2,3,0,0,8
4327,287864,1,2,4,6,0,14
4328,287864,1,2,5,6,0,20
4329,287864,1,2,6,4,0,24
4330,287864,1,3,1,0,1,24
4331,287864,1,3,2,6,0,30
4332,287864,1,3,3,4,0,34
4333,287864,1,3,4,0,1,34
4334,287864,1,3,5,4,0,38
4335,287864,1,3,6,1,0,39
4336,287864,1,4,1,4,0,43
4337,287864,1,4,2,2,0,45
4338,287864,1,4,3,0,0,45
4339,287864,1,4,4,4,0,49
4340,287864,1,4,5,1,0,50
4341,287864,1,4,6,4,0,54
4342,287864,1,5,1,4,0,58
4343,287864,1,5,2,0,1,58
4344,287864,1,5,3,1,0,59
4345,287864,1,5,4,0,0,59
4346,287864,1,5,5,1,0,60
4347,287864,1,5,6,0,0,60
4348,287864,1,6,1,2,0,62
4349,287864,1,6,2,0,0,62
4350,287864,1,6,3,1,0,63
4351,287864,1,6,4,0,0,63
4352,287864,1,6,5,1,0,64
4353,287864,1,6,6,1,0,65
4354,287864,1,7,1,0,0,65
4355,287864,1,7,2,4,0,69
4356,287864,1,7,3,4,0,73
4357,287864,1,7,4,1,0,74
4358,287864,1,7,5,1,0,75
4359,287864,1,7,6,1,0,76
4360,287864,1,8,1,1,0,77
4361,287864,1,8,2,0,1,77
4362,287864,1,8,3,1,0,78
4363,287864,1,8,4,0,0,78
4364,287864,1,8,5,0,0,78
4365,287864,1,8,6,0,0,78
4366,287864,1,9,1,0,0,78
4367,287864,1,9,2,0,0,78
4368,287864,1,9,3,1,0,79
4369,287864,1,9,4,0,0,79
4370,287864,1,9,5,6,0,85
4371,287864,1,9,6,6,0,91
4372,287864,1,10,1,0,0,91
4373,287864,1,10,2,0,0,91
4374,287864,1,10,3,0,0,91
4375,287864,1,10,4,3,0,94
4376,287864,1,10,5,2,0,96
4377,287864,1,10,6,0,0,96
4378,287864,1,11,1,0,0,96
4379,287864,1,11,2,4,0,100
4380,287864,1,11,3,1,0,101
4381,287864,1,11,4,0,1,101
4382,287864,1,11,5,0,0,101
4383,287864,1,11,6,0,0,101
4384,287864,1,12,1,1,0,102
4385,287864,1,12,2,0,0,102
4386,287864,1,12,3,0,0,102
4387,287864,1,12,4,0,0,102
4388,287864,1,12,5,0,0,102
4389,287864,1,12,6,1,0,103
4390,287864,1,13,1,0,0,103
4391,287864,1,13,2,1,0,104
4392,287864,1,13,3,0,0,104
4393,287864,1,13,4,0,0,104
4394,287864,1,13,5,0,0,104
4395,287864,1,13,6,0,0,104
4396,287864,1,14,1,1,0,105
4397,287864,1,14,2,0,0,105
4398,287864,1,14,3,0,0,105
4399,287864,1,14,4,1,0,106
4400,287864,1,14,5,2,0,108
4401,287864,1,14,6,0,0,108
4402,287864,1,15,1,1,0,109
4403,287864,1,15,2,1,0,110
4404,287864,1,15,3,1,0,111
4405,287864,1,15,4,6,0,117
4406,287864,1,15,5,1,0,118
4407,287864,1,15,6,1,0,119
4408,287864,1,16,1,0,0,119
4409,287864,1,16,2,0,0,119
4410,287864,1,16,3,0,1,119
4411,287864,1,16,4,0,0,119
4412,287864,1,16,5,0,0,119
4413,287864,1,16,6,1,0,120
4414,287864,1,17,1,1,0,121
4415,287864,1,17,2,1,0,122
4416,287864,1,17,3,0,0,122
4417,287864,1,17,4,0,0,122
4418,287864,1,17,5,1,0,123
4419,287864,1,17,6,2,0,125
4420,287864,1,18,1,6,0,131
4421,287864,1,18,2,0,1,131
4422,287864,1,18,3,0,0,131
4423,287864,1,18,4,0,0,131
4424,287864,1,18,5,1,0,132
4425,287864,1,18,6,1,0,133
4426,287864,1,19,1,0,0,133
4427,287864,1,19,2,1,0,134
4428,287864,1,19,3,0,1,134
4429,287864,1,19,4,0,0,134
4430,287864,1,19,5,0,0,134
4431,287864,1,19,6,4,0,138
4432,287864,1,20,1,2,0,140
4433,287864,1,20,2,4,0,144
4434,287864,1,20,3,0,1,144
4548,287865,1,1,1,1,0,1
4549,287865,1,1,2,1,0,2
4550,287865,1,1,3,0,0,2
4551,287865,1,1,4,1,0,3
4552,287865,1,1,5,0,0,3
4553,287865,1,1,6,4,0,7
4554,287865,1,2,1,1,0,8
4555,287865,1,2,2,0,0,8
4556,287865,1,2,3,1,0,9
4557,287865,1,2,4,1,0,10
4558,287865,1,2,5,1,0,11
4559,287865,1,2,6,0,1,11
4560,287865,1,3,1,4,0,15
4561,287865,1,3,2,0,0,15
4562,287865,1,3,3,0,0,15
4563,287865,1,3,4,4,0,19
4564,287865,1,3,5,4,0,23
4565,287865,1,3,6,0,0,23
4566,287865,1,4,1,2,0,25
4567,287865,1,4,2,5,0,30
4568,287865,1,4,3,4,0,34
4569,287865,1,4,4,0,0,34
4570,287865,1,4,5,0,0,34
4571,287865,1,4,6,0,0,34
4572,287865,1,5,1,0,0,34
4573,287865,1,5,2,0,0,34
4574,287865,1,5,3,1,0,35
4575,287865,1,5,4,1,0,36
4576,287865,1,5,5,0,0,36
4577,287865,1,5,6,0,0,36
4578,287865,1,6,1,4,0,40
4579,287865,1,6,2,4,0,44
4580,287865,1,6,3,1,0,45
4581,287865,1,6,4,1,0,46
4582,287865,1,6,5,1,0,47
4583,287865,1,6,6,1,0,48
4584,287865,1,7,1,0,0,48
4585,287865,1,7,2,2,0,50
4586,287865,1,7,3,0,0,50
4587,287865,1,7,4,0,0,50
4588,287865,1,7,5,6,0,56
4589,287865,1,7,6,1,0,57
4590,287865,1,8,1,4,0,61
4591,287865,1,8,2,1,0,62
4592,287865,1,8,3,0,0,62
4593,287865,1,8,4,1,0,63
4594,287865,1,8,5,1,0,64
4595,287865,1,8,6,1,0,65
4596,287865,1,9,1,3,0,68
4597,287865,1,9,2,1,0,69
4598,287865,1,9,3,0,0,69
4599,287865,1,9,4,0,0,69
4600,287865,1,9,5,0,0,69
4601,287865,1,9,6,0,1,69
4602,287865,1,10,1,1,0,70
4603,287865,1,10,2,0,0,70
4604,287865,1,10,3,1,0,71
4605,287865,1,10,4,2,0,73
4606,287865,1,10,5,0,0,73
4607,287865,1,10,6,4,0,77
4608,287865,1,11,1,6,0,83
4609,287865,1,11,2,1,0,84
4610,287865,1,11,3,1,0,85
4611,287865,1,11,4,0,0,85
4612,287865,1,11,5,1,0,86
4613,287865,1,11,6,0,1,86
4614,287865,1,12,1,0,0,86
4615,287865,1,12,2,1,0,87
4616,287865,1,12,3,2,0,89
4617,287865,1,12,4,0,0,89
4618,287865,1,12,5,0,1,89
4619,287865,1,12,6,0,0,89
4620,287865,1,13,1,1,0,90
4621,287865,1,13,2,0,0,90
4622,287865,1,13,3,1,0,91
4623,287865,1,13,4,0,1,91
4624,287865,1,13,5,1,0,92
4625,287865,1,13,6,2,0,94
4626,287865,1,14,1,4,0,98
4627,287865,1,14,2,1,0,99
4628,287865,1,14,3,2,0,101
4629,287865,1,14,4,1,0,102
4630,287865,1,14,5,1,0,103
4631,287865,1,14,6,1,0,104
4632,287865,1,15,1,1,0,105
4633,287865,1,15,2,4,0,109
4634,287865,1,15,3,1,0,110
4635,287865,1,15,4,0,0,110
4636,287865,1,15,5,2,0,112
4637,287865,1,15,6,0,0,112
4638,287865,1,16,1,6,0,118
4639,287865,1,16,2,6,0,124
4640,287865,1,16,3,1,0,125
4641,287865,1,16,4,6,0,131
4642,287865,1,16,5,4,0,135
4643,287865,1,16,6,2,0,137
4644,287865,1,17,1,2,0,139
4645,287865,1,17,2,1,0,140
4646,287865,1,17,3,1,0,141
4647,287865,1,17,4,1,0,142
4648,287865,1,17,5,2,0,144
4649,287865,1,17,6,1,0,145
4650,287865,1,18,1,6,0,151
4651,287865,1,18,2,6,0,157
4652,287865,1,18,3,1,0,158
4653,287865,1,18,4,0,0,158
4654,287865,1,18,5,6,0,164
4655,287865,1,18,6,0,1,164
4656,287865,1,19,1,4,0,168
4657,287865,1,19,2,4,0,172
4658,287865,1,19,3,4,0,176
4659,287865,1,19,4,3,0,179
4660,287865,1,19,5,6,0,185
4661,287865,1,19,6,0,0,185
4662,287865,1,20,1,0,1,185
4663,287865,1,20,2,4,0,189
4664,287865,1,20,3,0,1,189
4665,287865,1,20,4,1,0,190
4666,287865,1,20,5,0,1,190
4667,287865,1,20,6,0,1,190
4788,287866,1,1,1,0,0,0
4789,287866,1,1,2,0,0,0
4790,287866,1,1,3,0,0,0
4791,287866,1,1,4,1,0,1
4792,287866,1,1,5,0,0,1
4793,287866,1,1,6,1,0,2
4794,287866,1,2,1,0,0,2
4795,287866,1,2,2,1,0,3
4796,287866,1,2,3,0,0,3
4797,287866,1,2,4,1,0,4
4798,287866,1,2,5,1,0,5
4799,287866,1,2,6,0,0,5
4800,287866,1,3,1,1,0,6
4801,287866,1,3,2,0,0,6
4802,287866,1,3,3,4,0,10
4803,287866,1,3,4,0,0,10
4804,287866,1,3,5,2,0,12
4805,287866,1,3,6,4,0,16
4806,287866,1,4,1,0,0,16
4807,287866,1,4,2,0,0,16
4808,287866,1,4,3,1,0,17
4809,287866,1,4,4,0,0,17
4810,287866,1,4,5,0,0,17
4811,287866,1,4,6,1,0,18
4812,287866,1,5,1,0,0,18
4813,287866,1,5,2,0,0,18
4814,287866,1,5,3,2,0,20
4815,287866,1,5,4,4,0,24
4816,287866,1,5,5,1,0,25
4817,287866,1,5,6,0,0,25
4818,287866,1,6,1,0,0,25
4819,287866,1,6,2,0,0,25
4820,287866,1,6,3,0,0,25
4821,287866,1,6,4,1,0,26
4822,287866,1,6,5,5,0,31
4823,287866,1,6,6,0,0,31
4824,287866,1,7,1,4,0,35
4825,287866,1,7,2,1,0,36
4826,287866,1,7,3,0,0,36
4827,287866,1,7,4,1,0,37
4828,287866,1,7,5,3,0,40
4829,287866,1,7,6,0,1,40
4830,287866,1,8,1,0,0,40
4831,287866,1,8,2,1,0,41
4832,287866,1,8,3,1,0,42
4833,287866,1,8,4,1,0,43
4834,287866,1,8,5,0,0,43
4835,287866,1,8,6,1,0,44
4836,287866,1,9,1,0,0,44
4837,287866,1,9,2,1,0,45
4838,287866,1,9,3,6,0,51
4839,287866,1,9,4,1,0,52
4840,287866,1,9,5,5,0,57
4841,287866,1,9,6,0,0,57
4842,287866,1,10,1,1,0,58
4843,287866,1,10,2,1,0,59
4844,287866,1,10,3,1,0,60
4845,287866,1,10,4,2,0,62
4846,287866,1,10,5,1,0,63
4847,287866,1,10,6,0,0,63
4848,287866,1,11,1,0,0,63
4849,287866,1,11,2,1,0,64
4850,287866,1,11,3,0,0,64
4851,287866,1,11,4,1,0,65
4852,287866,1,11,5,0,1,65
4853,287866,1,11,6,1,0,66
4854,287866,1,12,1,1,0,67
4855,287866,1,12,2,1,0,68
4856,287866,1,12,3,4,0,72
4857,287866,1,12,4,0,0,72
4858,287866,1,12,5,0,0,72
4859,287866,1,12,6,1,0,73
4860,287866,1,13,1,2,0,75
4861,287866,1,13,2,4,0,79
4862,287866,1,13,3,0,0,79
4863,287866,1,13,4,1,0,80
4864,287866,1,13,5,1,0,81
4865,287866,1,13,6,1,0,82
4866,287866,1,14,1,0,1,82
4867,287866,1,14,2,0,0,82
4868,287866,1,14,3,1,0,83
4869,287866,1,14,4,1,0,84
4870,287866,1,14,5,1,0,85
4871,287866,1,14,6,1,0,86
4872,287866,1,15,1,2,0,88
4873,287866,1,15,2,0,0,88
4874,287866,1,15,3,1,0,89
4875,287866,1,15,4,0,0,89
4876,287866,1,15,5,0,0,89
4877,287866,1,15,6,2,0,91
4878,287866,1,16,1,6,0,97
4879,287866,1,16,2,1,0,98
4880,287866,1,16,3,1,0,99
4881,287866,1,16,4,4,0,103
4882,287866,1,16,5,0,0,103
4883,287866,1,16,6,0,0,103
4884,287866,1,17,1,4,0,107
4885,287866,1,17,2,1,0,108
4886,287866,1,17,3,0,1,108
4887,287866,1,17,4,0,1,108
4888,287866,1,17,5,0,1,108
4889,287866,1,17,6,4,0,112
4890,287866,1,18,1,0,0,112
4891,287866,1,18,2,0,0,112
4892,287866,1,18,3,1,0,113
4893,287866,1,18,4,1,0,114
4894,287866,1,18,5,0,0,114
4895,287866,1,18,6,0,0,114
4896,287866,1,19,1,0,0,114
4897,287866,1,19,2,1,0,115
4898,287866,1,19,3,3,0,118
4899,287866,1,19,4,0,0,118
4900,287866,1,19,5,0,0,118
4901,287866,1,19,6,1,0,119
4902,287866,1,20,1,0,0,119
4903,287866,1,20,2,1,0,120
4904,287866,1,20,3,0,1,120
4905,287866,1,20,4,0,1,120
4906,287866,1,20,5,2,0,122
4907,287866,1,20,6,1,0,123
4991,287867,1,1,1,1,0,1
4992,287867,1,1,2,0,0,1
4993,287867,1,1,3,0,0,1
4994,287867,1,1,4,3,0,4
4995,287867,1,1,5,4,0,8
4996,287867,1,1,6,0,0,8
4997,287867,1,2,1,0,1,8
4998,287867,1,2,2,0,0,8
4999,287867,1,2,3,0,0,8
5000,287867,1,2,4,4,0,12
5001,287867,1,2,5,4,0,16
5002,287867,1,2,6,2,0,18
5003,287867,1,3,1,0,0,18
5004,287867,1,3,2,4,0,22
5005,287867,1,3,3,1,0,23
5006,287867,1,3,4,0,0,23
5007,287867,1,3,5,0,0,23
5008,287867,1,3,6,0,0,23
5009,287867,1,4,1,0,0,23
5010,287867,1,4,2,4,0,27
5011,287867,1,4,3,0,0,27
5012,287867,1,4,4,0,0,27
5013,287867,1,4,5,4,0,31
5014,287867,1,4,6,1,0,32
5015,287867,1,5,1,1,1,33
5016,287867,1,5,2,0,0,33
5017,287867,1,5,3,4,0,37
5018,287867,1,5,4,0,0,37
5019,287867,1,5,5,4,0,41
5020,287867,1,5,6,1,0,42
5021,287867,1,6,1,0,1,42
5022,287867,1,6,2,1,0,43
5023,287867,1,6,3,0,0,43
5024,287867,1,6,4,0,0,43
5025,287867,1,6,5,0,0,43
5026,287867,1,6,6,0,0,43
5027,287867,1,7,1,0,0,43
5028,287867,1,7,2,0,0,43
5029,287867,1,7,3,4,0,47
5030,287867,1,7,4,1,0,48
5031,287867,1,7,5,1,0,49
5032,287867,1,7,6,0,0,49
5033,287867,1,8,1,0,0,49
5034,287867,1,8,2,3,0,52
5035,287867,1,8,3,1,0,53
5036,287867,1,8,4,0,0,53
5037,287867,1,8,5,0,0,53
5038,287867,1,8,6,1,0,54
5039,287867,1,9,1,1,0,55
5040,287867,1,9,2,0,0,55
5041,287867,1,9,3,0,0,55
5042,287867,1,9,4,1,0,56
5043,287867,1,9,5,0,0,56
5044,287867,1,9,6,0,0,56
5045,287867,1,10,1,1,0,57
5046,287867,1,10,2,1,0,58
5047,287867,1,10,3,1,0,59
5048,287867,1,10,4,2,0,61
5049,287867,1,10,5,1,0,62
5050,287867,1,10,6,6,0,68
5051,287867,1,11,1,4,0,72
5052,287867,1,11,2,1,0,73
5053,287867,1,11,3,1,0,74
5054,287867,1,11,4,1,0,75
5055,287867,1,11,5,1,0,76
5056,287867,1,11,6,1,0,77
5057,287867,1,12,1,4,0,81
5058,287867,1,12,2,1,0,82
5059,287867,1,12,3,1,0,83
5060,287867,1,12,4,0,0,83
5061,287867,1,12,5,2,0,85
5062,287867,1,12,6,1,0,86
5063,287867,1,13,1,1,0,87
5064,287867,1,13,2,0,0,87
5065,287867,1,13,3,1,0,88
5066,287867,1,13,4,0,0,88
5067,287867,1,13,5,1,0,89
5068,287867,1,13,6,0,0,89
5069,287867,1,14,1,1,0,90
5070,287867,1,14,2,1,0,91
5071,287867,1,14,3,0,1,91
5072,287867,1,14,4,0,0,91
5073,287867,1,14,5,0,0,91
5074,287867,1,14,6,0,0,91
5075,287867,1,15,1,0,1,91
5076,287867,1,15,2,1,0,92
5077,287867,1,15,3,0,0,92
5078,287867,1,15,4,0,0,92
5079,287867,1,15,5,1,0,93
5080,287867,1,15,6,1,0,94
5081,287867,1,16,1,0,1,94
5082,287867,1,16,2,1,0,95
5083,287867,1,16,3,1,0,96
5084,287867,1,16,4,6,0,102
5085,287867,1,16,5,1,0,103
5086,287867,1,16,6,1,0,104
5087,287867,1,17,1,2,0,106
5088,287867,1,17,2,0,0,106
5089,287867,1,17,3,1,0,107
5090,287867,1,17,4,1,0,108
5091,287867,1,17,5,4,0,112
5092,287867,1,17,6,0,0,112
5093,287867,1,18,1,1,0,113
5094,287867,1,18,2,1,0,114
5095,287867,1,18,3,1,0,115
5096,287867,1,18,4,6,0,121
5097,287867,1,18,5,6,0,127
5098,287867,1,18,6,6,0,133
5099,287867,1,19,1,0,1,133
5100,287867,1,19,2,1,0,134
5101,287867,1,19,3,1,0,135
5102,287867,1,19,4,6,0,141
5103,287867,1,19,5,0,0,141
5104,287867,1,19,6,4,0,145
5105,287867,1,20,1,1,0,146
5106,287867,1,20,2,1,0,147
5107,287867,1,20,3,4,0,151
5108,287867,1,20,4,2,0,153
5109,287867,1,20,5,1,0,154
5110,287867,1,20,6,0,1,154
5231,287868,1,1,1,0,0,0
5232,287868,1,1,2,4,0,4
5233,287868,1,1,3,1,0,5
5234,287868,1,1,4,1,0,6
5235,287868,1,1,5,0,0,6
5236,287868,1,1,6,1,0,7
5237,287868,1,2,1,0,0,7
5238,287868,1,2,2,3,0,10
5239,287868,1,2,3,0,0,10
5240,287868,1,2,4,1,0,11
5241,287868,1,2,5,6,0,17
5242,287868,1,2,6,0,0,17
5243,287868,1,3,1,2,0,19
5244,287868,1,3,2,0,0,19
5245,287868,1,3,3,2,0,21
5246,287868,1,3,4,0,0,21
5247,287868,1,3,5,1,0,22
5248,287868,1,3,6,0,1,22
5249,287868,1,4,1,0,0,22
5250,287868,1,4,2,0,1,22
5251,287868,1,4,3,0,0,22
5252,287868,1,4,4,0,0,22
5253,287868,1,4,5,1,0,23
5254,287868,1,4,6,1,0,24
5255,287868,1,5,1,0,0,24
5256,287868,1,5,2,0,0,24
5257,287868,1,5,3,4,0,28
5258,287868,1,5,4,4,0,32
5259,287868,1,5,5,1,0,33
5260,287868,1,5,6,0,0,33
5261,287868,1,6,1,0,0,33
5262,287868,1,6,2,0,0,33
5263,287868,1,6,3,0,0,33
5264,287868,1,6,4,0,0,33
5265,287868,1,6,5,0,1,33
5266,287868,1,6,6,0,0,33
5267,287868,1,7,1,0,0,33
5268,287868,1,7,2,0,0,33
5269,287868,1,7,3,1,0,34
5270,287868,1,7,4,1,0,35
5271,287868,1,7,5,2,0,37
5272,287868,1,7,6,0,0,37
5273,287868,1,8,1,1,0,38
5274,287868,1,8,2,3,0,41
5275,287868,1,8,3,4,0,45
5276,287868,1,8,4,1,0,46
5277,287868,1,8,5,2,0,48
5278,287868,1,8,6,1,0,49
5279,287868,1,9,1,1,0,50
5280,287868,1,9,2,1,0,51
5281,287868,1,9,3,4,0,55
5282,287868,1,9,4,1,0,56
5283,287868,1,9,5,1,0,57
5284,287868,1,9,6,6,0,63
5285,287868,1,10,1,0,0,63
5286,287868,1,10,2,0,0,63
5287,287868,1,10,3,1,0,64
5288,287868,1,10,4,4,0,68
5289,287868,1,10,5,1,0,69
5290,287868,1,10,6,0,0,69
5291,287868,1,11,1,2,0,71
5292,287868,1,11,2,1,0,72
5293,287868,1,11,3,1,0,73
5294,287868,1,11,4,2,0,75
5295,287868,1,11,5,4,0,79
5296,287868,1,11,6,2,0,81
5297,287868,1,12,1,2,0,83
5298,287868,1,12,2,2,0,85
5299,287868,1,12,3,1,0,86
5300,287868,1,12,4,1,0,87
5301,287868,1,12,5,1,0,88
5302,287868,1,12,6,1,0,89
5303,287868,1,13,1,1,0,90
5304,287868,1,13,2,6,0,96
5305,287868,1,13,3,4,0,100
5306,287868,1,13,4,6,0,106
5307,287868,1,13,5,2,0,108
5308,287868,1,13,6,1,0,109
5309,287868,1,14,1,6,0,115
5310,287868,1,14,2,1,0,116
5311,287868,1,14,3,2,0,118
5312,287868,1,14,4,0,0,118
5313,287868,1,14,5,1,0,119
5314,287868,1,14,6,2,0,121
5315,287868,1,15,1,1,0,122
5316,287868,1,15,2,5,0,127
5317,287868,1,15,3,6,0,133
5318,287868,1,15,4,1,0,134
5319,287868,1,15,5,0,0,134
5320,287868,1,15,6,0,1,134
5321,287868,1,16,1,1,0,135
5322,287868,1,16,2,1,0,136
5323,287868,1,16,3,1,0,137
5324,287868,1,16,4,6,0,143
5325,287868,1,16,5,2,0,145
5326,287868,1,16,6,2,0,147
5327,287868,1,17,1,3,0,150
5328,287868,1,17,2,1,0,151
5329,287868,1,17,3,1,0,152
5330,287868,1,17,4,0,1,152
5331,287868,1,17,5,2,0,154
5332,287868,1,17,6,4,0,158
5333,287868,1,18,1,0,0,158
5334,287868,1,18,2,0,0,158
5335,287868,1,18,3,0,0,158
5336,287868,1,18,4,2,0,160
5337,287868,1,18,5,0,0,160
5338,287868,1,18,6,4,0,164
5339,287868,1,19,1,1,0,165
5340,287868,1,19,2,1,0,166
5341,287868,1,19,3,4,0,170
5342,287868,1,19,4,0,1,170
5343,287868,1,19,5,0,0,170
5344,287868,1,19,6,1,0,171
5345,287868,1,20,1,2,0,173
5346,287868,1,20,2,6,0,179
5347,287868,1,20,3,1,0,180
5348,287868,1,20,4,2,0,182
5349,287868,1,20,5,1,0,183
5350,287868,1,20,6,6,0,189
5471,287869,1,1,1,3,0,3
5472,287869,1,1,2,4,0,7
5473,287869,1,1,3,0,0,7
5474,287869,1,1,4,0,0,7
5475,287869,1,1,5,0,0,7
5476,287869,1,1,6,0,1,7
5477,287869,1,2,1,0,0,7
5478,287869,1,2,2,0,0,7
5479,287869,1,2,3,2,0,9
5480,287869,1,2,4,2,0,11
5481,287869,1,2,5,4,0,15
5482,287869,1,2,6,1,0,16
5483,287869,1,3,1,0,0,16
5484,287869,1,3,2,0,1,16
5485,287869,1,3,3,0,0,16
5486,287869,1,3,4,1,0,17
5487,287869,1,3,5,1,0,18
5488,287869,1,3,6,1,0,19
5489,287869,1,4,1,0,0,19
5490,287869,1,4,2,6,0,25
5491,287869,1,4,3,0,0,25
5492,287869,1,4,4,0,0,25
5493,287869,1,4,5,0,1,25
5494,287869,1,4,6,1,0,26
5495,287869,1,5,1,0,0,26
5496,287869,1,5,2,0,0,26
5497,287869,1,5,3,1,0,27
5498,287869,1,5,4,1,0,28
5499,287869,1,5,5,0,0,28
5500,287869,1,5,6,1,0,29
5501,287869,1,6,1,0,0,29
5502,287869,1,6,2,1,0,30
5503,287869,1,6,3,0,0,30
5504,287869,1,6,4,1,0,31
5505,287869,1,6,5,0,1,31
5506,287869,1,6,6,0,0,31
5507,287869,1,7,1,0,0,31
5508,287869,1,7,2,2,0,33
5509,287869,1,7,3,0,0,33
5510,287869,1,7,4,0,0,33
5511,287869,1,7,5,0,0,33
5512,287869,1,7,6,1,0,34
5513,287869,1,8,1,0,0,34
5514,287869,1,8,2,0,0,34
5515,287869,1,8,3,0,0,34
5516,287869,1,8,4,0,0,34
5517,287869,1,8,5,0,0,34
5518,287869,1,8,6,1,0,35
5519,287869,1,9,1,1,0,36
5520,287869,1,9,2,1,0,37
5521,287869,1,9,3,1,0,38
5522,287869,1,9,4,1,0,39
5523,287869,1,9,5,0,0,39
5524,287869,1,9,6,1,0,40
5525,287869,1,10,1,6,0,46
5526,287869,1,10,2,6,0,52
5527,287869,1,10,3,6,0,58
5528,287869,1,10,4,0,0,58
5529,287869,1,10,5,1,0,59
5530,287869,1,10,6,1,0,60
5531,287869,1,11,1,1,0,61
5532,287869,1,11,2,1,0,62
5533,287869,1,11,3,2,0,64
5534,287869,1,11,4,6,0,70
5535,287869,1,11,5,1,0,71
5536,287869,1,11,6,1,0,72
5537,287869,1,12,1,6,0,78
5538,287869,1,12,2,1,0,79
5539,287869,1,12,3,0,0,79
5540,287869,1,12,4,4,0,83
5541,287869,1,12,5,0,0,83
5542,287869,1,12,6,1,0,84
5543,287869,1,13,1,1,0,85
5544,287869,1,13,2,0,0,85
5545,287869,1,13,3,4,0,89
5546,287869,1,13,4,1,0,90
5547,287869,1,13,5,1,1,91
5548,287869,1,13,6,1,0,92
5549,287869,1,14,1,2,0,94
5550,287869,1,14,2,1,0,95
5551,287869,1,14,3,2,0,97
5552,287869,1,14,4,1,0,98
5553,287869,1,14,5,1,0,99
5554,287869,1,14,6,1,0,100
5555,287869,1,15,1,6,0,106
5556,287869,1,15,2,2,0,108
5557,287869,1,15,3,4,0,112
5558,287869,1,15,4,1,0,113
5559,287869,1,15,5,1,0,114
5560,287869,1,15,6,0,0,114
5561,287869,1,16,1,1,0,115
5562,287869,1,16,2,2,0,117
5563,287869,1,16,3,4,0,121
5564,287869,1,16,4,6,0,127
5565,287869,1,16,5,6,0,133
5566,287869,1,16,6,1,0,134
5567,287869,1,17,1,0,0,134
5568,287869,1,17,2,0,1,134
5569,287869,1,17,3,4,0,138
5570,287869,1,17,4,0,1,138
5571,287869,1,17,5,1,0,139
5572,287869,1,17,6,1,0,140
5573,287869,1,18,1,3,0,143
5574,287869,1,18,2,1,0,144
5575,287869,1,18,3,1,0,145
5576,287869,1,18,4,0,1,145
5577,287869,1,18,5,0,0,145
5578,287869,1,18,6,1,0,146
5579,287869,1,19,1,1,0,147
5580,287869,1,19,2,1,0,148
5581,287869,1,19,3,1,0,149
5582,287869,1,19,4,1,0,150
5583,287869,1,19,5,2,0,152
5584,287869,1,19,6,0,0,152
5585,287869,1,20,1,1,0,153
5586,287869,1,20,2,1,0,154
5587,287869,1,20,3,4,0,158
5588,287869,1,20,4,4,0,162
5589,287869,1,20,5,1,0,163
5590,287869,1,20,6,1,1,164
5711,287870,1,1,1,4,0,4
5712,287870,1,1,2,1,0,5
5713,287870,1,1,3,0,0,5
5714,287870,1,1,4,1,0,6
5715,287870,1,1,5,0,0,6
5716,287870,1,1,6,2,0,8
5717,287870,1,2,1,0,0,8
5718,287870,1,2,2,0,0,8
5719,287870,1,2,3,0,1,8
5720,287870,1,2,4,0,0,8
5721,287870,1,2,5,1,0,9
5722,287870,1,2,6,4,0,13
5723,287870,1,3,1,1,0,14
5724,287870,1,3,2,0,0,14
5725,287870,1,3,3,4,0,18
5726,287870,1,3,4,5,0,23
5727,287870,1,3,5,4,0,27
5728,287870,1,3,6,2,0,29
5729,287870,1,4,1,2,0,31
5730,287870,1,4,2,0,0,31
5731,287870,1,4,3,1,0,32
5732,287870,1,4,4,0,1,32
5733,287870,1,4,5,1,0,33
5734,287870,1,4,6,1,0,34
5735,287870,1,5,1,0,0,34
5736,287870,1,5,2,1,0,35
5737,287870,1,5,3,1,0,36
5738,287870,1,5,4,1,0,37
5739,287870,1,5,5,1,0,38
5740,287870,1,5,6,4,0,42
5741,287870,1,6,1,4,0,46
5742,287870,1,6,2,1,0,47
5743,287870,1,6,3,0,0,47
5744,287870,1,6,4,4,0,51
5745,287870,1,6,5,4,0,55
5746,287870,1,6,6,3,0,58
5747,287870,1,7,1,0,0,58
5748,287870,1,7,2,4,0,62
5749,287870,1,7,3,1,0,63
5750,287870,1,7,4,4,0,67
5751,287870,1,7,5,0,0,67
5752,287870,1,7,6,4,0,71
5753,287870,1,8,1,4,0,75
5754,287870,1,8,2,0,0,75
5755,287870,1,8,3,1,0,76
5756,287870,1,8,4,1,0,77
5757,287870,1,8,5,0,0,77
5758,287870,1,8,6,2,0,79
5759,287870,1,9,1,0,0,79
5760,287870,1,9,2,0,0,79
5761,287870,1,9,3,0,0,79
5762,287870,1,9,4,1,0,80
5763,287870,1,9,5,0,1,80
5764,287870,1,9,6,0,0,80
5765,287870,1,10,1,1,0,81
5766,287870,1,10,2,0,0,81
5767,287870,1,10,3,1,0,82
5768,287870,1,10,4,1,0,83
5769,287870,1,10,5,1,0,84
5770,287870,1,10,6,1,0,85
5771,287870,1,11,1,2,0,87
5772,287870,1,11,2,1,0,88
5773,287870,1,11,3,1,0,89
5774,287870,1,11,4,1,0,90
5775,287870,1,11,5,1,0,91
5776,287870,1,11,6,1,0,92
5777,287870,1,12,1,0,1,92
5778,287870,1,12,2,1,0,93
5779,287870,1,12,3,1,0,94
5780,287870,1,12,4,1,0,95
5781,287870,1,12,5,0,0,95
5782,287870,1,12,6,4,0,99
5783,287870,1,13,1,0,0,99
5784,287870,1,13,2,0,0,99
5785,287870,1,13,3,1,0,100
5786,287870,1,13,4,0,0,100
5787,287870,1,13,5,1,0,101
5788,287870,1,13,6,0,0,101
5789,287870,1,14,1,1,0,102
5790,287870,1,14,2,2,0,104
5791,287870,1,14,3,4,0,108
5792,287870,1,14,4,2,0,110
5793,287870,1,14,5,1,0,111
5794,287870,1,14,6,1,0,112
5795,287870,1,15,1,3,0,115
5796,287870,1,15,2,1,0,116
5797,287870,1,15,3,1,0,117
5798,287870,1,15,4,2,0,119
5799,287870,1,15,5,4,0,123
5800,287870,1,15,6,0,0,123
5801,287870,1,16,1,2,0,125
5802,287870,1,16,2,6,0,131
5803,287870,1,16,3,1,0,132
5804,287870,1,16,4,1,0,133
5805,287870,1,16,5,1,0,134
5806,287870,1,16,6,4,0,138
5807,287870,1,17,1,4,0,142
5808,287870,1,17,2,4,0,146
5809,287870,1,17,3,1,0,147
5810,287870,1,17,4,1,0,148
5811,287870,1,17,5,1,0,149
5812,287870,1,17,6,1,0,150
5813,287870,1,18,1,2,0,152
5814,287870,1,18,2,1,0,153
5815,287870,1,18,3,1,0,154
5816,287870,1,18,4,1,0,155
5817,287870,1,18,5,0,1,155
5818,287870,1,18,6,1,0,156
5819,287870,1,19,1,2,0,158
5820,287870,1,19,2,0,0,158
5821,287870,1,19,3,1,0,159
5822,287870,1,19,4,0,1,159
5823,287870,1,19,5,0,0,159
5824,287870,1,19,6,1,0,160
5825,287870,1,20,1,1,0,161
5826,287870,1,20,2,1,0,162
5827,287870,1,20,3,0,1,162
5828,287870,1,20,4,0,0,162
5829,287870,1,20,5,1,0,163
5830,287870,1,20,6,1,0,164
5947,287871,1,1,1,4,0,4
5948,287871,1,1,2,1,0,5
5949,287871,1,1,3,0,1,5
5950,287871,1,1,4,0,0,5
5951,287871,1,1,5,1,0,6
5952,287871,1,1,6,2,0,8
5953,287871,1,2,1,0,0,8
5954,287871,1,2,2,0,0,8
5955,287871,1,2,3,0,0,8
5956,287871,1,2,4,4,0,12
5957,287871,1,2,5,0,0,12
5958,287871,1,2,6,0,0,12
5959,287871,1,3,1,2,0,14
5960,287871,1,3,2,0,0,14
5961,287871,1,3,3,1,0,15
5962,287871,1,3,4,0,0,15
5963,287871,1,3,5,0,0,15
5964,287871,1,3,6,4,0,19
5965,287871,1,4,1,0,0,19
5966,287871,1,4,2,1,0,20
5967,287871,1,4,3,1,0,21
5968,287871,1,4,4,4,0,25
5969,287871,1,4,5,0,0,25
5970,287871,1,4,6,1,0,26
5971,287871,1,5,1,4,0,30
5972,287871,1,5,2,3,0,33
5973,287871,1,5,3,0,0,33
5974,287871,1,5,4,4,0,37
5975,287871,1,5,5,0,0,37
5976,287871,1,5,6,0,0,37
5977,287871,1,6,1,0,1,37
5978,287871,1,6,2,0,0,37
5979,287871,1,6,3,0,0,37
5980,287871,1,6,4,1,0,38
5981,287871,1,6,5,1,0,39
5982,287871,1,6,6,0,0,39
5983,287871,1,7,1,0,0,39
5984,287871,1,7,2,1,0,40
5985,287871,1,7,3,2,0,42
5986,287871,1,7,4,2,0,44
5987,287871,1,7,5,1,0,45
5988,287871,1,7,6,1,0,46
5989,287871,1,8,1,1,0,47
5990,287871,1,8,2,0,0,47
5991,287871,1,8,3,1,0,48
5992,287871,1,8,4,1,0,49
5993,287871,1,8,5,0,0,49
5994,287871,1,8,6,0,0,49
5995,287871,1,9,1,1,0,50
5996,287871,1,9,2,1,0,51
5997,287871,1,9,3,1,0,52
5998,287871,1,9,4,1,0,53
5999,287871,1,9,5,2,0,55
6000,287871,1,9,6,2,0,57
6001,287871,1,10,1,1,0,58
6002,287871,1,10,2,1,0,59
6003,287871,1,10,3,0,1,59
6004,287871,1,10,4,1,0,60
6005,287871,1,10,5,1,0,61
6006,287871,1,10,6,0,0,61
6007,287871,1,11,1,1,0,62
6008,287871,1,11,2,1,0,63
6009,287871,1,11,3,1,0,64
6010,287871,1,11,4,6,0,70
6011,287871,1,11,5,1,0,71
6012,287871,1,11,6,0,0,71
6013,287871,1,12,1,0,0,71
6014,287871,1,12,2,1,0,72
6015,287871,1,12,3,2,0,74
6016,287871,1,12,4,1,0,75
6017,287871,1,12,5,2,0,77
6018,287871,1,12,6,0,0,77
6019,287871,1,13,1,2,0,79
6020,287871,1,13,2,4,0,83
6021,287871,1,13,3,1,0,84
6022,287871,1,13,4,0,0,84
6023,287871,1,13,5,0,0,84
6024,287871,1,13,6,0,1,84
6025,287871,1,14,1,0,0,84
6026,287871,1,14,2,2,0,86
6027,287871,1,14,3,2,0,88
6028,287871,1,14,4,1,0,89
6029,287871,1,14,5,1,0,90
6030,287871,1,14,6,0,0,90
6031,287871,1,15,1,1,0,91
6032,287871,1,15,2,3,0,94
6033,287871,1,15,3,0,0,94
6034,287871,1,15,4,1,0,95
6035,287871,1,15,5,1,1,96
6036,287871,1,15,6,1,0,97
6037,287871,1,16,1,1,0,98
6038,287871,1,16,2,2,0,100
6039,287871,1,16,3,1,0,101
6040,287871,1,16,4,1,0,102
6041,287871,1,16,5,1,0,103
6042,287871,1,16,6,0,0,103
6043,287871,1,17,1,1,0,104
6044,287871,1,17,2,1,0,105
6045,287871,1,17,3,1,0,106
6046,287871,1,17,4,1,0,107
6047,287871,1,17,5,1,0,108
6048,287871,1,17,6,1,0,109
6049,287871,1,18,1,1,0,110
6050,287871,1,18,2,1,0,111
6051,287871,1,18,3,4,0,115
6052,287871,1,18,4,2,0,117
6053,287871,1,18,5,1,0,118
6054,287871,1,18,6,4,0,122
6055,287871,1,19,1,2,0,124
6056,287871,1,19,2,2,0,126
6057,287871,1,19,3,4,0,130
6058,287871,1,19,4,6,0,136
6059,287871,1,19,5,1,0,137
6060,287871,1,19,6,2,0,139
6061,287871,1,20,1,0,0,139
6062,287871,1,20,2,1,0,140
6063,287871,1,20,3,0,0,140
6064,287871,1,20,4,1,0,141
6065,287871,1,20,5,2,0,143
6066,287871,1,20,6,4,0,147
6163,287872,1,1,1,0,0,0
6164,287872,1,1,2,0,0,0
6165,287872,1,1,3,1,0,1
6166,287872,1,1,4,0,0,1
6167,287872,1,1,5,0,0,1
6168,287872,1,1,6,1,0,2
6169,287872,1,2,1,1,0,3
6170,287872,1,2,2,1,0,4
6171,287872,1,2,3,2,0,6
6172,287872,1,2,4,0,0,6
6173,287872,1,2,5,1,0,7
6174,287872,1,2,6,0,0,7
6175,287872,1,3,1,0,0,7
6176,287872,1,3,2,0,0,7
6177,287872,1,3,3,4,0,11
6178,287872,1,3,4,6,0,17
6179,287872,1,3,5,1,0,18
6180,287872,1,3,6,1,0,19
6181,287872,1,4,1,1,0,20
6182,287872,1,4,2,1,0,21
6183,287872,1,4,3,0,0,21
6184,287872,1,4,4,0,0,21
6185,287872,1,4,5,4,0,25
6186,287872,1,4,6,0,0,25
6187,287872,1,5,1,6,0,31
6188,287872,1,5,2,4,0,35
6189,287872,1,5,3,1,0,36
6190,287872,1,5,4,0,0,36
6191,287872,1,5,5,4,0,40
6192,287872,1,5,6,2,0,42
6193,287872,1,6,1,1,0,43
6194,287872,1,6,2,1,0,44
6195,287872,1,6,3,2,0,46
6196,287872,1,6,4,4,0,50
6197,287872,1,6,5,0,0,50
6198,287872,1,6,6,0,0,50
6199,287872,1,7,1,0,0,50
6200,287872,1,7,2,2,0,52
6201,287872,1,7,3,0,0,52
6202,287872,1,7,4,4,0,56
6203,287872,1,7,5,1,0,57
6204,287872,1,7,6,2,0,59
6205,287872,1,8,1,2,0,61
6206,287872,1,8,2,1,0,62
6207,287872,1,8,3,1,0,63
6208,287872,1,8,4,2,0,65
6209,287872,1,8,5,2,0,67
6210,287872,1,8,6,0,0,67
6211,287872,1,9,1,1,0,68
6212,287872,1,9,2,0,1,68
6213,287872,1,9,3,0,0,68
6214,287872,1,9,4,1,0,69
6215,287872,1,9,5,1,0,70
6216,287872,1,9,6,0,1,70
6217,287872,1,10,1,0,0,70
6218,287872,1,10,2,1,0,71
6219,287872,1,10,3,0,0,71
6220,287872,1,10,4,1,0,72
6221,287872,1,10,5,4,0,76
6222,287872,1,10,6,0,1,76
6223,287872,1,11,1,1,0,77
6224,287872,1,11,2,0,0,77
6225,287872,1,11,3,1,0,78
6226,287872,1,11,4,0,0,78
6227,287872,1,11,5,0,0,78
6228,287872,1,11,6,2,0,80
6229,287872,1,12,1,1,0,81
6230,287872,1,12,2,1,0,82
6231,287872,1,12,3,6,0,88
6232,287872,1,12,4,0,0,88
6233,287872,1,12,5,1,0,89
6234,287872,1,12,6,1,0,90
6235,287872,1,13,1,0,1,90
6236,287872,1,13,2,0,0,90
6237,287872,1,13,3,1,0,91
6238,287872,1,13,4,0,0,91
6239,287872,1,13,5,0,0,91
6240,287872,1,13,6,1,0,92
6241,287872,1,14,1,0,0,92
6242,287872,1,14,2,4,0,96
6243,287872,1,14,3,0,0,96
6244,287872,1,14,4,0,0,96
6245,287872,1,14,5,1,0,97
6246,287872,1,14,6,0,0,97
6247,287872,1,15,1,1,0,98
6248,287872,1,15,2,1,0,99
6249,287872,1,15,3,4,0,103
6250,287872,1,15,4,1,0,104
6251,287872,1,15,5,11,0,115
6252,287872,1,15,6,6,0,121
6253,287872,1,16,1,1,0,122
6254,287872,1,16,2,2,0,124
6255,287872,1,16,3,1,0,125
6256,287872,1,16,4,4,0,129
6257,287872,1,16,5,1,0,130
6258,287872,1,16,6,1,0,131
6259,287872,1,17,1,0,1,131
6260,287872,1,17,2,0,0,131
6261,287872,1,17,3,0,0,131
6262,287872,1,17,4,0,0,131
6263,287872,1,17,5,1,1,132
6264,287872,1,17,6,0,0,132
6265,287872,1,18,1,1,0,133
6266,287872,1,18,2,1,0,134
6267,287872,1,18,3,2,0,136
6268,287872,1,18,4,1,0,137
6269,287872,1,18,5,0,1,137
6270,287872,1,18,6,1,0,138
6271,287872,1,19,1,1,0,139
6272,287872,1,19,2,0,1,139
6273,287872,1,19,3,0,0,139
6274,287872,1,19,4,0,0,139
6275,287872,1,19,5,2,0,141
6276,287872,1,19,6,1,0,142
6277,287872,1,20,1,1,0,143
6278,287872,1,20,2,1,0,144
6279,287872,1,20,3,6,0,150
6280,287872,1,20,4,1,0,151
6281,287872,1,20,5,1,0,152
6282,287872,1,20,6,1,0,153
6398,287873,1,1,1,1,0,1
6399,287873,1,1,2,0,0,1
6400,287873,1,1,3,1,0,2
6401,287873,1,1,4,6,0,8
6402,287873,1,1,5,0,0,8
6403,287873,1,1,6,1,0,9
6404,287873,1,2,1,0,0,9
6405,287873,1,2,2,0,0,9
6406,287873,1,2,3,1,0,10
6407,287873,1,2,4,0,0,10
6408,287873,1,2,5,1,0,11
6409,287873,1,2,6,2,0,13
6410,287873,1,3,1,2,0,15
6411,287873,1,3,2,0,0,15
6412,287873,1,3,3,0,0,15
6413,287873,1,3,4,1,0,16
6414,287873,1,3,5,0,0,16
6415,287873,1,3,6,1,0,17
6416,287873,1,4,1,1,0,18
6417,287873,1,4,2,1,0,19
6418,287873,1,4,3,2,0,21
6419,287873,1,4,4,2,0,23
6420,287873,1,4,5,0,0,23
6421,287873,1,4,6,0,0,23
6422,287873,1,5,1,1,0,24
6423,287873,1,5,2,6,0,30
6424,287873,1,5,3,1,0,31
6425,287873,1,5,4,0,0,31
6426,287873,1,5,5,1,0,32
6427,287873,1,5,6,3,0,35
6428,287873,1,6,1,0,0,35
6429,287873,1,6,2,2,0,37
6430,287873,1,6,3,0,0,37
6431,287873,1,6,4,0,0,37
6432,287873,1,6,5,3,0,40
6433,287873,1,6,6,1,0,41
6434,287873,1,7,1,4,0,45
6435,287873,1,7,2,1,0,46
6436,287873,1,7,3,1,0,47
6437,287873,1,7,4,6,0,53
6438,287873,1,7,5,2,0,55
6439,287873,1,7,6,1,0,56
6440,287873,1,8,1,6,0,62
6441,287873,1,8,2,1,0,63
6442,287873,1,8,3,4,0,67
6443,287873,1,8,4,2,0,69
6444,287873,1,8,5,1,0,70
6445,287873,1,8,6,0,0,70
6446,287873,1,9,1,0,0,70
6447,287873,1,9,2,1,0,71
6448,287873,1,9,3,1,0,72
6449,287873,1,9,4,0,0,72
6450,287873,1,9,5,1,0,73
6451,287873,1,9,6,4,0,77
6452,287873,1,10,1,1,0,78
6453,287873,1,10,2,0,0,78
6454,287873,1,10,3,1,0,79
6455,287873,1,10,4,6,0,85
6456,287873,1,10,5,4,0,89
6457,287873,1,10,6,1,0,90
6458,287873,1,11,1,2,0,92
6459,287873,1,11,2,1,0,93
6460,287873,1,11,3,0,0,93
6461,287873,1,11,4,1,0,94
6462,287873,1,11,5,0,0,94
6463,287873,1,11,6,4,0,98
6464,287873,1,12,1,4,0,102
6465,287873,1,12,2,6,0,108
6466,287873,1,12,3,1,0,109
6467,287873,1,12,4,1,0,110
6468,287873,1,12,5,0,0,110
6469,287873,1,12,6,0,0,110
6470,287873,1,13,1,1,0,111
6471,287873,1,13,2,1,0,112
6472,287873,1,13,3,1,0,113
6473,287873,1,13,4,1,0,114
6474,287873,1,13,5,3,0,117
6475,287873,1,13,6,1,0,118
6476,287873,1,14,1,0,0,118
6477,287873,1,14,2,4,0,122
6478,287873,1,14,3,4,0,126
6479,287873,1,14,4,1,0,127
6480,287873,1,14,5,1,0,128
6481,287873,1,14,6,1,0,129
6482,287873,1,15,1,4,0,133
6483,287873,1,15,2,1,0,134
6484,287873,1,15,3,2,0,136
6485,287873,1,15,4,0,1,136
6486,287873,1,15,5,1,0,137
6487,287873,1,15,6,1,0,138
6488,287873,1,16,1,4,0,142
6489,287873,1,16,2,2,0,144
6490,287873,1,16,3,0,1,144
6491,287873,1,16,4,0,0,144
6492,287873,1,16,5,2,0,146
6493,287873,1,16,6,2,0,148
6494,287873,1,17,1,4,0,152
6495,287873,1,17,2,1,0,153
6496,287873,1,17,3,1,0,154
6497,287873,1,17,4,1,1,155
6498,287873,1,17,5,0,0,155
6499,287873,1,17,6,4,0,159
6500,287873,1,18,1,1,0,160
6501,287873,1,18,2,1,0,161
6502,287873,1,18,3,1,0,162
6503,287873,1,18,4,4,0,166
6504,287873,1,18,5,4,0,170
6505,287873,1,18,6,1,0,171
6506,287873,1,19,1,6,0,177
6507,287873,1,19,2,6,0,183
6508,287873,1,19,3,6,0,189
6509,287873,1,19,4,6,0,195
6510,287873,1,19,5,6,0,201
6511,287873,1,19,6,6,0,207
6512,287873,1,20,1,1,0,208
6513,287873,1,20,2,0,0,208
6514,287873,1,20,3,2,0,210
6515,287873,1,20,4,6,0,216
6516,287873,1,20,5,0,1,216
6517,287873,1,20,6,2,0,218
6638,287874,1,1,1,1,0,1
6639,287874,1,1,2,0,0,1
6640,287874,1,1,3,0,1,1
6641,287874,1,1,4,1,0,2
6642,287874,1,1,5,1,0,3
6643,287874,1,1,6,4,0,7
6644,287874,1,2,1,0,0,7
6645,287874,1,2,2,0,0,7
6646,287874,1,2,3,2,0,9
6647,287874,1,2,4,0,0,9
6648,287874,1,2,5,0,0,9
6649,287874,1,2,6,0,1,9
6650,287874,1,3,1,1,0,10
6651,287874,1,3,2,0,0,10
6652,287874,1,3,3,1,0,11
6653,287874,1,3,4,0,1,11
6654,287874,1,3,5,0,0,11
6655,287874,1,3,6,0,0,11
6656,287874,1,4,1,0,0,11
6657,287874,1,4,2,1,0,12
6658,287874,1,4,3,1,0,13
6659,287874,1,4,4,0,0,13
6660,287874,1,4,5,2,0,15
6661,287874,1,4,6,0,0,15
6662,287874,1,5,1,4,0,19
6663,287874,1,5,2,0,0,19
6664,287874,1,5,3,0,0,19
6665,287874,1,5,4,1,0,20
6666,287874,1,5,5,1,0,21
6667,287874,1,5,6,0,0,21
6668,287874,1,6,1,0,0,21
6669,287874,1,6,2,0,0,21
6670,287874,1,6,3,0,1,21
6671,287874,1,6,4,4,0,25
6672,287874,1,6,5,1,0,26
6673,287874,1,6,6,0,0,26
6674,287874,1,7,1,0,0,26
6675,287874,1,7,2,0,0,26
6676,287874,1,7,3,0,0,26
6677,287874,1,7,4,1,0,27
6678,287874,1,7,5,1,0,28
6679,287874,1,7,6,0,0,28
6680,287874,1,8,1,2,0,30
6681,287874,1,8,2,0,0,30
6682,287874,1,8,3,0,1,30
6683,287874,1,8,4,0,0,30
6684,287874,1,8,5,4,0,34
6685,287874,1,8,6,0,0,34
6686,287874,1,9,1,1,0,35
6687,287874,1,9,2,0,0,35
6688,287874,1,9,3,1,0,36
6689,287874,1,9,4,1,0,37
6690,287874,1,9,5,1,0,38
6691,287874,1,9,6,1,0,39
6692,287874,1,10,1,0,0,39
6693,287874,1,10,2,4,0,43
6694,287874,1,10,3,0,1,43
6695,287874,1,10,4,0,0,43
6696,287874,1,10,5,0,1,43
6697,287874,1,10,6,0,0,43
6698,287874,1,11,1,1,0,44
6699,287874,1,11,2,4,0,48
6700,287874,1,11,3,1,0,49
6701,287874,1,11,4,4,0,53
6702,287874,1,11,5,0,0,53
6703,287874,1,11,6,2,0,55
6704,287874,1,12,1,0,0,55
6705,287874,1,12,2,1,0,56
6706,287874,1,12,3,1,0,57
6707,287874,1,12,4,3,0,60
6708,287874,1,12,5,0,0,60
6709,287874,1,12,6,0,0,60
6710,287874,1,13,1,1,0,61
6711,287874,1,13,2,1,0,62
6712,287874,1,13,3,1,0,63
6713,287874,1,13,4,0,0,63
6714,287874,1,13,5,1,0,64
6715,287874,1,13,6,1,0,65
6716,287874,1,14,1,4,0,69
6717,287874,1,14,2,0,0,69
6718,287874,1,14,3,1,0,70
6719,287874,1,14,4,0,0,70
6720,287874,1,14,5,1,0,71
6721,287874,1,14,6,1,0,72
6722,287874,1,15,1,1,0,73
6723,287874,1,15,2,2,0,75
6724,287874,1,15,3,0,0,75
6725,287874,1,15,4,1,0,76
6726,287874,1,15,5,1,0,77
6727,287874,1,15,6,0,0,77
6728,287874,1,16,1,1,0,78
6729,287874,1,16,2,1,0,79
6730,287874,1,16,3,0,0,79
6731,287874,1,16,4,1,0,80
6732,287874,1,16,5,1,0,81
6733,287874,1,16,6,1,0,82
6734,287874,1,17,1,1,0,83
6735,287874,1,17,2,0,1,83
6736,287874,1,17,3,1,0,84
6737,287874,1,17,4,0,0,84
6738,287874,1,17,5,1,0,85
6739,287874,1,17,6,1,0,86
6740,287874,1,18,1,1,0,87
6741,287874,1,18,2,1,0,88
6742,287874,1,18,3,1,0,89
6743,287874,1,18,4,1,0,90
6744,287874,1,18,5,1,0,91
6745,287874,1,18,6,1,0,92
6746,287874,1,19,1,0,0,92
6747,287874,1,19,2,6,0,98
6748,287874,1,19,3,1,0,99
6749,287874,1,19,4,0,0,99
6750,287874,1,19,5,0,1,99
6751,287874,1,19,6,1,0,100
6752,287874,1,20,1,1,0,101
6753,287874,1,20,2,0,0,101
6754,287874,1,20,3,0,1,101
6817,287875,1,1,1,1,0,1
6818,287875,1,1,2,2,0,3
6819,287875,1,1,3,0,0,3
6820,287875,1,1,4,2,0,5
6821,287875,1,1,5,1,0,6
6822,287875,1,1,6,4,0,10
6823,287875,1,2,1,1,0,11
6824,287875,1,2,2,0,0,11
6825,287875,1,2,3,3,0,14
6826,287875,1,2,4,0,0,14
6827,287875,1,2,5,0,0,14
6828,287875,1,2,6,0,0,14
6829,287875,1,3,1,1,0,15
6830,287875,1,3,2,0,0,15
6831,287875,1,3,3,0,0,15
6832,287875,1,3,4,1,0,16
6833,287875,1,3,5,0,1,16
6834,287875,1,3,6,1,0,17
6835,287875,1,4,1,1,0,18
6836,287875,1,4,2,1,0,19
6837,287875,1,4,3,2,0,21
6838,287875,1,4,4,0,0,21
6839,287875,1,4,5,2,0,23
6840,287875,1,4,6,4,0,27
6841,287875,1,5,1,0,0,27
6842,287875,1,5,2,1,0,28
6843,287875,1,5,3,4,0,32
6844,287875,1,5,4,4,0,36
6845,287875,1,5,5,0,0,36
6846,287875,1,5,6,2,0,38
6847,287875,1,6,1,2,0,40
6848,287875,1,6,2,1,0,41
6849,287875,1,6,3,2,0,43
6850,287875,1,6,4,6,0,49
6851,287875,1,6,5,0,0,49
6852,287875,1,6,6,2,0,51
6853,287875,1,7,1,0,0,51
6854,287875,1,7,2,1,0,52
6855,287875,1,7,3,2,0,54
6856,287875,1,7,4,0,0,54
6857,287875,1,7,5,1,0,55
6858,287875,1,7,6,1,0,56
6859,287875,1,8,1,1,0,57
6860,287875,1,8,2,1,0,58
6861,287875,1,8,3,2,0,60
6862,287875,1,8,4,0,0,60
6863,287875,1,8,5,1,0,61
6864,287875,1,8,6,1,0,62
6865,287875,1,9,1,1,0,63
6866,287875,1,9,2,4,0,67
6867,287875,1,9,3,1,0,68
6868,287875,1,9,4,1,0,69
6869,287875,1,9,5,4,0,73
6870,287875,1,9,6,1,0,74
6871,287875,1,10,1,1,0,75
6872,287875,1,10,2,2,0,77
6873,287875,1,10,3,1,0,78
6874,287875,1,10,4,1,0,79
6875,287875,1,10,5,0,1,79
6876,287875,1,10,6,1,0,80
6877,287875,1,11,1,2,0,82
6878,287875,1,11,2,2,0,84
6879,287875,1,11,3,0,1,84
6880,287875,1,11,4,1,0,85
6881,287875,1,11,5,0,0,85
6882,287875,1,11,6,0,0,85
6883,287875,1,12,1,0,0,85
6884,287875,1,12,2,1,1,86
6885,287875,1,12,3,1,0,87
6886,287875,1,12,4,6,0,93
6887,287875,1,12,5,6,0,99
6888,287875,1,12,6,3,0,102
6889,287875,1,13,1,0,0,102
6890,287875,1,13,2,0,0,102
6891,287875,1,13,3,1,0,103
6892,287875,1,13,4,1,0,104
6893,287875,1,13,5,1,0,105
6894,287875,1,13,6,0,0,105
6895,287875,1,14,1,1,0,106
6896,287875,1,14,2,1,0,107
6897,287875,1,14,3,1,0,108
6898,287875,1,14,4,1,0,109
6899,287875,1,14,5,1,0,110
6900,287875,1,14,6,2,0,112
6901,287875,1,15,1,0,1,112
6902,287875,1,15,2,2,0,114
6903,287875,1,15,3,5,0,119
6904,287875,1,15,4,0,1,119
6905,287875,1,15,5,0,0,119
6906,287875,1,15,6,2,0,121
6907,287875,1,16,1,1,0,122
6908,287875,1,16,2,0,1,122
6909,287875,1,16,3,1,0,123
6910,287875,1,16,4,0,0,123
6911,287875,1,16,5,0,0,123
6912,287875,1,16,6,1,0,124
6913,287875,1,17,1,2,0,126
6914,287875,1,17,2,2,0,128
6915,287875,1,17,3,0,0,128
6916,287875,1,17,4,1,0,129
6917,287875,1,17,5,0,0,129
6918,287875,1,17,6,1,0,130
6919,287875,1,18,1,0,0,130
6920,287875,1,18,2,1,0,131
6921,287875,1,18,3,1,0,132
6922,287875,1,18,4,1,0,133
6923,287875,1,18,5,4,0,137
6924,287875,1,18,6,0,0,137
6925,287875,1,19,1,0,1,137
6926,287875,1,19,2,0,1,137
6927,287875,1,19,3,0,0,137
6928,287875,1,19,4,0,0,137
6929,287875,1,19,5,1,0,138
6930,287875,1,19,6,1,0,139
6931,287875,1,20,1,1,0,140
6932,287875,1,20,2,0,0,140
6933,287875,1,20,3,0,0,140
6934,287875,1,20,4,0,1,140
7049,287876,1,1,1,0,0,0
7050,287876,1,1,2,0,0,0
7051,287876,1,1,3,2,0,2
7052,287876,1,1,4,0,0,2
7053,287876,1,1,5,1,0,3
7054,287876,1,1,6,0,0,3
7055,287876,1,2,1,1,0,4
7056,287876,1,2,2,0,0,4
7057,287876,1,2,3,4,0,8
7058,287876,1,2,4,0,0,8
7059,287876,1,2,5,0,0,8
7060,287876,1,2,6,4,0,12
7061,287876,1,3,1,0,0,12
7062,287876,1,3,2,2,0,14
7063,287876,1,3,3,1,0,15
7064,287876,1,3,4,0,0,15
7065,287876,1,3,5,4,0,19
7066,287876,1,3,6,0,0,19
7067,287876,1,4,1,4,0,23
7068,287876,1,4,2,1,0,24
7069,287876,1,4,3,2,0,26
7070,287876,1,4,4,0,0,26
7071,287876,1,4,5,2,0,28
7072,287876,1,4,6,1,0,29
7073,287876,1,5,1,1,0,30
7074,287876,1,5,2,1,0,31
7075,287876,1,5,3,1,0,32
7076,287876,1,5,4,0,1,32
7077,287876,1,5,5,1,0,33
7078,287876,1,5,6,0,1,33
7079,287876,1,6,1,0,1,33
7080,287876,1,6,2,0,0,33
7081,287876,1,6,3,0,0,33
7082,287876,1,6,4,1,0,34
7083,287876,1,6,5,0,0,34
7084,287876,1,6,6,0,0,34
7085,287876,1,7,1,1,0,35
7086,287876,1,7,2,2,0,37
7087,287876,1,7,3,0,0,37
7088,287876,1,7,4,0,0,37
7089,287876,1,7,5,0,0,37
7090,287876,1,7,6,0,0,37
7091,287876,1,8,1,0,0,37
7092,287876,1,8,2,1,0,38
7093,287876,1,8,3,0,0,38
7094,287876,1,8,4,1,0,39
7095,287876,1,8,5,1,0,40
7096,287876,1,8,6,6,0,46
7097,287876,1,9,1,0,0,46
7098,287876,1,9,2,0,0,46
7099,287876,1,9,3,0,0,46
7100,287876,1,9,4,0,0,46
7101,287876,1,9,5,1,0,47
7102,287876,1,9,6,1,0,48
7103,287876,1,10,1,0,0,48
7104,287876,1,10,2,1,0,49
7105,287876,1,10,3,0,0,49
7106,287876,1,10,4,0,0,49
7107,287876,1,10,5,4,0,53
7108,287876,1,10,6,4,0,57
7109,287876,1,11,1,0,0,57
7110,287876,1,11,2,4,0,61
7111,287876,1,11,3,0,1,61
7112,287876,1,11,4,1,0,62
7113,287876,1,11,5,0,0,62
7114,287876,1,11,6,0,0,62
7115,287876,1,12,1,1,0,63
7116,287876,1,12,2,1,0,64
7117,287876,1,12,3,0,0,64
7118,287876,1,12,4,5,0,69
7119,287876,1,12,5,2,0,71
7120,287876,1,12,6,1,0,72
7121,287876,1,13,1,0,0,72
7122,287876,1,13,2,0,0,72
7123,287876,1,13,3,1,0,73
7124,287876,1,13,4,4,0,77
7125,287876,1,13,5,1,0,78
7126,287876,1,13,6,1,0,79
7127,287876,1,14,1,0,0,79
7128,287876,1,14,2,2,0,81
7129,287876,1,14,3,0,0,81
7130,287876,1,14,4,1,0,82
7131,287876,1,14,5,4,0,86
7132,287876,1,14,6,4,0,90
7133,287876,1,15,1,0,0,90
7134,287876,1,15,2,4,0,94
7135,287876,1,15,3,1,0,95
7136,287876,1,15,4,1,0,96
7137,287876,1,15,5,1,0,97
7138,287876,1,15,6,0,0,97
7139,287876,1,16,1,1,0,98
7140,287876,1,16,2,0,0,98
7141,287876,1,16,3,1,0,99
7142,287876,1,16,4,1,0,100
7143,287876,1,16,5,1,0,101
7144,287876,1,16,6,0,0,101
7145,287876,1,17,1,1,0,102
7146,287876,1,17,2,4,0,106
7147,287876,1,17,3,1,0,107
7148,287876,1,17,4,4,0,111
7149,287876,1,17,5,2,0,113
7150,287876,1,17,6,6,0,119
7151,287876,1,18,1,6,0,125
7152,287876,1,18,2,1,0,126
7153,287876,1,18,3,1,0,127
7154,287876,1,18,4,4,0,131
7155,287876,1,18,5,0,0,131
7156,287876,1,18,6,0,0,131
7157,287876,1,19,1,0,0,131
7158,287876,1,19,2,1,0,132
7159,287876,1,19,3,1,0,133
7160,287876,1,19,4,6,0,139
7161,287876,1,19,5,0,0,139
7162,287876,1,19,6,0,0,139
7163,287876,1,20,1,0,0,139
7164,287876,1,20,2,2,0,141
7165,287876,1,20,3,4,0,145
7166,287876,1,20,4,1,1,146
7167,287876,1,20,5,1,0,147
7168,287876,1,20,6,6,0,153
7289,287877,1,1,1,0,0,0
7290,287877,1,1,2,0,0,0
7291,287877,1,1,3,1,0,1
7292,287877,1,1,4,0,0,1
7293,287877,1,1,5,1,0,2
7294,287877,1,1,6,0,0,2
7295,287877,1,2,1,1,0,3
7296,287877,1,2,2,0,0,3
7297,287877,1,2,3,0,0,3
7298,287877,1,2,4,0,0,3
7299,287877,1,2,5,0,0,3
7300,287877,1,2,6,1,0,4
7301,287877,1,3,1,1,0,5
7302,287877,1,3,2,0,0,5
7303,287877,1,3,3,1,0,6
7304,287877,1,3,4,1,0,7
7305,287877,1,3,5,4,0,11
7306,287877,1,3,6,4,0,15
7307,287877,1,4,1,0,0,15
7308,287877,1,4,2,1,0,16
7309,287877,1,4,3,1,0,17
7310,287877,1,4,4,2,0,19
7311,287877,1,4,5,6,0,25
7312,287877,1,4,6,4,0,29
7313,287877,1,5,1,0,0,29
7314,287877,1,5,2,1,0,30
7315,287877,1,5,3,1,0,31
7316,287877,1,5,4,0,0,31
7317,287877,1,5,5,1,0,32
7318,287877,1,5,6,1,0,33
7319,287877,1,6,1,2,0,35
7320,287877,1,6,2,2,0,37
7321,287877,1,6,3,0,0,37
7322,287877,1,6,4,2,0,39
7323,287877,1,6,5,1,0,40
7324,287877,1,6,6,1,0,41
7325,287877,1,7,1,2,0,43
7326,287877,1,7,2,1,0,44
7327,287877,1,7,3,2,0,46
7328,287877,1,7,4,0,0,46
7329,287877,1,7,5,0,0,46
7330,287877,1,7,6,0,0,46
7331,287877,1,8,1,1,0,47
7332,287877,1,8,2,0,0,47
7333,287877,1,8,3,1,0,48
7334,287877,1,8,4,2,0,50
7335,287877,1,8,5,0,1,50
7336,287877,1,8,6,1,0,51
7337,287877,1,9,1,1,0,52
7338,287877,1,9,2,1,0,53
7339,287877,1,9,3,2,0,55
7340,287877,1,9,4,4,0,59
7341,287877,1,9,5,1,0,60
7342,287877,1,9,6,1,0,61
7343,287877,1,10,1,2,0,63
7344,287877,1,10,2,1,0,64
7345,287877,1,10,3,1,0,65
7346,287877,1,10,4,1,0,66
7347,287877,1,10,5,6,0,72
7348,287877,1,10,6,0,0,72
7349,287877,1,11,1,1,0,73
7350,287877,1,11,2,1,0,74
7351,287877,1,11,3,0,1,74
7352,287877,1,11,4,0,0,74
7353,287877,1,11,5,0,0,74
7354,287877,1,11,6,1,0,75
7355,287877,1,12,1,0,0,75
7356,287877,1,12,2,0,0,75
7357,287877,1,12,3,0,0,75
7358,287877,1,12,4,2,0,77
7359,287877,1,12,5,0,0,77
7360,287877,1,12,6,1,0,78
7361,287877,1,13,1,1,0,79
7362,287877,1,13,2,2,0,81
7363,287877,1,13,3,0,0,81
7364,287877,1,13,4,2,0,83
7365,287877,1,13,5,1,0,84
7366,287877,1,13,6,1,0,85
7367,287877,1,14,1,0,1,85
7368,287877,1,14,2,2,0,87
7369,287877,1,14,3,0,1,87
7370,287877,1,14,4,0,0,87
7371,287877,1,14,5,4,0,91
7372,287877,1,14,6,0,0,91
7373,287877,1,15,1,2,0,93
7374,287877,1,15,2,2,0,95
7375,287877,1,15,3,1,0,96
7376,287877,1,15,4,6,0,102
7377,287877,1,15,5,2,0,104
7378,287877,1,15,6,0,1,104
7379,287877,1,16,1,1,0,105
7380,287877,1,16,2,0,0,105
7381,287877,1,16,3,1,0,106
7382,287877,1,16,4,0,0,106
7383,287877,1,16,5,0,0,106
7384,287877,1,16,6,0,1,106
7385,287877,1,17,1,0,0,106
7386,287877,1,17,2,1,1,107
7387,287877,1,17,3,2,0,109
7388,287877,1,17,4,6,0,115
7389,287877,1,17,5,1,0,116
7390,287877,1,17,6,0,0,116
7391,287877,1,18,1,0,0,116
7392,287877,1,18,2,1,0,117
7393,287877,1,18,3,1,0,118
7394,287877,1,18,4,0,0,118
7395,287877,1,18,5,1,0,119
7396,287877,1,18,6,1,0,120
7397,287877,1,19,1,1,0,121
7398,287877,1,19,2,0,0,121
7399,287877,1,19,3,3,0,124
7400,287877,1,19,4,1,0,125
7401,287877,1,19,5,0,0,125
7402,287877,1,19,6,1,1,126
7403,287877,1,20,1,4,0,130
7404,287877,1,20,2,6,0,136
7405,287877,1,20,3,4,0,140
7406,287877,1,20,4,0,0,140
7407,287877,1,20,5,2,0,142
7408,287877,1,20,6,1,0,143
7522,287878,1,1,1,0,0,0
7523,287878,1,1,2,0,0,0
7524,287878,1,1,3,4,0,4
7525,287878,1,1,4,1,0,5
7526,287878,1,1,5,0,0,5
7527,287878,1,1,6,0,0,5
7528,287878,1,2,1,1,0,6
7529,287878,1,2,2,1,0,7
7530,287878,1,2,3,0,0,7
7531,287878,1,2,4,0,0,7
7532,287878,1,2,5,1,0,8
7533,287878,1,2,6,1,0,9
7534,287878,1,3,1,0,0,9
7535,287878,1,3,2,0,0,9
7536,287878,1,3,3,0,0,9
7537,287878,1,3,4,1,0,10
7538,287878,1,3,5,0,0,10
7539,287878,1,3,6,0,0,10
7540,287878,1,4,1,1,0,11
7541,287878,1,4,2,0,0,11
7542,287878,1,4,3,4,0,15
7543,287878,1,4,4,0,0,15
7544,287878,1,4,5,4,0,19
7545,287878,1,4,6,0,0,19
7546,287878,1,5,1,1,0,20
7547,287878,1,5,2,1,0,21
7548,287878,1,5,3,1,0,22
7549,287878,1,5,4,0,0,22
7550,287878,1,5,5,0,0,22
7551,287878,1,5,6,4,0,26
7552,287878,1,6,1,4,0,30
7553,287878,1,6,2,0,1,30
7554,287878,1,6,3,1,0,31
7555,287878,1,6,4,1,0,32
7556,287878,1,6,5,0,0,32
7557,287878,1,6,6,4,0,36
7558,287878,1,7,1,1,0,37
7559,287878,1,7,2,0,0,37
7560,287878,1,7,3,0,0,37
7561,287878,1,7,4,1,0,38
7562,287878,1,7,5,0,0,38
7563,287878,1,7,6,1,0,39
7564,287878,1,8,1,1,0,40
7565,287878,1,8,2,0,0,40
7566,287878,1,8,3,0,0,40
7567,287878,1,8,4,0,0,40
7568,287878,1,8,5,1,0,41
7569,287878,1,8,6,0,1,41
7570,287878,1,9,1,0,0,41
7571,287878,1,9,2,6,0,47
7572,287878,1,9,3,1,0,48
7573,287878,1,9,4,0,0,48
7574,287878,1,9,5,0,0,48
7575,287878,1,9,6,0,0,48
7576,287878,1,10,1,0,0,48
7577,287878,1,10,2,2,0,50
7578,287878,1,10,3,1,0,51
7579,287878,1,10,4,2,0,53
7580,287878,1,10,5,1,0,54
7581,287878,1,10,6,6,0,60
7582,287878,1,11,1,1,0,61
7583,287878,1,11,2,4,0,65
7584,287878,1,11,3,1,0,66
7585,287878,1,11,4,6,0,72
7586,287878,1,11,5,1,0,73
7587,287878,1,11,6,6,0,79
7588,287878,1,12,1,1,0,80
7589,287878,1,12,2,1,0,81
7590,287878,1,12,3,1,0,82
7591,287878,1,12,4,4,0,86
7592,287878,1,12,5,1,0,87
7593,287878,1,12,6,1,0,88
7594,287878,1,13,1,0,0,88
7595,287878,1,13,2,0,0,88
7596,287878,1,13,3,1,0,89
7597,287878,1,13,4,1,0,90
7598,287878,1,13,5,1,0,91
7599,287878,1,13,6,1,0,92
7600,287878,1,14,1,4,0,96
7601,287878,1,14,2,3,0,99
7602,287878,1,14,3,2,0,101
7603,287878,1,14,4,2,0,103
7604,287878,1,14,5,6,0,109
7605,287878,1,14,6,4,0,113
7606,287878,1,15,1,6,0,119
7607,287878,1,15,2,6,0,125
7608,287878,1,15,3,0,1,125
7609,287878,1,15,4,1,0,126
7610,287878,1,15,5,1,0,127
7611,287878,1,15,6,0,0,127
7612,287878,1,16,1,1,0,128
7613,287878,1,16,2,4,0,132
7614,287878,1,16,3,4,0,136
7615,287878,1,16,4,1,0,137
7616,287878,1,16,5,4,0,141
7617,287878,1,16,6,0,0,141
7618,287878,1,17,1,2,0,143
7619,287878,1,17,2,1,0,144
7620,287878,1,17,3,0,0,144
7621,287878,1,17,4,1,0,145
7622,287878,1,17,5,1,0,146
7623,287878,1,17,6,2,0,148
7624,287878,1,18,1,1,0,149
7625,287878,1,18,2,6,0,155
7626,287878,1,18,3,0,1,155
7627,287878,1,18,4,1,0,156
7628,287878,1,18,5,1,0,157
7629,287878,1,18,6,4,0,161
7630,287878,1,19,1,0,0,161
7631,287878,1,19,2,1,0,162
7632,287878,1,19,3,6,0,168
7633,287878,1,19,4,4,0,172
7634,287878,1,19,5,1,0,173
7635,287878,1,19,6,6,0,179
7636,287878,1,20,1,2,0,181
7637,287878,1,20,2,2,0,183
7638,287878,1,20,3,0,0,183
7639,287878,1,20,4,1,0,184
7640,287878,1,20,5,0,1,184
7641,287878,1,20,6,4,0,188
7762,287879,1,1,1,1,0,1
7763,287879,1,1,2,1,0,2
7764,287879,1,1,3,1,0,3
7765,287879,1,1,4,6,0,9
7766,287879,1,1,5,3,0,12
7767,287879,1,1,6,1,0,13
7768,287879,1,2,1,1,0,14
7769,287879,1,2,2,5,0,19
7770,287879,1,2,3,0,0,19
7771,287879,1,2,4,1,0,20
7772,287879,1,2,5,0,0,20
7773,287879,1,2,6,0,0,20
7774,287879,1,3,1,0,0,20
7775,287879,1,3,2,1,0,21
7776,287879,1,3,3,4,0,25
7777,287879,1,3,4,0,1,25
7778,287879,1,3,5,0,0,25
7779,287879,1,3,6,1,0,26
7780,287879,1,4,1,1,0,27
7781,287879,1,4,2,1,0,28
7782,287879,1,4,3,1,0,29
7783,287879,1,4,4,1,0,30
7784,287879,1,4,5,1,0,31
7785,287879,1,4,6,2,0,33
7786,287879,1,5,1,0,0,33
7787,287879,1,5,2,4,0,37
7788,287879,1,5,3,1,0,38
7789,287879,1,5,4,1,0,39
7790,287879,1,5,5,0,0,39
7791,287879,1,5,6,0,0,39
7792,287879,1,6,1,1,0,40
7793,287879,1,6,2,0,0,40
7794,287879,1,6,3,0,0,40
7795,287879,1,6,4,0,1,40
7796,287879,1,6,5,0,0,40
7797,287879,1,6,6,0,0,40
7798,287879,1,7,1,2,0,42
7799,287879,1,7,2,0,0,42
7800,287879,1,7,3,1,0,43
7801,287879,1,7,4,1,0,44
7802,287879,1,7,5,0,0,44
7803,287879,1,7,6,1,0,45
7804,287879,1,8,1,0,0,45
7805,287879,1,8,2,4,0,49
7806,287879,1,8,3,0,0,49
7807,287879,1,8,4,1,0,50
7808,287879,1,8,5,0,0,50
7809,287879,1,8,6,0,0,50
7810,287879,1,9,1,1,0,51
7811,287879,1,9,2,1,0,52
7812,287879,1,9,3,4,0,56
7813,287879,1,9,4,1,0,57
7814,287879,1,9,5,0,0,57
7815,287879,1,9,6,1,0,58
7816,287879,1,10,1,0,0,58
7817,287879,1,10,2,1,0,59
7818,287879,1,10,3,4,0,63
7819,287879,1,10,4,2,0,65
7820,287879,1,10,5,0,0,65
7821,287879,1,10,6,4,0,69
7822,287879,1,11,1,0,0,69
7823,287879,1,11,2,1,0,70
7824,287879,1,11,3,1,0,71
7825,287879,1,11,4,4,0,75
7826,287879,1,11,5,1,0,76
7827,287879,1,11,6,6,0,82
7828,287879,1,12,1,2,0,84
7829,287879,1,12,2,0,0,84
7830,287879,1,12,3,0,0,84
7831,287879,1,12,4,0,0,84
7832,287879,1,12,5,4,0,88
7833,287879,1,12,6,1,0,89
7834,287879,1,13,1,1,0,90
7835,287879,1,13,2,1,0,91
7836,287879,1,13,3,4,0,95
7837,287879,1,13,4,1,0,96
7838,287879,1,13,5,0,0,96
7839,287879,1,13,6,2,0,98
7840,287879,1,14,1,4,0,102
7841,287879,1,14,2,1,0,103
7842,287879,1,14,3,0,1,103
7843,287879,1,14,4,1,0,104
7844,287879,1,14,5,0,0,104
7845,287879,1,14,6,1,0,105
7846,287879,1,15,1,2,0,107
7847,287879,1,15,2,0,0,107
7848,287879,1,15,3,2,0,109
7849,287879,1,15,4,0,0,109
7850,287879,1,15,5,1,0,110
7851,287879,1,15,6,0,0,110
7852,287879,1,16,1,1,0,111
7853,287879,1,16,2,0,1,111
7854,287879,1,16,3,1,0,112
7855,287879,1,16,4,1,0,113
7856,287879,1,16,5,0,0,113
7857,287879,1,16,6,1,0,114
7858,287879,1,17,1,1,0,115
7859,287879,1,17,2,2,0,117
7860,287879,1,17,3,0,0,117
7861,287879,1,17,4,1,0,118
7862,287879,1,17,5,1,0,119
7863,287879,1,17,6,1,0,120
7864,287879,1,18,1,1,0,121
7865,287879,1,18,2,1,0,122
7866,287879,1,18,3,6,0,128
7867,287879,1,18,4,1,0,129
7868,287879,1,18,5,1,0,130
7869,287879,1,18,6,0,1,130
7870,287879,1,19,1,4,0,134
7871,287879,1,19,2,4,0,138
7872,287879,1,19,3,2,0,140
7873,287879,1,19,4,1,0,141
7874,287879,1,19,5,0,0,141
7875,287879,1,19,6,2,0,143
7876,287879,1,20,1,2,0,145
7877,287879,1,20,2,6,0,151
7878,287879,1,20,3,1,0,152
7879,287879,1,20,4,1,0,153
7880,287879,1,20,5,2,0,155
7881,287879,1,20,6,2,0,157
7999,291343,1,1,1,0,0,0
8000,291343,1,1,2,0,0,0
8001,291343,1,1,3,1,0,1
8002,291343,1,1,4,4,0,5
8003,291343,1,1,5,0,0,5
8004,291343,1,1,6,0,0,5
8005,291343,1,2,1,0,0,5
8006,291343,1,2,2,0,1,5
8007,291343,1,2,3,0,0,5
8008,291343,1,2,4,0,0,5
8009,291343,1,2,5,0,0,5
8010,291343,1,2,6,0,0,5
8011,291343,1,3,1,1,0,6
8012,291343,1,3,2,1,0,7
8013,291343,1,3,3,1,0,8
8014,291343,1,3,4,2,0,10
8015,291343,1,3,5,0,0,10
8016,291343,1,3,6,0,0,10
8017,291343,1,4,1,0,0,10
8018,291343,1,4,2,0,0,10
8019,291343,1,4,3,6,0,16
8020,291343,1,4,4,4,0,20
8021,291343,1,4,5,1,0,21
8022,291343,1,4,6,4,0,25
8023,291343,1,5,1,0,0,25
8024,291343,1,5,2,5,0,30
8025,291343,1,5,3,1,0,31
8026,291343,1,5,4,4,0,35
8027,291343,1,5,5,4,0,39
8028,291343,1,5,6,2,0,41
8029,291343,1,6,1,0,0,41
8030,291343,1,6,2,1,0,42
8031,291343,1,6,3,0,0,42
8032,291343,1,6,4,4,0,46
8033,291343,1,6,5,1,0,47
8034,291343,1,6,6,1,0,48
8035,291343,1,7,1,2,0,50
8036,291343,1,7,2,0,0,50
8037,291343,1,7,3,1,0,51
8038,291343,1,7,4,0,1,51
8039,291343,1,7,5,3,0,54
8040,291343,1,7,6,1,0,55
8041,291343,1,8,1,0,0,55
8042,291343,1,8,2,1,0,56
8043,291343,1,8,3,0,0,56
8044,291343,1,8,4,2,0,58
8045,291343,1,8,5,1,0,59
8046,291343,1,8,6,1,0,60
8047,291343,1,9,1,1,0,61
8048,291343,1,9,2,4,0,65
8049,291343,1,9,3,0,0,65
8050,291343,1,9,4,0,0,65
8051,291343,1,9,5,2,0,67
8052,291343,1,9,6,1,0,68
8053,291343,1,10,1,0,0,68
8054,291343,1,10,2,1,0,69
8055,291343,1,10,3,2,0,71
8056,291343,1,10,4,0,1,71
8057,291343,1,10,5,1,0,72
8058,291343,1,10,6,1,0,73
8059,291343,1,11,1,0,0,73
8060,291343,1,11,2,0,0,73
8061,291343,1,11,3,0,0,73
8062,291343,1,11,4,4,0,77
8063,291343,1,11,5,2,0,79
8064,291343,1,11,6,4,0,83
8065,291343,1,12,1,1,0,84
8066,291343,1,12,2,2,0,86
8067,291343,1,12,3,0,0,86
8068,291343,1,12,4,1,0,87
8069,291343,1,12,5,1,0,88
8070,291343,1,12,6,2,0,90
8071,291343,1,13,1,4,0,94
8072,291343,1,13,2,4,0,98
8073,291343,1,13,3,1,0,99
8074,291343,1,13,4,1,0,100
8075,291343,1,13,5,4,0,104
8076,291343,1,13,6,1,0,105
8077,291343,1,14,1,6,0,111
8078,291343,1,14,2,1,0,112
8079,291343,1,14,3,1,0,113
8080,291343,1,14,4,0,0,113
8081,291343,1,14,5,2,0,115
8082,291343,1,14,6,4,0,119
8083,291343,1,15,1,0,0,119
8084,291343,1,15,2,0,0,119
8085,291343,1,15,3,1,0,120
8086,291343,1,15,4,4,0,124
8087,291343,1,15,5,6,0,130
8088,291343,1,15,6,1,0,131
8089,291343,1,16,1,2,0,133
8090,291343,1,16,2,2,0,135
8091,291343,1,16,3,1,0,136
8092,291343,1,16,4,2,0,138
8093,291343,1,16,5,1,0,139
8094,291343,1,16,6,1,0,140
8095,291343,1,17,1,6,0,146
8096,291343,1,17,2,1,0,147
8097,291343,1,17,3,4,0,151
8098,291343,1,17,4,0,1,151
8099,291343,1,17,5,1,0,152
8100,291343,1,17,6,1,0,153
8101,291343,1,18,1,1,0,154
8102,291343,1,18,2,2,0,156
8103,291343,1,18,3,4,0,160
8104,291343,1,18,4,2,0,162
8105,291343,1,18,5,1,0,163
8106,291343,1,18,6,6,0,169
8107,291343,1,19,1,2,0,171
8108,291343,1,19,2,0,0,171
8109,291343,1,19,3,1,0,172
8110,291343,1,19,4,1,0,173
8111,291343,1,19,5,1,0,174
8112,291343,1,19,6,4,0,178
8113,291343,1,20,1,2,0,180
8114,291343,1,20,2,1,0,181
8115,291343,1,20,3,2,0,183
8116,291343,1,20,4,0,1,183
8117,291343,1,20,5,1,1,184
8118,291343,1,20,6,2,0,186
8230,291356,1,1,1,1,0,1
8231,291356,1,1,2,4,0,5
8232,291356,1,1,3,0,0,5
8233,291356,1,1,4,0,0,5
8234,291356,1,1,5,0,1,5
8235,291356,1,1,6,0,0,5
8236,291356,1,2,1,1,0,6
8237,291356,1,2,2,2,0,8
8238,291356,1,2,3,4,0,12
8239,291356,1,2,4,0,1,12
8240,291356,1,2,5,1,0,13
8241,291356,1,2,6,1,0,14
8242,291356,1,3,1,0,0,14
8243,291356,1,3,2,0,0,14
8244,291356,1,3,3,0,0,14
8245,291356,1,3,4,4,0,18
8246,291356,1,3,5,2,0,20
8247,291356,1,3,6,0,1,20
8248,291356,1,4,1,0,0,20
8249,291356,1,4,2,0,1,20
8250,291356,1,4,3,0,0,20
8251,291356,1,4,4,0,0,20
8252,291356,1,4,5,0,0,20
8253,291356,1,4,6,0,0,20
8254,291356,1,5,1,0,0,20
8255,291356,1,5,2,1,0,21
8256,291356,1,5,3,0,0,21
8257,291356,1,5,4,0,0,21
8258,291356,1,5,5,0,0,21
8259,291356,1,5,6,1,0,22
8260,291356,1,6,1,0,0,22
8261,291356,1,6,2,1,0,23
8262,291356,1,6,3,4,0,27
8263,291356,1,6,4,1,0,28
8264,291356,1,6,5,1,0,29
8265,291356,1,6,6,1,0,30
8266,291356,1,7,1,0,0,30
8267,291356,1,7,2,1,0,31
8268,291356,1,7,3,1,0,32
8269,291356,1,7,4,0,1,32
8270,291356,1,7,5,2,0,34
8271,291356,1,7,6,0,0,34
8272,291356,1,8,1,0,0,34
8273,291356,1,8,2,1,0,35
8274,291356,1,8,3,0,0,35
8275,291356,1,8,4,1,0,36
8276,291356,1,8,5,1,0,37
8277,291356,1,8,6,1,0,38
8278,291356,1,9,1,0,0,38
8279,291356,1,9,2,1,0,39
8280,291356,1,9,3,0,0,39
8281,291356,1,9,4,0,0,39
8282,291356,1,9,5,0,0,39
8283,291356,1,9,6,0,0,39
8284,291356,1,10,1,1,0,40
8285,291356,1,10,2,1,0,41
8286,291356,1,10,3,2,0,43
8287,291356,1,10,4,0,0,43
8288,291356,1,10,5,0,0,43
8289,291356,1,10,6,0,0,43
8290,291356,1,11,1,1,0,44
8291,291356,1,11,2,1,0,45
8292,291356,1,11,3,0,0,45
8293,291356,1,11,4,1,0,46
8294,291356,1,11,5,2,0,48
8295,291356,1,11,6,0,0,48
8296,291356,1,12,1,0,0,48
8297,291356,1,12,2,1,0,49
8298,291356,1,12,3,0,0,49
8299,291356,1,12,4,0,1,49
8300,291356,1,12,5,0,0,49
8301,291356,1,12,6,0,0,49
8302,291356,1,13,1,1,0,50
8303,291356,1,13,2,0,0,50
8304,291356,1,13,3,1,0,51
8305,291356,1,13,4,1,0,52
8306,291356,1,13,5,0,0,52
8307,291356,1,13,6,1,0,53
8308,291356,1,14,1,1,0,54
8309,291356,1,14,2,2,0,56
8310,291356,1,14,3,1,0,57
8311,291356,1,14,4,2,0,59
8312,291356,1,14,5,1,0,60
8313,291356,1,14,6,0,0,60
8314,291356,1,15,1,0,1,60
8315,291356,1,15,2,1,0,61
8316,291356,1,15,3,0,0,61
8317,291356,1,15,4,0,0,61
8318,291356,1,15,5,1,0,62
8319,291356,1,15,6,0,0,62
8320,291356,1,16,1,1,0,63
8321,291356,1,16,2,0,1,63
8322,291356,1,16,3,0,1,63
8323,291356,1,16,4,0,0,63
8324,291356,1,16,5,0,0,63
8325,291356,1,16,6,0,0,63
8326,291356,1,17,1,3,0,66
8327,291356,1,17,2,1,0,67
8328,291356,1,17,3,2,0,69
8329,291356,1,17,4,1,0,70
8330,291356,1,17,5,1,0,71
8331,291356,1,17,6,1,0,72
8332,291356,1,18,1,1,0,73
8333,291356,1,18,2,1,0,74
8334,291356,1,18,3,0,1,74
8404,296903,1,1,1,0,0,0
8405,296903,1,1,2,0,0,0
8406,296903,1,1,3,0,0,0
8407,296903,1,1,4,1,0,1
8408,296903,1,1,5,0,0,1
8409,296903,1,1,6,0,0,1
8410,296903,1,2,1,0,1,1
8411,296903,1,2,2,0,0,1
8412,296903,1,2,3,0,0,1
8413,296903,1,2,4,4,0,5
8414,296903,1,2,5,0,0,5
8415,296903,1,2,6,1,0,6
8416,296903,1,3,1,2,0,8
8417,296903,1,3,2,0,0,8
8418,296903,1,3,3,2,0,10
8419,296903,1,3,4,4,0,14
8420,296903,1,3,5,0,0,14
8421,296903,1,3,6,0,1,14
8422,296903,1,4,1,0,0,14
8423,296903,1,4,2,0,0,14
8424,296903,1,4,3,0,0,14
8425,296903,1,4,4,0,0,14
8426,296903,1,4,5,0,0,14
8427,296903,1,4,6,0,0,14
8428,296903,1,5,1,0,0,14
8429,296903,1,5,2,0,0,14
8430,296903,1,5,3,0,0,14
8431,296903,1,5,4,4,0,18
8432,296903,1,5,5,0,0,18
8433,296903,1,5,6,1,0,19
8434,296903,1,6,1,4,0,23
8435,296903,1,6,2,6,0,29
8436,296903,1,6,3,0,0,29
8437,296903,1,6,4,4,0,33
8438,296903,1,6,5,0,0,33
8439,296903,1,6,6,0,0,33
8440,296903,1,7,1,1,0,34
8441,296903,1,7,2,0,0,34
8442,296903,1,7,3,0,0,34
8443,296903,1,7,4,0,0,34
8444,296903,1,7,5,6,0,40
8445,296903,1,7,6,0,0,40
8446,296903,1,8,1,2,0,42
8447,296903,1,8,2,0,0,42
8448,296903,1,8,3,3,0,45
8449,296903,1,8,4,0,1,45
8450,296903,1,8,5,1,0,46
8451,296903,1,8,6,2,0,48
8452,296903,1,9,1,1,0,49
8453,296903,1,9,2,1,0,50
8454,296903,1,9,3,0,0,50
8455,296903,1,9,4,0,0,50
8456,296903,1,9,5,0,0,50
8457,296903,1,9,6,0,0,50
8458,296903,1,10,1,0,0,50
8459,296903,1,10,2,1,0,51
8460,296903,1,10,3,1,0,52
8461,296903,1,10,4,2,0,54
8462,296903,1,10,5,4,0,58
8463,296903,1,10,6,1,0,59
8464,296903,1,11,1,0,0,59
8465,296903,1,11,2,6,0,65
8466,296903,1,11,3,1,0,66
8467,296903,1,11,4,1,0,67
8468,296903,1,11,5,0,1,67
8469,296903,1,11,6,0,0,67
8470,296903,1,12,1,1,0,68
8471,296903,1,12,2,0,1,68
8472,296903,1,12,3,0,0,68
8473,296903,1,12,4,0,0,68
8474,296903,1,12,5,1,0,69
8475,296903,1,12,6,0,0,69
8476,296903,1,13,1,1,0,70
8477,296903,1,13,2,1,0,71
8478,296903,1,13,3,0,0,71
8479,296903,1,13,4,1,0,72
8480,296903,1,13,5,0,0,72
8481,296903,1,13,6,0,0,72
8482,296903,1,14,1,1,0,73
8483,296903,1,14,2,0,0,73
8484,296903,1,14,3,1,0,74
8485,296903,1,14,4,1,0,75
8486,296903,1,14,5,1,0,76
8487,296903,1,14,6,2,0,78
8488,296903,1,15,1,0,0,78
8489,296903,1,15,2,0,0,78
8490,296903,1,15,3,1,0,79
8491,296903,1,15,4,6,0,85
8492,296903,1,15,5,0,0,85
8493,296903,1,15,6,1,0,86
8494,296903,1,16,1,4,0,90
8495,296903,1,16,2,1,0,91
8496,296903,1,16,3,1,0,92
8497,296903,1,16,4,1,0,93
8498,296903,1,16,5,1,0,94
8499,296903,1,16,6,1,0,95
8500,296903,1,17,1,1,0,96
8501,296903,1,17,2,0,1,96
8502,296903,1,17,3,0,0,96
8503,296903,1,17,4,0,0,96
8504,296903,1,17,5,1,0,97
8505,296903,1,17,6,1,0,98
8506,296903,1,18,1,0,1,98
8507,296903,1,18,2,0,0,98
8508,296903,1,18,3,1,0,99
8509,296903,1,18,4,1,0,100
8510,296903,1,18,5,1,0,101
8511,296903,1,18,6,1,0,102
8512,296903,1,19,1,4,0,106
8513,296903,1,19,2,0,0,106
8514,296903,1,19,3,1,0,107
8515,296903,1,19,4,2,0,109
8516,296903,1,19,5,4,0,113
8517,296903,1,19,6,4,0,117
8518,296903,1,20,1,1,0,118
8519,296903,1,20,2,0,1,118
8520,296903,1,20,3,2,0,120
8521,296903,1,20,4,1,0,121
8522,296903,1,20,5,1,0,122
8523,296903,1,20,6,1,1,123
8629,297800,1,1,1,0,0,0
8630,297800,1,1,2,4,0,4
8631,297800,1,1,3,4,0,8
8632,297800,1,1,4,4,0,12
8633,297800,1,1,5,0,1,12
8634,297800,1,1,6,0,0,12
8635,297800,1,2,1,0,0,12
8636,297800,1,2,2,0,0,12
8637,297800,1,2,3,0,0,12
8638,297800,1,2,4,0,0,12
8639,297800,1,2,5,1,0,13
8640,297800,1,2,6,0,0,13
8641,297800,1,3,1,4,0,17
8642,297800,1,3,2,0,0,17
8643,297800,1,3,3,0,0,17
8644,297800,1,3,4,0,0,17
8645,297800,1,3,5,4,0,21
8646,297800,1,3,6,4,0,25
8647,297800,1,4,1,0,0,25
8648,297800,1,4,2,4,0,29
8649,297800,1,4,3,0,0,29
8650,297800,1,4,4,0,0,29
8651,297800,1,4,5,6,0,35
8652,297800,1,4,6,0,0,35
8653,297800,1,5,1,0,0,35
8654,297800,1,5,2,0,0,35
8655,297800,1,5,3,1,0,36
8656,297800,1,5,4,0,0,36
8657,297800,1,5,5,6,0,42
8658,297800,1,5,6,0,0,42
8659,297800,1,6,1,4,0,46
8660,297800,1,6,2,4,0,50
8661,297800,1,6,3,0,0,50
8662,297800,1,6,4,4,0,54
8663,297800,1,6,5,0,0,54
8664,297800,1,6,6,4,0,58
8665,297800,1,7,1,0,0,58
8666,297800,1,7,2,1,0,59
8667,297800,1,7,3,0,0,59
8668,297800,1,7,4,1,0,60
8669,297800,1,7,5,0,0,60
8670,297800,1,7,6,0,1,60
8671,297800,1,8,1,1,0,61
8672,297800,1,8,2,1,0,62
8673,297800,1,8,3,1,0,63
8674,297800,1,8,4,1,0,64
8675,297800,1,8,5,4,0,68
8676,297800,1,8,6,1,0,69
8677,297800,1,9,1,1,0,70
8678,297800,1,9,2,0,0,70
8679,297800,1,9,3,1,0,71
8680,297800,1,9,4,1,0,72
8681,297800,1,9,5,1,0,73
8682,297800,1,9,6,1,0,74
8683,297800,1,10,1,1,0,75
8684,297800,1,10,2,1,0,76
8685,297800,1,10,3,1,0,77
8686,297800,1,10,4,0,0,77
8687,297800,1,10,5,2,0,79
8688,297800,1,10,6,2,0,81
8689,297800,1,11,1,1,0,82
8690,297800,1,11,2,1,0,83
8691,297800,1,11,3,1,0,84
8692,297800,1,11,4,1,0,85
8693,297800,1,11,5,1,0,86
8694,297800,1,11,6,1,0,87
8695,297800,1,12,1,1,0,88
8696,297800,1,12,2,1,0,89
8697,297800,1,12,3,4,0,93
8698,297800,1,12,4,2,0,95
8699,297800,1,12,5,1,0,96
8700,297800,1,12,6,0,0,96
8701,297800,1,13,1,0,0,96
8702,297800,1,13,2,1,0,97
8703,297800,1,13,3,4,0,101
8704,297800,1,13,4,4,0,105
8705,297800,1,13,5,4,0,109
8706,297800,1,13,6,1,0,110
8707,297800,1,14,1,0,1,110
8708,297800,1,14,2,1,0,111
8709,297800,1,14,3,1,0,112
8710,297800,1,14,4,1,0,113
8711,297800,1,14,5,0,0,113
8712,297800,1,14,6,0,0,113
8713,297800,1,15,1,1,0,114
8714,297800,1,15,2,0,0,114
8715,297800,1,15,3,1,0,115
8716,297800,1,15,4,0,0,115
8717,297800,1,15,5,1,0,116
8718,297800,1,15,6,0,1,116
8719,297800,1,16,1,1,0,117
8720,297800,1,16,2,2,0,119
8721,297800,1,16,3,1,0,120
8722,297800,1,16,4,0,0,120
8723,297800,1,16,5,0,0,120
8724,297800,1,16,6,0,0,120
8725,297800,1,17,1,0,0,120
8726,297800,1,17,2,1,0,121
8727,297800,1,17,3,1,0,122
8728,297800,1,17,4,2,0,124
8729,297800,1,17,5,2,0,126
8730,297800,1,17,6,1,0,127
8731,297800,1,18,1,4,0,131
8732,297800,1,18,2,1,0,132
8733,297800,1,18,3,4,0,136
8734,297800,1,18,4,1,0,137
8735,297800,1,18,5,3,0,140
8736,297800,1,18,6,9,0,149
8737,297800,1,19,1,4,0,153
8738,297800,1,19,2,1,0,154
8739,297800,1,19,3,1,0,155
8740,297800,1,19,4,1,0,156
8741,297800,1,19,5,2,0,158
8742,297800,1,19,6,0,1,158
8743,297800,1,20,1,1,0,159
8744,297800,1,20,2,0,0,159
8745,297800,1,20,3,3,0,162
8746,297800,1,20,4,2,0,164
8747,297800,1,20,5,1,0,165
8748,297800,1,20,6,1,0,166
8858,298795,1,1,1,2,0,2
8859,298795,1,1,2,0,0,2
8860,298795,1,1,3,0,0,2
8861,298795,1,1,4,1,0,3
8862,298795,1,1,5,0,0,3
8863,298795,1,1,6,1,0,4
8864,298795,1,2,1,1,0,5
8865,298795,1,2,2,1,0,6
8866,298795,1,2,3,0,0,6
8867,298795,1,2,4,0,0,6
8868,298795,1,2,5,1,0,7
8869,298795,1,2,6,0,0,7
8870,298795,1,3,1,7,0,14
8871,298795,1,3,2,0,1,14
8872,298795,1,3,3,0,0,14
8873,298795,1,3,4,0,0,14
8874,298795,1,3,5,2,0,16
8875,298795,1,3,6,6,0,22
8876,298795,1,4,1,1,0,23
8877,298795,1,4,2,4,0,27
8878,298795,1,4,3,0,0,27
8879,298795,1,4,4,0,0,27
8880,298795,1,4,5,1,0,28
8881,298795,1,4,6,0,0,28
8882,298795,1,5,1,0,0,28
8883,298795,1,5,2,1,0,29
8884,298795,1,5,3,4,0,33
8885,298795,1,5,4,0,0,33
8886,298795,1,5,5,1,0,34
8887,298795,1,5,6,0,1,34
8888,298795,1,6,1,1,0,35
8889,298795,1,6,2,1,0,36
8890,298795,1,6,3,0,0,36
8891,298795,1,6,4,2,0,38
8892,298795,1,6,5,0,0,38
8893,298795,1,6,6,1,0,39
8894,298795,1,7,1,0,0,39
8895,298795,1,7,2,6,0,45
8896,298795,1,7,3,0,0,45
8897,298795,1,7,4,0,1,45
8898,298795,1,7,5,0,0,45
8899,298795,1,7,6,3,0,48
8900,298795,1,8,1,1,0,49
8901,298795,1,8,2,1,0,50
8902,298795,1,8,3,2,0,52
8903,298795,1,8,4,1,0,53
8904,298795,1,8,5,1,0,54
8905,298795,1,8,6,0,0,54
8906,298795,1,9,1,0,0,54
8907,298795,1,9,2,4,0,58
8908,298795,1,9,3,4,0,62
8909,298795,1,9,4,0,0,62
8910,298795,1,9,5,0,0,62
8911,298795,1,9,6,1,0,63
8912,298795,1,10,1,0,0,63
8913,298795,1,10,2,1,0,64
8914,298795,1,10,3,1,0,65
8915,298795,1,10,4,1,0,66
8916,298795,1,10,5,0,0,66
8917,298795,1,10,6,0,1,66
8918,298795,1,11,1,1,0,67
8919,298795,1,11,2,0,0,67
8920,298795,1,11,3,1,0,68
8921,298795,1,11,4,2,0,70
8922,298795,1,11,5,0,0,70
8923,298795,1,11,6,1,0,71
8924,298795,1,12,1,0,0,71
8925,298795,1,12,2,0,0,71
8926,298795,1,12,3,1,0,72
8927,298795,1,12,4,1,0,73
8928,298795,1,12,5,1,0,74
8929,298795,1,12,6,1,0,75
8930,298795,1,13,1,1,0,76
8931,298795,1,13,2,2,0,78
8932,298795,1,13,3,0,1,78
8933,298795,1,13,4,1,0,79
8934,298795,1,13,5,0,0,79
8935,298795,1,13,6,2,0,81
8936,298795,1,14,1,0,0,81
8937,298795,1,14,2,0,0,81
8938,298795,1,14,3,0,0,81
8939,298795,1,14,4,0,0,81
8940,298795,1,14,5,1,0,82
8941,298795,1,14,6,1,0,83
8942,298795,1,15,1,0,0,83
8943,298795,1,15,2,1,0,84
8944,298795,1,15,3,0,1,84
8945,298795,1,15,4,1,0,85
8946,298795,1,15,5,0,0,85
8947,298795,1,15,6,1,0,86
8948,298795,1,16,1,2,0,88
8949,298795,1,16,2,2,0,90
8950,298795,1,16,3,1,0,91
8951,298795,1,16,4,4,0,95
8952,298795,1,16,5,1,0,96
8953,298795,1,16,6,1,0,97
8954,298795,1,17,1,1,0,98
8955,298795,1,17,2,0,1,98
8956,298795,1,17,3,1,0,99
8957,298795,1,17,4,0,0,99
8958,298795,1,17,5,0,0,99
8959,298795,1,17,6,0,0,99
8960,298795,1,18,1,1,0,100
8961,298795,1,18,2,1,0,101
8962,298795,1,18,3,4,0,105
8963,298795,1,18,4,0,0,105
8964,298795,1,18,5,6,0,111
8965,298795,1,18,6,2,0,113
8966,298795,1,19,1,1,0,114
8967,298795,1,19,2,0,0,114
8968,298795,1,19,3,2,0,116
8969,298795,1,19,4,2,0,118
8970,298795,1,19,5,1,0,119
8971,298795,1,19,6,0,0,119
8972,298795,1,20,1,6,0,125
8973,298795,1,20,2,0,0,125
8974,298795,1,20,3,0,0,125
8975,298795,1,20,4,1,0,126
8976,298795,1,20,5,2,0,128
8977,298795,1,20,6,1,0,129
9097,298804,1,1,1,1,0,1
9098,298804,1,1,2,0,0,1
9099,298804,1,1,3,0,0,1
9100,298804,1,1,4,2,0,3
9101,298804,1,1,5,0,0,3
9102,298804,1,1,6,0,0,3
9103,298804,1,2,1,1,0,4
9104,298804,1,2,2,0,0,4
9105,298804,1,2,3,0,0,4
9106,298804,1,2,4,1,0,5
9107,298804,1,2,5,1,0,6
9108,298804,1,2,6,4,0,10
9109,298804,1,3,1,4,0,14
9110,298804,1,3,2,1,0,15
9111,298804,1,3,3,0,0,15
9112,298804,1,3,4,1,0,16
9113,298804,1,3,5,0,0,16
9114,298804,1,3,6,4,0,20
9115,298804,1,4,1,0,1,20
9116,298804,1,4,2,0,0,20
9117,298804,1,4,3,0,0,20
9118,298804,1,4,4,4,0,24
9119,298804,1,4,5,0,0,24
9120,298804,1,4,6,0,0,24
9121,298804,1,5,1,0,0,24
9122,298804,1,5,2,4,0,28
9123,298804,1,5,3,0,0,28
9124,298804,1,5,4,0,0,28
9125,298804,1,5,5,1,0,29
9126,298804,1,5,6,0,0,29
9127,298804,1,6,1,1,0,30
9128,298804,1,6,2,0,1,30
9129,298804,1,6,3,1,0,31
9130,298804,1,6,4,0,0,31
9131,298804,1,6,5,0,0,31
9132,298804,1,6,6,0,0,31
9133,298804,1,7,1,0,0,31
9134,298804,1,7,2,0,0,31
9135,298804,1,7,3,0,0,31
9136,298804,1,7,4,0,0,31
9137,298804,1,7,5,1,0,32
9138,298804,1,7,6,1,0,33
9139,298804,1,8,1,0,0,33
9140,298804,1,8,2,1,0,34
9141,298804,1,8,3,6,0,40
9142,298804,1,8,4,1,0,41
9143,298804,1,8,5,0,1,41
9144,298804,1,8,6,0,0,41
9145,298804,1,9,1,1,0,42
9146,298804,1,9,2,0,0,42
9147,298804,1,9,3,0,0,42
9148,298804,1,9,4,0,0,42
9149,298804,1,9,5,0,0,42
9150,298804,1,9,6,4,0,46
9151,298804,1,10,1,1,0,47
9152,298804,1,10,2,0,0,47
9153,298804,1,10,3,1,0,48
9154,298804,1,10,4,0,0,48
9155,298804,1,10,5,0,0,48
9156,298804,1,10,6,0,0,48
9157,298804,1,11,1,0,0,48
9158,298804,1,11,2,1,0,49
9159,298804,1,11,3,1,0,50
9160,298804,1,11,4,0,0,50
9161,298804,1,11,5,0,0,50
9162,298804,1,11,6,0,0,50
9163,298804,1,12,1,1,0,51
9164,298804,1,12,2,4,0,55
9165,298804,1,12,3,0,0,55
9166,298804,1,12,4,1,0,56
9167,298804,1,12,5,1,0,57
9168,298804,1,12,6,1,0,58
9169,298804,1,13,1,0,1,58
9170,298804,1,13,2,0,0,58
9171,298804,1,13,3,1,0,59
9172,298804,1,13,4,1,0,60
9173,298804,1,13,5,1,0,61
9174,298804,1,13,6,1,0,62
9175,298804,1,14,1,1,0,63
9176,298804,1,14,2,6,0,69
9177,298804,1,14,3,1,0,70
9178,298804,1,14,4,2,0,72
9179,298804,1,14,5,0,1,72
9180,298804,1,14,6,7,0,79
9181,298804,1,15,1,0,0,79
9182,298804,1,15,2,0,0,79
9183,298804,1,15,3,0,0,79
9184,298804,1,15,4,0,1,79
9185,298804,1,15,5,1,0,80
9186,298804,1,15,6,1,0,81
9187,298804,1,16,1,4,0,85
9188,298804,1,16,2,1,0,86
9189,298804,1,16,3,1,0,87
9190,298804,1,16,4,1,0,88
9191,298804,1,16,5,2,0,90
9192,298804,1,16,6,1,0,91
9193,298804,1,17,1,2,0,93
9194,298804,1,17,2,1,0,94
9195,298804,1,17,3,0,0,94
9196,298804,1,17,4,1,0,95
9197,298804,1,17,5,0,0,95
9198,298804,1,17,6,2,0,97
9199,298804,1,18,1,3,0,100
9200,298804,1,18,2,1,0,101
9201,298804,1,18,3,0,0,101
9202,298804,1,18,4,0,1,101
9203,298804,1,18,5,1,0,102
9204,298804,1,18,6,6,0,108
9205,298804,1,19,1,0,0,108
9206,298804,1,19,2,4,0,112
9207,298804,1,19,3,2,0,114
9208,298804,1,19,4,2,0,116
9209,298804,1,19,5,1,0,117
9210,298804,1,19,6,0,0,117
9211,298804,1,20,1,6,0,123
9212,298804,1,20,2,1,0,124
9213,298804,1,20,3,4,0,128
9214,298804,1,20,4,1,0,129
9215,298804,1,20,5,1,0,130
9216,298804,1,20,6,1,0,131
9333,300435,1,1,1,1,0,1
9334,300435,1,1,2,1,0,2
9335,300435,1,1,3,0,0,2
9336,300435,1,1,4,0,0,2
9337,300435,1,1,5,4,0,6
9338,300435,1,1,6,4,0,10
9339,300435,1,2,1,1,0,11
9340,300435,1,2,2,0,0,11
9341,300435,1,2,3,0,0,11
9342,300435,1,2,4,1,0,12
9343,300435,1,2,5,0,1,12
9344,300435,1,2,6,4,0,16
9345,300435,1,3,1,2,0,18
9346,300435,1,3,2,6,0,24
9347,300435,1,3,3,1,0,25
9348,300435,1,3,4,1,0,26
9349,300435,1,3,5,1,0,27
9350,300435,1,3,6,4,0,31
9351,300435,1,4,1,0,1,31
9352,300435,1,4,2,4,0,35
9353,300435,1,4,3,0,0,35
9354,300435,1,4,4,1,0,36
9355,300435,1,4,5,0,0,36
9356,300435,1,4,6,2,0,38
9357,300435,1,5,1,1,0,39
9358,300435,1,5,2,0,0,39
9359,300435,1,5,3,4,0,43
9360,300435,1,5,4,0,0,43
9361,300435,1,5,5,1,0,44
9362,300435,1,5,6,1,0,45
9363,300435,1,6,1,4,0,49
9364,300435,1,6,2,4,0,53
9365,300435,1,6,3,2,0,55
9366,300435,1,6,4,0,0,55
9367,300435,1,6,5,4,0,59
9368,300435,1,6,6,0,0,59
9369,300435,1,7,1,0,0,59
9370,300435,1,7,2,1,0,60
9371,300435,1,7,3,1,0,61
9372,300435,1,7,4,4,0,65
9373,300435,1,7,5,0,1,65
9374,300435,1,7,6,2,0,67
9375,300435,1,8,1,6,0,73
9376,300435,1,8,2,0,0,73
9377,300435,1,8,3,1,0,74
9378,300435,1,8,4,0,0,74
9379,300435,1,8,5,0,0,74
9380,300435,1,8,6,1,0,75
9381,300435,1,9,1,1,0,76
9382,300435,1,9,2,1,0,77
9383,300435,1,9,3,1,0,78
9384,300435,1,9,4,2,0,80
9385,300435,1,9,5,1,0,81
9386,300435,1,9,6,0,0,81
9387,300435,1,10,1,1,0,82
9388,300435,1,10,2,0,0,82
9389,300435,1,10,3,2,0,84
9390,300435,1,10,4,1,0,85
9391,300435,1,10,5,0,1,85
9392,300435,1,10,6,1,0,86
9393,300435,1,11,1,0,0,86
9394,300435,1,11,2,2,0,88
9395,300435,1,11,3,0,0,88
9396,300435,1,11,4,4,0,92
9397,300435,1,11,5,0,0,92
9398,300435,1,11,6,1,0,93
9399,300435,1,12,1,1,0,94
9400,300435,1,12,2,1,0,95
9401,300435,1,12,3,1,0,96
9402,300435,1,12,4,1,0,97
9403,300435,1,12,5,1,0,98
9404,300435,1,12,6,6,0,104
9405,300435,1,13,1,0,0,104
9406,300435,1,13,2,1,0,105
9407,300435,1,13,3,1,0,106
9408,300435,1,13,4,6,0,112
9409,300435,1,13,5,4,0,116
9410,300435,1,13,6,1,0,117
9411,300435,1,14,1,0,0,117
9412,300435,1,14,2,0,1,117
9413,300435,1,14,3,0,0,117
9414,300435,1,14,4,0,0,117
9415,300435,1,14,5,1,0,118
9416,300435,1,14,6,1,0,119
9417,300435,1,15,1,1,0,120
9418,300435,1,15,2,0,0,120
9419,300435,1,15,3,1,0,121
9420,300435,1,15,4,0,0,121
9421,300435,1,15,5,1,0,122
9422,300435,1,15,6,0,0,122
9423,300435,1,16,1,1,0,123
9424,300435,1,16,2,1,0,124
9425,300435,1,16,3,6,0,130
9426,300435,1,16,4,6,0,136
9427,300435,1,16,5,6,0,142
9428,300435,1,16,6,6,0,148
9429,300435,1,17,1,4,0,152
9430,300435,1,17,2,1,0,153
9431,300435,1,17,3,4,0,157
9432,300435,1,17,4,0,1,157
9433,300435,1,17,5,1,0,158
9434,300435,1,17,6,1,0,159
9435,300435,1,18,1,1,0,160
9436,300435,1,18,2,0,1,160
9437,300435,1,18,3,4,0,164
9438,300435,1,18,4,0,0,164
9439,300435,1,18,5,1,0,165
9440,300435,1,18,6,1,0,166
9441,300435,1,19,1,4,0,170
9442,300435,1,19,2,1,0,171
9443,300435,1,19,3,1,0,172
9444,300435,1,19,4,0,1,172
9445,300435,1,19,5,1,0,173
9446,300435,1,19,6,0,0,173
9447,300435,1,20,1,1,0,174
9448,300435,1,20,2,0,0,174
9449,300435,1,20,3,4,0,178
9450,300435,1,20,4,1,0,179
9451,300435,1,20,5,4,0,183
9452,300435,1,20,6,1,0,184
9569,300436,1,1,1,1,0,1
9570,300436,1,1,2,0,0,1
9571,300436,1,1,3,0,0,1
9572,300436,1,1,4,0,0,1
9573,300436,1,1,5,1,0,2
9574,300436,1,1,6,0,0,2
9575,300436,1,2,1,1,0,3
9576,300436,1,2,2,1,0,4
9577,300436,1,2,3,0,0,4
9578,300436,1,2,4,1,0,5
9579,300436,1,2,5,6,0,11
9580,300436,1,2,6,2,0,13
9581,300436,1,3,1,0,0,13
9582,300436,1,3,2,6,0,19
9583,300436,1,3,3,0,0,19
9584,300436,1,3,4,0,0,19
9585,300436,1,3,5,4,0,23
9586,300436,1,3,6,1,0,24
9587,300436,1,4,1,1,0,25
9588,300436,1,4,2,4,0,29
9589,300436,1,4,3,1,0,30
9590,300436,1,4,4,1,0,31
9591,300436,1,4,5,0,0,31
9592,300436,1,4,6,4,0,35
9593,300436,1,5,1,6,0,41
9594,300436,1,5,2,1,0,42
9595,300436,1,5,3,4,0,46
9596,300436,1,5,4,6,0,52
9597,300436,1,5,5,1,0,53
9598,300436,1,5,6,4,0,57
9599,300436,1,6,1,4,0,61
9600,300436,1,6,2,0,0,61
9601,300436,1,6,3,0,0,61
9602,300436,1,6,4,4,0,65
9603,300436,1,6,5,0,1,65
9604,300436,1,6,6,2,0,67
9605,300436,1,7,1,0,0,67
9606,300436,1,7,2,1,0,68
9607,300436,1,7,3,1,0,69
9608,300436,1,7,4,1,0,70
9609,300436,1,7,5,0,1,70
9610,300436,1,7,6,1,0,71
9611,300436,1,8,1,0,0,71
9612,300436,1,8,2,0,0,71
9613,300436,1,8,3,0,1,71
9614,300436,1,8,4,4,0,75
9615,300436,1,8,5,0,0,75
9616,300436,1,8,6,1,0,76
9617,300436,1,9,1,0,0,76
9618,300436,1,9,2,0,1,76
9619,300436,1,9,3,1,0,77
9620,300436,1,9,4,0,0,77
9621,300436,1,9,5,0,0,77
9622,300436,1,9,6,0,0,77
9623,300436,1,10,1,1,0,78
9624,300436,1,10,2,0,0,78
9625,300436,1,10,3,4,0,82
9626,300436,1,10,4,0,0,82
9627,300436,1,10,5,2,0,84
9628,300436,1,10,6,0,0,84
9629,300436,1,11,1,1,0,85
9630,300436,1,11,2,1,0,86
9631,300436,1,11,3,1,0,87
9632,300436,1,11,4,0,0,87
9633,300436,1,11,5,1,0,88
9634,300436,1,11,6,1,0,89
9635,300436,1,12,1,1,0,90
9636,300436,1,12,2,1,0,91
9637,300436,1,12,3,6,0,97
9638,300436,1,12,4,4,0,101
9639,300436,1,12,5,0,0,101
9640,300436,1,12,6,1,0,102
9641,300436,1,13,1,0,0,102
9642,300436,1,13,2,6,0,108
9643,300436,1,13,3,4,0,112
9644,300436,1,13,4,1,0,113
9645,300436,1,13,5,0,0,113
9646,300436,1,13,6,1,0,114
9647,300436,1,14,1,0,0,114
9648,300436,1,14,2,1,0,115
9649,300436,1,14,3,0,0,115
9650,300436,1,14,4,1,0,116
9651,300436,1,14,5,4,0,120
9652,300436,1,14,6,0,0,120
9653,300436,1,15,1,1,0,121
9654,300436,1,15,2,1,0,122
9655,300436,1,15,3,1,0,123
9656,300436,1,15,4,1,0,124
9657,300436,1,15,5,1,0,125
9658,300436,1,15,6,1,0,126
9659,300436,1,16,1,2,0,128
9660,300436,1,16,2,1,0,129
9661,300436,1,16,3,1,0,130
9662,300436,1,16,4,1,0,131
9663,300436,1,16,5,4,0,135
9664,300436,1,16,6,4,0,139
9665,300436,1,17,1,2,0,141
9666,300436,1,17,2,4,0,145
9667,300436,1,17,3,6,0,151
9668,300436,1,17,4,0,0,151
9669,300436,1,17,5,0,0,151
9670,300436,1,17,6,4,0,155
9671,300436,1,18,1,4,0,159
9672,300436,1,18,2,6,0,165
9673,300436,1,18,3,1,0,166
9674,300436,1,18,4,1,0,167
9675,300436,1,18,5,1,0,168
9676,300436,1,18,6,1,0,169
9677,300436,1,19,1,1,0,170
9678,300436,1,19,2,1,0,171
9679,300436,1,19,3,7,0,178
9680,300436,1,19,4,0,1,178
9681,300436,1,19,5,0,1,178
9682,300436,1,19,6,6,0,184
9683,300436,1,20,1,3,0,187
9684,300436,1,20,2,1,0,188
9685,300436,1,20,3,4,0,192
9686,300436,1,20,4,0,0,192
9687,300436,1,20,5,1,1,193
9688,300436,1,20,6,0,1,193
9809,306989,1,1,1,3,0,3
9810,306989,1,1,2,0,0,3
9811,306989,1,1,3,4,0,7
9812,306989,1,1,4,0,0,7
9813,306989,1,1,5,1,0,8
9814,306989,1,1,6,1,0,9
9815,306989,1,2,1,0,0,9
9816,306989,1,2,2,0,0,9
9817,306989,1,2,3,1,0,10
9818,306989,1,2,4,0,0,10
9819,306989,1,2,5,0,0,10
9820,306989,1,2,6,0,0,10
9821,306989,1,3,1,0,0,10
9822,306989,1,3,2,4,0,14
9823,306989,1,3,3,4,0,18
9824,306989,1,3,4,1,0,19
9825,306989,1,3,5,6,0,25
9826,306989,1,3,6,2,0,27
9827,306989,1,4,1,1,0,28
9828,306989,1,4,2,2,0,30
9829,306989,1,4,3,0,0,30
9830,306989,1,4,4,2,0,32
9831,306989,1,4,5,4,0,36
9832,306989,1,4,6,1,0,37
9833,306989,1,5,1,0,0,37
9834,306989,1,5,2,4,0,41
9835,306989,1,5,3,4,0,45
9836,306989,1,5,4,6,0,51
9837,306989,1,5,5,6,0,57
9838,306989,1,5,6,1,0,58
9839,306989,1,6,1,0,0,58
9840,306989,1,6,2,2,0,60
9841,306989,1,6,3,2,0,62
9842,306989,1,6,4,4,0,66
9843,306989,1,6,5,1,0,67
9844,306989,1,6,6,0,0,67
9845,306989,1,7,1,1,0,68
9846,306989,1,7,2,0,0,68
9847,306989,1,7,3,2,0,70
9848,306989,1,7,4,1,0,71
9849,306989,1,7,5,1,0,72
9850,306989,1,7,6,1,0,73
9851,306989,1,8,1,0,0,73
9852,306989,1,8,2,1,0,74
9853,306989,1,8,3,2,0,76
9854,306989,1,8,4,0,1,76
9855,306989,1,8,5,0,0,76
9856,306989,1,8,6,0,0,76
9857,306989,1,9,1,1,0,77
9858,306989,1,9,2,1,0,78
9859,306989,1,9,3,0,0,78
9860,306989,1,9,4,0,0,78
9861,306989,1,9,5,0,0,78
9862,306989,1,9,6,2,0,80
9863,306989,1,10,1,2,0,82
9864,306989,1,10,2,0,0,82
9865,306989,1,10,3,1,0,83
9866,306989,1,10,4,2,0,85
9867,306989,1,10,5,6,0,91
9868,306989,1,10,6,1,0,92
9869,306989,1,11,1,2,0,94
9870,306989,1,11,2,1,0,95
9871,306989,1,11,3,0,0,95
9872,306989,1,11,4,1,0,96
9873,306989,1,11,5,2,0,98
9874,306989,1,11,6,2,0,100
9875,306989,1,12,1,2,0,102
9876,306989,1,12,2,0,1,102
9877,306989,1,12,3,1,0,103
9878,306989,1,12,4,1,0,104
9879,306989,1,12,5,1,0,105
9880,306989,1,12,6,6,0,111
9881,306989,1,13,1,1,0,112
9882,306989,1,13,2,1,0,113
9883,306989,1,13,3,1,0,114
9884,306989,1,13,4,1,0,115
9885,306989,1,13,5,6,0,121
9886,306989,1,13,6,0,1,121
9887,306989,1,14,1,6,0,127
9888,306989,1,14,2,1,0,128
9889,306989,1,14,3,2,0,130
9890,306989,1,14,4,1,0,131
9891,306989,1,14,5,4,0,135
9892,306989,1,14,6,0,0,135
9893,306989,1,15,1,1,0,136
9894,306989,1,15,2,1,0,137
9895,306989,1,15,3,1,0,138
9896,306989,1,15,4,6,0,144
9897,306989,1,15,5,2,0,146
9898,306989,1,15,6,0,0,146
9899,306989,1,16,1,1,0,147
9900,306989,1,16,2,0,1,147
9901,306989,1,16,3,0,0,147
9902,306989,1,16,4,1,0,148
9903,306989,1,16,5,1,0,149
9904,306989,1,16,6,0,0,149
9905,306989,1,17,1,6,0,155
9906,306989,1,17,2,1,0,156
9907,306989,1,17,3,1,0,157
9908,306989,1,17,4,6,0,163
9909,306989,1,17,5,1,0,164
9910,306989,1,17,6,0,1,164
9911,306989,1,18,1,0,0,164
9912,306989,1,18,2,1,0,165
9913,306989,1,18,3,1,0,166
9914,306989,1,18,4,1,0,167
9915,306989,1,18,5,0,0,167
9916,306989,1,18,6,0,0,167
9917,306989,1,19,1,2,0,169
9918,306989,1,19,2,6,0,175
9919,306989,1,19,3,1,0,176
9920,306989,1,19,4,1,0,177
9921,306989,1,19,5,1,0,178
9922,306989,1,19,6,8,0,186
9923,306989,1,20,1,0,1,186
9924,306989,1,20,2,2,0,188
9925,306989,1,20,3,0,1,188
9926,306989,1,20,4,1,0,189
9927,306989,1,20,5,1,0,190
9928,306989,1,20,6,1,0,191
10049,319112,1,1,1,0,0,0
10050,319112,1,1,2,0,0,0
10051,319112,1,1,3,1,0,1
10052,319112,1,1,4,0,0,1
10053,319112,1,1,5,0,0,1
10054,319112,1,1,6,4,0,5
10055,319112,1,2,1,0,1,5
10056,319112,1,2,2,0,1,5
10057,319112,1,2,3,0,0,5
10058,319112,1,2,4,0,0,5
10059,319112,1,2,5,0,0,5
10060,319112,1,2,6,0,1,5
10061,319112,1,3,1,0,1,5
10062,319112,1,3,2,1,0,6
10063,319112,1,3,3,1,0,7
10064,319112,1,3,4,1,0,8
10065,319112,1,3,5,0,0,8
10066,319112,1,3,6,0,0,8
10067,319112,1,4,1,1,0,9
10068,319112,1,4,2,0,0,9
10069,319112,1,4,3,1,0,10
10070,319112,1,4,4,0,1,10
10071,319112,1,4,5,0,0,10
10072,319112,1,4,6,0,0,10
10073,319112,1,5,1,0,0,10
10074,319112,1,5,2,0,0,10
10075,319112,1,5,3,0,0,10
10076,319112,1,5,4,1,0,11
10077,319112,1,5,5,1,0,12
10078,319112,1,5,6,0,0,12
10079,319112,1,6,1,0,1,12
10080,319112,1,6,2,0,0,12
10081,319112,1,6,3,1,0,13
10082,319112,1,6,4,1,0,14
10083,319112,1,6,5,2,0,16
10084,319112,1,6,6,0,0,16
10085,319112,1,7,1,0,0,16
10086,319112,1,7,2,1,0,17
10087,319112,1,7,3,0,0,17
10088,319112,1,7,4,0,0,17
10089,319112,1,7,5,0,0,17
10090,319112,1,7,6,1,0,18
10091,319112,1,8,1,4,0,22
10092,319112,1,8,2,0,1,22
10093,319112,1,8,3,0,0,22
10094,319112,1,8,4,1,0,23
10095,319112,1,8,5,0,0,23
10096,319112,1,8,6,0,0,23
10097,319112,1,9,1,0,0,23
10098,319112,1,9,2,0,0,23
10099,319112,1,9,3,1,0,24
10100,319112,1,9,4,1,0,25
10101,319112,1,9,5,0,0,25
10102,319112,1,9,6,0,0,25
10103,319112,1,10,1,0,0,25
10104,319112,1,10,2,0,0,25
10105,319112,1,10,3,1,0,26
10106,319112,1,10,4,1,0,27
10107,319112,1,10,5,0,0,27
10108,319112,1,10,6,1,0,28
10109,319112,1,11,1,6,0,34
10110,319112,1,11,2,1,0,35
10111,319112,1,11,3,1,0,36
10112,319112,1,11,4,1,0,37
10113,319112,1,11,5,0,0,37
10114,319112,1,11,6,0,1,37
10115,319112,1,12,1,0,0,37
10116,319112,1,12,2,0,0,37
10117,319112,1,12,3,4,0,41
10118,319112,1,12,4,0,0,41
10119,319112,1,12,5,0,0,41
10120,319112,1,12,6,2,0,43
10121,319112,1,13,1,1,0,44
10122,319112,1,13,2,1,0,45
10123,319112,1,13,3,4,0,49
10124,319112,1,13,4,2,0,51
10125,319112,1,13,5,6,0,57
10126,319112,1,13,6,1,0,58
10186,319142,1,1,1,0,0,0
10187,319142,1,1,2,0,0,0
10188,319142,1,1,3,0,0,0
10189,319142,1,1,4,2,0,2
10190,319142,1,1,5,0,0,2
10191,319142,1,1,6,7,0,9
10192,319142,1,2,1,0,0,9
10193,319142,1,2,2,0,0,9
10194,319142,1,2,3,0,0,9
10195,319142,1,2,4,1,0,10
10196,319142,1,2,5,1,0,11
10197,319142,1,2,6,1,0,12
10198,319142,1,3,1,6,0,18
10199,319142,1,3,2,4,0,22
10200,319142,1,3,3,4,0,26
10201,319142,1,3,4,0,0,26
10202,319142,1,3,5,0,0,26
10203,319142,1,3,6,0,0,26
10204,319142,1,4,1,1,0,27
10205,319142,1,4,2,5,0,32
10206,319142,1,4,3,4,0,36
10207,319142,1,4,4,1,0,37
10208,319142,1,4,5,1,0,38
10209,319142,1,4,6,4,0,42
10210,319142,1,5,1,0,0,42
10211,319142,1,5,2,2,0,44
10212,319142,1,5,3,1,0,45
10213,319142,1,5,4,0,0,45
10214,319142,1,5,5,1,0,46
10215,319142,1,5,6,1,0,47
10216,319142,1,6,1,3,0,50
10217,319142,1,6,2,1,0,51
10218,319142,1,6,3,4,0,55
10219,319142,1,6,4,2,0,57
10220,319142,1,6,5,0,0,57
10221,319142,1,6,6,0,1,57
10222,319142,1,7,1,1,0,58
10223,319142,1,7,2,1,0,59
10224,319142,1,7,3,1,0,60
10225,319142,1,7,4,1,0,61
10226,319142,1,7,5,0,0,61
10227,319142,1,7,6,4,0,65
10228,319142,1,8,1,0,0,65
10229,319142,1,8,2,1,0,66
10230,319142,1,8,3,0,0,66
10231,319142,1,8,4,6,0,72
10232,319142,1,8,5,0,1,72
10233,319142,1,8,6,0,0,72
10234,319142,1,9,1,0,0,72
10235,319142,1,9,2,0,1,72
10236,319142,1,9,3,0,0,72
10237,319142,1,9,4,1,0,73
10238,319142,1,9,5,1,0,74
10239,319142,1,9,6,4,0,78
10240,319142,1,10,1,1,0,79
10241,319142,1,10,2,1,0,80
10242,319142,1,10,3,4,0,84
10243,319142,1,10,4,1,0,85
10244,319142,1,10,5,0,0,85
10245,319142,1,10,6,6,0,91
10246,319142,1,11,1,2,0,93
10247,319142,1,11,2,1,0,94
10248,319142,1,11,3,0,0,94
10249,319142,1,11,4,0,0,94
10250,319142,1,11,5,2,0,96
10251,319142,1,11,6,1,0,97
10307,343764,1,1,1,1,0,1
10308,343764,1,1,2,5,1,6
10309,343764,1,1,3,0,0,6
10310,343764,1,1,4,0,0,6
10311,343764,1,1,5,0,0,6
10312,343764,1,1,6,0,1,6
10313,343764,1,2,1,1,0,7
10314,343764,1,2,2,1,0,8
10315,343764,1,2,3,0,0,8
10316,343764,1,2,4,1,0,9
10317,343764,1,2,5,5,0,14
10318,343764,1,2,6,0,0,14
10319,343764,1,3,1,4,0,18
10320,343764,1,3,2,0,0,18
10321,343764,1,3,3,1,0,19
10322,343764,1,3,4,1,0,20
10323,343764,1,3,5,0,0,20
10324,343764,1,3,6,1,0,21
10325,343764,1,4,1,0,0,21
10326,343764,1,4,2,6,0,27
10327,343764,1,4,3,1,0,28
10328,343764,1,4,4,0,0,28
10329,343764,1,4,5,4,0,32
10330,343764,1,4,6,1,0,33
10331,343764,1,5,1,2,0,35
10332,343764,1,5,2,0,0,35
10333,343764,1,5,3,4,0,39
10334,343764,1,5,4,4,0,43
10335,343764,1,5,5,4,0,47
10336,343764,1,5,6,1,0,48
10337,343764,1,6,1,4,0,52
10338,343764,1,6,2,1,0,53
10339,343764,1,6,3,0,0,53
10340,343764,1,6,4,1,0,54
10341,343764,1,6,5,4,0,58
10342,343764,1,6,6,2,0,60
10343,343764,1,7,1,4,0,64
10344,343764,1,7,2,0,0,64
10345,343764,1,7,3,2,0,66
10346,343764,1,7,4,1,0,67
10347,343764,1,7,5,1,0,68
10348,343764,1,7,6,1,0,69
10349,343764,1,8,1,1,0,70
10350,343764,1,8,2,1,0,71
10351,343764,1,8,3,1,0,72
10352,343764,1,8,4,2,0,74
10353,343764,1,8,5,1,0,75
10354,343764,1,8,6,0,0,75
10355,343764,1,9,1,4,0,79
10356,343764,1,9,2,1,0,80
10357,343764,1,9,3,1,0,81
10358,343764,1,9,4,0,0,81
10359,343764,1,9,5,2,0,83
10360,343764,1,9,6,1,0,84
10361,343764,1,10,1,0,1,84
10362,343764,1,10,2,1,0,85
10363,343764,1,10,3,2,0,87
10364,343764,1,10,4,1,0,88
10365,343764,1,10,5,1,0,89
10366,343764,1,10,6,1,0,90
10367,343764,1,11,1,1,0,91
10368,343764,1,11,2,1,0,92
10369,343764,1,11,3,1,0,93
10370,343764,1,11,4,4,0,97
10371,343764,1,11,5,0,0,97
10372,343764,1,11,6,6,0,103
10373,343764,1,12,1,2,0,105
10374,343764,1,12,2,0,0,105
10375,343764,1,12,3,0,0,105
10376,343764,1,12,4,1,0,106
10377,343764,1,12,5,6,0,112
10378,343764,1,12,6,1,0,113
10379,343764,1,13,1,0,0,113
10380,343764,1,13,2,1,0,114
10381,343764,1,13,3,6,0,120
10382,343764,1,13,4,2,0,122
10383,343764,1,13,5,1,0,123
10384,343764,1,13,6,0,0,123
10385,343764,1,14,1,1,0,124
10386,343764,1,14,2,1,0,125
10387,343764,1,14,3,1,0,126
10388,343764,1,14,4,1,0,127
10389,343764,1,14,5,6,0,133
10390,343764,1,14,6,2,0,135
10391,343764,1,15,1,0,0,135
10392,343764,1,15,2,6,0,141
10393,343764,1,15,3,2,0,143
10394,343764,1,15,4,4,0,147
10395,343764,1,15,5,0,1,147
10396,343764,1,15,6,1,0,148
10397,343764,1,16,1,1,0,149
10398,343764,1,16,2,1,0,150
10399,343764,1,16,3,1,0,151
10400,343764,1,16,4,0,0,151
10401,343764,1,16,5,1,0,152
10402,343764,1,16,6,1,0,153
10403,343764,1,17,1,4,0,157
10404,343764,1,17,2,1,0,158
10405,343764,1,17,3,2,0,160
10406,343764,1,17,4,1,0,161
10407,343764,1,17,5,1,0,162
10408,343764,1,17,6,6,0,168
10409,343764,1,18,1,0,1,168
10410,343764,1,18,2,0,0,168
10411,343764,1,18,3,1,0,169
10412,343764,1,18,4,1,0,170
10413,343764,1,18,5,1,0,171
10414,343764,1,18,6,1,0,172
10415,343764,1,19,1,4,0,176
10416,343764,1,19,2,1,0,177
10417,343764,1,19,3,1,0,178
10418,343764,1,19,4,2,0,180
10419,343764,1,19,5,2,0,182
10420,343764,1,19,6,1,0,183
10421,343764,1,20,1,0,0,183
10422,343764,1,20,2,6,0,189
10423,343764,1,20,3,1,0,190
10424,343764,1,20,4,4,0,194
10425,343764,1,20,5,6,0,200
10426,343764,1,20,6,3,0,203
10523,350347,1,1,1,0,0,0
10524,350347,1,1,2,1,0,1
10525,350347,1,1,3,1,0,2
10526,350347,1,1,4,0,0,2
10527,350347,1,1,5,1,0,3
10528,350347,1,1,6,0,0,3
10529,350347,1,2,1,0,0,3
10530,350347,1,2,2,0,0,3
10531,350347,1,2,3,0,0,3
10532,350347,1,2,4,0,0,3
10533,350347,1,2,5,0,0,3
10534,350347,1,2,6,4,0,7
10535,350347,1,3,1,4,0,11
10536,350347,1,3,2,4,0,15
10537,350347,1,3,3,0,0,15
10538,350347,1,3,4,4,0,19
10539,350347,1,3,5,4,0,23
10540,350347,1,3,6,0,0,23
10541,350347,1,4,1,2,0,25
10542,350347,1,4,2,4,0,29
10543,350347,1,4,3,5,0,34
10544,350347,1,4,4,1,0,35
10545,350347,1,4,5,4,0,39
10546,350347,1,4,6,4,0,43
10547,350347,1,5,1,0,1,43
10548,350347,1,5,2,5,0,48
10549,350347,1,5,3,0,0,48
10550,350347,1,5,4,1,0,49
10551,350347,1,5,5,2,0,51
10552,350347,1,5,6,6,0,57
10553,350347,1,6,1,1,0,58
10554,350347,1,6,2,0,1,58
10555,350347,1,6,3,2,0,60
10556,350347,1,6,4,1,0,61
10557,350347,1,6,5,1,0,62
10558,350347,1,6,6,0,0,62
10559,350347,1,7,1,0,0,62
10560,350347,1,7,2,2,0,64
10561,350347,1,7,3,1,0,65
10562,350347,1,7,4,0,0,65
10563,350347,1,7,5,0,0,65
10564,350347,1,7,6,1,0,66
10565,350347,1,8,1,1,0,67
10566,350347,1,8,2,4,0,71
10567,350347,1,8,3,0,0,71
10568,350347,1,8,4,0,0,71
10569,350347,1,8,5,1,0,72
10570,350347,1,8,6,0,1,72
10571,350347,1,9,1,3,0,75
10572,350347,1,9,2,3,0,78
10573,350347,1,9,3,0,0,78
10574,350347,1,9,4,1,0,79
10575,350347,1,9,5,1,0,80
10576,350347,1,9,6,2,0,82
10577,350347,1,10,1,1,0,83
10578,350347,1,10,2,2,0,85
10579,350347,1,10,3,1,0,86
10580,350347,1,10,4,1,0,87
10581,350347,1,10,5,1,0,88
10582,350347,1,10,6,1,0,89
10583,350347,1,11,1,0,1,89
10584,350347,1,11,2,0,0,89
10585,350347,1,11,3,1,0,90
10586,350347,1,11,4,1,0,91
10587,350347,1,11,5,3,0,94
10588,350347,1,11,6,1,0,95
10589,350347,1,12,1,0,0,95
10590,350347,1,12,2,1,0,96
10591,350347,1,12,3,1,0,97
10592,350347,1,12,4,6,0,103
10593,350347,1,12,5,4,0,107
10594,350347,1,12,6,1,0,108
10595,350347,1,13,1,1,0,109
10596,350347,1,13,2,1,0,110
10597,350347,1,13,3,1,0,111
10598,350347,1,13,4,0,1,111
10599,350347,1,13,5,1,0,112
10600,350347,1,13,6,1,0,113
10601,350347,1,14,1,0,1,113
10602,350347,1,14,2,1,0,114
10603,350347,1,14,3,1,0,115
10604,350347,1,14,4,0,1,115
10605,350347,1,14,5,2,0,117
10606,350347,1,14,6,1,0,118
10691,350475,1,1,1,0,0,0
10692,350475,1,1,2,0,0,0
10693,350475,1,1,3,1,0,1
10694,350475,1,1,4,0,0,1
10695,350475,1,1,5,0,0,1
10696,350475,1,1,6,1,0,2
10697,350475,1,2,1,2,0,4
10698,350475,1,2,2,0,0,4
10699,350475,1,2,3,1,0,5
10700,350475,1,2,4,0,0,5
10701,350475,1,2,5,0,1,5
10702,350475,1,2,6,0,0,5
10703,350475,1,3,1,4,0,9
10704,350475,1,3,2,2,0,11
10705,350475,1,3,3,2,0,13
10706,350475,1,3,4,1,0,14
10707,350475,1,3,5,1,0,15
10708,350475,1,3,6,1,0,16
10709,350475,1,4,1,0,0,16
10710,350475,1,4,2,0,1,16
10711,350475,1,4,3,0,0,16
10712,350475,1,4,4,1,0,17
10713,350475,1,4,5,0,0,17
10714,350475,1,4,6,0,0,17
10715,350475,1,5,1,1,0,18
10716,350475,1,5,2,4,0,22
10717,350475,1,5,3,0,0,22
10718,350475,1,5,4,0,0,22
10719,350475,1,5,5,1,0,23
10720,350475,1,5,6,1,0,24
10721,350475,1,6,1,4,0,28
10722,350475,1,6,2,1,0,29
10723,350475,1,6,3,1,0,30
10724,350475,1,6,4,4,0,34
10725,350475,1,6,5,6,0,40
10726,350475,1,6,6,0,0,40
10727,350475,1,7,1,0,0,40
10728,350475,1,7,2,1,0,41
10729,350475,1,7,3,2,0,43
10730,350475,1,7,4,4,0,47
10731,350475,1,7,5,0,0,47
10732,350475,1,7,6,0,0,47
10733,350475,1,8,1,2,0,49
10734,350475,1,8,2,2,0,51
10735,350475,1,8,3,6,0,57
10736,350475,1,8,4,1,0,58
10737,350475,1,8,5,0,0,58
10738,350475,1,8,6,1,0,59
10739,350475,1,9,1,0,0,59
10740,350475,1,9,2,1,0,60
10741,350475,1,9,3,1,0,61
10742,350475,1,9,4,2,0,63
10743,350475,1,9,5,1,0,64
10744,350475,1,9,6,6,0,70
10745,350475,1,10,1,0,1,70
10746,350475,1,10,2,0,1,70
10747,350475,1,10,3,1,0,71
10748,350475,1,10,4,0,0,71
10749,350475,1,10,5,0,0,71
10750,350475,1,10,6,0,1,71
10751,350475,1,11,1,0,0,71
10752,350475,1,11,2,0,0,71
10753,350475,1,11,3,1,0,72
10754,350475,1,11,4,0,0,72
10755,350475,1,11,5,1,0,73
10756,350475,1,11,6,1,0,74
10757,350475,1,12,1,1,0,75
10758,350475,1,12,2,1,0,76
10759,350475,1,12,3,0,0,76
10760,350475,1,12,4,0,0,76
10761,350475,1,12,5,0,0,76
10762,350475,1,12,6,2,0,78
10763,350475,1,13,1,2,0,80
10764,350475,1,13,2,1,0,81
10765,350475,1,13,3,1,0,82
10766,350475,1,13,4,0,0,82
10767,350475,1,13,5,4,0,86
10768,350475,1,13,6,1,0,87
10769,350475,1,14,1,1,0,88
10770,350475,1,14,2,0,0,88
10771,350475,1,14,3,0,0,88
10772,350475,1,14,4,1,0,89
10773,350475,1,14,5,1,0,90
10774,350475,1,14,6,1,0,91
10775,350475,1,15,1,1,0,92
10776,350475,1,15,2,1,0,93
10777,350475,1,15,3,1,0,94
10778,350475,1,15,4,2,0,96
10779,350475,1,15,5,6,0,102
10780,350475,1,15,6,1,0,103
10781,350475,1,16,1,6,0,109
10782,350475,1,16,2,1,0,110
10783,350475,1,16,3,0,0,110
10784,350475,1,16,4,0,0,110
10785,350475,1,16,5,6,0,116
10786,350475,1,16,6,0,1,116
10787,350475,1,17,1,1,0,117
10788,350475,1,17,2,0,0,117
10789,350475,1,17,3,1,0,118
10790,350475,1,17,4,2,0,120
10791,350475,1,17,5,1,0,121
10792,350475,1,17,6,6,0,127
10793,350475,1,18,1,2,0,129
10794,350475,1,18,2,1,0,130
10795,350475,1,18,3,4,0,134
10796,350475,1,18,4,2,0,136
10797,350475,1,18,5,2,0,138
10798,350475,1,18,6,4,0,142
10799,350475,1,19,1,4,0,146
10800,350475,1,19,2,2,0,148
10801,350475,1,19,3,1,0,149
10802,350475,1,19,4,0,0,149
10803,350475,1,19,5,0,0,149
10804,350475,1,19,6,0,1,149
10805,350475,1,20,1,1,0,150
10806,350475,1,20,2,4,0,154
10807,350475,1,20,3,1,0,155
10808,350475,1,20,4,4,0,159
10809,350475,1,20,5,6,0,165
10810,350475,1,20,6,1,0,166
10927,350476,1,1,1,1,0,1
10928,350476,1,1,2,0,0,1
10929,350476,1,1,3,0,0,1
10930,350476,1,1,4,0,0,1
10931,350476,1,1,5,1,0,2
10932,350476,1,1,6,1,0,3
10933,350476,1,2,1,4,0,7
10934,350476,1,2,2,2,0,9
10935,350476,1,2,3,5,0,14
10936,350476,1,2,4,0,0,14
10937,350476,1,2,5,0,0,14
10938,350476,1,2,6,0,0,14
10939,350476,1,3,1,0,0,14
10940,350476,1,3,2,2,0,16
10941,350476,1,3,3,0,0,16
10942,350476,1,3,4,6,0,22
10943,350476,1,3,5,0,1,22
10944,350476,1,3,6,0,0,22
10945,350476,1,4,1,0,0,22
10946,350476,1,4,2,1,0,23
10947,350476,1,4,3,0,0,23
10948,350476,1,4,4,0,0,23
10949,350476,1,4,5,0,0,23
10950,350476,1,4,6,1,1,24
10951,350476,1,5,1,1,0,25
10952,350476,1,5,2,0,0,25
10953,350476,1,5,3,1,0,26
10954,350476,1,5,4,0,0,26
10955,350476,1,5,5,0,0,26
10956,350476,1,5,6,1,0,27
10957,350476,1,6,1,4,0,31
10958,350476,1,6,2,1,0,32
10959,350476,1,6,3,2,0,34
10960,350476,1,6,4,1,0,35
10961,350476,1,6,5,0,0,35
10962,350476,1,6,6,1,0,36
10963,350476,1,7,1,0,0,36
10964,350476,1,7,2,1,0,37
10965,350476,1,7,3,0,0,37
10966,350476,1,7,4,1,0,38
10967,350476,1,7,5,6,0,44
10968,350476,1,7,6,0,0,44
10969,350476,1,8,1,0,0,44
10970,350476,1,8,2,1,0,45
10971,350476,1,8,3,6,0,51
10972,350476,1,8,4,1,0,52
10973,350476,1,8,5,1,0,53
10974,350476,1,8,6,1,0,54
10975,350476,1,9,1,4,0,58
10976,350476,1,9,2,1,0,59
10977,350476,1,9,3,0,0,59
10978,350476,1,9,4,0,0,59
10979,350476,1,9,5,1,0,60
10980,350476,1,9,6,4,0,64
10981,350476,1,10,1,2,0,66
10982,350476,1,10,2,2,0,68
10983,350476,1,10,3,1,0,69
10984,350476,1,10,4,0,0,69
10985,350476,1,10,5,1,0,70
10986,350476,1,10,6,0,0,70
10987,350476,1,11,1,0,0,70
10988,350476,1,11,2,1,0,71
10989,350476,1,11,3,0,1,71
10990,350476,1,11,4,0,0,71
10991,350476,1,11,5,1,0,72
10992,350476,1,11,6,4,0,76
10993,350476,1,12,1,1,0,77
10994,350476,1,12,2,1,0,78
10995,350476,1,12,3,1,0,79
10996,350476,1,12,4,1,0,80
10997,350476,1,12,5,0,0,80
10998,350476,1,12,6,1,0,81
10999,350476,1,13,1,0,0,81
11000,350476,1,13,2,0,0,81
11001,350476,1,13,3,1,0,82
11002,350476,1,13,4,0,0,82
11003,350476,1,13,5,1,0,83
11004,350476,1,13,6,0,0,83
11005,350476,1,14,1,0,0,83
11006,350476,1,14,2,1,0,84
11007,350476,1,14,3,0,0,84
11008,350476,1,14,4,6,0,90
11009,350476,1,14,5,1,0,91
11010,350476,1,14,6,1,0,92
11011,350476,1,15,1,1,0,93
11012,350476,1,15,2,2,0,95
11013,350476,1,15,3,0,0,95
11014,350476,1,15,4,0,0,95
11015,350476,1,15,5,1,0,96
11016,350476,1,15,6,0,1,96
11017,350476,1,16,1,6,0,102
11018,350476,1,16,2,0,0,102
11019,350476,1,16,3,6,0,108
11020,350476,1,16,4,5,0,113
11021,350476,1,16,5,4,0,117
11022,350476,1,16,6,2,0,119
11023,350476,1,17,1,1,0,120
11024,350476,1,17,2,2,0,122
11025,350476,1,17,3,2,0,124
11026,350476,1,17,4,6,0,130
11027,350476,1,17,5,1,0,131
11028,350476,1,17,6,0,0,131
11029,350476,1,18,1,1,0,132
11030,350476,1,18,2,1,0,133
11031,350476,1,18,3,0,1,133
11032,350476,1,18,4,0,0,133
11033,350476,1,18,5,0,0,133
11034,350476,1,18,6,1,0,134
11035,350476,1,19,1,2,0,136
11036,350476,1,19,2,1,0,137
11037,350476,1,19,3,1,0,138
11038,350476,1,19,4,0,0,138
11039,350476,1,19,5,0,0,138
11040,350476,1,19,6,6,0,144
11041,350476,1,20,1,1,0,145
11042,350476,1,20,2,4,0,149
11043,350476,1,20,3,0,0,149
11044,350476,1,20,4,1,0,150
11045,350476,1,20,5,0,0,150
11046,350476,1,20,6,6,0,156
11167,351694,1,1,1,0,0,0
11168,351694,1,1,2,1,0,1
11169,351694,1,1,3,1,0,2
11170,351694,1,1,4,1,0,3
11171,351694,1,1,5,4,0,7
11172,351694,1,1,6,1,0,8
11173,351694,1,2,1,0,0,8
11174,351694,1,2,2,4,0,12
11175,351694,1,2,3,1,0,13
11176,351694,1,2,4,0,0,13
11177,351694,1,2,5,4,0,17
11178,351694,1,2,6,2,0,19
11179,351694,1,3,1,0,0,19
11180,351694,1,3,2,1,0,20
11181,351694,1,3,3,1,0,21
11182,351694,1,3,4,6,0,27
11183,351694,1,3,5,6,0,33
11184,351694,1,3,6,4,0,37
11185,351694,1,4,1,0,0,37
11186,351694,1,4,2,1,1,38
11187,351694,1,4,3,1,0,39
11188,351694,1,4,4,0,0,39
11189,351694,1,4,5,3,0,42
11190,351694,1,4,6,0,0,42
11191,351694,1,5,1,4,0,46
11192,351694,1,5,2,0,0,46
11193,351694,1,5,3,4,0,50
11194,351694,1,5,4,1,0,51
11195,351694,1,5,5,2,0,53
11196,351694,1,5,6,1,0,54
11197,351694,1,6,1,1,0,55
11198,351694,1,6,2,6,0,61
11199,351694,1,6,3,6,0,67
11200,351694,1,6,4,1,0,68
11201,351694,1,6,5,1,0,69
11202,351694,1,6,6,0,0,69
11203,351694,1,7,1,1,0,70
11204,351694,1,7,2,1,0,71
11205,351694,1,7,3,2,0,73
11206,351694,1,7,4,1,0,74
11207,351694,1,7,5,0,0,74
11208,351694,1,7,6,0,0,74
11209,351694,1,8,1,2,0,76
11210,351694,1,8,2,1,0,77
11211,351694,1,8,3,3,0,80
11212,351694,1,8,4,1,0,81
11213,351694,1,8,5,1,0,82
11214,351694,1,8,6,4,0,86
11215,351694,1,9,1,0,0,86
11216,351694,1,9,2,0,0,86
11217,351694,1,9,3,1,0,87
11218,351694,1,9,4,6,0,93
11219,351694,1,9,5,0,0,93
11220,351694,1,9,6,0,0,93
11221,351694,1,10,1,4,0,97
11222,351694,1,10,2,0,0,97
11223,351694,1,10,3,0,1,97
11224,351694,1,10,4,1,0,98
11225,351694,1,10,5,1,0,99
11226,351694,1,10,6,2,0,101
11227,351694,1,11,1,1,0,102
11228,351694,1,11,2,2,0,104
11229,351694,1,11,3,0,0,104
11230,351694,1,11,4,6,0,110
11231,351694,1,11,5,2,0,112
11232,351694,1,11,6,2,0,114
11233,351694,1,12,1,1,0,115
11234,351694,1,12,2,0,0,115
11235,351694,1,12,3,1,0,116
11236,351694,1,12,4,0,0,116
11237,351694,1,12,5,2,0,118
11238,351694,1,12,6,1,0,119
11239,351694,1,13,1,0,0,119
11240,351694,1,13,2,6,0,125
11241,351694,1,13,3,1,0,126
11242,351694,1,13,4,1,0,127
11243,351694,1,13,5,4,0,131
11244,351694,1,13,6,2,0,133
11245,351694,1,14,1,4,0,137
11246,351694,1,14,2,2,0,139
11247,351694,1,14,3,1,0,140
11248,351694,1,14,4,0,1,140
11249,351694,1,14,5,0,1,140
11250,351694,1,14,6,0,0,140
11251,351694,1,15,1,2,0,142
11252,351694,1,15,2,0,0,142
11253,351694,1,15,3,1,0,143
11254,351694,1,15,4,1,0,144
11255,351694,1,15,5,1,0,145
11256,351694,1,15,6,0,0,145
11257,351694,1,16,1,2,0,147
11258,351694,1,16,2,1,0,148
11259,351694,1,16,3,6,0,154
11260,351694,1,16,4,0,1,154
11261,351694,1,16,5,0,0,154
11262,351694,1,16,6,0,1,154
11263,351694,1,17,1,0,0,154
11264,351694,1,17,2,0,0,154
11265,351694,1,17,3,1,0,155
11266,351694,1,17,4,1,0,156
11267,351694,1,17,5,1,0,157
11268,351694,1,17,6,4,0,161
11269,351694,1,18,1,1,0,162
11270,351694,1,18,2,4,0,166
11271,351694,1,18,3,2,0,168
11272,351694,1,18,4,0,1,168
11273,351694,1,18,5,2,0,170
11274,351694,1,18,6,0,0,170
11275,351694,1,19,1,1,0,171
11276,351694,1,19,2,2,0,173
11277,351694,1,19,3,2,0,175
11278,351694,1,19,4,2,0,177
11279,351694,1,19,5,0,0,177
11280,351694,1,19,6,1,0,178
11281,351694,1,20,1,1,0,179
11282,351694,1,20,2,1,0,180
11283,351694,1,20,3,0,1,180
11284,351694,1,20,4,1,0,181
11285,351694,1,20,5,0,1,181
11286,351694,1,20,6,1,0,182
11395,351695,1,1,1,2,0,2
11396,351695,1,1,2,0,0,2
11397,351695,1,1,3,0,0,2
11398,351695,1,1,4,0,0,2
11399,351695,1,1,5,2,0,4
11400,351695,1,1,6,0,0,4
11401,351695,1,2,1,1,0,5
11402,351695,1,2,2,0,0,5
11403,351695,1,2,3,0,0,5
11404,351695,1,2,4,1,0,6
11405,351695,1,2,5,0,0,6
11406,351695,1,2,6,1,0,7
11407,351695,1,3,1,0,0,7
11408,351695,1,3,2,6,0,13
11409,351695,1,3,3,3,0,16
11410,351695,1,3,4,0,0,16
11411,351695,1,3,5,1,0,17
11412,351695,1,3,6,4,0,21
11413,351695,1,4,1,0,0,21
11414,351695,1,4,2,1,0,22
11415,351695,1,4,3,1,0,23
11416,351695,1,4,4,1,0,24
11417,351695,1,4,5,0,0,24
11418,351695,1,4,6,1,0,25
11419,351695,1,5,1,1,0,26
11420,351695,1,5,2,3,0,29
11421,351695,1,5,3,4,0,33
11422,351695,1,5,4,0,0,33
11423,351695,1,5,5,0,0,33
11424,351695,1,5,6,1,0,34
11425,351695,1,6,1,0,0,34
11426,351695,1,6,2,1,0,35
11427,351695,1,6,3,0,0,35
11428,351695,1,6,4,0,1,35
11429,351695,1,6,5,1,0,36
11430,351695,1,6,6,0,0,36
11431,351695,1,7,1,1,0,37
11432,351695,1,7,2,0,0,37
11433,351695,1,7,3,1,0,38
11434,351695,1,7,4,1,0,39
11435,351695,1,7,5,1,0,40
11436,351695,1,7,6,0,1,40
11437,351695,1,8,1,1,0,41
11438,351695,1,8,2,0,1,41
11439,351695,1,8,3,0,0,41
11440,351695,1,8,4,1,0,42
11441,351695,1,8,5,4,0,46
11442,351695,1,8,6,1,0,47
11443,351695,1,9,1,1,0,48
11444,351695,1,9,2,1,0,49
11445,351695,1,9,3,1,0,50
11446,351695,1,9,4,1,0,51
11447,351695,1,9,5,1,0,52
11448,351695,1,9,6,1,0,53
11449,351695,1,10,1,1,0,54
11450,351695,1,10,2,1,0,55
11451,351695,1,10,3,1,0,56
11452,351695,1,10,4,1,0,57
11453,351695,1,10,5,1,0,58
11454,351695,1,10,6,1,0,59
11455,351695,1,11,1,1,0,60
11456,351695,1,11,2,1,0,61
11457,351695,1,11,3,1,0,62
11458,351695,1,11,4,1,0,63
11459,351695,1,11,5,1,0,64
11460,351695,1,11,6,1,0,65
11461,351695,1,12,1,0,0,65
11462,351695,1,12,2,1,0,66
11463,351695,1,12,3,1,0,67
11464,351695,1,12,4,1,0,68
11465,351695,1,12,5,1,0,69
11466,351695,1,12,6,1,0,70
11467,351695,1,13,1,1,0,71
11468,351695,1,13,2,4,0,75
11469,351695,1,13,3,2,0,77
11470,351695,1,13,4,1,0,78
11471,351695,1,13,5,1,0,79
11472,351695,1,13,6,4,0,83
11473,351695,1,14,1,6,0,89
11474,351695,1,14,2,1,0,90
11475,351695,1,14,3,0,1,90
11476,351695,1,14,4,1,0,91
11477,351695,1,14,5,0,0,91
11478,351695,1,14,6,2,0,93
11479,351695,1,15,1,1,0,94
11480,351695,1,15,2,0,0,94
11481,351695,1,15,3,1,0,95
11482,351695,1,15,4,4,0,99
11483,351695,1,15,5,0,0,99
11484,351695,1,15,6,4,0,103
11485,351695,1,16,1,0,0,103
11486,351695,1,16,2,4,0,107
11487,351695,1,16,3,1,0,108
11488,351695,1,16,4,4,0,112
11489,351695,1,16,5,1,0,113
11490,351695,1,16,6,1,0,114
11491,351695,1,17,1,2,0,116
11492,351695,1,17,2,2,0,118
11493,351695,1,17,3,2,0,120
11494,351695,1,17,4,1,0,121
11495,351695,1,17,5,6,0,127
11496,351695,1,17,6,1,0,128
11497,351695,1,18,1,0,1,128
11498,351695,1,18,2,1,0,129
11499,351695,1,18,3,1,0,130
11500,351695,1,18,4,1,0,131
11501,351695,1,18,5,1,0,132
11502,351695,1,18,6,4,0,136
11503,351695,1,19,1,0,0,136
11504,351695,1,19,2,2,0,138
11505,351695,1,19,3,1,0,139
11506,351695,1,19,4,2,0,141
11507,351695,1,19,5,1,0,142
11508,351695,1,19,6,0,0,142
11509,351695,1,20,1,1,0,143
11510,351695,1,20,2,1,0,144
11511,351695,1,20,3,1,0,145
11512,351695,1,20,4,6,0,151
11513,351695,1,20,5,4,0,155
11514,351695,1,20,6,2,0,157
11628,351696,1,1,1,1,0,1
11629,351696,1,1,2,0,0,1
11630,351696,1,1,3,2,0,3
11631,351696,1,1,4,1,0,4
11632,351696,1,1,5,0,0,4
11633,351696,1,1,6,2,0,6
11634,351696,1,2,1,4,0,10
11635,351696,1,2,2,0,0,10
11636,351696,1,2,3,0,0,10
11637,351696,1,2,4,3,0,13
11638,351696,1,2,5,0,0,13
11639,351696,1,2,6,1,0,14
11640,351696,1,3,1,4,0,18
11641,351696,1,3,2,1,0,19
11642,351696,1,3,3,4,0,23
11643,351696,1,3,4,1,0,24
11644,351696,1,3,5,4,0,28
11645,351696,1,3,6,1,0,29
11646,351696,1,4,1,0,0,29
11647,351696,1,4,2,4,0,33
11648,351696,1,4,3,1,0,34
11649,351696,1,4,4,0,1,34
11650,351696,1,4,5,0,0,34
11651,351696,1,4,6,0,0,34
11652,351696,1,5,1,4,0,38
11653,351696,1,5,2,0,0,38
11654,351696,1,5,3,0,1,38
11655,351696,1,5,4,1,0,39
11656,351696,1,5,5,0,0,39
11657,351696,1,5,6,2,0,41
11658,351696,1,6,1,0,0,41
11659,351696,1,6,2,0,0,41
11660,351696,1,6,3,0,0,41
11661,351696,1,6,4,1,0,42
11662,351696,1,6,5,4,0,46
11663,351696,1,6,6,1,0,47
11664,351696,1,7,1,0,0,47
11665,351696,1,7,2,2,0,49
11666,351696,1,7,3,0,0,49
11667,351696,1,7,4,2,0,51
11668,351696,1,7,5,1,0,52
11669,351696,1,7,6,0,1,52
11670,351696,1,8,1,1,0,53
11671,351696,1,8,2,0,0,53
11672,351696,1,8,3,1,0,54
11673,351696,1,8,4,1,0,55
11674,351696,1,8,5,2,0,57
11675,351696,1,8,6,1,0,58
11676,351696,1,9,1,0,0,58
11677,351696,1,9,2,1,0,59
11678,351696,1,9,3,1,0,60
11679,351696,1,9,4,1,0,61
11680,351696,1,9,5,0,0,61
11681,351696,1,9,6,1,0,62
11682,351696,1,10,1,0,0,62
11683,351696,1,10,2,0,0,62
11684,351696,1,10,3,2,0,64
11685,351696,1,10,4,1,0,65
11686,351696,1,10,5,1,0,66
11687,351696,1,10,6,1,0,67
11688,351696,1,11,1,1,0,68
11689,351696,1,11,2,0,0,68
11690,351696,1,11,3,4,0,72
11691,351696,1,11,4,2,0,74
11692,351696,1,11,5,1,0,75
11693,351696,1,11,6,1,0,76
11694,351696,1,12,1,0,0,76
11695,351696,1,12,2,2,0,78
11696,351696,1,12,3,1,0,79
11697,351696,1,12,4,1,0,80
11698,351696,1,12,5,1,0,81
11699,351696,1,12,6,1,0,82
11700,351696,1,13,1,0,0,82
11701,351696,1,13,2,1,0,83
11702,351696,1,13,3,0,0,83
11703,351696,1,13,4,1,0,84
11704,351696,1,13,5,4,0,88
11705,351696,1,13,6,1,0,89
11706,351696,1,14,1,1,0,90
11707,351696,1,14,2,1,0,91
11708,351696,1,14,3,1,0,92
11709,351696,1,14,4,1,0,93
11710,351696,1,14,5,0,0,93
11711,351696,1,14,6,1,0,94
11712,351696,1,15,1,1,0,95
11713,351696,1,15,2,2,0,97
11714,351696,1,15,3,6,0,103
11715,351696,1,15,4,1,0,104
11716,351696,1,15,5,0,1,104
11717,351696,1,15,6,1,0,105
11718,351696,1,16,1,1,0,106
11719,351696,1,16,2,0,0,106
11720,351696,1,16,3,2,0,108
11721,351696,1,16,4,1,0,109
11722,351696,1,16,5,1,0,110
11723,351696,1,16,6,4,0,114
11724,351696,1,17,1,2,0,116
11725,351696,1,17,2,1,0,117
11726,351696,1,17,3,1,0,118
11727,351696,1,17,4,1,0,119
11728,351696,1,17,5,1,0,120
11729,351696,1,17,6,6,0,126
11730,351696,1,18,1,2,0,128
11731,351696,1,18,2,0,1,128
11732,351696,1,18,3,1,0,129
11733,351696,1,18,4,0,0,129
11734,351696,1,18,5,2,0,131
11735,351696,1,18,6,1,0,132
11736,351696,1,19,1,1,0,133
11737,351696,1,19,2,0,0,133
11738,351696,1,19,3,2,0,135
11739,351696,1,19,4,0,1,135
11740,351696,1,19,5,1,0,136
11741,351696,1,19,6,1,0,137
11742,351696,1,20,1,2,1,139
11743,351696,1,20,2,1,0,140
11744,351696,1,20,3,2,0,142
11745,351696,1,20,4,2,0,144
11746,351696,1,20,5,2,0,146
11747,351696,1,20,6,4,0,150
11868,352674,1,1,1,4,0,4
11869,352674,1,1,2,0,0,4
11870,352674,1,1,3,1,0,5
11871,352674,1,1,4,0,0,5
11872,352674,1,1,5,4,0,9
11873,352674,1,1,6,0,0,9
11874,352674,1,2,1,1,0,10
11875,352674,1,2,2,2,0,12
11876,352674,1,2,3,4,0,16
11877,352674,1,2,4,1,0,17
11878,352674,1,2,5,0,0,17
11879,352674,1,2,6,1,0,18
11880,352674,1,3,1,4,0,22
11881,352674,1,3,2,0,0,22
11882,352674,1,3,3,1,0,23
11883,352674,1,3,4,0,0,23
11884,352674,1,3,5,1,0,24
11885,352674,1,3,6,1,0,25
11886,352674,1,4,1,0,1,25
11887,352674,1,4,2,0,0,25
11888,352674,1,4,3,1,0,26
11889,352674,1,4,4,0,0,26
11890,352674,1,4,5,1,0,27
11891,352674,1,4,6,1,0,28
11892,352674,1,5,1,0,0,28
11893,352674,1,5,2,0,0,28
11894,352674,1,5,3,4,0,32
11895,352674,1,5,4,2,0,34
11896,352674,1,5,5,1,0,35
11897,352674,1,5,6,1,0,36
11898,352674,1,6,1,0,0,36
11899,352674,1,6,2,4,0,40
11900,352674,1,6,3,1,0,41
11901,352674,1,6,4,2,0,43
11902,352674,1,6,5,0,0,43
11903,352674,1,6,6,4,0,47
11904,352674,1,7,1,2,0,49
11905,352674,1,7,2,1,0,50
11906,352674,1,7,3,0,0,50
11907,352674,1,7,4,4,0,54
11908,352674,1,7,5,0,0,54
11909,352674,1,7,6,1,0,55
11910,352674,1,8,1,0,1,55
11911,352674,1,8,2,0,0,55
11912,352674,1,8,3,0,0,55
11913,352674,1,8,4,0,0,55
11914,352674,1,8,5,6,0,61
11915,352674,1,8,6,1,0,62
11916,352674,1,9,1,0,0,62
11917,352674,1,9,2,1,0,63
11918,352674,1,9,3,1,0,64
11919,352674,1,9,4,1,0,65
11920,352674,1,9,5,1,0,66
11921,352674,1,9,6,0,1,66
11922,352674,1,10,1,1,0,67
11923,352674,1,10,2,0,0,67
11924,352674,1,10,3,1,0,68
11925,352674,1,10,4,0,0,68
11926,352674,1,10,5,1,0,69
11927,352674,1,10,6,4,0,73
11928,352674,1,11,1,1,0,74
11929,352674,1,11,2,1,0,75
11930,352674,1,11,3,6,0,81
11931,352674,1,11,4,1,0,82
11932,352674,1,11,5,0,1,82
11933,352674,1,11,6,0,0,82
11934,352674,1,12,1,1,0,83
11935,352674,1,12,2,1,0,84
11936,352674,1,12,3,2,0,86
11937,352674,1,12,4,1,0,87
11938,352674,1,12,5,1,0,88
11939,352674,1,12,6,4,0,92
11940,352674,1,13,1,0,0,92
11941,352674,1,13,2,1,0,93
11942,352674,1,13,3,1,0,94
11943,352674,1,13,4,1,0,95
11944,352674,1,13,5,0,1,95
11945,352674,1,13,6,1,0,96
11946,352674,1,14,1,0,0,96
11947,352674,1,14,2,0,0,96
11948,352674,1,14,3,0,0,96
11949,352674,1,14,4,1,0,97
11950,352674,1,14,5,0,0,97
11951,352674,1,14,6,0,0,97
11952,352674,1,15,1,0,0,97
11953,352674,1,15,2,1,0,98
11954,352674,1,15,3,0,1,98
11955,352674,1,15,4,1,0,99
11956,352674,1,15,5,1,0,100
11957,352674,1,15,6,1,0,101
11958,352674,1,16,1,2,0,103
11959,352674,1,16,2,4,0,107
11960,352674,1,16,3,0,0,107
11961,352674,1,16,4,4,0,111
11962,352674,1,16,5,0,0,111
11963,352674,1,16,6,1,0,112
11964,352674,1,17,1,0,0,112
11965,352674,1,17,2,1,0,113
11966,352674,1,17,3,1,0,114
11967,352674,1,17,4,0,0,114
11968,352674,1,17,5,0,1,114
11969,352674,1,17,6,1,0,115
11970,352674,1,18,1,1,0,116
11971,352674,1,18,2,1,0,117
11972,352674,1,18,3,0,0,117
11973,352674,1,18,4,0,0,117
11974,352674,1,18,5,0,1,117
11975,352674,1,18,6,0,0,117
11976,352674,1,19,1,1,0,118
11977,352674,1,19,2,1,0,119
11978,352674,1,19,3,0,0,119
11979,352674,1,19,4,1,0,120
11980,352674,1,19,5,1,0,121
11981,352674,1,19,6,0,1,121
11982,352674,1,20,1,0,1,121
12091,355991,1,1,1,4,0,4
12092,355991,1,1,2,0,0,4
12093,355991,1,1,3,0,0,4
12094,355991,1,1,4,4,0,8
12095,355991,1,1,5,1,0,9
12096,355991,1,1,6,0,0,9
12097,355991,1,2,1,4,0,13
12098,355991,1,2,2,0,0,13
12099,355991,1,2,3,0,0,13
12100,355991,1,2,4,1,0,14
12101,355991,1,2,5,2,0,16
12102,355991,1,2,6,1,0,17
12103,355991,1,3,1,0,0,17
12104,355991,1,3,2,1,0,18
12105,355991,1,3,3,1,0,19
12106,355991,1,3,4,1,0,20
12107,355991,1,3,5,2,0,22
12108,355991,1,3,6,1,0,23
12109,355991,1,4,1,1,0,24
12110,355991,1,4,2,0,0,24
12111,355991,1,4,3,1,0,25
12112,355991,1,4,4,0,0,25
12113,355991,1,4,5,4,0,29
12114,355991,1,4,6,0,0,29
12115,355991,1,5,1,1,0,30
12116,355991,1,5,2,3,0,33
12117,355991,1,5,3,0,0,33
12118,355991,1,5,4,0,0,33
12119,355991,1,5,5,1,0,34
12120,355991,1,5,6,4,0,38
12121,355991,1,6,1,4,0,42
12122,355991,1,6,2,0,0,42
12123,355991,1,6,3,2,0,44
12124,355991,1,6,4,2,0,46
12125,355991,1,6,5,4,0,50
12126,355991,1,6,6,1,0,51
12127,355991,1,7,1,0,0,51
12128,355991,1,7,2,1,0,52
12129,355991,1,7,3,1,0,53
12130,355991,1,7,4,1,0,54
12131,355991,1,7,5,1,0,55
12132,355991,1,7,6,0,0,55
12133,355991,1,8,1,1,0,56
12134,355991,1,8,2,1,0,57
12135,355991,1,8,3,1,0,58
12136,355991,1,8,4,1,0,59
12137,355991,1,8,5,1,0,60
12138,355991,1,8,6,7,0,67
12139,355991,1,9,1,2,0,69
12140,355991,1,9,2,1,0,70
12141,355991,1,9,3,1,0,71
12142,355991,1,9,4,2,0,73
12143,355991,1,9,5,4,0,77
12144,355991,1,9,6,1,0,78
12145,355991,1,10,1,1,0,79
12146,355991,1,10,2,4,0,83
12147,355991,1,10,3,2,0,85
12148,355991,1,10,4,2,0,87
12149,355991,1,10,5,0,0,87
12150,355991,1,10,6,2,0,89
12151,355991,1,11,1,1,0,90
12152,355991,1,11,2,1,0,91
12153,355991,1,11,3,2,0,93
12154,355991,1,11,4,1,0,94
12155,355991,1,11,5,2,0,96
12156,355991,1,11,6,4,0,100
12157,355991,1,12,1,2,0,102
12158,355991,1,12,2,0,1,102
12159,355991,1,12,3,1,0,103
12160,355991,1,12,4,0,0,103
12161,355991,1,12,5,2,0,105
12162,355991,1,12,6,1,0,106
12163,355991,1,13,1,0,0,106
12164,355991,1,13,2,0,0,106
12165,355991,1,13,3,1,0,107
12166,355991,1,13,4,1,0,108
12167,355991,1,13,5,1,0,109
12168,355991,1,13,6,1,0,110
12169,355991,1,14,1,2,0,112
12170,355991,1,14,2,1,0,113
12171,355991,1,14,3,0,1,113
12172,355991,1,14,4,1,0,114
12173,355991,1,14,5,1,0,115
12174,355991,1,14,6,1,0,116
12175,355991,1,15,1,1,0,117
12176,355991,1,15,2,1,0,118
12177,355991,1,15,3,0,0,118
12178,355991,1,15,4,1,0,119
12179,355991,1,15,5,4,0,123
12180,355991,1,15,6,1,0,124
12181,355991,1,16,1,1,0,125
12182,355991,1,16,2,2,0,127
12183,355991,1,16,3,0,0,127
12184,355991,1,16,4,0,1,127
12185,355991,1,16,5,0,0,127
12186,355991,1,16,6,1,0,128
12187,355991,1,17,1,4,0,132
12188,355991,1,17,2,1,0,133
12189,355991,1,17,3,1,0,134
12190,355991,1,17,4,1,0,135
12191,355991,1,17,5,4,0,139
12192,355991,1,17,6,1,0,140
12193,355991,1,18,1,4,0,144
12194,355991,1,18,2,0,1,144
12195,355991,1,18,3,1,0,145
12196,355991,1,18,4,2,0,147
12197,355991,1,18,5,1,0,148
12198,355991,1,18,6,1,0,149
12199,355991,1,19,1,1,0,150
12200,355991,1,19,2,1,0,151
12201,355991,1,19,3,1,0,152
12202,355991,1,19,4,1,0,153
12203,355991,1,19,5,0,1,153
12204,355991,1,19,6,2,0,155
12205,355991,1,20,1,1,0,156
12206,355991,1,20,2,1,0,157
12207,355991,1,20,3,1,0,158
12208,355991,1,20,4,2,0,160
12209,355991,1,20,5,1,0,161
12210,355991,1,20,6,1,0,162
12331,355993,1,1,1,0,0,0
12332,355993,1,1,2,0,0,0
12333,355993,1,1,3,1,1,1
12334,355993,1,1,4,2,1,3
12335,355993,1,1,5,0,0,3
12336,355993,1,1,6,0,0,3
12337,355993,1,2,1,0,0,3
12338,355993,1,2,2,0,0,3
12339,355993,1,2,3,0,0,3
12340,355993,1,2,4,3,0,6
12341,355993,1,2,5,0,0,6
12342,355993,1,2,6,0,0,6
12343,355993,1,3,1,1,0,7
12344,355993,1,3,2,0,0,7
12345,355993,1,3,3,0,0,7
12346,355993,1,3,4,4,0,11
12347,355993,1,3,5,0,0,11
12348,355993,1,3,6,4,0,15
12349,355993,1,4,1,0,0,15
12350,355993,1,4,2,0,0,15
12351,355993,1,4,3,0,1,15
12352,355993,1,4,4,6,0,21
12353,355993,1,4,5,0,0,21
12354,355993,1,4,6,1,0,22
12355,355993,1,5,1,0,0,22
12356,355993,1,5,2,4,0,26
12357,355993,1,5,3,0,0,26
12358,355993,1,5,4,0,0,26
12359,355993,1,5,5,1,0,27
12360,355993,1,5,6,0,0,27
12361,355993,1,6,1,1,0,28
12362,355993,1,6,2,4,0,32
12363,355993,1,6,3,0,0,32
12364,355993,1,6,4,1,0,33
12365,355993,1,6,5,2,0,35
12366,355993,1,6,6,0,0,35
12367,355993,1,7,1,0,0,35
12368,355993,1,7,2,0,0,35
12369,355993,1,7,3,1,0,36
12370,355993,1,7,4,1,0,37
12371,355993,1,7,5,2,0,39
12372,355993,1,7,6,1,0,40
12373,355993,1,8,1,4,0,44
12374,355993,1,8,2,2,0,46
12375,355993,1,8,3,1,0,47
12376,355993,1,8,4,1,0,48
12377,355993,1,8,5,1,0,49
12378,355993,1,8,6,1,0,50
12379,355993,1,9,1,2,0,52
12380,355993,1,9,2,1,0,53
12381,355993,1,9,3,0,0,53
12382,355993,1,9,4,1,0,54
12383,355993,1,9,5,0,0,54
12384,355993,1,9,6,1,0,55
12385,355993,1,10,1,0,0,55
12386,355993,1,10,2,1,0,56
12387,355993,1,10,3,4,0,60
12388,355993,1,10,4,0,0,60
12389,355993,1,10,5,2,0,62
12390,355993,1,10,6,1,0,63
12391,355993,1,11,1,2,0,65
12392,355993,1,11,2,2,0,67
12393,355993,1,11,3,0,0,67
12394,355993,1,11,4,1,0,68
12395,355993,1,11,5,6,0,74
12396,355993,1,11,6,4,0,78
12397,355993,1,12,1,2,0,80
12398,355993,1,12,2,1,0,81
12399,355993,1,12,3,0,1,81
12400,355993,1,12,4,0,0,81
12401,355993,1,12,5,1,0,82
12402,355993,1,12,6,1,0,83
12403,355993,1,13,1,1,0,84
12404,355993,1,13,2,1,0,85
12405,355993,1,13,3,1,0,86
12406,355993,1,13,4,0,0,86
12407,355993,1,13,5,2,0,88
12408,355993,1,13,6,0,0,88
12409,355993,1,14,1,1,0,89
12410,355993,1,14,2,4,0,93
12411,355993,1,14,3,1,0,94
12412,355993,1,14,4,6,0,100
12413,355993,1,14,5,0,0,100
12414,355993,1,14,6,0,0,100
12415,355993,1,15,1,3,0,103
12416,355993,1,15,2,0,0,103
12417,355993,1,15,3,6,0,109
12418,355993,1,15,4,1,0,110
12419,355993,1,15,5,0,0,110
12420,355993,1,15,6,1,0,111
12421,355993,1,16,1,1,0,112
12422,355993,1,16,2,1,0,113
12423,355993,1,16,3,0,1,113
12424,355993,1,16,4,6,0,119
12425,355993,1,16,5,0,0,119
12426,355993,1,16,6,1,0,120
12427,355993,1,17,1,1,0,121
12428,355993,1,17,2,0,0,121
12429,355993,1,17,3,6,0,127
12430,355993,1,17,4,1,0,128
12431,355993,1,17,5,2,0,130
12432,355993,1,17,6,2,0,132
12433,355993,1,18,1,4,0,136
12434,355993,1,18,2,4,0,140
12435,355993,1,18,3,1,0,141
12436,355993,1,18,4,2,0,143
12437,355993,1,18,5,0,1,143
12438,355993,1,18,6,1,0,144
12439,355993,1,19,1,1,0,145
12440,355993,1,19,2,1,0,146
12441,355993,1,19,3,2,0,148
12442,355993,1,19,4,0,0,148
12443,355993,1,19,5,4,0,152
12444,355993,1,19,6,1,0,153
12445,355993,1,20,1,0,1,153
12446,355993,1,20,2,1,0,154
12447,355993,1,20,3,1,0,155
12448,355993,1,20,4,2,0,157
12449,355993,1,20,5,11,0,168
12450,355993,1,20,6,1,0,169
12546,355994,1,1,1,0,0,0
12547,355994,1,1,2,4,0,4
12548,355994,1,1,3,1,0,5
12549,355994,1,1,4,4,0,9
12550,355994,1,1,5,1,0,10
12551,355994,1,1,6,1,0,11
12552,355994,1,2,1,0,0,11
12553,355994,1,2,2,4,0,15
12554,355994,1,2,3,0,0,15
12555,355994,1,2,4,0,0,15
12556,355994,1,2,5,0,0,15
12557,355994,1,2,6,1,0,16
12558,355994,1,3,1,1,0,17
12559,355994,1,3,2,0,0,17
12560,355994,1,3,3,0,0,17
12561,355994,1,3,4,0,0,17
12562,355994,1,3,5,1,0,18
12563,355994,1,3,6,1,0,19
12564,355994,1,4,1,1,0,20
12565,355994,1,4,2,6,0,26
12566,355994,1,4,3,4,0,30
12567,355994,1,4,4,1,0,31
12568,355994,1,4,5,2,0,33
12569,355994,1,4,6,0,0,33
12570,355994,1,5,1,1,0,34
12571,355994,1,5,2,0,0,34
12572,355994,1,5,3,1,0,35
12573,355994,1,5,4,4,0,39
12574,355994,1,5,5,1,0,40
12575,355994,1,5,6,1,0,41
12576,355994,1,6,1,6,0,47
12577,355994,1,6,2,4,0,51
12578,355994,1,6,3,0,0,51
12579,355994,1,6,4,2,0,53
12580,355994,1,6,5,1,0,54
12581,355994,1,6,6,0,0,54
12582,355994,1,7,1,1,0,55
12583,355994,1,7,2,0,0,55
12584,355994,1,7,3,0,0,55
12585,355994,1,7,4,1,0,56
12586,355994,1,7,5,2,0,58
12587,355994,1,7,6,1,0,59
12588,355994,1,8,1,0,0,59
12589,355994,1,8,2,0,1,59
12590,355994,1,8,3,1,0,60
12591,355994,1,8,4,0,0,60
12592,355994,1,8,5,1,0,61
12593,355994,1,8,6,1,0,62
12594,355994,1,9,1,2,0,64
12595,355994,1,9,2,0,0,64
12596,355994,1,9,3,1,0,65
12597,355994,1,9,4,2,0,67
12598,355994,1,9,5,1,0,68
12599,355994,1,9,6,2,0,70
12600,355994,1,10,1,1,0,71
12601,355994,1,10,2,1,0,72
12602,355994,1,10,3,2,0,74
12603,355994,1,10,4,0,0,74
12604,355994,1,10,5,1,0,75
12605,355994,1,10,6,1,0,76
12606,355994,1,11,1,6,0,82
12607,355994,1,11,2,1,0,83
12608,355994,1,11,3,0,0,83
12609,355994,1,11,4,1,0,84
12610,355994,1,11,5,0,0,84
12611,355994,1,11,6,2,0,86
12612,355994,1,12,1,2,0,88
12613,355994,1,12,2,1,0,89
12614,355994,1,12,3,1,0,90
12615,355994,1,12,4,1,0,91
12616,355994,1,12,5,1,0,92
12617,355994,1,12,6,1,0,93
12618,355994,1,13,1,4,0,97
12619,355994,1,13,2,1,0,98
12620,355994,1,13,3,1,0,99
12621,355994,1,13,4,2,0,101
12622,355994,1,13,5,1,0,102
12623,355994,1,13,6,1,0,103
12624,355994,1,14,1,1,0,104
12625,355994,1,14,2,1,0,105
12626,355994,1,14,3,1,0,106
12627,355994,1,14,4,1,0,107
12628,355994,1,14,5,1,0,108
12629,355994,1,14,6,2,0,110
12630,355994,1,15,1,1,0,111
12631,355994,1,15,2,1,0,112
12632,355994,1,15,3,0,1,112
12633,355994,1,15,4,0,0,112
12634,355994,1,15,5,0,0,112
12635,355994,1,15,6,1,0,113
12636,355994,1,16,1,1,0,114
12637,355994,1,16,2,1,0,115
12638,355994,1,16,3,0,0,115
12639,355994,1,16,4,5,0,120
12640,355994,1,16,5,1,0,121
12641,355994,1,16,6,0,0,121
12642,355994,1,17,1,6,0,127
12643,355994,1,17,2,6,0,133
12644,355994,1,17,3,0,0,133
12645,355994,1,17,4,6,0,139
12646,355994,1,17,5,1,0,140
12647,355994,1,17,6,0,1,140
12648,355994,1,18,1,7,0,147
12649,355994,1,18,2,4,0,151
12650,355994,1,18,3,4,0,155
12651,355994,1,18,4,1,0,156
12652,355994,1,18,5,1,0,157
12653,355994,1,18,6,0,0,157
12654,355994,1,19,1,0,1,157
12655,355994,1,19,2,0,0,157
12656,355994,1,19,3,2,0,159
12657,355994,1,19,4,4,0,163
12658,355994,1,19,5,2,0,165
12659,355994,1,19,6,1,0,166
12660,355994,1,20,1,1,0,167
12661,355994,1,20,2,1,0,168
12662,355994,1,20,3,1,1,169
12663,355994,1,20,4,6,0,175
12664,355994,1,20,5,4,0,179
12665,355994,1,20,6,1,0,180
12786,355996,1,1,1,0,0,0
12787,355996,1,1,2,0,0,0
12788,355996,1,1,3,4,0,4
12789,355996,1,1,4,1,0,5
12790,355996,1,1,5,0,0,5
12791,355996,1,1,6,4,0,9
12792,355996,1,2,1,0,0,9
12793,355996,1,2,2,0,1,9
12794,355996,1,2,3,0,0,9
12795,355996,1,2,4,0,0,9
12796,355996,1,2,5,1,0,10
12797,355996,1,2,6,0,0,10
12798,355996,1,3,1,0,0,10
12799,355996,1,3,2,1,0,11
12800,355996,1,3,3,0,0,11
12801,355996,1,3,4,2,0,13
12802,355996,1,3,5,0,0,13
12803,355996,1,3,6,4,0,17
12804,355996,1,4,1,0,0,17
12805,355996,1,4,2,1,0,18
12806,355996,1,4,3,0,0,18
12807,355996,1,4,4,4,0,22
12808,355996,1,4,5,6,0,28
12809,355996,1,4,6,4,0,32
12810,355996,1,5,1,0,0,32
12811,355996,1,5,2,1,0,33
12812,355996,1,5,3,4,0,37
12813,355996,1,5,4,4,0,41
12814,355996,1,5,5,1,0,42
12815,355996,1,5,6,11,0,53
12816,355996,1,6,1,1,0,54
12817,355996,1,6,2,8,0,62
12818,355996,1,6,3,0,1,62
12819,355996,1,6,4,1,0,63
12820,355996,1,6,5,0,0,63
12821,355996,1,6,6,0,0,63
12822,355996,1,7,1,5,0,68
12823,355996,1,7,2,1,0,69
12824,355996,1,7,3,5,0,74
12825,355996,1,7,4,0,0,74
12826,355996,1,7,5,1,0,75
12827,355996,1,7,6,1,0,76
12828,355996,1,8,1,1,0,77
12829,355996,1,8,2,1,0,78
12830,355996,1,8,3,1,0,79
12831,355996,1,8,4,1,0,80
12832,355996,1,8,5,1,0,81
12833,355996,1,8,6,1,0,82
12834,355996,1,9,1,2,0,84
12835,355996,1,9,2,0,0,84
12836,355996,1,9,3,0,0,84
12837,355996,1,9,4,2,0,86
12838,355996,1,9,5,1,0,87
12839,355996,1,9,6,1,0,88
12840,355996,1,10,1,0,0,88
12841,355996,1,10,2,0,0,88
12842,355996,1,10,3,1,0,89
12843,355996,1,10,4,0,0,89
12844,355996,1,10,5,1,0,90
12845,355996,1,10,6,0,0,90
12846,355996,1,11,1,4,0,94
12847,355996,1,11,2,1,0,95
12848,355996,1,11,3,4,0,99
12849,355996,1,11,4,0,0,99
12850,355996,1,11,5,1,0,100
12851,355996,1,11,6,0,0,100
12852,355996,1,12,1,0,0,100
12853,355996,1,12,2,4,0,104
12854,355996,1,12,3,1,0,105
12855,355996,1,12,4,6,0,111
12856,355996,1,12,5,1,0,112
12857,355996,1,12,6,1,0,113
12858,355996,1,13,1,2,0,115
12859,355996,1,13,2,0,0,115
12860,355996,1,13,3,6,0,121
12861,355996,1,13,4,1,0,122
12862,355996,1,13,5,0,0,122
12863,355996,1,13,6,6,0,128
12864,355996,1,14,1,0,0,128
12865,355996,1,14,2,0,1,128
12866,355996,1,14,3,1,0,129
12867,355996,1,14,4,2,0,131
12868,355996,1,14,5,1,0,132
12869,355996,1,14,6,4,0,136
12870,355996,1,15,1,1,0,137
12871,355996,1,15,2,0,0,137
12872,355996,1,15,3,1,0,138
12873,355996,1,15,4,0,0,138
12874,355996,1,15,5,1,0,139
12875,355996,1,15,6,0,0,139
12876,355996,1,16,1,2,0,141
12877,355996,1,16,2,4,0,145
12878,355996,1,16,3,4,0,149
12879,355996,1,16,4,1,0,150
12880,355996,1,16,5,1,0,151
12881,355996,1,16,6,1,0,152
12882,355996,1,17,1,0,1,152
12883,355996,1,17,2,1,0,153
12884,355996,1,17,3,1,0,154
12885,355996,1,17,4,2,0,156
12886,355996,1,17,5,0,1,156
12887,355996,1,17,6,1,0,157
12888,355996,1,18,1,1,0,158
12889,355996,1,18,2,0,0,158
12890,355996,1,18,3,1,0,159
12891,355996,1,18,4,1,0,160
12892,355996,1,18,5,1,0,161
12893,355996,1,18,6,1,0,162
12894,355996,1,19,1,4,0,166
12895,355996,1,19,2,2,0,168
12896,355996,1,19,3,0,0,168
12897,355996,1,19,4,1,0,169
12898,355996,1,19,5,6,0,175
12899,355996,1,19,6,2,0,177
12900,355996,1,20,1,1,0,178
12901,355996,1,20,2,1,0,179
12902,355996,1,20,3,1,0,180
12903,355996,1,20,4,2,0,182
12904,355996,1,20,5,1,0,183
12905,355996,1,20,6,2,0,185
13026,355997,1,1,1,0,0,0
13027,355997,1,1,2,1,0,1
13028,355997,1,1,3,4,0,5
13029,355997,1,1,4,4,0,9
13030,355997,1,1,5,1,0,10
13031,355997,1,1,6,0,0,10
13032,355997,1,2,1,4,0,14
13033,355997,1,2,2,1,1,15
13034,355997,1,2,3,0,0,15
13035,355997,1,2,4,4,0,19
13036,355997,1,2,5,0,0,19
13037,355997,1,2,6,1,0,20
13038,355997,1,3,1,1,0,21
13039,355997,1,3,2,1,0,22
13040,355997,1,3,3,0,0,22
13041,355997,1,3,4,4,0,26
13042,355997,1,3,5,0,0,26
13043,355997,1,3,6,0,0,26
13044,355997,1,4,1,0,0,26
13045,355997,1,4,2,1,0,27
13046,355997,1,4,3,0,0,27
13047,355997,1,4,4,0,0,27
13048,355997,1,4,5,0,0,27
13049,355997,1,4,6,0,0,27
13050,355997,1,5,1,0,0,27
13051,355997,1,5,2,6,0,33
13052,355997,1,5,3,0,0,33
13053,355997,1,5,4,2,0,35
13054,355997,1,5,5,4,0,39
13055,355997,1,5,6,0,0,39
13056,355997,1,6,1,0,0,39
13057,355997,1,6,2,1,0,40
13058,355997,1,6,3,0,1,40
13059,355997,1,6,4,0,0,40
13060,355997,1,6,5,1,0,41
13061,355997,1,6,6,1,0,42
13062,355997,1,7,1,1,0,43
13063,355997,1,7,2,0,0,43
13064,355997,1,7,3,4,0,47
13065,355997,1,7,4,1,0,48
13066,355997,1,7,5,1,0,49
13067,355997,1,7,6,1,0,50
13068,355997,1,8,1,0,1,50
13069,355997,1,8,2,1,0,51
13070,355997,1,8,3,1,0,52
13071,355997,1,8,4,1,0,53
13072,355997,1,8,5,1,0,54
13073,355997,1,8,6,2,0,56
13074,355997,1,9,1,1,0,57
13075,355997,1,9,2,0,0,57
13076,355997,1,9,3,2,0,59
13077,355997,1,9,4,0,0,59
13078,355997,1,9,5,1,0,60
13079,355997,1,9,6,1,0,61
13080,355997,1,10,1,0,1,61
13081,355997,1,10,2,0,0,61
13082,355997,1,10,3,0,0,61
13083,355997,1,10,4,0,0,61
13084,355997,1,10,5,3,0,64
13085,355997,1,10,6,1,0,65
13086,355997,1,11,1,0,0,65
13087,355997,1,11,2,1,0,66
13088,355997,1,11,3,0,1,66
13089,355997,1,11,4,0,0,66
13090,355997,1,11,5,0,0,66
13091,355997,1,11,6,1,0,67
13092,355997,1,12,1,1,0,68
13093,355997,1,12,2,0,0,68
13094,355997,1,12,3,0,0,68
13095,355997,1,12,4,0,0,68
13096,355997,1,12,5,1,0,69
13097,355997,1,12,6,0,0,69
13098,355997,1,13,1,1,0,70
13099,355997,1,13,2,2,0,72
13100,355997,1,13,3,1,0,73
13101,355997,1,13,4,1,0,74
13102,355997,1,13,5,1,0,75
13103,355997,1,13,6,1,0,76
13104,355997,1,14,1,2,0,78
13105,355997,1,14,2,1,0,79
13106,355997,1,14,3,1,0,80
13107,355997,1,14,4,1,0,81
13108,355997,1,14,5,1,0,82
13109,355997,1,14,6,1,0,83
13110,355997,1,15,1,1,0,84
13111,355997,1,15,2,1,0,85
13112,355997,1,15,3,1,0,86
13113,355997,1,15,4,3,0,89
13114,355997,1,15,5,0,0,89
13115,355997,1,15,6,0,0,89
13116,355997,1,16,1,1,0,90
13117,355997,1,16,2,0,0,90
13118,355997,1,16,3,0,1,90
13119,355997,1,16,4,1,0,91
13120,355997,1,16,5,1,0,92
13121,355997,1,16,6,1,0,93
13122,355997,1,17,1,1,0,94
13123,355997,1,17,2,0,1,94
13124,355997,1,17,3,1,0,95
13125,355997,1,17,4,2,0,97
13126,355997,1,17,5,1,0,98
13127,355997,1,17,6,1,0,99
13128,355997,1,18,1,1,0,100
13129,355997,1,18,2,1,0,101
13130,355997,1,18,3,1,0,102
13131,355997,1,18,4,0,0,102
13132,355997,1,18,5,1,0,103
13133,355997,1,18,6,6,0,109
13134,355997,1,19,1,1,0,110
13135,355997,1,19,2,4,0,114
13136,355997,1,19,3,1,0,115
13137,355997,1,19,4,2,0,117
13138,355997,1,19,5,0,0,117
13139,355997,1,19,6,0,1,117
13140,355997,1,20,1,2,0,119
13141,355997,1,20,2,2,0,121
13142,355997,1,20,3,2,0,123
13143,355997,1,20,4,6,0,129
13144,355997,1,20,5,2,0,131
13145,355997,1,20,6,6,0,137
13256,355998,1,1,1,1,0,1
13257,355998,1,1,2,0,0,1
13258,355998,1,1,3,0,0,1
13259,355998,1,1,4,0,1,1
13260,355998,1,1,5,0,0,1
13261,355998,1,1,6,0,0,1
13262,355998,1,2,1,1,0,2
13263,355998,1,2,2,0,0,2
13264,355998,1,2,3,1,0,3
13265,355998,1,2,4,1,0,4
13266,355998,1,2,5,4,0,8
13267,355998,1,2,6,0,0,8
13268,355998,1,3,1,0,0,8
13269,355998,1,3,2,1,0,9
13270,355998,1,3,3,4,0,13
13271,355998,1,3,4,3,0,16
13272,355998,1,3,5,0,0,16
13273,355998,1,3,6,1,0,17
13274,355998,1,4,1,1,0,18
13275,355998,1,4,2,4,0,22
13276,355998,1,4,3,4,0,26
13277,355998,1,4,4,6,0,32
13278,355998,1,4,5,0,0,32
13279,355998,1,4,6,0,0,32
13280,355998,1,5,1,4,0,36
13281,355998,1,5,2,4,0,40
13282,355998,1,5,3,4,0,44
13283,355998,1,5,4,2,0,46
13284,355998,1,5,5,0,0,46
13285,355998,1,5,6,1,0,47
13286,355998,1,6,1,0,0,47
13287,355998,1,6,2,0,0,47
13288,355998,1,6,3,1,0,48
13289,355998,1,6,4,0,0,48
13290,355998,1,6,5,0,0,48
13291,355998,1,6,6,0,1,48
13292,355998,1,7,1,1,0,49
13293,355998,1,7,2,1,0,50
13294,355998,1,7,3,1,0,51
13295,355998,1,7,4,0,0,51
13296,355998,1,7,5,6,0,57
13297,355998,1,7,6,1,0,58
13298,355998,1,8,1,0,0,58
13299,355998,1,8,2,1,0,59
13300,355998,1,8,3,0,1,59
13301,355998,1,8,4,0,0,59
13302,355998,1,8,5,2,0,61
13303,355998,1,8,6,0,0,61
13304,355998,1,9,1,0,0,61
13305,355998,1,9,2,2,0,63
13306,355998,1,9,3,1,0,64
13307,355998,1,9,4,1,0,65
13308,355998,1,9,5,1,0,66
13309,355998,1,9,6,0,0,66
13310,355998,1,10,1,1,0,67
13311,355998,1,10,2,1,0,68
13312,355998,1,10,3,1,0,69
13313,355998,1,10,4,1,0,70
13314,355998,1,10,5,0,0,70
13315,355998,1,10,6,0,0,70
13316,355998,1,11,1,1,0,71
13317,355998,1,11,2,1,0,72
13318,355998,1,11,3,0,0,72
13319,355998,1,11,4,1,0,73
13320,355998,1,11,5,1,0,74
13321,355998,1,11,6,0,1,74
13322,355998,1,12,1,1,0,75
13323,355998,1,12,2,0,0,75
13324,355998,1,12,3,0,0,75
13325,355998,1,12,4,1,0,76
13326,355998,1,12,5,0,0,76
13327,355998,1,12,6,1,0,77
13328,355998,1,13,1,2,0,79
13329,355998,1,13,2,0,1,79
13330,355998,1,13,3,0,0,79
13331,355998,1,13,4,2,0,81
13332,355998,1,13,5,4,0,85
13333,355998,1,13,6,1,0,86
13334,355998,1,14,1,0,0,86
13335,355998,1,14,2,0,0,86
13336,355998,1,14,3,0,0,86
13337,355998,1,14,4,1,0,87
13338,355998,1,14,5,0,0,87
13339,355998,1,14,6,0,0,87
13340,355998,1,15,1,0,0,87
13341,355998,1,15,2,0,0,87
13342,355998,1,15,3,6,0,93
13343,355998,1,15,4,1,0,94
13344,355998,1,15,5,0,1,94
13345,355998,1,15,6,0,0,94
13346,355998,1,16,1,1,0,95
13347,355998,1,16,2,6,0,101
13348,355998,1,16,3,3,0,104
13349,355998,1,16,4,1,0,105
13350,355998,1,16,5,6,0,111
13351,355998,1,16,6,4,0,115
13352,355998,1,17,1,2,0,117
13353,355998,1,17,2,1,0,118
13354,355998,1,17,3,4,0,122
13355,355998,1,17,4,0,0,122
13356,355998,1,17,5,1,0,123
13357,355998,1,17,6,1,0,124
13358,355998,1,18,1,1,0,125
13359,355998,1,18,2,2,0,127
13360,355998,1,18,3,1,0,128
13361,355998,1,18,4,1,0,129
13362,355998,1,18,5,0,0,129
13363,355998,1,18,6,0,0,129
13364,355998,1,19,1,6,0,135
13365,355998,1,19,2,0,1,135
13366,355998,1,19,3,1,0,136
13367,355998,1,19,4,4,0,140
13368,355998,1,19,5,6,0,146
13369,355998,1,19,6,1,0,147
13370,355998,1,20,1,4,0,151
13371,355998,1,20,2,0,1,151
13372,355998,1,20,3,0,0,151
13373,355998,1,20,4,4,0,155
13374,355998,1,20,5,0,1,155
13375,355998,1,20,6,4,0,159
13491,355999,1,1,1,0,0,0
13492,355999,1,1,2,0,0,0
13493,355999,1,1,3,0,0,0
13494,355999,1,1,4,2,0,2
13495,355999,1,1,5,2,0,4
13496,355999,1,1,6,1,0,5
13497,355999,1,2,1,0,0,5
13498,355999,1,2,2,4,0,9
13499,355999,1,2,3,1,0,10
13500,355999,1,2,4,1,0,11
13501,355999,1,2,5,2,0,13
13502,355999,1,2,6,4,0,17
13503,355999,1,3,1,4,0,21
13504,355999,1,3,2,0,0,21
13505,355999,1,3,3,0,0,21
13506,355999,1,3,4,0,0,21
13507,355999,1,3,5,1,0,22
13508,355999,1,3,6,0,0,22
13509,355999,1,4,1,6,0,28
13510,355999,1,4,2,0,0,28
13511,355999,1,4,3,2,0,30
13512,355999,1,4,4,4,0,34
13513,355999,1,4,5,0,0,34
13514,355999,1,4,6,0,0,34
13515,355999,1,5,1,2,0,36
13516,355999,1,5,2,1,0,37
13517,355999,1,5,3,1,1,38
13518,355999,1,5,4,4,0,42
13519,355999,1,5,5,0,0,42
13520,355999,1,5,6,4,0,46
13521,355999,1,6,1,1,0,47
13522,355999,1,6,2,0,0,47
13523,355999,1,6,3,1,0,48
13524,355999,1,6,4,1,0,49
13525,355999,1,6,5,0,0,49
13526,355999,1,6,6,1,0,50
13527,355999,1,7,1,0,0,50
13528,355999,1,7,2,1,0,51
13529,355999,1,7,3,0,0,51
13530,355999,1,7,4,2,0,53
13531,355999,1,7,5,0,0,53
13532,355999,1,7,6,1,0,54
13533,355999,1,8,1,1,0,55
13534,355999,1,8,2,6,0,61
13535,355999,1,8,3,1,0,62
13536,355999,1,8,4,1,0,63
13537,355999,1,8,5,0,0,63
13538,355999,1,8,6,4,0,67
13539,355999,1,9,1,0,0,67
13540,355999,1,9,2,0,0,67
13541,355999,1,9,3,1,0,68
13542,355999,1,9,4,6,0,74
13543,355999,1,9,5,1,0,75
13544,355999,1,9,6,2,0,77
13545,355999,1,10,1,1,0,78
13546,355999,1,10,2,1,0,79
13547,355999,1,10,3,1,0,80
13548,355999,1,10,4,1,0,81
13549,355999,1,10,5,0,0,81
13550,355999,1,10,6,0,1,81
13551,355999,1,11,1,2,0,83
13552,355999,1,11,2,1,0,84
13553,355999,1,11,3,1,0,85
13554,355999,1,11,4,1,0,86
13555,355999,1,11,5,1,0,87
13556,355999,1,11,6,1,0,88
13557,355999,1,12,1,1,0,89
13558,355999,1,12,2,1,0,90
13559,355999,1,12,3,1,0,91
13560,355999,1,12,4,1,0,92
13561,355999,1,12,5,1,0,93
13562,355999,1,12,6,1,0,94
13563,355999,1,13,1,1,0,95
13564,355999,1,13,2,1,0,96
13565,355999,1,13,3,1,0,97
13566,355999,1,13,4,0,0,97
13567,355999,1,13,5,2,0,99
13568,355999,1,13,6,0,1,99
13569,355999,1,14,1,1,0,100
13570,355999,1,14,2,1,0,101
13571,355999,1,14,3,2,0,103
13572,355999,1,14,4,4,0,107
13573,355999,1,14,5,2,0,109
13574,355999,1,14,6,1,0,110
13575,355999,1,15,1,1,0,111
13576,355999,1,15,2,1,0,112
13577,355999,1,15,3,1,0,113
13578,355999,1,15,4,1,0,114
13579,355999,1,15,5,0,0,114
13580,355999,1,15,6,1,0,115
13581,355999,1,16,1,1,0,116
13582,355999,1,16,2,6,0,122
13583,355999,1,16,3,1,0,123
13584,355999,1,16,4,4,0,127
13585,355999,1,16,5,1,0,128
13586,355999,1,16,6,2,0,130
13587,355999,1,17,1,2,0,132
13588,355999,1,17,2,1,0,133
13589,355999,1,17,3,2,0,135
13590,355999,1,17,4,1,0,136
13591,355999,1,17,5,1,0,137
13592,355999,1,17,6,2,0,139
13593,355999,1,18,1,1,0,140
13594,355999,1,18,2,6,0,146
13595,355999,1,18,3,6,0,152
13596,355999,1,18,4,0,0,152
13597,355999,1,18,5,0,1,152
13598,355999,1,18,6,4,0,156
13599,355999,1,19,1,2,0,158
13600,355999,1,19,2,2,0,160
13601,355999,1,19,3,1,0,161
13602,355999,1,19,4,1,0,162
13603,355999,1,19,5,0,0,162
13604,355999,1,19,6,2,0,164
13605,355999,1,20,1,1,0,165
13606,355999,1,20,2,6,0,171
13607,355999,1,20,3,0,1,171
13608,355999,1,20,4,1,0,172
13609,355999,1,20,5,1,0,173
13610,355999,1,20,6,2,0,175
13716,356000,1,1,1,0,0,0
13717,356000,1,1,2,0,0,0
13718,356000,1,1,3,2,0,2
13719,356000,1,1,4,1,0,3
13720,356000,1,1,5,0,0,3
13721,356000,1,1,6,1,0,4
13722,356000,1,2,1,0,0,4
13723,356000,1,2,2,1,0,5
13724,356000,1,2,3,4,0,9
13725,356000,1,2,4,0,0,9
13726,356000,1,2,5,1,0,10
13727,356000,1,2,6,0,0,10
13728,356000,1,3,1,0,0,10
13729,356000,1,3,2,0,0,10
13730,356000,1,3,3,4,0,14
13731,356000,1,3,4,1,0,15
13732,356000,1,3,5,1,0,16
13733,356000,1,3,6,6,0,22
13734,356000,1,4,1,1,0,23
13735,356000,1,4,2,1,0,24
13736,356000,1,4,3,0,0,24
13737,356000,1,4,4,1,0,25
13738,356000,1,4,5,1,0,26
13739,356000,1,4,6,2,0,28
13740,356000,1,5,1,4,0,32
13741,356000,1,5,2,0,0,32
13742,356000,1,5,3,1,0,33
13743,356000,1,5,4,0,0,33
13744,356000,1,5,5,1,0,34
13745,356000,1,5,6,1,0,35
13746,356000,1,6,1,1,0,36
13747,356000,1,6,2,1,0,37
13748,356000,1,6,3,4,0,41
13749,356000,1,6,4,1,0,42
13750,356000,1,6,5,1,0,43
13751,356000,1,6,6,4,0,47
13752,356000,1,7,1,0,0,47
13753,356000,1,7,2,0,0,47
13754,356000,1,7,3,0,0,47
13755,356000,1,7,4,1,0,48
13756,356000,1,7,5,1,0,49
13757,356000,1,7,6,0,0,49
13758,356000,1,8,1,0,1,49
13759,356000,1,8,2,0,0,49
13760,356000,1,8,3,1,0,50
13761,356000,1,8,4,0,0,50
13762,356000,1,8,5,0,0,50
13763,356000,1,8,6,0,0,50
13764,356000,1,9,1,0,0,50
13765,356000,1,9,2,0,0,50
13766,356000,1,9,3,0,0,50
13767,356000,1,9,4,1,0,51
13768,356000,1,9,5,1,0,52
13769,356000,1,9,6,1,0,53
13770,356000,1,10,1,2,0,55
13771,356000,1,10,2,0,0,55
13772,356000,1,10,3,0,0,55
13773,356000,1,10,4,1,0,56
13774,356000,1,10,5,1,0,57
13775,356000,1,10,6,4,0,61
13776,356000,1,11,1,1,0,62
13777,356000,1,11,2,1,0,63
13778,356000,1,11,3,0,1,63
13779,356000,1,11,4,0,0,63
13780,356000,1,11,5,0,0,63
13781,356000,1,11,6,0,0,63
13782,356000,1,12,1,0,0,63
13783,356000,1,12,2,0,1,63
13784,356000,1,12,3,0,0,63
13785,356000,1,12,4,0,0,63
13786,356000,1,12,5,1,0,64
13787,356000,1,12,6,0,0,64
13788,356000,1,13,1,0,0,64
13789,356000,1,13,2,1,0,65
13790,356000,1,13,3,0,0,65
13791,356000,1,13,4,0,1,65
13792,356000,1,13,5,1,0,66
13793,356000,1,13,6,2,0,68
13794,356000,1,14,1,4,0,72
13795,356000,1,14,2,1,0,73
13796,356000,1,14,3,1,0,74
13797,356000,1,14,4,2,0,76
13798,356000,1,14,5,1,0,77
13799,356000,1,14,6,0,0,77
13800,356000,1,15,1,4,0,81
13801,356000,1,15,2,1,0,82
13802,356000,1,15,3,1,0,83
13803,356000,1,15,4,1,0,84
13804,356000,1,15,5,1,1,85
13805,356000,1,15,6,1,0,86
13806,356000,1,16,1,1,0,87
13807,356000,1,16,2,1,0,88
13808,356000,1,16,3,4,0,92
13809,356000,1,16,4,1,0,93
13810,356000,1,16,5,1,0,94
13811,356000,1,16,6,0,0,94
13812,356000,1,17,1,2,0,96
13813,356000,1,17,2,1,0,97
13814,356000,1,17,3,1,0,98
13815,356000,1,17,4,1,0,99
13816,356000,1,17,5,6,0,105
13817,356000,1,17,6,1,0,106
13818,356000,1,18,1,1,0,107
13819,356000,1,18,2,0,1,107
13820,356000,1,18,3,2,0,109
13821,356000,1,18,4,2,0,111
13822,356000,1,18,5,0,0,111
13823,356000,1,18,6,1,0,112
13824,356000,1,19,1,1,0,113
13825,356000,1,19,2,1,0,114
13826,356000,1,19,3,1,0,115
13827,356000,1,19,4,6,0,121
13828,356000,1,19,5,0,1,121
13829,356000,1,19,6,1,0,122
13830,356000,1,20,1,1,0,123
13831,356000,1,20,2,1,0,124
13832,356000,1,20,3,2,0,126
13833,356000,1,20,4,1,0,127
13834,356000,1,20,5,1,0,128
13835,356000,1,20,6,0,0,128
13956,356001,1,1,1,1,0,1
13957,356001,1,1,2,0,0,1
13958,356001,1,1,3,1,0,2
13959,356001,1,1,4,0,0,2
13960,356001,1,1,5,0,0,2
13961,356001,1,1,6,0,0,2
13962,356001,1,2,1,0,0,2
13963,356001,1,2,2,2,0,4
13964,356001,1,2,3,0,0,4
13965,356001,1,2,4,0,0,4
13966,356001,1,2,5,0,0,4
13967,356001,1,2,6,0,1,4
13968,356001,1,3,1,2,0,6
13969,356001,1,3,2,1,0,7
13970,356001,1,3,3,0,0,7
13971,356001,1,3,4,0,0,7
13972,356001,1,3,5,0,0,7
13973,356001,1,3,6,2,0,9
13974,356001,1,4,1,0,1,9
13975,356001,1,4,2,0,0,9
13976,356001,1,4,3,2,0,11
13977,356001,1,4,4,4,0,15
13978,356001,1,4,5,2,0,17
13979,356001,1,4,6,0,1,17
13980,356001,1,5,1,4,0,21
13981,356001,1,5,2,2,0,23
13982,356001,1,5,3,0,0,23
13983,356001,1,5,4,0,0,23
13984,356001,1,5,5,1,0,24
13985,356001,1,5,6,0,0,24
13986,356001,1,6,1,1,0,25
13987,356001,1,6,2,1,0,26
13988,356001,1,6,3,1,0,27
13989,356001,1,6,4,1,0,28
13990,356001,1,6,5,0,0,28
13991,356001,1,6,6,0,0,28
13992,356001,1,7,1,0,1,28
13993,356001,1,7,2,1,0,29
13994,356001,1,7,3,0,0,29
13995,356001,1,7,4,0,0,29
13996,356001,1,7,5,1,0,30
13997,356001,1,7,6,0,0,30
13998,356001,1,8,1,0,0,30
13999,356001,1,8,2,1,0,31
14000,356001,1,8,3,0,0,31
14001,356001,1,8,4,1,0,32
14002,356001,1,8,5,1,0,33
14003,356001,1,8,6,1,0,34
14004,356001,1,9,1,4,0,38
14005,356001,1,9,2,1,0,39
14006,356001,1,9,3,1,0,40
14007,356001,1,9,4,1,0,41
14008,356001,1,9,5,2,0,43
14009,356001,1,9,6,2,0,45
14010,356001,1,10,1,2,0,47
14011,356001,1,10,2,0,0,47
14012,356001,1,10,3,1,0,48
14013,356001,1,10,4,0,1,48
14014,356001,1,10,5,0,0,48
14015,356001,1,10,6,0,0,48
14016,356001,1,11,1,1,0,49
14017,356001,1,11,2,4,0,53
14018,356001,1,11,3,0,0,53
14019,356001,1,11,4,0,0,53
14020,356001,1,11,5,0,0,53
14021,356001,1,11,6,1,0,54
14022,356001,1,12,1,0,0,54
14023,356001,1,12,2,4,0,58
14024,356001,1,12,3,1,0,59
14025,356001,1,12,4,0,0,59
14026,356001,1,12,5,1,0,60
14027,356001,1,12,6,1,0,61
14028,356001,1,13,1,0,0,61
14029,356001,1,13,2,1,0,62
14030,356001,1,13,3,0,0,62
14031,356001,1,13,4,1,0,63
14032,356001,1,13,5,0,0,63
14033,356001,1,13,6,1,0,64
14034,356001,1,14,1,1,0,65
14035,356001,1,14,2,2,0,67
14036,356001,1,14,3,0,0,67
14037,356001,1,14,4,1,0,68
14038,356001,1,14,5,1,0,69
14039,356001,1,14,6,0,0,69
14040,356001,1,15,1,1,0,70
14041,356001,1,15,2,1,0,71
14042,356001,1,15,3,1,0,72
14043,356001,1,15,4,0,1,72
14044,356001,1,15,5,1,1,73
14045,356001,1,15,6,0,0,73
14046,356001,1,16,1,6,0,79
14047,356001,1,16,2,1,0,80
14048,356001,1,16,3,1,0,81
14049,356001,1,16,4,2,0,83
14050,356001,1,16,5,1,0,84
14051,356001,1,16,6,4,0,88
14052,356001,1,17,1,4,0,92
14053,356001,1,17,2,0,1,92
14054,356001,1,17,3,0,0,92
14055,356001,1,17,4,1,0,93
14056,356001,1,17,5,4,0,97
14057,356001,1,17,6,0,0,97
14058,356001,1,18,1,1,0,98
14059,356001,1,18,2,3,0,101
14060,356001,1,18,3,2,0,103
14061,356001,1,18,4,4,0,107
14062,356001,1,18,5,4,0,111
14063,356001,1,18,6,1,0,112
14157,356002,1,1,1,1,0,1
14158,356002,1,1,2,0,0,1
14159,356002,1,1,3,0,0,1
14160,356002,1,1,4,1,0,2
14161,356002,1,1,5,1,0,3
14162,356002,1,1,6,1,0,4
14163,356002,1,2,1,4,0,8
14164,356002,1,2,2,0,0,8
14165,356002,1,2,3,4,0,12
14166,356002,1,2,4,0,0,12
14167,356002,1,2,5,6,0,18
14168,356002,1,2,6,3,0,21
14169,356002,1,3,1,2,0,23
14170,356002,1,3,2,1,0,24
14171,356002,1,3,3,6,0,30
14172,356002,1,3,4,1,0,31
14173,356002,1,3,5,1,0,32
14174,356002,1,3,6,0,0,32
14175,356002,1,4,1,1,0,33
14176,356002,1,4,2,1,0,34
14177,356002,1,4,3,1,0,35
14178,356002,1,4,4,1,0,36
14179,356002,1,4,5,0,0,36
14180,356002,1,4,6,4,0,40
14181,356002,1,5,1,1,0,41
14182,356002,1,5,2,1,0,42
14183,356002,1,5,3,0,0,42
14184,356002,1,5,4,1,0,43
14185,356002,1,5,5,0,0,43
14186,356002,1,5,6,4,0,47
14187,356002,1,6,1,4,0,51
14188,356002,1,6,2,0,0,51
14189,356002,1,6,3,6,0,57
14190,356002,1,6,4,4,0,61
14191,356002,1,6,5,1,0,62
14192,356002,1,6,6,4,0,66
14193,356002,1,7,1,0,0,66
14194,356002,1,7,2,1,0,67
14195,356002,1,7,3,2,0,69
14196,356002,1,7,4,4,0,73
14197,356002,1,7,5,1,0,74
14198,356002,1,7,6,0,0,74
14199,356002,1,8,1,1,0,75
14200,356002,1,8,2,0,0,75
14201,356002,1,8,3,2,0,77
14202,356002,1,8,4,2,0,79
14203,356002,1,8,5,1,0,80
14204,356002,1,8,6,0,0,80
14205,356002,1,9,1,0,0,80
14206,356002,1,9,2,0,0,80
14207,356002,1,9,3,4,0,84
14208,356002,1,9,4,0,0,84
14209,356002,1,9,5,0,0,84
14210,356002,1,9,6,1,0,85
14211,356002,1,10,1,6,0,91
14212,356002,1,10,2,1,0,92
14213,356002,1,10,3,1,0,93
14214,356002,1,10,4,4,0,97
14215,356002,1,10,5,4,0,101
14216,356002,1,10,6,4,0,105
14217,356002,1,11,1,0,0,105
14218,356002,1,11,2,1,0,106
14219,356002,1,11,3,2,0,108
14220,356002,1,11,4,1,0,109
14221,356002,1,11,5,0,0,109
14222,356002,1,11,6,1,0,110
14223,356002,1,12,1,4,0,114
14224,356002,1,12,2,3,0,117
14225,356002,1,12,3,0,0,117
14226,356002,1,12,4,1,0,118
14227,356002,1,12,5,4,0,122
14228,356002,1,12,6,0,0,122
14229,356002,1,13,1,1,0,123
14230,356002,1,13,2,1,0,124
14231,356002,1,13,3,0,1,124
14232,356002,1,13,4,1,0,125
14233,356002,1,13,5,1,0,126
14234,356002,1,13,6,0,0,126
14235,356002,1,14,1,4,0,130
14236,356002,1,14,2,1,0,131
14237,356002,1,14,3,4,0,135
14238,356002,1,14,4,4,0,139
14239,356002,1,14,5,1,0,140
14240,356002,1,14,6,0,0,140
14241,356002,1,15,1,1,0,141
14242,356002,1,15,2,1,0,142
14243,356002,1,15,3,4,0,146
14244,356002,1,15,4,1,0,147
14245,356002,1,15,5,0,1,147
14246,356002,1,15,6,1,0,148
14247,356002,1,16,1,1,0,149
14248,356002,1,16,2,4,0,153
14249,356002,1,16,3,4,0,157
14250,356002,1,16,4,2,0,159
14251,356002,1,16,5,1,0,160
14252,356002,1,16,6,2,0,162
14253,356002,1,17,1,0,0,162
14254,356002,1,17,2,1,0,163
14255,356002,1,17,3,0,0,163
14256,356002,1,17,4,1,0,164
14257,356002,1,17,5,4,0,168
14258,356002,1,17,6,0,0,168
14259,356002,1,18,1,0,0,168
14260,356002,1,18,2,0,1,168
14261,356002,1,18,3,4,0,172
14262,356002,1,18,4,0,1,172
14263,356002,1,18,5,1,0,173
14264,356002,1,18,6,2,0,175
14265,356002,1,19,1,4,0,179
14266,356002,1,19,2,1,0,180
14267,356002,1,19,3,2,0,182
14268,356002,1,19,4,1,0,183
14269,356002,1,19,5,4,0,187
14270,356002,1,19,6,0,0,187
14271,356002,1,20,1,1,0,188
14272,356002,1,20,2,1,0,189
14273,356002,1,20,3,0,0,189
14274,356002,1,20,4,0,1,189
14275,356002,1,20,5,2,0,191
14276,356002,1,20,6,1,0,192
14397,356003,1,1,1,1,0,1
14398,356003,1,1,2,4,0,5
14399,356003,1,1,3,4,0,9
14400,356003,1,1,4,0,0,9
14401,356003,1,1,5,4,0,13
14402,356003,1,1,6,1,0,14
14403,356003,1,2,1,4,0,18
14404,356003,1,2,2,4,0,22
14405,356003,1,2,3,1,0,23
14406,356003,1,2,4,1,0,24
14407,356003,1,2,5,4,0,28
14408,356003,1,2,6,4,0,32
14409,356003,1,3,1,0,0,32
14410,356003,1,3,2,0,0,32
14411,356003,1,3,3,0,0,32
14412,356003,1,3,4,1,0,33
14413,356003,1,3,5,0,0,33
14414,356003,1,3,6,1,0,34
14415,356003,1,4,1,4,0,38
14416,356003,1,4,2,4,0,42
14417,356003,1,4,3,1,0,43
14418,356003,1,4,4,0,0,43
14419,356003,1,4,5,0,0,43
14420,356003,1,4,6,0,0,43
14421,356003,1,5,1,0,0,43
14422,356003,1,5,2,1,0,44
14423,356003,1,5,3,0,0,44
14424,356003,1,5,4,6,0,50
14425,356003,1,5,5,1,0,51
14426,356003,1,5,6,0,0,51
14427,356003,1,6,1,0,0,51
14428,356003,1,6,2,0,1,51
14429,356003,1,6,3,0,0,51
14430,356003,1,6,4,0,0,51
14431,356003,1,6,5,0,0,51
14432,356003,1,6,6,1,0,52
14433,356003,1,7,1,1,0,53
14434,356003,1,7,2,0,0,53
14435,356003,1,7,3,1,0,54
14436,356003,1,7,4,1,0,55
14437,356003,1,7,5,1,0,56
14438,356003,1,7,6,0,0,56
14439,356003,1,8,1,4,0,60
14440,356003,1,8,2,4,0,64
14441,356003,1,8,3,1,0,65
14442,356003,1,8,4,1,0,66
14443,356003,1,8,5,0,0,66
14444,356003,1,8,6,4,0,70
14445,356003,1,9,1,6,0,76
14446,356003,1,9,2,2,0,78
14447,356003,1,9,3,1,0,79
14448,356003,1,9,4,4,0,83
14449,356003,1,9,5,2,0,85
14450,356003,1,9,6,2,0,87
14451,356003,1,10,1,0,0,87
14452,356003,1,10,2,4,0,91
14453,356003,1,10,3,0,1,91
14454,356003,1,10,4,1,0,92
14455,356003,1,10,5,1,0,93
14456,356003,1,10,6,1,0,94
14457,356003,1,11,1,1,0,95
14458,356003,1,11,2,1,0,96
14459,356003,1,11,3,0,0,96
14460,356003,1,11,4,3,0,99
14461,356003,1,11,5,0,0,99
14462,356003,1,11,6,1,0,100
14463,356003,1,12,1,0,0,100
14464,356003,1,12,2,6,0,106
14465,356003,1,12,3,1,0,107
14466,356003,1,12,4,2,0,109
14467,356003,1,12,5,1,0,110
14468,356003,1,12,6,1,0,111
14469,356003,1,13,1,2,0,113
14470,356003,1,13,2,2,0,115
14471,356003,1,13,3,2,0,117
14472,356003,1,13,4,0,0,117
14473,356003,1,13,5,1,0,118
14474,356003,1,13,6,6,0,124
14475,356003,1,14,1,1,0,125
14476,356003,1,14,2,0,0,125
14477,356003,1,14,3,1,0,126
14478,356003,1,14,4,1,0,127
14479,356003,1,14,5,0,0,127
14480,356003,1,14,6,1,0,128
14481,356003,1,15,1,1,0,129
14482,356003,1,15,2,2,0,131
14483,356003,1,15,3,1,0,132
14484,356003,1,15,4,1,0,133
14485,356003,1,15,5,6,0,139
14486,356003,1,15,6,1,0,140
14487,356003,1,16,1,2,0,142
14488,356003,1,16,2,6,0,148
14489,356003,1,16,3,4,0,152
14490,356003,1,16,4,0,1,152
14491,356003,1,16,5,1,0,153
14492,356003,1,16,6,1,0,154
14493,356003,1,17,1,2,0,156
14494,356003,1,17,2,4,0,160
14495,356003,1,17,3,0,0,160
14496,356003,1,17,4,2,0,162
14497,356003,1,17,5,6,0,168
14498,356003,1,17,6,0,1,168
14499,356003,1,18,1,1,0,169
14500,356003,1,18,2,1,0,170
14501,356003,1,18,3,2,0,172
14502,356003,1,18,4,2,0,174
14503,356003,1,18,5,2,0,176
14504,356003,1,18,6,0,1,176
14505,356003,1,19,1,1,0,177
14506,356003,1,19,2,1,0,178
14507,356003,1,19,3,6,0,184
14508,356003,1,19,4,1,0,185
14509,356003,1,19,5,0,0,185
14510,356003,1,19,6,2,0,187
14511,356003,1,20,1,6,0,193
14512,356003,1,20,2,1,0,194
14513,356003,1,20,3,0,0,194
14514,356003,1,20,4,0,0,194
14515,356003,1,20,5,2,0,196
14516,356003,1,20,6,2,0,198
14617,356004,1,1,1,2,0,2
14618,356004,1,1,2,0,0,2
14619,356004,1,1,3,1,0,3
14620,356004,1,1,4,1,0,4
14621,356004,1,1,5,0,0,4
14622,356004,1,1,6,0,1,4
14623,356004,1,2,1,0,0,4
14624,356004,1,2,2,0,0,4
14625,356004,1,2,3,0,0,4
14626,356004,1,2,4,0,0,4
14627,356004,1,2,5,0,1,4
14628,356004,1,2,6,1,0,5
14629,356004,1,3,1,1,0,6
14630,356004,1,3,2,4,0,10
14631,356004,1,3,3,4,0,14
14632,356004,1,3,4,0,0,14
14633,356004,1,3,5,0,0,14
14634,356004,1,3,6,1,0,15
14635,356004,1,4,1,0,0,15
14636,356004,1,4,2,0,0,15
14637,356004,1,4,3,0,0,15
14638,356004,1,4,4,0,0,15
14639,356004,1,4,5,1,0,16
14640,356004,1,4,6,0,0,16
14641,356004,1,5,1,0,0,16
14642,356004,1,5,2,4,0,20
14643,356004,1,5,3,4,0,24
14644,356004,1,5,4,0,0,24
14645,356004,1,5,5,1,0,25
14646,356004,1,5,6,0,0,25
14647,356004,1,6,1,0,0,25
14648,356004,1,6,2,0,1,25
14649,356004,1,6,3,0,0,25
14650,356004,1,6,4,0,0,25
14651,356004,1,6,5,0,0,25
14652,356004,1,6,6,0,0,25
14653,356004,1,7,1,1,0,26
14654,356004,1,7,2,0,0,26
14655,356004,1,7,3,1,0,27
14656,356004,1,7,4,0,0,27
14657,356004,1,7,5,1,0,28
14658,356004,1,7,6,0,0,28
14659,356004,1,8,1,0,0,28
14660,356004,1,8,2,0,0,28
14661,356004,1,8,3,2,0,30
14662,356004,1,8,4,2,0,32
14663,356004,1,8,5,2,0,34
14664,356004,1,8,6,0,0,34
14665,356004,1,9,1,0,0,34
14666,356004,1,9,2,0,0,34
14667,356004,1,9,3,6,0,40
14668,356004,1,9,4,1,0,41
14669,356004,1,9,5,0,0,41
14670,356004,1,9,6,1,0,42
14671,356004,1,10,1,0,0,42
14672,356004,1,10,2,1,0,43
14673,356004,1,10,3,2,0,45
14674,356004,1,10,4,1,0,46
14675,356004,1,10,5,1,0,47
14676,356004,1,10,6,0,0,47
14677,356004,1,11,1,1,0,48
14678,356004,1,11,2,1,0,49
14679,356004,1,11,3,0,0,49
14680,356004,1,11,4,6,0,55
14681,356004,1,11,5,0,0,55
14682,356004,1,11,6,1,0,56
14683,356004,1,12,1,6,0,62
14684,356004,1,12,2,4,0,66
14685,356004,1,12,3,4,0,70
14686,356004,1,12,4,1,0,71
14687,356004,1,12,5,1,0,72
14688,356004,1,12,6,1,0,73
14689,356004,1,13,1,1,0,74
14690,356004,1,13,2,4,0,78
14691,356004,1,13,3,0,1,78
14692,356004,1,13,4,0,0,78
14693,356004,1,13,5,0,0,78
14694,356004,1,13,6,1,0,79
14695,356004,1,14,1,0,1,79
14696,356004,1,14,2,0,0,79
14697,356004,1,14,3,1,0,80
14698,356004,1,14,4,2,0,82
14699,356004,1,14,5,0,1,82
14700,356004,1,14,6,1,0,83
14701,356004,1,15,1,1,0,84
14702,356004,1,15,2,4,0,88
14703,356004,1,15,3,0,0,88
14704,356004,1,15,4,0,0,88
14705,356004,1,15,5,0,1,88
14706,356004,1,15,6,0,0,88
14707,356004,1,16,1,2,0,90
14708,356004,1,16,2,1,0,91
14709,356004,1,16,3,1,0,92
14710,356004,1,16,4,0,0,92
14711,356004,1,16,5,0,1,92
14712,356004,1,16,6,1,0,93
14713,356004,1,17,1,0,0,93
14714,356004,1,17,2,2,0,95
14715,356004,1,17,3,0,0,95
14716,356004,1,17,4,0,0,95
14717,356004,1,17,5,1,0,96
14718,356004,1,17,6,0,0,96
14719,356004,1,18,1,0,0,96
14720,356004,1,18,2,1,0,97
14721,356004,1,18,3,1,0,98
14722,356004,1,18,4,1,0,99
14723,356004,1,18,5,1,0,100
14724,356004,1,18,6,1,0,101
14725,356004,1,19,1,0,0,101
14726,356004,1,19,2,0,0,101
14727,356004,1,19,3,0,0,101
14728,356004,1,19,4,0,0,101
14729,356004,1,19,5,2,0,103
14730,356004,1,19,6,1,0,104
14731,356004,1,20,1,1,0,105
14732,356004,1,20,2,2,0,107
14733,356004,1,20,3,4,0,111
14734,356004,1,20,4,0,1,111
14735,356004,1,20,5,0,1,111
14846,356005,1,1,1,2,0,2
14847,356005,1,1,2,6,0,8
14848,356005,1,1,3,1,0,9
14849,356005,1,1,4,5,0,14
14850,356005,1,1,5,0,0,14
14851,356005,1,1,6,4,0,18
14852,356005,1,2,1,1,0,19
14853,356005,1,2,2,0,0,19
14854,356005,1,2,3,0,0,19
14855,356005,1,2,4,1,0,20
14856,356005,1,2,5,1,0,21
14857,356005,1,2,6,0,0,21
14858,356005,1,3,1,0,0,21
14859,356005,1,3,2,4,0,25
14860,356005,1,3,3,0,0,25
14861,356005,1,3,4,5,0,30
14862,356005,1,3,5,1,0,31
14863,356005,1,3,6,1,0,32
14864,356005,1,4,1,2,0,34
14865,356005,1,4,2,6,0,40
14866,356005,1,4,3,1,0,41
14867,356005,1,4,4,4,0,45
14868,356005,1,4,5,1,0,46
14869,356005,1,4,6,1,0,47
14870,356005,1,5,1,1,0,48
14871,356005,1,5,2,0,0,48
14872,356005,1,5,3,1,0,49
14873,356005,1,5,4,2,0,51
14874,356005,1,5,5,4,0,55
14875,356005,1,5,6,4,0,59
14876,356005,1,6,1,0,0,59
14877,356005,1,6,2,1,0,60
14878,356005,1,6,3,4,0,64
14879,356005,1,6,4,0,0,64
14880,356005,1,6,5,1,0,65
14881,356005,1,6,6,0,0,65
14882,356005,1,7,1,0,0,65
14883,356005,1,7,2,1,0,66
14884,356005,1,7,3,1,0,67
14885,356005,1,7,4,4,0,71
14886,356005,1,7,5,1,0,72
14887,356005,1,7,6,1,0,73
14888,356005,1,8,1,1,0,74
14889,356005,1,8,2,1,0,75
14890,356005,1,8,3,0,0,75
14891,356005,1,8,4,4,0,79
14892,356005,1,8,5,0,0,79
14893,356005,1,8,6,1,0,80
14894,356005,1,9,1,0,0,80
14895,356005,1,9,2,0,0,80
14896,356005,1,9,3,1,0,81
14897,356005,1,9,4,0,0,81
14898,356005,1,9,5,0,0,81
14899,356005,1,9,6,0,1,81
14900,356005,1,10,1,1,0,82
14901,356005,1,10,2,0,0,82
14902,356005,1,10,3,1,0,83
14903,356005,1,10,4,1,0,84
14904,356005,1,10,5,1,0,85
14905,356005,1,10,6,1,0,86
14906,356005,1,11,1,1,0,87
14907,356005,1,11,2,1,0,88
14908,356005,1,11,3,1,0,89
14909,356005,1,11,4,0,0,89
14910,356005,1,11,5,0,1,89
14911,356005,1,11,6,0,0,89
14912,356005,1,12,1,0,0,89
14913,356005,1,12,2,0,0,89
14914,356005,1,12,3,1,0,90
14915,356005,1,12,4,0,0,90
14916,356005,1,12,5,1,0,91
14917,356005,1,12,6,0,0,91
14918,356005,1,13,1,1,0,92
14919,356005,1,13,2,4,0,96
14920,356005,1,13,3,3,0,99
14921,356005,1,13,4,2,0,101
14922,356005,1,13,5,1,0,102
14923,356005,1,13,6,0,0,102
14924,356005,1,14,1,1,0,103
14925,356005,1,14,2,1,0,104
14926,356005,1,14,3,1,0,105
14927,356005,1,14,4,4,0,109
14928,356005,1,14,5,1,0,110
14929,356005,1,14,6,0,1,110
14930,356005,1,15,1,2,0,112
14931,356005,1,15,2,0,0,112
14932,356005,1,15,3,1,0,113
14933,356005,1,15,4,4,0,117
14934,356005,1,15,5,3,0,120
14935,356005,1,15,6,0,0,120
14936,356005,1,16,1,1,0,121
14937,356005,1,16,2,1,0,122
14938,356005,1,16,3,4,0,126
14939,356005,1,16,4,1,0,127
14940,356005,1,16,5,1,0,128
14941,356005,1,16,6,0,0,128
14942,356005,1,17,1,0,1,128
14943,356005,1,17,2,0,0,128
14944,356005,1,17,3,1,0,129
14945,356005,1,17,4,2,0,131
14946,356005,1,17,5,1,0,132
14947,356005,1,17,6,0,0,132
14948,356005,1,18,1,0,1,132
14949,356005,1,18,2,1,0,133
14950,356005,1,18,3,1,0,134
14951,356005,1,18,4,1,0,135
14952,356005,1,18,5,0,0,135
14953,356005,1,18,6,1,0,136
14954,356005,1,19,1,1,0,137
14955,356005,1,19,2,0,0,137
14956,356005,1,19,3,1,0,138
14957,356005,1,19,4,1,0,139
14958,356005,1,19,5,1,0,140
14959,356005,1,19,6,2,0,142
14960,356005,1,20,1,0,0,142
14961,356005,1,20,2,4,0,146
14962,356005,1,20,3,1,0,147
14963,356005,1,20,4,1,1,148
14964,356005,1,20,5,0,1,148
14965,356005,1,20,6,2,0,150
15086,356006,1,1,1,0,0,0
15087,356006,1,1,2,4,0,4
15088,356006,1,1,3,0,0,4
15089,356006,1,1,4,1,0,5
15090,356006,1,1,5,1,0,6
15091,356006,1,1,6,2,0,8
15092,356006,1,2,1,4,0,12
15093,356006,1,2,2,0,1,12
15094,356006,1,2,3,0,0,12
15095,356006,1,2,4,0,0,12
15096,356006,1,2,5,1,0,13
15097,356006,1,2,6,1,0,14
15098,356006,1,3,1,1,0,15
15099,356006,1,3,2,2,0,17
15100,356006,1,3,3,3,0,20
15101,356006,1,3,4,4,0,24
15102,356006,1,3,5,1,0,25
15103,356006,1,3,6,0,0,25
15104,356006,1,4,1,1,0,26
15105,356006,1,4,2,0,0,26
15106,356006,1,4,3,0,0,26
15107,356006,1,4,4,0,0,26
15108,356006,1,4,5,1,1,27
15109,356006,1,4,6,1,0,28
15110,356006,1,5,1,1,0,29
15111,356006,1,5,2,0,1,29
15112,356006,1,5,3,0,0,29
15113,356006,1,5,4,0,0,29
15114,356006,1,5,5,1,0,30
15115,356006,1,5,6,0,0,30
15116,356006,1,6,1,2,0,32
15117,356006,1,6,2,0,0,32
15118,356006,1,6,3,1,0,33
15119,356006,1,6,4,1,0,34
15120,356006,1,6,5,2,0,36
15121,356006,1,6,6,4,0,40
15122,356006,1,7,1,0,0,40
15123,356006,1,7,2,0,0,40
15124,356006,1,7,3,1,0,41
15125,356006,1,7,4,0,0,41
15126,356006,1,7,5,2,0,43
15127,356006,1,7,6,1,0,44
15128,356006,1,8,1,1,0,45
15129,356006,1,8,2,1,0,46
15130,356006,1,8,3,1,0,47
15131,356006,1,8,4,0,0,47
15132,356006,1,8,5,0,0,47
15133,356006,1,8,6,0,0,47
15134,356006,1,9,1,1,0,48
15135,356006,1,9,2,0,0,48
15136,356006,1,9,3,1,0,49
15137,356006,1,9,4,1,0,50
15138,356006,1,9,5,0,0,50
15139,356006,1,9,6,0,0,50
15140,356006,1,10,1,1,0,51
15141,356006,1,10,2,0,0,51
15142,356006,1,10,3,1,0,52
15143,356006,1,10,4,2,0,54
15144,356006,1,10,5,0,0,54
15145,356006,1,10,6,0,0,54
15146,356006,1,11,1,2,0,56
15147,356006,1,11,2,1,0,57
15148,356006,1,11,3,1,0,58
15149,356006,1,11,4,1,0,59
15150,356006,1,11,5,1,0,60
15151,356006,1,11,6,0,0,60
15152,356006,1,12,1,0,0,60
15153,356006,1,12,2,3,0,63
15154,356006,1,12,3,0,0,63
15155,356006,1,12,4,1,0,64
15156,356006,1,12,5,1,0,65
15157,356006,1,12,6,1,0,66
15158,356006,1,13,1,0,1,66
15159,356006,1,13,2,1,0,67
15160,356006,1,13,3,4,0,71
15161,356006,1,13,4,1,0,72
15162,356006,1,13,5,0,0,72
15163,356006,1,13,6,1,0,73
15164,356006,1,14,1,0,0,73
15165,356006,1,14,2,1,0,74
15166,356006,1,14,3,1,0,75
15167,356006,1,14,4,0,0,75
15168,356006,1,14,5,0,0,75
15169,356006,1,14,6,6,0,81
15170,356006,1,15,1,0,0,81
15171,356006,1,15,2,1,0,82
15172,356006,1,15,3,4,0,86
15173,356006,1,15,4,1,0,87
15174,356006,1,15,5,4,0,91
15175,356006,1,15,6,6,0,97
15176,356006,1,16,1,1,0,98
15177,356006,1,16,2,0,0,98
15178,356006,1,16,3,4,0,102
15179,356006,1,16,4,1,0,103
15180,356006,1,16,5,2,0,105
15181,356006,1,16,6,4,0,109
15182,356006,1,17,1,1,0,110
15183,356006,1,17,2,4,0,114
15184,356006,1,17,3,2,0,116
15185,356006,1,17,4,0,0,116
15186,356006,1,17,5,4,0,120
15187,356006,1,17,6,6,0,126
15188,356006,1,18,1,0,0,126
15189,356006,1,18,2,2,0,128
15190,356006,1,18,3,2,0,130
15191,356006,1,18,4,0,1,130
15192,356006,1,18,5,1,0,131
15193,356006,1,18,6,0,0,131
15194,356006,1,19,1,4,0,135
15195,356006,1,19,2,2,0,137
15196,356006,1,19,3,0,0,137
15197,356006,1,19,4,0,0,137
15198,356006,1,19,5,1,0,138
15199,356006,1,19,6,2,0,140
15200,356006,1,20,1,0,1,140
15201,356006,1,20,2,1,0,141
15202,356006,1,20,3,0,1,141
15203,356006,1,20,4,4,0,145
15204,356006,1,20,5,4,0,149
15205,356006,1,20,6,4,0,153
15318,356007,1,1,1,0,0,0
15319,356007,1,1,2,0,0,0
15320,356007,1,1,3,0,0,0
15321,356007,1,1,4,1,0,1
15322,356007,1,1,5,1,0,2
15323,356007,1,1,6,0,0,2
15324,356007,1,2,1,0,0,2
15325,356007,1,2,2,0,0,2
15326,356007,1,2,3,0,0,2
15327,356007,1,2,4,4,0,6
15328,356007,1,2,5,4,0,10
15329,356007,1,2,6,0,0,10
15330,356007,1,3,1,0,0,10
15331,356007,1,3,2,4,0,14
15332,356007,1,3,3,6,0,20
15333,356007,1,3,4,1,0,21
15334,356007,1,3,5,1,0,22
15335,356007,1,3,6,4,0,26
15336,356007,1,4,1,0,0,26
15337,356007,1,4,2,1,0,27
15338,356007,1,4,3,0,0,27
15339,356007,1,4,4,4,0,31
15340,356007,1,4,5,0,0,31
15341,356007,1,4,6,1,0,32
15342,356007,1,5,1,0,0,32
15343,356007,1,5,2,1,0,33
15344,356007,1,5,3,4,0,37
15345,356007,1,5,4,4,0,41
15346,356007,1,5,5,0,0,41
15347,356007,1,5,6,4,0,45
15348,356007,1,6,1,1,0,46
15349,356007,1,6,2,2,0,48
15350,356007,1,6,3,4,0,52
15351,356007,1,6,4,2,0,54
15352,356007,1,6,5,0,1,54
15353,356007,1,6,6,0,0,54
15354,356007,1,7,1,1,0,55
15355,356007,1,7,2,0,0,55
15356,356007,1,7,3,4,0,59
15357,356007,1,7,4,4,0,63
15358,356007,1,7,5,1,0,64
15359,356007,1,7,6,1,0,65
15360,356007,1,8,1,4,0,69
15361,356007,1,8,2,1,0,70
15362,356007,1,8,3,0,0,70
15363,356007,1,8,4,0,0,70
15364,356007,1,8,5,0,0,70
15365,356007,1,8,6,0,0,70
15366,356007,1,9,1,1,0,71
15367,356007,1,9,2,0,0,71
15368,356007,1,9,3,0,0,71
15369,356007,1,9,4,4,0,75
15370,356007,1,9,5,2,0,77
15371,356007,1,9,6,0,0,77
15372,356007,1,10,1,1,0,78
15373,356007,1,10,2,4,0,82
15374,356007,1,10,3,1,0,83
15375,356007,1,10,4,1,0,84
15376,356007,1,10,5,1,0,85
15377,356007,1,10,6,1,0,86
15378,356007,1,11,1,1,0,87
15379,356007,1,11,2,1,0,88
15380,356007,1,11,3,1,0,89
15381,356007,1,11,4,1,0,90
15382,356007,1,11,5,4,0,94
15383,356007,1,11,6,4,0,98
15384,356007,1,12,1,4,0,102
15385,356007,1,12,2,0,0,102
15386,356007,1,12,3,1,0,103
15387,356007,1,12,4,2,0,105
15388,356007,1,12,5,0,1,105
15389,356007,1,12,6,1,0,106
15390,356007,1,13,1,1,0,107
15391,356007,1,13,2,1,0,108
15392,356007,1,13,3,2,0,110
15393,356007,1,13,4,1,0,111
15394,356007,1,13,5,1,0,112
15395,356007,1,13,6,1,0,113
15396,356007,1,14,1,1,0,114
15397,356007,1,14,2,1,0,115
15398,356007,1,14,3,0,0,115
15399,356007,1,14,4,2,0,117
15400,356007,1,14,5,6,0,123
15401,356007,1,14,6,4,0,127
15402,356007,1,15,1,1,0,128
15403,356007,1,15,2,4,0,132
15404,356007,1,15,3,4,0,136
15405,356007,1,15,4,0,1,136
15406,356007,1,15,5,1,0,137
15407,356007,1,15,6,1,0,138
15408,356007,1,16,1,3,0,141
15409,356007,1,16,2,1,0,142
15410,356007,1,16,3,4,0,146
15411,356007,1,16,4,1,0,147
15412,356007,1,16,5,4,0,151
15413,356007,1,16,6,0,0,151
15414,356007,1,17,1,4,0,155
15415,356007,1,17,2,0,1,155
15416,356007,1,17,3,4,0,159
15417,356007,1,17,4,0,0,159
15418,356007,1,17,5,0,0,159
15419,356007,1,17,6,0,1,159
15420,356007,1,18,1,2,0,161
15421,356007,1,18,2,1,0,162
15422,356007,1,18,3,1,0,163
15423,356007,1,18,4,0,1,163
15424,356007,1,18,5,1,0,164
15425,356007,1,18,6,2,0,166
15426,356007,1,19,1,0,0,166
15427,356007,1,19,2,0,1,166
15428,356007,1,19,3,2,0,168
15429,356007,1,19,4,2,0,170
15430,356007,1,19,5,0,0,170
15431,356007,1,19,6,0,0,170
15432,356007,1,20,1,1,0,171
15433,356007,1,20,2,6,0,177
15434,356007,1,20,3,1,0,178
15435,356007,1,20,4,3,0,181
15436,356007,1,20,5,0,0,181
15437,356007,1,20,6,2,0,183
15558,356008,1,1,1,4,0,4
15559,356008,1,1,2,2,0,6
15560,356008,1,1,3,1,0,7
15561,356008,1,1,4,2,0,9
15562,356008,1,1,5,1,0,10
15563,356008,1,1,6,4,0,14
15564,356008,1,2,1,1,0,15
15565,356008,1,2,2,1,0,16
15566,356008,1,2,3,1,0,17
15567,356008,1,2,4,0,1,17
15568,356008,1,2,5,0,0,17
15569,356008,1,2,6,0,0,17
15570,356008,1,3,1,0,0,17
15571,356008,1,3,2,0,0,17
15572,356008,1,3,3,0,0,17
15573,356008,1,3,4,4,0,21
15574,356008,1,3,5,1,0,22
15575,356008,1,3,6,1,0,23
15576,356008,1,4,1,4,0,27
15577,356008,1,4,2,0,0,27
15578,356008,1,4,3,1,0,28
15579,356008,1,4,4,0,0,28
15580,356008,1,4,5,4,0,32
15581,356008,1,4,6,1,0,33
15582,356008,1,5,1,0,0,33
15583,356008,1,5,2,0,1,33
15584,356008,1,5,3,0,0,33
15585,356008,1,5,4,0,0,33
15586,356008,1,5,5,1,0,34
15587,356008,1,5,6,2,0,36
15588,356008,1,6,1,0,0,36
15589,356008,1,6,2,1,0,37
15590,356008,1,6,3,0,1,37
15591,356008,1,6,4,0,0,37
15592,356008,1,6,5,0,0,37
15593,356008,1,6,6,0,0,37
15594,356008,1,7,1,1,0,38
15595,356008,1,7,2,1,0,39
15596,356008,1,7,3,0,0,39
15597,356008,1,7,4,0,0,39
15598,356008,1,7,5,1,0,40
15599,356008,1,7,6,1,0,41
15600,356008,1,8,1,0,0,41
15601,356008,1,8,2,1,0,42
15602,356008,1,8,3,0,0,42
15603,356008,1,8,4,0,0,42
15604,356008,1,8,5,1,0,43
15605,356008,1,8,6,0,0,43
15606,356008,1,9,1,6,0,49
15607,356008,1,9,2,1,0,50
15608,356008,1,9,3,2,0,52
15609,356008,1,9,4,1,0,53
15610,356008,1,9,5,0,0,53
15611,356008,1,9,6,1,0,54
15612,356008,1,10,1,0,0,54
15613,356008,1,10,2,1,0,55
15614,356008,1,10,3,0,1,55
15615,356008,1,10,4,0,0,55
15616,356008,1,10,5,0,0,55
15617,356008,1,10,6,1,0,56
15618,356008,1,11,1,1,0,57
15619,356008,1,11,2,1,0,58
15620,356008,1,11,3,1,0,59
15621,356008,1,11,4,0,0,59
15622,356008,1,11,5,4,0,63
15623,356008,1,11,6,1,0,64
15624,356008,1,12,1,1,0,65
15625,356008,1,12,2,1,0,66
15626,356008,1,12,3,0,0,66
15627,356008,1,12,4,1,0,67
15628,356008,1,12,5,2,0,69
15629,356008,1,12,6,3,0,72
15630,356008,1,13,1,0,0,72
15631,356008,1,13,2,0,0,72
15632,356008,1,13,3,1,1,73
15633,356008,1,13,4,0,1,73
15634,356008,1,13,5,1,0,74
15635,356008,1,13,6,0,0,74
15636,356008,1,14,1,1,0,75
15637,356008,1,14,2,4,0,79
15638,356008,1,14,3,0,0,79
15639,356008,1,14,4,1,0,80
15640,356008,1,14,5,0,0,80
15641,356008,1,14,6,0,0,80
15642,356008,1,15,1,1,0,81
15643,356008,1,15,2,1,0,82
15644,356008,1,15,3,1,0,83
15645,356008,1,15,4,0,0,83
15646,356008,1,15,5,1,0,84
15647,356008,1,15,6,0,0,84
15648,356008,1,16,1,1,0,85
15649,356008,1,16,2,2,0,87
15650,356008,1,16,3,1,0,88
15651,356008,1,16,4,0,1,88
15652,356008,1,16,5,0,0,88
15653,356008,1,16,6,0,0,88
15654,356008,1,17,1,1,0,89
15655,356008,1,17,2,2,0,91
15656,356008,1,17,3,0,0,91
15657,356008,1,17,4,1,0,92
15658,356008,1,17,5,0,0,92
15659,356008,1,17,6,1,0,93
15660,356008,1,18,1,0,0,93
15661,356008,1,18,2,0,0,93
15662,356008,1,18,3,0,1,93
15663,356008,1,18,4,0,1,93
15664,356008,1,18,5,1,0,94
15665,356008,1,18,6,1,0,95
15666,356008,1,19,1,4,0,99
15667,356008,1,19,2,0,0,99
15668,356008,1,19,3,0,1,99
15748,356009,1,1,1,0,0,0
15749,356009,1,1,2,0,1,0
15750,356009,1,1,3,0,0,0
15751,356009,1,1,4,4,0,4
15752,356009,1,1,5,0,0,4
15753,356009,1,1,6,0,0,4
15754,356009,1,2,1,1,0,5
15755,356009,1,2,2,0,0,5
15756,356009,1,2,3,1,0,6
15757,356009,1,2,4,0,0,6
15758,356009,1,2,5,0,0,6
15759,356009,1,2,6,1,0,7
15760,356009,1,3,1,1,0,8
15761,356009,1,3,2,0,0,8
15762,356009,1,3,3,0,0,8
15763,356009,1,3,4,1,0,9
15764,356009,1,3,5,2,0,11
15765,356009,1,3,6,1,0,12
15766,356009,1,4,1,0,0,12
15767,356009,1,4,2,2,0,14
15768,356009,1,4,3,0,1,14
15769,356009,1,4,4,0,0,14
15770,356009,1,4,5,0,0,14
15771,356009,1,4,6,0,0,14
15772,356009,1,5,1,4,0,18
15773,356009,1,5,2,0,0,18
15774,356009,1,5,3,1,0,19
15775,356009,1,5,4,1,0,20
15776,356009,1,5,5,4,0,24
15777,356009,1,5,6,0,0,24
15778,356009,1,6,1,0,0,24
15779,356009,1,6,2,4,0,28
15780,356009,1,6,3,0,0,28
15781,356009,1,6,4,0,0,28
15782,356009,1,6,5,0,0,28
15783,356009,1,6,6,0,0,28
15784,356009,1,7,1,0,0,28
15785,356009,1,7,2,0,0,28
15786,356009,1,7,3,0,0,28
15787,356009,1,7,4,1,0,29
15788,356009,1,7,5,1,0,30
15789,356009,1,7,6,0,0,30
15790,356009,1,8,1,4,0,34
15791,356009,1,8,2,2,0,36
15792,356009,1,8,3,0,0,36
15793,356009,1,8,4,1,0,37
15794,356009,1,8,5,4,0,41
15795,356009,1,8,6,1,0,42
15796,356009,1,9,1,1,0,43
15797,356009,1,9,2,4,0,47
15798,356009,1,9,3,2,0,49
15799,356009,1,9,4,2,0,51
15800,356009,1,9,5,4,0,55
15801,356009,1,9,6,2,0,57
15802,356009,1,10,1,1,0,58
15803,356009,1,10,2,1,0,59
15804,356009,1,10,3,4,0,63
15805,356009,1,10,4,1,0,64
15806,356009,1,10,5,2,0,66
15807,356009,1,10,6,1,0,67
15808,356009,1,11,1,0,0,67
15809,356009,1,11,2,0,0,67
15810,356009,1,11,3,6,0,73
15811,356009,1,11,4,0,0,73
15812,356009,1,11,5,1,0,74
15813,356009,1,11,6,0,0,74
15814,356009,1,12,1,0,0,74
15815,356009,1,12,2,4,0,78
15816,356009,1,12,3,3,0,81
15817,356009,1,12,4,0,1,81
15818,356009,1,12,5,1,0,82
15819,356009,1,12,6,1,0,83
15820,356009,1,13,1,4,0,87
15821,356009,1,13,2,4,0,91
15822,356009,1,13,3,0,0,91
15823,356009,1,13,4,1,0,92
15824,356009,1,13,5,0,0,92
15825,356009,1,13,6,0,0,92
15826,356009,1,14,1,1,0,93
15827,356009,1,14,2,2,0,95
15828,356009,1,14,3,1,0,96
15829,356009,1,14,4,1,0,97
15830,356009,1,14,5,0,1,97
15831,356009,1,14,6,0,0,97
15832,356009,1,15,1,0,0,97
15833,356009,1,15,2,1,0,98
15834,356009,1,15,3,0,0,98
15835,356009,1,15,4,1,0,99
15836,356009,1,15,5,1,0,100
15837,356009,1,15,6,1,0,101
15838,356009,1,16,1,1,0,102
15839,356009,1,16,2,1,0,103
15840,356009,1,16,3,1,0,104
15841,356009,1,16,4,1,0,105
15842,356009,1,16,5,2,0,107
15843,356009,1,16,6,4,0,111
15844,356009,1,17,1,1,0,112
15845,356009,1,17,2,2,0,114
15846,356009,1,17,3,1,0,115
15847,356009,1,17,4,1,0,116
15848,356009,1,17,5,4,0,120
15849,356009,1,17,6,4,0,124
15850,356009,1,18,1,0,0,124
15851,356009,1,18,2,2,0,126
15852,356009,1,18,3,0,1,126
15853,356009,1,18,4,1,0,127
15854,356009,1,18,5,1,0,128
15855,356009,1,18,6,0,1,128
15856,356009,1,19,1,1,0,129
15857,356009,1,19,2,2,0,131
15858,356009,1,19,3,1,0,132
15859,356009,1,19,4,0,1,132
15860,356009,1,19,5,4,0,136
15861,356009,1,19,6,1,0,137
15862,356009,1,20,1,2,0,139
15863,356009,1,20,2,0,1,139
15864,356009,1,20,3,0,0,139
15865,356009,1,20,4,1,0,140
15866,356009,1,20,5,0,1,140
15867,356009,1,20,6,4,0,144
15988,356010,1,1,1,0,0,0
15989,356010,1,1,2,0,0,0
15990,356010,1,1,3,2,0,2
15991,356010,1,1,4,0,0,2
15992,356010,1,1,5,0,0,2
15993,356010,1,1,6,1,0,3
15994,356010,1,2,1,0,0,3
15995,356010,1,2,2,0,0,3
15996,356010,1,2,3,0,0,3
15997,356010,1,2,4,0,1,3
15998,356010,1,2,5,0,0,3
15999,356010,1,2,6,1,0,4
16000,356010,1,3,1,4,0,8
16001,356010,1,3,2,0,0,8
16002,356010,1,3,3,1,0,9
16003,356010,1,3,4,4,0,13
16004,356010,1,3,5,2,0,15
16005,356010,1,3,6,0,0,15
16006,356010,1,4,1,1,0,16
16007,356010,1,4,2,1,0,17
16008,356010,1,4,3,4,0,21
16009,356010,1,4,4,0,0,21
16010,356010,1,4,5,0,0,21
16011,356010,1,4,6,0,0,21
16012,356010,1,5,1,2,0,23
16013,356010,1,5,2,4,0,27
16014,356010,1,5,3,0,0,27
16015,356010,1,5,4,1,0,28
16016,356010,1,5,5,0,0,28
16017,356010,1,5,6,6,0,34
16018,356010,1,6,1,0,0,34
16019,356010,1,6,2,4,0,38
16020,356010,1,6,3,0,0,38
16021,356010,1,6,4,1,0,39
16022,356010,1,6,5,0,0,39
16023,356010,1,6,6,1,0,40
16024,356010,1,7,1,4,0,44
16025,356010,1,7,2,0,0,44
16026,356010,1,7,3,2,0,46
16027,356010,1,7,4,0,0,46
16028,356010,1,7,5,1,0,47
16029,356010,1,7,6,4,0,51
16030,356010,1,8,1,0,0,51
16031,356010,1,8,2,0,0,51
16032,356010,1,8,3,3,0,54
16033,356010,1,8,4,1,0,55
16034,356010,1,8,5,0,0,55
16035,356010,1,8,6,1,0,56
16036,356010,1,9,1,2,0,58
16037,356010,1,9,2,1,0,59
16038,356010,1,9,3,1,0,60
16039,356010,1,9,4,1,0,61
16040,356010,1,9,5,4,0,65
16041,356010,1,9,6,1,0,66
16042,356010,1,10,1,1,0,67
16043,356010,1,10,2,0,0,67
16044,356010,1,10,3,1,0,68
16045,356010,1,10,4,1,0,69
16046,356010,1,10,5,0,0,69
16047,356010,1,10,6,2,0,71
16048,356010,1,11,1,1,0,72
16049,356010,1,11,2,1,0,73
16050,356010,1,11,3,1,0,74
16051,356010,1,11,4,0,0,74
16052,356010,1,11,5,0,1,74
16053,356010,1,11,6,1,0,75
16054,356010,1,12,1,0,0,75
16055,356010,1,12,2,1,0,76
16056,356010,1,12,3,1,0,77
16057,356010,1,12,4,1,0,78
16058,356010,1,12,5,2,0,80
16059,356010,1,12,6,2,0,82
16060,356010,1,13,1,2,0,84
16061,356010,1,13,2,1,0,85
16062,356010,1,13,3,0,0,85
16063,356010,1,13,4,1,0,86
16064,356010,1,13,5,6,0,92
16065,356010,1,13,6,0,1,92
16066,356010,1,14,1,0,0,92
16067,356010,1,14,2,0,0,92
16068,356010,1,14,3,1,0,93
16069,356010,1,14,4,1,0,94
16070,356010,1,14,5,0,0,94
16071,356010,1,14,6,2,0,96
16072,356010,1,15,1,0,0,96
16073,356010,1,15,2,1,0,97
16074,356010,1,15,3,0,0,97
16075,356010,1,15,4,0,0,97
16076,356010,1,15,5,1,0,98
16077,356010,1,15,6,2,0,100
16078,356010,1,16,1,1,0,101
16079,356010,1,16,2,2,0,103
16080,356010,1,16,3,1,0,104
16081,356010,1,16,4,4,0,108
16082,356010,1,16,5,1,0,109
16083,356010,1,16,6,4,0,113
16084,356010,1,17,1,2,0,115
16085,356010,1,17,2,1,0,116
16086,356010,1,17,3,4,0,120
16087,356010,1,17,4,0,0,120
16088,356010,1,17,5,1,0,121
16089,356010,1,17,6,0,0,121
16090,356010,1,18,1,1,0,122
16091,356010,1,18,2,0,1,122
16092,356010,1,18,3,1,0,123
16093,356010,1,18,4,0,0,123
16094,356010,1,18,5,1,0,124
16095,356010,1,18,6,7,0,131
16096,356010,1,19,1,4,0,135
16097,356010,1,19,2,2,0,137
16098,356010,1,19,3,1,1,138
16099,356010,1,19,4,2,0,140
16100,356010,1,19,5,2,0,142
16101,356010,1,19,6,1,0,143
16102,356010,1,20,1,1,0,144
16103,356010,1,20,2,1,0,145
16104,356010,1,20,3,0,1,145
16105,356010,1,20,4,0,1,145
16106,356010,1,20,5,3,0,148
16107,356010,1,20,6,5,0,153
16228,356011,1,1,1,0,0,0
16229,356011,1,1,2,1,0,1
16230,356011,1,1,3,0,0,1
16231,356011,1,1,4,0,0,1
16232,356011,1,1,5,4,0,5
16233,356011,1,1,6,2,0,7
16234,356011,1,2,1,1,0,8
16235,356011,1,2,2,0,0,8
16236,356011,1,2,3,0,1,8
16237,356011,1,2,4,1,0,9
16238,356011,1,2,5,4,0,13
16239,356011,1,2,6,4,0,17
16240,356011,1,3,1,0,0,17
16241,356011,1,3,2,0,0,17
16242,356011,1,3,3,4,0,21
16243,356011,1,3,4,0,0,21
16244,356011,1,3,5,1,0,22
16245,356011,1,3,6,1,0,23
16246,356011,1,4,1,0,0,23
16247,356011,1,4,2,0,0,23
16248,356011,1,4,3,1,0,24
16249,356011,1,4,4,1,0,25
16250,356011,1,4,5,2,0,27
16251,356011,1,4,6,1,0,28
16252,356011,1,5,1,4,0,32
16253,356011,1,5,2,1,0,33
16254,356011,1,5,3,1,0,34
16255,356011,1,5,4,4,0,38
16256,356011,1,5,5,1,0,39
16257,356011,1,5,6,4,0,43
16258,356011,1,6,1,1,0,44
16259,356011,1,6,2,1,0,45
16260,356011,1,6,3,0,0,45
16261,356011,1,6,4,2,0,47
16262,356011,1,6,5,1,0,48
16263,356011,1,6,6,1,0,49
16264,356011,1,7,1,2,0,51
16265,356011,1,7,2,1,0,52
16266,356011,1,7,3,1,0,53
16267,356011,1,7,4,0,0,53
16268,356011,1,7,5,0,0,53
16269,356011,1,7,6,1,0,54
16270,356011,1,8,1,4,0,58
16271,356011,1,8,2,0,0,58
16272,356011,1,8,3,1,0,59
16273,356011,1,8,4,4,0,63
16274,356011,1,8,5,1,1,64
16275,356011,1,8,6,4,0,68
16276,356011,1,9,1,0,0,68
16277,356011,1,9,2,1,0,69
16278,356011,1,9,3,1,0,70
16279,356011,1,9,4,4,0,74
16280,356011,1,9,5,1,0,75
16281,356011,1,9,6,0,0,75
16282,356011,1,10,1,1,0,76
16283,356011,1,10,2,1,0,77
16284,356011,1,10,3,0,0,77
16285,356011,1,10,4,1,0,78
16286,356011,1,10,5,4,0,82
16287,356011,1,10,6,1,0,83
16288,356011,1,11,1,1,0,84
16289,356011,1,11,2,6,0,90
16290,356011,1,11,3,0,0,90
16291,356011,1,11,4,1,0,91
16292,356011,1,11,5,2,0,93
16293,356011,1,11,6,1,0,94
16294,356011,1,12,1,1,0,95
16295,356011,1,12,2,1,0,96
16296,356011,1,12,3,0,0,96
16297,356011,1,12,4,1,0,97
16298,356011,1,12,5,1,0,98
16299,356011,1,12,6,0,1,98
16300,356011,1,13,1,1,0,99
16301,356011,1,13,2,1,0,100
16302,356011,1,13,3,1,0,101
16303,356011,1,13,4,1,0,102
16304,356011,1,13,5,2,0,104
16305,356011,1,13,6,1,0,105
16306,356011,1,14,1,1,0,106
16307,356011,1,14,2,1,0,107
16308,356011,1,14,3,1,0,108
16309,356011,1,14,4,1,0,109
16310,356011,1,14,5,2,0,111
16311,356011,1,14,6,1,0,112
16312,356011,1,15,1,0,0,112
16313,356011,1,15,2,0,0,112
16314,356011,1,15,3,1,0,113
16315,356011,1,15,4,1,0,114
16316,356011,1,15,5,2,0,116
16317,356011,1,15,6,0,0,116
16318,356011,1,16,1,1,0,117
16319,356011,1,16,2,3,0,120
16320,356011,1,16,3,1,0,121
16321,356011,1,16,4,0,1,121
16322,356011,1,16,5,0,0,121
16323,356011,1,16,6,1,0,122
16324,356011,1,17,1,2,0,124
16325,356011,1,17,2,2,0,126
16326,356011,1,17,3,1,0,127
16327,356011,1,17,4,2,0,129
16328,356011,1,17,5,3,0,132
16329,356011,1,17,6,0,1,132
16330,356011,1,18,1,1,0,133
16331,356011,1,18,2,1,0,134
16332,356011,1,18,3,2,0,136
16333,356011,1,18,4,1,0,137
16334,356011,1,18,5,1,0,138
16335,356011,1,18,6,0,0,138
16336,356011,1,19,1,1,0,139
16337,356011,1,19,2,3,0,142
16338,356011,1,19,3,1,0,143
16339,356011,1,19,4,1,0,144
16340,356011,1,19,5,2,0,146
16341,356011,1,19,6,1,0,147
16342,356011,1,20,1,2,0,149
16343,356011,1,20,2,1,0,150
16344,356011,1,20,3,0,1,150
16345,356011,1,20,4,1,0,151
16346,356011,1,20,5,4,0,155
16347,356011,1,20,6,6,0,161
16398,356012,1,1,1,0,0,0
16399,356012,1,1,2,1,0,1
16400,356012,1,1,3,0,0,1
16401,356012,1,1,4,2,0,3
16402,356012,1,1,5,1,0,4
16403,356012,1,1,6,0,0,4
16404,356012,1,2,1,5,0,9
16405,356012,1,2,2,0,0,9
16406,356012,1,2,3,0,0,9
16407,356012,1,2,4,0,0,9
16408,356012,1,2,5,4,0,13
16409,356012,1,2,6,0,0,13
16410,356012,1,3,1,0,0,13
16411,356012,1,3,2,0,0,13
16412,356012,1,3,3,0,0,13
16413,356012,1,3,4,0,0,13
16414,356012,1,3,5,1,0,14
16415,356012,1,3,6,0,0,14
16416,356012,1,4,1,0,0,14
16417,356012,1,4,2,0,0,14
16418,356012,1,4,3,6,0,20
16419,356012,1,4,4,6,0,26
16420,356012,1,4,5,2,0,28
16421,356012,1,4,6,6,0,34
16422,356012,1,5,1,1,0,35
16423,356012,1,5,2,1,0,36
16424,356012,1,5,3,1,0,37
16425,356012,1,5,4,0,0,37
16426,356012,1,5,5,0,0,37
16427,356012,1,5,6,0,0,37
16428,356012,1,6,1,0,0,37
16429,356012,1,6,2,1,0,38
16430,356012,1,6,3,0,0,38
16431,356012,1,6,4,0,1,38
16432,356012,1,6,5,0,0,38
16433,356012,1,6,6,0,0,38
16434,356012,1,7,1,1,0,39
16435,356012,1,7,2,4,0,43
16436,356012,1,7,3,2,0,45
16437,356012,1,7,4,1,0,46
16438,356012,1,7,5,2,0,48
16439,356012,1,7,6,1,0,49
16440,356012,1,8,1,4,0,53
16441,356012,1,8,2,1,0,54
16442,356012,1,8,3,4,0,58
16443,356012,1,8,4,1,0,59
16444,356012,1,8,5,2,0,61
16445,356012,1,8,6,2,0,63
16446,356012,1,9,1,1,0,64
16447,356012,1,9,2,2,0,66
16448,356012,1,9,3,0,0,66
16449,356012,1,9,4,4,0,70
16450,356012,1,9,5,1,0,71
16451,356012,1,9,6,2,0,73
16452,356012,1,10,1,1,0,74
16453,356012,1,10,2,4,0,78
16454,356012,1,10,3,0,1,78
16455,356012,1,10,4,0,0,78
16456,356012,1,10,5,0,0,78
16457,356012,1,10,6,1,0,79
16458,356012,1,11,1,0,0,79
16459,356012,1,11,2,1,0,80
16460,356012,1,11,3,2,0,82
16461,356012,1,11,4,4,0,86
16462,356012,1,11,5,1,0,87
16463,356012,1,11,6,4,0,91
16464,356012,1,12,1,1,0,92
16465,356012,1,12,2,2,0,94
16466,356012,1,12,3,0,0,94
16467,356012,1,12,4,1,0,95
16468,356012,1,12,5,1,0,96
16469,356012,1,12,6,0,0,96
16470,356012,1,13,1,0,0,96
16471,356012,1,13,2,1,0,97
16472,356012,1,13,3,4,0,101
16473,356012,1,13,4,1,0,102
16474,356012,1,13,5,0,1,102
16475,356012,1,13,6,1,0,103
16476,356012,1,14,1,1,0,104
16477,356012,1,14,2,0,0,104
16478,356012,1,14,3,1,0,105
16479,356012,1,14,4,1,0,106
16480,356012,1,14,5,2,0,108
16481,356012,1,14,6,1,0,109
16482,356012,1,15,1,3,0,112
16483,356012,1,15,2,0,0,112
16484,356012,1,15,3,1,0,113
16485,356012,1,15,4,1,0,114
16486,356012,1,15,5,1,0,115
16487,356012,1,15,6,1,0,116
16488,356012,1,16,1,1,0,117
16489,356012,1,16,2,2,0,119
16490,356012,1,16,3,1,0,120
16491,356012,1,16,4,4,0,124
16492,356012,1,16,5,1,0,125
16493,356012,1,16,6,4,0,129
16494,356012,1,17,1,1,0,130
16495,356012,1,17,2,1,0,131
16496,356012,1,17,3,1,0,132
16497,356012,1,17,4,1,0,133
16498,356012,1,17,5,0,1,133
16499,356012,1,17,6,0,0,133
16500,356012,1,18,1,6,0,139
16501,356012,1,18,2,1,0,140
16502,356012,1,18,3,1,0,141
16503,356012,1,18,4,0,1,141
16504,356012,1,18,5,0,0,141
16505,356012,1,18,6,1,0,142
16506,356012,1,19,1,0,0,142
16507,356012,1,19,2,1,0,143
16508,356012,1,19,3,1,0,144
16509,356012,1,19,4,0,0,144
16510,356012,1,19,5,1,0,145
16511,356012,1,19,6,1,0,146
16512,356012,1,20,1,1,0,147
16513,356012,1,20,2,1,0,148
16514,356012,1,20,3,6,0,154
16515,356012,1,20,4,2,0,156
16516,356012,1,20,5,2,0,158
16517,356012,1,20,6,1,0,159
16638,356013,1,1,1,2,0,2
16639,356013,1,1,2,1,0,3
16640,356013,1,1,3,0,1,3
16641,356013,1,1,4,1,0,4
16642,356013,1,1,5,1,0,5
16643,356013,1,1,6,4,0,9
16644,356013,1,2,1,0,0,9
16645,356013,1,2,2,0,0,9
16646,356013,1,2,3,1,0,10
16647,356013,1,2,4,0,0,10
16648,356013,1,2,5,4,0,14
16649,356013,1,2,6,1,0,15
16650,356013,1,3,1,0,0,15
16651,356013,1,3,2,0,0,15
16652,356013,1,3,3,1,0,16
16653,356013,1,3,4,0,0,16
16654,356013,1,3,5,2,0,18
16655,356013,1,3,6,1,0,19
16656,356013,1,4,1,1,0,20
16657,356013,1,4,2,4,0,24
16658,356013,1,4,3,0,0,24
16659,356013,1,4,4,1,0,25
16660,356013,1,4,5,0,1,25
16661,356013,1,4,6,2,0,27
16662,356013,1,5,1,4,0,31
16663,356013,1,5,2,4,0,35
16664,356013,1,5,3,0,0,35
16665,356013,1,5,4,0,0,35
16666,356013,1,5,5,4,0,39
16667,356013,1,5,6,0,0,39
16668,356013,1,6,1,4,0,43
16669,356013,1,6,2,0,0,43
16670,356013,1,6,3,4,0,47
16671,356013,1,6,4,0,0,47
16672,356013,1,6,5,0,0,47
16673,356013,1,6,6,4,0,51
16674,356013,1,7,1,0,0,51
16675,356013,1,7,2,0,0,51
16676,356013,1,7,3,1,0,52
16677,356013,1,7,4,1,0,53
16678,356013,1,7,5,0,0,53
16679,356013,1,7,6,1,0,54
16680,356013,1,8,1,2,0,56
16681,356013,1,8,2,5,0,61
16682,356013,1,8,3,1,0,62
16683,356013,1,8,4,1,0,63
16684,356013,1,8,5,2,0,65
16685,356013,1,8,6,1,0,66
16686,356013,1,9,1,1,0,67
16687,356013,1,9,2,0,0,67
16688,356013,1,9,3,1,0,68
16689,356013,1,9,4,1,0,69
16690,356013,1,9,5,1,0,70
16691,356013,1,9,6,1,0,71
16692,356013,1,10,1,4,0,75
16693,356013,1,10,2,2,0,77
16694,356013,1,10,3,1,0,78
16695,356013,1,10,4,1,0,79
16696,356013,1,10,5,1,0,80
16697,356013,1,10,6,0,0,80
16698,356013,1,11,1,0,0,80
16699,356013,1,11,2,1,0,81
16700,356013,1,11,3,0,0,81
16701,356013,1,11,4,1,0,82
16702,356013,1,11,5,2,0,84
16703,356013,1,11,6,1,0,85
16704,356013,1,12,1,1,0,86
16705,356013,1,12,2,1,0,87
16706,356013,1,12,3,0,1,87
16707,356013,1,12,4,0,0,87
16708,356013,1,12,5,0,0,87
16709,356013,1,12,6,1,0,88
16710,356013,1,13,1,0,0,88
16711,356013,1,13,2,4,0,92
16712,356013,1,13,3,0,0,92
16713,356013,1,13,4,0,0,92
16714,356013,1,13,5,1,0,93
16715,356013,1,13,6,1,0,94
16716,356013,1,14,1,1,0,95
16717,356013,1,14,2,1,0,96
16718,356013,1,14,3,8,0,104
16719,356013,1,14,4,0,0,104
16720,356013,1,14,5,1,0,105
16721,356013,1,14,6,0,0,105
16722,356013,1,15,1,1,0,106
16723,356013,1,15,2,1,0,107
16724,356013,1,15,3,0,0,107
16725,356013,1,15,4,0,0,107
16726,356013,1,15,5,1,0,108
16727,356013,1,15,6,1,0,109
16728,356013,1,16,1,1,0,110
16729,356013,1,16,2,4,0,114
16730,356013,1,16,3,4,0,118
16731,356013,1,16,4,4,0,122
16732,356013,1,16,5,1,0,123
16733,356013,1,16,6,1,0,124
16734,356013,1,17,1,1,0,125
16735,356013,1,17,2,4,0,129
16736,356013,1,17,3,1,0,130
16737,356013,1,17,4,0,0,130
16738,356013,1,17,5,1,0,131
16739,356013,1,17,6,1,0,132
16740,356013,1,18,1,1,0,133
16741,356013,1,18,2,2,0,135
16742,356013,1,18,3,2,0,137
16743,356013,1,18,4,0,1,137
16744,356013,1,18,5,1,0,138
16745,356013,1,18,6,1,0,139
16746,356013,1,19,1,1,0,140
16747,356013,1,19,2,1,0,141
16748,356013,1,19,3,2,0,143
16749,356013,1,19,4,4,0,147
16750,356013,1,19,5,0,1,147
16751,356013,1,19,6,1,0,148
16752,356013,1,20,1,2,0,150
16753,356013,1,20,2,2,0,152
16754,356013,1,20,3,1,0,153
16755,356013,1,20,4,4,0,157
16756,356013,1,20,5,0,0,157
16757,356013,1,20,6,1,0,158
16860,356014,1,1,1,0,0,0
16861,356014,1,1,2,2,0,2
16862,356014,1,1,3,1,0,3
16863,356014,1,1,4,0,0,3
16864,356014,1,1,5,4,0,7
16865,356014,1,1,6,0,0,7
16866,356014,1,2,1,1,0,8
16867,356014,1,2,2,1,0,9
16868,356014,1,2,3,4,0,13
16869,356014,1,2,4,0,1,13
16870,356014,1,2,5,0,0,13
16871,356014,1,2,6,4,0,17
16872,356014,1,3,1,4,0,21
16873,356014,1,3,2,2,0,23
16874,356014,1,3,3,0,0,23
16875,356014,1,3,4,1,0,24
16876,356014,1,3,5,1,0,25
16877,356014,1,3,6,2,0,27
16878,356014,1,4,1,4,0,31
16879,356014,1,4,2,0,0,31
16880,356014,1,4,3,4,0,35
16881,356014,1,4,4,0,0,35
16882,356014,1,4,5,1,0,36
16883,356014,1,4,6,2,0,38
16884,356014,1,5,1,0,0,38
16885,356014,1,5,2,4,0,42
16886,356014,1,5,3,0,0,42
16887,356014,1,5,4,1,0,43
16888,356014,1,5,5,1,0,44
16889,356014,1,5,6,0,0,44
16890,356014,1,6,1,0,0,44
16891,356014,1,6,2,1,0,45
16892,356014,1,6,3,0,0,45
16893,356014,1,6,4,1,0,46
16894,356014,1,6,5,0,0,46
16895,356014,1,6,6,1,0,47
16896,356014,1,7,1,0,0,47
16897,356014,1,7,2,1,0,48
16898,356014,1,7,3,2,0,50
16899,356014,1,7,4,1,0,51
16900,356014,1,7,5,1,0,52
16901,356014,1,7,6,1,0,53
16902,356014,1,8,1,1,0,54
16903,356014,1,8,2,0,0,54
16904,356014,1,8,3,1,0,55
16905,356014,1,8,4,0,0,55
16906,356014,1,8,5,1,0,56
16907,356014,1,8,6,1,0,57
16908,356014,1,9,1,1,0,58
16909,356014,1,9,2,1,0,59
16910,356014,1,9,3,0,1,59
16911,356014,1,9,4,0,0,59
16912,356014,1,9,5,0,0,59
16913,356014,1,9,6,0,0,59
16914,356014,1,10,1,1,0,60
16915,356014,1,10,2,1,0,61
16916,356014,1,10,3,1,0,62
16917,356014,1,10,4,0,0,62
16918,356014,1,10,5,2,0,64
16919,356014,1,10,6,1,0,65
16920,356014,1,11,1,2,0,67
16921,356014,1,11,2,1,0,68
16922,356014,1,11,3,2,0,70
16923,356014,1,11,4,1,0,71
16924,356014,1,11,5,1,0,72
16925,356014,1,11,6,0,0,72
16926,356014,1,12,1,0,0,72
16927,356014,1,12,2,1,0,73
16928,356014,1,12,3,0,0,73
16929,356014,1,12,4,2,0,75
16930,356014,1,12,5,0,0,75
16931,356014,1,12,6,0,0,75
16932,356014,1,13,1,1,0,76
16933,356014,1,13,2,1,0,77
16934,356014,1,13,3,2,0,79
16935,356014,1,13,4,1,0,80
16936,356014,1,13,5,0,0,80
16937,356014,1,13,6,0,0,80
16938,356014,1,14,1,2,0,82
16939,356014,1,14,2,0,0,82
16940,356014,1,14,3,4,0,86
16941,356014,1,14,4,4,0,90
16942,356014,1,14,5,1,0,91
16943,356014,1,14,6,1,0,92
16944,356014,1,15,1,1,0,93
16945,356014,1,15,2,4,0,97
16946,356014,1,15,3,1,0,98
16947,356014,1,15,4,0,1,98
16948,356014,1,15,5,0,0,98
16949,356014,1,15,6,0,0,98
16950,356014,1,16,1,0,0,98
16951,356014,1,16,2,1,0,99
16952,356014,1,16,3,0,0,99
16953,356014,1,16,4,0,0,99
16954,356014,1,16,5,0,0,99
16955,356014,1,16,6,0,0,99
16956,356014,1,17,1,1,0,100
16957,356014,1,17,2,1,0,101
16958,356014,1,17,3,2,0,103
16959,356014,1,17,4,1,0,104
16960,356014,1,17,5,0,0,104
16961,356014,1,17,6,4,0,108
16962,356014,1,18,1,2,0,110
16963,356014,1,18,2,0,1,110
16964,356014,1,18,3,1,0,111
16965,356014,1,18,4,0,0,111
16966,356014,1,18,5,1,0,112
16967,356014,1,18,6,1,0,113
16968,356014,1,19,1,1,0,114
16969,356014,1,19,2,0,0,114
16970,356014,1,19,3,1,0,115
16971,356014,1,19,4,1,0,116
16972,356014,1,19,5,1,0,117
16973,356014,1,19,6,2,0,119
16974,356014,1,20,1,1,0,120
16975,356014,1,20,2,0,1,120
16976,356014,1,20,3,4,0,124
16977,356014,1,20,4,1,0,125
16978,356014,1,20,5,4,0,129
16979,356014,1,20,6,1,0,130
17100,356015,1,1,1,0,0,0
17101,356015,1,1,2,4,0,4
17102,356015,1,1,3,0,0,4
17103,356015,1,1,4,0,0,4
17104,356015,1,1,5,0,0,4
17105,356015,1,1,6,4,0,8
17106,356015,1,2,1,0,0,8
17107,356015,1,2,2,0,1,8
17108,356015,1,2,3,4,0,12
17109,356015,1,2,4,4,0,16
17110,356015,1,2,5,1,0,17
17111,356015,1,2,6,5,0,22
17112,356015,1,3,1,0,0,22
17113,356015,1,3,2,6,0,28
17114,356015,1,3,3,0,1,28
17115,356015,1,3,4,0,0,28
17116,356015,1,3,5,1,0,29
17117,356015,1,3,6,0,0,29
17118,356015,1,4,1,0,0,29
17119,356015,1,4,2,0,0,29
17120,356015,1,4,3,1,0,30
17121,356015,1,4,4,1,0,31
17122,356015,1,4,5,1,0,32
17123,356015,1,4,6,0,0,32
17124,356015,1,5,1,1,0,33
17125,356015,1,5,2,0,0,33
17126,356015,1,5,3,0,0,33
17127,356015,1,5,4,4,0,37
17128,356015,1,5,5,2,0,39
17129,356015,1,5,6,4,0,43
17130,356015,1,6,1,0,0,43
17131,356015,1,6,2,1,0,44
17132,356015,1,6,3,1,0,45
17133,356015,1,6,4,1,0,46
17134,356015,1,6,5,0,0,46
17135,356015,1,6,6,1,0,47
17136,356015,1,7,1,0,0,47
17137,356015,1,7,2,1,0,48
17138,356015,1,7,3,0,0,48
17139,356015,1,7,4,1,0,49
17140,356015,1,7,5,0,0,49
17141,356015,1,7,6,1,0,50
17142,356015,1,8,1,1,0,51
17143,356015,1,8,2,1,0,52
17144,356015,1,8,3,0,0,52
17145,356015,1,8,4,2,0,54
17146,356015,1,8,5,1,0,55
17147,356015,1,8,6,1,0,56
17148,356015,1,9,1,1,0,57
17149,356015,1,9,2,1,0,58
17150,356015,1,9,3,0,0,58
17151,356015,1,9,4,2,0,60
17152,356015,1,9,5,1,0,61
17153,356015,1,9,6,0,0,61
17154,356015,1,10,1,4,0,65
17155,356015,1,10,2,1,0,66
17156,356015,1,10,3,0,0,66
17157,356015,1,10,4,1,0,67
17158,356015,1,10,5,1,0,68
17159,356015,1,10,6,0,0,68
17160,356015,1,11,1,1,0,69
17161,356015,1,11,2,1,0,70
17162,356015,1,11,3,4,0,74
17163,356015,1,11,4,4,0,78
17164,356015,1,11,5,4,0,82
17165,356015,1,11,6,4,0,86
17166,356015,1,12,1,1,0,87
17167,356015,1,12,2,1,0,88
17168,356015,1,12,3,2,0,90
17169,356015,1,12,4,1,0,91
17170,356015,1,12,5,3,0,94
17171,356015,1,12,6,1,0,95
17172,356015,1,13,1,0,1,95
17173,356015,1,13,2,1,0,96
17174,356015,1,13,3,1,0,97
17175,356015,1,13,4,1,0,98
17176,356015,1,13,5,1,0,99
17177,356015,1,13,6,0,0,99
17178,356015,1,14,1,1,0,100
17179,356015,1,14,2,0,0,100
17180,356015,1,14,3,4,0,104
17181,356015,1,14,4,1,0,105
17182,356015,1,14,5,3,0,108
17183,356015,1,14,6,1,0,109
17184,356015,1,15,1,4,0,113
17185,356015,1,15,2,0,0,113
17186,356015,1,15,3,1,0,114
17187,356015,1,15,4,4,0,118
17188,356015,1,15,5,1,0,119
17189,356015,1,15,6,1,0,120
17190,356015,1,16,1,1,0,121
17191,356015,1,16,2,1,0,122
17192,356015,1,16,3,2,0,124
17193,356015,1,16,4,0,1,124
17194,356015,1,16,5,1,0,125
17195,356015,1,16,6,1,0,126
17196,356015,1,17,1,2,0,128
17197,356015,1,17,2,0,0,128
17198,356015,1,17,3,2,0,130
17199,356015,1,17,4,0,0,130
17200,356015,1,17,5,1,0,131
17201,356015,1,17,6,1,0,132
17202,356015,1,18,1,1,0,133
17203,356015,1,18,2,0,0,133
17204,356015,1,18,3,1,0,134
17205,356015,1,18,4,1,0,135
17206,356015,1,18,5,1,0,136
17207,356015,1,18,6,1,0,137
17208,356015,1,19,1,1,0,138
17209,356015,1,19,2,1,0,139
17210,356015,1,19,3,2,0,141
17211,356015,1,19,4,1,0,142
17212,356015,1,19,5,2,0,144
17213,356015,1,19,6,0,0,144
17214,356015,1,20,1,1,0,145
17215,356015,1,20,2,0,0,145
17216,356015,1,20,3,1,0,146
17217,356015,1,20,4,1,0,147
17218,356015,1,20,5,1,0,148
17219,356015,1,20,6,1,0,149
17340,356016,1,1,1,1,0,1
17341,356016,1,1,2,0,0,1
17342,356016,1,1,3,0,0,1
17343,356016,1,1,4,1,0,2
17344,356016,1,1,5,1,0,3
17345,356016,1,1,6,0,0,3
17346,356016,1,2,1,1,0,4
17347,356016,1,2,2,0,0,4
17348,356016,1,2,3,0,0,4
17349,356016,1,2,4,1,0,5
17350,356016,1,2,5,1,0,6
17351,356016,1,2,6,0,0,6
17352,356016,1,3,1,1,0,7
17353,356016,1,3,2,4,0,11
17354,356016,1,3,3,0,0,11
17355,356016,1,3,4,0,0,11
17356,356016,1,3,5,0,0,11
17357,356016,1,3,6,1,0,12
17358,356016,1,4,1,0,0,12
17359,356016,1,4,2,0,0,12
17360,356016,1,4,3,0,0,12
17361,356016,1,4,4,1,0,13
17362,356016,1,4,5,4,0,17
17363,356016,1,4,6,6,0,23
17364,356016,1,5,1,1,0,24
17365,356016,1,5,2,0,0,24
17366,356016,1,5,3,4,0,28
17367,356016,1,5,4,4,0,32
17368,356016,1,5,5,0,0,32
17369,356016,1,5,6,4,0,36
17370,356016,1,6,1,4,0,40
17371,356016,1,6,2,1,0,41
17372,356016,1,6,3,0,0,41
17373,356016,1,6,4,1,0,42
17374,356016,1,6,5,1,0,43
17375,356016,1,6,6,1,0,44
17376,356016,1,7,1,1,0,45
17377,356016,1,7,2,0,0,45
17378,356016,1,7,3,0,0,45
17379,356016,1,7,4,1,0,46
17380,356016,1,7,5,2,0,48
17381,356016,1,7,6,0,0,48
17382,356016,1,8,1,0,0,48
17383,356016,1,8,2,0,0,48
17384,356016,1,8,3,0,0,48
17385,356016,1,8,4,1,0,49
17386,356016,1,8,5,1,0,50
17387,356016,1,8,6,0,0,50
17388,356016,1,9,1,4,0,54
17389,356016,1,9,2,6,0,60
17390,356016,1,9,3,1,0,61
17391,356016,1,9,4,2,0,63
17392,356016,1,9,5,0,0,63
17393,356016,1,9,6,1,0,64
17394,356016,1,10,1,4,0,68
17395,356016,1,10,2,1,0,69
17396,356016,1,10,3,2,0,71
17397,356016,1,10,4,1,0,72
17398,356016,1,10,5,0,0,72
17399,356016,1,10,6,0,0,72
17400,356016,1,11,1,0,0,72
17401,356016,1,11,2,1,0,73
17402,356016,1,11,3,0,1,73
17403,356016,1,11,4,0,0,73
17404,356016,1,11,5,0,1,73
17405,356016,1,11,6,1,0,74
17406,356016,1,12,1,2,0,76
17407,356016,1,12,2,1,0,77
17408,356016,1,12,3,0,1,77
17409,356016,1,12,4,0,0,77
17410,356016,1,12,5,0,0,77
17411,356016,1,12,6,0,0,77
17412,356016,1,13,1,2,0,79
17413,356016,1,13,2,0,0,79
17414,356016,1,13,3,1,0,80
17415,356016,1,13,4,0,0,80
17416,356016,1,13,5,0,0,80
17417,356016,1,13,6,0,0,80
17418,356016,1,14,1,2,0,82
17419,356016,1,14,2,0,0,82
17420,356016,1,14,3,4,0,86
17421,356016,1,14,4,4,0,90
17422,356016,1,14,5,0,0,90
17423,356016,1,14,6,1,0,91
17424,356016,1,15,1,0,0,91
17425,356016,1,15,2,0,0,91
17426,356016,1,15,3,1,0,92
17427,356016,1,15,4,4,0,96
17428,356016,1,15,5,1,0,97
17429,356016,1,15,6,1,0,98
17430,356016,1,16,1,1,0,99
17431,356016,1,16,2,1,0,100
17432,356016,1,16,3,0,0,100
17433,356016,1,16,4,4,0,104
17434,356016,1,16,5,2,0,106
17435,356016,1,16,6,2,0,108
17436,356016,1,17,1,1,0,109
17437,356016,1,17,2,4,0,113
17438,356016,1,17,3,4,0,117
17439,356016,1,17,4,4,0,121
17440,356016,1,17,5,1,0,122
17441,356016,1,17,6,4,0,126
17442,356016,1,18,1,1,0,127
17443,356016,1,18,2,0,1,127
17444,356016,1,18,3,4,0,131
17445,356016,1,18,4,1,0,132
17446,356016,1,18,5,0,0,132
17447,356016,1,18,6,0,0,132
17448,356016,1,19,1,0,0,132
17449,356016,1,19,2,2,0,134
17450,356016,1,19,3,0,1,134
17451,356016,1,19,4,1,0,135
17452,356016,1,19,5,1,0,136
17453,356016,1,19,6,4,0,140
17454,356016,1,20,1,4,0,144
17455,356016,1,20,2,1,0,145
17456,356016,1,20,3,6,0,151
17457,356016,1,20,4,4,0,155
17458,356016,1,20,5,1,0,156
17459,356016,1,20,6,2,0,158
17566,356017,1,1,1,0,0,0
17567,356017,1,1,2,0,0,0
17568,356017,1,1,3,0,0,0
17569,356017,1,1,4,0,0,0
17570,356017,1,1,5,0,1,0
17571,356017,1,1,6,0,0,0
17572,356017,1,2,1,1,0,1
17573,356017,1,2,2,1,0,2
17574,356017,1,2,3,0,1,2
17575,356017,1,2,4,0,0,2
17576,356017,1,2,5,2,0,4
17577,356017,1,2,6,4,0,8
17578,356017,1,3,1,0,0,8
17579,356017,1,3,2,0,0,8
17580,356017,1,3,3,4,0,12
17581,356017,1,3,4,4,0,16
17582,356017,1,3,5,0,0,16
17583,356017,1,3,6,0,0,16
17584,356017,1,4,1,6,0,22
17585,356017,1,4,2,4,0,26
17586,356017,1,4,3,0,0,26
17587,356017,1,4,4,0,0,26
17588,356017,1,4,5,0,1,26
17589,356017,1,4,6,0,0,26
17590,356017,1,5,1,2,0,28
17591,356017,1,5,2,1,0,29
17592,356017,1,5,3,1,0,30
17593,356017,1,5,4,0,0,30
17594,356017,1,5,5,0,0,30
17595,356017,1,5,6,1,0,31
17596,356017,1,6,1,1,0,32
17597,356017,1,6,2,0,0,32
17598,356017,1,6,3,0,1,32
17599,356017,1,6,4,0,0,32
17600,356017,1,6,5,1,0,33
17601,356017,1,6,6,1,0,34
17602,356017,1,7,1,1,0,35
17603,356017,1,7,2,1,0,36
17604,356017,1,7,3,1,0,37
17605,356017,1,7,4,1,0,38
17606,356017,1,7,5,1,0,39
17607,356017,1,7,6,0,0,39
17608,356017,1,8,1,1,0,40
17609,356017,1,8,2,0,0,40
17610,356017,1,8,3,0,0,40
17611,356017,1,8,4,0,0,40
17612,356017,1,8,5,4,0,44
17613,356017,1,8,6,0,0,44
17614,356017,1,9,1,0,0,44
17615,356017,1,9,2,0,0,44
17616,356017,1,9,3,1,0,45
17617,356017,1,9,4,0,0,45
17618,356017,1,9,5,0,0,45
17619,356017,1,9,6,1,0,46
17620,356017,1,10,1,1,0,47
17621,356017,1,10,2,1,0,48
17622,356017,1,10,3,4,0,52
17623,356017,1,10,4,1,0,53
17624,356017,1,10,5,0,0,53
17625,356017,1,10,6,1,0,54
17626,356017,1,11,1,0,0,54
17627,356017,1,11,2,1,0,55
17628,356017,1,11,3,1,0,56
17629,356017,1,11,4,4,0,60
17630,356017,1,11,5,4,0,64
17631,356017,1,11,6,1,0,65
17632,356017,1,12,1,1,0,66
17633,356017,1,12,2,1,0,67
17634,356017,1,12,3,0,1,67
17635,356017,1,12,4,0,0,67
17636,356017,1,12,5,0,0,67
17637,356017,1,12,6,0,0,67
17638,356017,1,13,1,0,0,67
17639,356017,1,13,2,1,0,68
17640,356017,1,13,3,1,0,69
17641,356017,1,13,4,0,0,69
17642,356017,1,13,5,1,0,70
17643,356017,1,13,6,0,1,70
17644,356017,1,14,1,0,0,70
17645,356017,1,14,2,1,0,71
17646,356017,1,14,3,0,0,71
17647,356017,1,14,4,1,0,72
17648,356017,1,14,5,1,0,73
17649,356017,1,14,6,1,0,74
17650,356017,1,15,1,2,0,76
17651,356017,1,15,2,1,0,77
17652,356017,1,15,3,0,0,77
17653,356017,1,15,4,1,0,78
17654,356017,1,15,5,1,0,79
17655,356017,1,15,6,0,0,79
17656,356017,1,16,1,1,0,80
17657,356017,1,16,2,1,0,81
17658,356017,1,16,3,2,0,83
17659,356017,1,16,4,2,0,85
17660,356017,1,16,5,2,0,87
17661,356017,1,16,6,1,0,88
17662,356017,1,17,1,4,0,92
17663,356017,1,17,2,1,0,93
17664,356017,1,17,3,2,0,95
17665,356017,1,17,4,1,0,96
17666,356017,1,17,5,3,0,99
17667,356017,1,17,6,4,0,103
17668,356017,1,18,1,0,0,103
17669,356017,1,18,2,0,0,103
17670,356017,1,18,3,1,0,104
17671,356017,1,18,4,4,0,108
17672,356017,1,18,5,1,0,109
17673,356017,1,18,6,4,0,113
17674,356017,1,19,1,1,0,114
17675,356017,1,19,2,4,0,118
17676,356017,1,19,3,1,0,119
17677,356017,1,19,4,1,0,120
17678,356017,1,19,5,0,0,120
17679,356017,1,19,6,1,0,121
17680,356017,1,20,1,2,0,123
17681,356017,1,20,2,4,0,127
17682,356017,1,20,3,6,0,133
17683,356017,1,20,4,2,0,135
17684,356017,1,20,5,1,0,136
17685,356017,1,20,6,2,0,138
17798,361656,1,1,1,0,0,0
17799,361656,1,1,2,4,0,4
17800,361656,1,1,3,4,0,8
17801,361656,1,1,4,0,1,8
17802,361656,1,1,5,0,0,8
17803,361656,1,1,6,0,0,8
17804,361656,1,2,1,0,0,8
17805,361656,1,2,2,0,0,8
17806,361656,1,2,3,0,0,8
17807,361656,1,2,4,0,0,8
17808,361656,1,2,5,1,0,9
17809,361656,1,2,6,0,0,9
17810,361656,1,3,1,0,0,9
17811,361656,1,3,2,4,0,13
17812,361656,1,3,3,1,0,14
17813,361656,1,3,4,0,0,14
17814,361656,1,3,5,1,0,15
17815,361656,1,3,6,1,0,16
17816,361656,1,4,1,1,0,17
17817,361656,1,4,2,3,0,20
17818,361656,1,4,3,0,0,20
17819,361656,1,4,4,2,0,22
17820,361656,1,4,5,5,0,27
17821,361656,1,4,6,0,0,27
17822,361656,1,5,1,4,0,31
17823,361656,1,5,2,0,0,31
17824,361656,1,5,3,4,0,35
17825,361656,1,5,4,1,0,36
17826,361656,1,5,5,1,0,37
17827,361656,1,5,6,4,0,41
17828,361656,1,6,1,1,0,42
17829,361656,1,6,2,4,0,46
17830,361656,1,6,3,1,0,47
17831,361656,1,6,4,0,0,47
17832,361656,1,6,5,1,0,48
17833,361656,1,6,6,4,0,52
17834,361656,1,7,1,2,0,54
17835,361656,1,7,2,0,0,54
17836,361656,1,7,3,1,0,55
17837,361656,1,7,4,1,0,56
17838,361656,1,7,5,0,0,56
17839,361656,1,7,6,1,0,57
17840,361656,1,8,1,1,0,58
17841,361656,1,8,2,1,0,59
17842,361656,1,8,3,0,1,59
17843,361656,1,8,4,2,0,61
17844,361656,1,8,5,1,0,62
17845,361656,1,8,6,1,0,63
17846,361656,1,9,1,1,0,64
17847,361656,1,9,2,4,0,68
17848,361656,1,9,3,1,0,69
17849,361656,1,9,4,2,0,71
17850,361656,1,9,5,0,0,71
17851,361656,1,9,6,0,0,71
17852,361656,1,10,1,0,0,71
17853,361656,1,10,2,1,0,72
17854,361656,1,10,3,1,0,73
17855,361656,1,10,4,1,0,74
17856,361656,1,10,5,0,0,74
17857,361656,1,10,6,0,0,74
17858,361656,1,11,1,1,0,75
17859,361656,1,11,2,4,0,79
17860,361656,1,11,3,0,0,79
17861,361656,1,11,4,1,0,80
17862,361656,1,11,5,0,1,80
17863,361656,1,11,6,1,0,81
17864,361656,1,12,1,1,0,82
17865,361656,1,12,2,1,0,83
17866,361656,1,12,3,1,0,84
17867,361656,1,12,4,1,0,85
17868,361656,1,12,5,0,0,85
17869,361656,1,12,6,2,0,87
17870,361656,1,13,1,1,0,88
17871,361656,1,13,2,0,0,88
17872,361656,1,13,3,1,0,89
17873,361656,1,13,4,0,0,89
17874,361656,1,13,5,1,0,90
17875,361656,1,13,6,1,0,91
17876,361656,1,14,1,1,0,92
17877,361656,1,14,2,0,0,92
17878,361656,1,14,3,2,0,94
17879,361656,1,14,4,4,0,98
17880,361656,1,14,5,0,0,98
17881,361656,1,14,6,0,0,98
17882,361656,1,15,1,2,0,100
17883,361656,1,15,2,2,0,102
17884,361656,1,15,3,1,0,103
17885,361656,1,15,4,1,0,104
17886,361656,1,15,5,1,0,105
17887,361656,1,15,6,1,0,106
17888,361656,1,16,1,2,0,108
17889,361656,1,16,2,0,1,108
17890,361656,1,16,3,4,0,112
17891,361656,1,16,4,6,0,118
17892,361656,1,16,5,1,0,119
17893,361656,1,16,6,0,0,119
17894,361656,1,17,1,1,0,120
17895,361656,1,17,2,0,0,120
17896,361656,1,17,3,0,1,120
17897,361656,1,17,4,1,0,121
17898,361656,1,17,5,0,1,121
17899,361656,1,17,6,1,0,122
17900,361656,1,18,1,1,0,123
17901,361656,1,18,2,2,0,125
17902,361656,1,18,3,1,0,126
17903,361656,1,18,4,0,0,126
17904,361656,1,18,5,2,0,128
17905,361656,1,18,6,1,0,129
17906,361656,1,19,1,1,0,130
17907,361656,1,19,2,0,0,130
17908,361656,1,19,3,0,1,130
17909,361656,1,19,4,1,0,131
17910,361656,1,19,5,1,0,132
17911,361656,1,19,6,0,1,132
17912,361656,1,20,1,1,0,133
17913,361656,1,20,2,1,0,134
17914,361656,1,20,3,1,0,135
17915,361656,1,20,4,0,0,135
17916,361656,1,20,5,0,1,135
17917,361656,1,20,6,2,0,137
18037,361660,1,1,1,4,0,4
18038,361660,1,1,2,0,0,4
18039,361660,1,1,3,1,0,5
18040,361660,1,1,4,1,0,6
18041,361660,1,1,5,1,0,7
18042,361660,1,1,6,0,0,7
18043,361660,1,2,1,0,0,7
18044,361660,1,2,2,1,0,8
18045,361660,1,2,3,1,0,9
18046,361660,1,2,4,0,1,9
18047,361660,1,2,5,1,0,10
18048,361660,1,2,6,1,0,11
18049,361660,1,3,1,1,0,12
18050,361660,1,3,2,2,0,14
18051,361660,1,3,3,1,0,15
18052,361660,1,3,4,0,0,15
18053,361660,1,3,5,1,0,16
18054,361660,1,3,6,0,0,16
18055,361660,1,4,1,1,0,17
18056,361660,1,4,2,2,0,19
18057,361660,1,4,3,4,0,23
18058,361660,1,4,4,1,0,24
18059,361660,1,4,5,4,0,28
18060,361660,1,4,6,1,0,29
18061,361660,1,5,1,0,0,29
18062,361660,1,5,2,1,0,30
18063,361660,1,5,3,1,0,31
18064,361660,1,5,4,0,0,31
18065,361660,1,5,5,2,0,33
18066,361660,1,5,6,1,0,34
18067,361660,1,6,1,0,1,34
18068,361660,1,6,2,1,0,35
18069,361660,1,6,3,0,0,35
18070,361660,1,6,4,0,0,35
18071,361660,1,6,5,0,0,35
18072,361660,1,6,6,0,0,35
18073,361660,1,7,1,0,0,35
18074,361660,1,7,2,0,1,35
18075,361660,1,7,3,0,0,35
18076,361660,1,7,4,4,0,39
18077,361660,1,7,5,0,0,39
18078,361660,1,7,6,0,0,39
18079,361660,1,8,1,0,0,39
18080,361660,1,8,2,6,0,45
18081,361660,1,8,3,0,0,45
18082,361660,1,8,4,0,0,45
18083,361660,1,8,5,0,0,45
18084,361660,1,8,6,4,0,49
18085,361660,1,9,1,6,0,55
18086,361660,1,9,2,1,0,56
18087,361660,1,9,3,1,0,57
18088,361660,1,9,4,1,0,58
18089,361660,1,9,5,0,0,58
18090,361660,1,9,6,1,0,59
18091,361660,1,10,1,0,0,59
18092,361660,1,10,2,2,0,61
18093,361660,1,10,3,1,0,62
18094,361660,1,10,4,1,0,63
18095,361660,1,10,5,0,0,63
18096,361660,1,10,6,1,0,64
18097,361660,1,11,1,1,0,65
18098,361660,1,11,2,1,0,66
18099,361660,1,11,3,0,0,66
18100,361660,1,11,4,1,0,67
18101,361660,1,11,5,5,0,72
18102,361660,1,11,6,1,0,73
18103,361660,1,12,1,0,0,73
18104,361660,1,12,2,4,0,77
18105,361660,1,12,3,0,0,77
18106,361660,1,12,4,2,0,79
18107,361660,1,12,5,1,0,80
18108,361660,1,12,6,1,0,81
18109,361660,1,13,1,0,1,81
18110,361660,1,13,2,4,0,85
18111,361660,1,13,3,1,0,86
18112,361660,1,13,4,1,0,87
18113,361660,1,13,5,0,0,87
18114,361660,1,13,6,0,0,87
18115,361660,1,14,1,1,0,88
18116,361660,1,14,2,1,0,89
18117,361660,1,14,3,1,0,90
18118,361660,1,14,4,4,0,94
18119,361660,1,14,5,1,0,95
18120,361660,1,14,6,1,0,96
18121,361660,1,15,1,1,0,97
18122,361660,1,15,2,0,0,97
18123,361660,1,15,3,1,0,98
18124,361660,1,15,4,0,0,98
18125,361660,1,15,5,1,0,99
18126,361660,1,15,6,0,0,99
18127,361660,1,16,1,0,0,99
18128,361660,1,16,2,0,1,99
18129,361660,1,16,3,1,0,100
18130,361660,1,16,4,0,0,100
18131,361660,1,16,5,1,0,101
18132,361660,1,16,6,1,0,102
18133,361660,1,17,1,1,0,103
18134,361660,1,17,2,1,0,104
18135,361660,1,17,3,0,0,104
18136,361660,1,17,4,2,0,106
18137,361660,1,17,5,0,0,106
18138,361660,1,17,6,1,0,107
18139,361660,1,18,1,1,0,108
18140,361660,1,18,2,1,1,109
18141,361660,1,18,3,1,0,110
18142,361660,1,18,4,0,0,110
18143,361660,1,18,5,1,0,111
18144,361660,1,18,6,1,0,112
18145,361660,1,19,1,2,0,114
18146,361660,1,19,2,1,0,115
18147,361660,1,19,3,5,0,120
18148,361660,1,19,4,1,0,121
18149,361660,1,19,5,1,0,122
18150,361660,1,19,6,1,0,123
18151,361660,1,20,1,0,0,123
18152,361660,1,20,2,1,0,124
18153,361660,1,20,3,4,0,128
18154,361660,1,20,4,2,0,130
18155,361660,1,20,5,0,1,130
18156,361660,1,20,6,2,0,132
18271,366622,1,1,1,1,0,1
18272,366622,1,1,2,0,0,1
18273,366622,1,1,3,0,0,1
18274,366622,1,1,4,0,0,1
18275,366622,1,1,5,0,0,1
18276,366622,1,1,6,1,0,2
18277,366622,1,2,1,1,0,3
18278,366622,1,2,2,2,0,5
18279,366622,1,2,3,4,0,9
18280,366622,1,2,4,0,0,9
18281,366622,1,2,5,4,0,13
18282,366622,1,2,6,1,0,14
18283,366622,1,3,1,1,0,15
18284,366622,1,3,2,1,0,16
18285,366622,1,3,3,4,0,20
18286,366622,1,3,4,0,0,20
18287,366622,1,3,5,4,0,24
18288,366622,1,3,6,4,0,28
18289,366622,1,4,1,0,0,28
18290,366622,1,4,2,1,0,29
18291,366622,1,4,3,0,1,29
18292,366622,1,4,4,0,0,29
18293,366622,1,4,5,0,0,29
18294,366622,1,4,6,0,0,29
18295,366622,1,5,1,6,0,35
18296,366622,1,5,2,1,0,36
18297,366622,1,5,3,0,1,36
18298,366622,1,5,4,0,0,36
18299,366622,1,5,5,0,0,36
18300,366622,1,5,6,1,0,37
18301,366622,1,6,1,0,0,37
18302,366622,1,6,2,4,0,41
18303,366622,1,6,3,0,0,41
18304,366622,1,6,4,0,0,41
18305,366622,1,6,5,4,0,45
18306,366622,1,6,6,2,0,47
18307,366622,1,7,1,0,1,47
18308,366622,1,7,2,1,0,48
18309,366622,1,7,3,0,0,48
18310,366622,1,7,4,6,0,54
18311,366622,1,7,5,0,0,54
18312,366622,1,7,6,1,0,55
18313,366622,1,8,1,1,0,56
18314,366622,1,8,2,1,0,57
18315,366622,1,8,3,0,0,57
18316,366622,1,8,4,0,0,57
18317,366622,1,8,5,1,0,58
18318,366622,1,8,6,1,0,59
18319,366622,1,9,1,0,0,59
18320,366622,1,9,2,1,0,60
18321,366622,1,9,3,1,0,61
18322,366622,1,9,4,0,0,61
18323,366622,1,9,5,0,0,61
18324,366622,1,9,6,0,0,61
18325,366622,1,10,1,0,0,61
18326,366622,1,10,2,1,0,62
18327,366622,1,10,3,0,0,62
18328,366622,1,10,4,0,0,62
18329,366622,1,10,5,1,0,63
18330,366622,1,10,6,1,0,64
18331,366622,1,11,1,2,0,66
18332,366622,1,11,2,0,0,66
18333,366622,1,11,3,4,0,70
18334,366622,1,11,4,1,0,71
18335,366622,1,11,5,1,0,72
18336,366622,1,11,6,1,0,73
18337,366622,1,12,1,0,0,73
18338,366622,1,12,2,6,0,79
18339,366622,1,12,3,6,0,85
18340,366622,1,12,4,1,0,86
18341,366622,1,12,5,0,0,86
18342,366622,1,12,6,0,0,86
18343,366622,1,13,1,0,0,86
18344,366622,1,13,2,6,0,92
18345,366622,1,13,3,0,0,92
18346,366622,1,13,4,0,1,92
18347,366622,1,13,5,1,0,93
18348,366622,1,13,6,0,0,93
18349,366622,1,14,1,1,0,94
18350,366622,1,14,2,0,1,94
18351,366622,1,14,3,0,0,94
18352,366622,1,14,4,0,0,94
18353,366622,1,14,5,1,0,95
18354,366622,1,14,6,0,0,95
18355,366622,1,15,1,0,0,95
18356,366622,1,15,2,0,0,95
18357,366622,1,15,3,1,0,96
18358,366622,1,15,4,1,0,97
18359,366622,1,15,5,0,0,97
18360,366622,1,15,6,1,0,98
18361,366622,1,16,1,0,0,98
18362,366622,1,16,2,2,0,100
18363,366622,1,16,3,2,0,102
18364,366622,1,16,4,1,0,103
18365,366622,1,16,5,4,0,107
18366,366622,1,16,6,2,0,109
18367,366622,1,17,1,6,0,115
18368,366622,1,17,2,1,0,116
18369,366622,1,17,3,1,0,117
18370,366622,1,17,4,4,0,121
18371,366622,1,17,5,0,1,121
18372,366622,1,17,6,1,0,122
18373,366622,1,18,1,1,0,123
18374,366622,1,18,2,0,0,123
18375,366622,1,18,3,1,0,124
18376,366622,1,18,4,1,0,125
18377,366622,1,18,5,0,0,125
18378,366622,1,18,6,1,0,126
18379,366622,1,19,1,1,0,127
18380,366622,1,19,2,1,0,128
18381,366622,1,19,3,2,0,130
18382,366622,1,19,4,1,0,131
18383,366622,1,19,5,2,0,133
18384,366622,1,19,6,0,0,133
18385,366622,1,20,1,1,0,134
18386,366622,1,20,2,2,0,136
18387,366622,1,20,3,4,0,140
18388,366622,1,20,4,1,0,141
18389,366622,1,20,5,2,0,143
18390,366622,1,20,6,6,0,149
18511,366708,1,1,1,0,0,0
18512,366708,1,1,2,0,0,0
18513,366708,1,1,3,1,0,1
18514,366708,1,1,4,0,0,1
18515,366708,1,1,5,4,0,5
18516,366708,1,1,6,4,0,9
18517,366708,1,2,1,0,0,9
18518,366708,1,2,2,4,0,13
18519,366708,1,2,3,1,0,14
18520,366708,1,2,4,1,0,15
18521,366708,1,2,5,1,0,16
18522,366708,1,2,6,0,0,16
18523,366708,1,3,1,0,0,16
18524,366708,1,3,2,0,0,16
18525,366708,1,3,3,1,0,17
18526,366708,1,3,4,0,0,17
18527,366708,1,3,5,0,0,17
18528,366708,1,3,6,4,0,21
18529,366708,1,4,1,4,0,25
18530,366708,1,4,2,4,0,29
18531,366708,1,4,3,0,0,29
18532,366708,1,4,4,1,0,30
18533,366708,1,4,5,6,0,36
18534,366708,1,4,6,0,0,36
18535,366708,1,5,1,1,0,37
18536,366708,1,5,2,1,0,38
18537,366708,1,5,3,6,0,44
18538,366708,1,5,4,0,0,44
18539,366708,1,5,5,4,0,48
18540,366708,1,5,6,1,0,49
18541,366708,1,6,1,1,0,50
18542,366708,1,6,2,0,0,50
18543,366708,1,6,3,1,0,51
18544,366708,1,6,4,4,0,55
18545,366708,1,6,5,1,0,56
18546,366708,1,6,6,0,0,56
18547,366708,1,7,1,0,0,56
18548,366708,1,7,2,1,0,57
18549,366708,1,7,3,1,0,58
18550,366708,1,7,4,0,0,58
18551,366708,1,7,5,0,0,58
18552,366708,1,7,6,0,0,58
18553,366708,1,8,1,6,0,64
18554,366708,1,8,2,0,0,64
18555,366708,1,8,3,4,0,68
18556,366708,1,8,4,1,0,69
18557,366708,1,8,5,6,0,75
18558,366708,1,8,6,7,0,82
18559,366708,1,9,1,2,0,84
18560,366708,1,9,2,4,0,88
18561,366708,1,9,3,0,0,88
18562,366708,1,9,4,4,0,92
18563,366708,1,9,5,0,0,92
18564,366708,1,9,6,4,0,96
18565,366708,1,10,1,1,0,97
18566,366708,1,10,2,4,0,101
18567,366708,1,10,3,3,0,104
18568,366708,1,10,4,0,0,104
18569,366708,1,10,5,1,0,105
18570,366708,1,10,6,1,0,106
18571,366708,1,11,1,0,0,106
18572,366708,1,11,2,4,0,110
18573,366708,1,11,3,6,0,116
18574,366708,1,11,4,4,0,120
18575,366708,1,11,5,1,0,121
18576,366708,1,11,6,1,0,122
18577,366708,1,12,1,6,0,128
18578,366708,1,12,2,1,0,129
18579,366708,1,12,3,1,0,130
18580,366708,1,12,4,0,1,130
18581,366708,1,12,5,1,0,131
18582,366708,1,12,6,0,0,131
18583,366708,1,13,1,5,0,136
18584,366708,1,13,2,2,0,138
18585,366708,1,13,3,1,0,139
18586,366708,1,13,4,0,1,139
18587,366708,1,13,5,2,0,141
18588,366708,1,13,6,1,0,142
18589,366708,1,14,1,0,1,142
18590,366708,1,14,2,1,0,143
18591,366708,1,14,3,2,0,145
18592,366708,1,14,4,0,0,145
18593,366708,1,14,5,0,0,145
18594,366708,1,14,6,1,0,146
18595,366708,1,15,1,1,0,147
18596,366708,1,15,2,1,0,148
18597,366708,1,15,3,1,0,149
18598,366708,1,15,4,1,0,150
18599,366708,1,15,5,2,0,152
18600,366708,1,15,6,0,1,152
18601,366708,1,16,1,4,0,156
18602,366708,1,16,2,1,0,157
18603,366708,1,16,3,1,0,158
18604,366708,1,16,4,1,0,159
18605,366708,1,16,5,1,0,160
18606,366708,1,16,6,0,0,160
18607,366708,1,17,1,0,0,160
18608,366708,1,17,2,1,1,161
18609,366708,1,17,3,0,0,161
18610,366708,1,17,4,1,0,162
18611,366708,1,17,5,1,0,163
18612,366708,1,17,6,1,0,164
18613,366708,1,18,1,0,1,164
18614,366708,1,18,2,1,0,165
18615,366708,1,18,3,0,0,165
18616,366708,1,18,4,1,0,166
18617,366708,1,18,5,0,0,166
18618,366708,1,18,6,1,0,167
18619,366708,1,19,1,1,0,168
18620,366708,1,19,2,6,0,174
18621,366708,1,19,3,4,0,178
18622,366708,1,19,4,6,0,184
18623,366708,1,19,5,0,1,184
18624,366708,1,19,6,1,0,185
18625,366708,1,20,1,3,0,188
18626,366708,1,20,2,1,0,189
18627,366708,1,20,3,0,1,189
18628,366708,1,20,4,0,0,189
18629,366708,1,20,5,2,0,191
18630,366708,1,20,6,0,1,191
18751,386494,1,1,1,0,0,0
18752,386494,1,1,2,0,0,0
18753,386494,1,1,3,1,0,1
18754,386494,1,1,4,6,0,7
18755,386494,1,1,5,6,0,13
18756,386494,1,1,6,6,0,19
18757,386494,1,2,1,0,0,19
18758,386494,1,2,2,1,0,20
18759,386494,1,2,3,0,0,20
18760,386494,1,2,4,1,0,21
18761,386494,1,2,5,4,0,25
18762,386494,1,2,6,0,1,25
18763,386494,1,3,1,0,0,25
18764,386494,1,3,2,6,0,31
18765,386494,1,3,3,0,0,31
18766,386494,1,3,4,1,0,32
18767,386494,1,3,5,0,0,32
18768,386494,1,3,6,0,0,32
18769,386494,1,4,1,0,1,32
18770,386494,1,4,2,1,0,33
18771,386494,1,4,3,0,0,33
18772,386494,1,4,4,6,0,39
18773,386494,1,4,5,1,0,40
18774,386494,1,4,6,0,0,40
18775,386494,1,5,1,0,0,40
18776,386494,1,5,2,1,0,41
18777,386494,1,5,3,0,0,41
18778,386494,1,5,4,0,0,41
18779,386494,1,5,5,1,0,42
18780,386494,1,5,6,6,0,48
18781,386494,1,6,1,6,0,54
18782,386494,1,6,2,0,1,54
18783,386494,1,6,3,0,0,54
18784,386494,1,6,4,0,0,54
18785,386494,1,6,5,1,0,55
18786,386494,1,6,6,1,0,56
18787,386494,1,7,1,0,0,56
18788,386494,1,7,2,0,1,56
18789,386494,1,7,3,1,0,57
18790,386494,1,7,4,1,0,58
18791,386494,1,7,5,0,0,58
18792,386494,1,7,6,0,0,58
18793,386494,1,8,1,1,0,59
18794,386494,1,8,2,0,0,59
18795,386494,1,8,3,1,0,60
18796,386494,1,8,4,1,0,61
18797,386494,1,8,5,0,1,61
18798,386494,1,8,6,1,0,62
18799,386494,1,9,1,0,0,62
18800,386494,1,9,2,0,0,62
18801,386494,1,9,3,1,0,63
18802,386494,1,9,4,0,0,63
18803,386494,1,9,5,1,0,64
18804,386494,1,9,6,0,0,64
18805,386494,1,10,1,6,0,70
18806,386494,1,10,2,6,0,76
18807,386494,1,10,3,6,0,82
18808,386494,1,10,4,0,1,82
18809,386494,1,10,5,0,0,82
18810,386494,1,10,6,1,0,83
18811,386494,1,11,1,0,0,83
18812,386494,1,11,2,1,0,84
18813,386494,1,11,3,1,0,85
18814,386494,1,11,4,0,0,85
18815,386494,1,11,5,1,0,86
18816,386494,1,11,6,1,0,87
18817,386494,1,12,1,1,0,88
18818,386494,1,12,2,1,0,89
18819,386494,1,12,3,1,0,90
18820,386494,1,12,4,1,0,91
18821,386494,1,12,5,0,0,91
18822,386494,1,12,6,1,0,92
18823,386494,1,13,1,4,0,96
18824,386494,1,13,2,1,0,97
18825,386494,1,13,3,0,0,97
18826,386494,1,13,4,1,0,98
18827,386494,1,13,5,1,0,99
18828,386494,1,13,6,1,0,100
18829,386494,1,14,1,0,0,100
18830,386494,1,14,2,1,0,101
18831,386494,1,14,3,0,1,101
18832,386494,1,14,4,0,0,101
18833,386494,1,14,5,0,0,101
18834,386494,1,14,6,1,0,102
18835,386494,1,15,1,1,0,103
18836,386494,1,15,2,6,0,109
18837,386494,1,15,3,1,0,110
18838,386494,1,15,4,0,0,110
18839,386494,1,15,5,1,0,111
18840,386494,1,15,6,1,0,112
18841,386494,1,16,1,2,0,114
18842,386494,1,16,2,1,0,115
18843,386494,1,16,3,0,0,115
18844,386494,1,16,4,0,0,115
18845,386494,1,16,5,1,0,116
18846,386494,1,16,6,1,0,117
18847,386494,1,17,1,1,0,118
18848,386494,1,17,2,1,0,119
18849,386494,1,17,3,1,0,120
18850,386494,1,17,4,2,0,122
18851,386494,1,17,5,1,0,123
18852,386494,1,17,6,5,0,128
18853,386494,1,18,1,0,0,128
18854,386494,1,18,2,2,0,130
18855,386494,1,18,3,1,0,131
18856,386494,1,18,4,1,0,132
18857,386494,1,18,5,0,0,132
18858,386494,1,18,6,1,0,133
18859,386494,1,19,1,1,0,134
18860,386494,1,19,2,6,0,140
18861,386494,1,19,3,6,0,146
18862,386494,1,19,4,0,0,146
18863,386494,1,19,5,4,0,150
18864,386494,1,19,6,1,0,151
18865,386494,1,20,1,1,0,152
18866,386494,1,20,2,1,0,153
18867,386494,1,20,3,1,0,154
18868,386494,1,20,4,4,0,158
18869,386494,1,20,5,4,0,162
18870,386494,1,20,6,0,1,162
18984,386535,1,1,1,0,0,0
18985,386535,1,1,2,0,0,0
18986,386535,1,1,3,0,0,0
18987,386535,1,1,4,1,0,1
18988,386535,1,1,5,1,0,2
18989,386535,1,1,6,1,0,3
18990,386535,1,2,1,0,0,3
18991,386535,1,2,2,0,0,3
18992,386535,1,2,3,4,0,7
18993,386535,1,2,4,1,0,8
18994,386535,1,2,5,2,0,10
18995,386535,1,2,6,1,0,11
18996,386535,1,3,1,4,0,15
18997,386535,1,3,2,1,0,16
18998,386535,1,3,3,4,0,20
18999,386535,1,3,4,0,0,20
19000,386535,1,3,5,0,0,20
19001,386535,1,3,6,0,0,20
19002,386535,1,4,1,1,0,21
19003,386535,1,4,2,4,0,25
19004,386535,1,4,3,6,0,31
19005,386535,1,4,4,0,0,31
19006,386535,1,4,5,6,0,37
19007,386535,1,4,6,1,0,38
19008,386535,1,5,1,2,0,40
19009,386535,1,5,2,4,0,44
19010,386535,1,5,3,1,0,45
19011,386535,1,5,4,4,0,49
19012,386535,1,5,5,4,0,53
19013,386535,1,5,6,0,0,53
19014,386535,1,6,1,1,0,54
19015,386535,1,6,2,2,0,56
19016,386535,1,6,3,1,0,57
19017,386535,1,6,4,2,0,59
19018,386535,1,6,5,0,1,59
19019,386535,1,6,6,0,0,59
19020,386535,1,7,1,1,0,60
19021,386535,1,7,2,1,0,61
19022,386535,1,7,3,1,0,62
19023,386535,1,7,4,0,0,62
19024,386535,1,7,5,0,0,62
19025,386535,1,7,6,1,0,63
19026,386535,1,8,1,1,0,64
19027,386535,1,8,2,0,0,64
19028,386535,1,8,3,1,0,65
19029,386535,1,8,4,0,0,65
19030,386535,1,8,5,0,0,65
19031,386535,1,8,6,1,0,66
19032,386535,1,9,1,0,0,66
19033,386535,1,9,2,2,0,68
19034,386535,1,9,3,4,0,72
19035,386535,1,9,4,1,0,73
19036,386535,1,9,5,1,0,74
19037,386535,1,9,6,0,0,74
19038,386535,1,10,1,1,0,75
19039,386535,1,10,2,1,0,76
19040,386535,1,10,3,1,0,77
19041,386535,1,10,4,0,0,77
19042,386535,1,10,5,1,0,78
19043,386535,1,10,6,1,0,79
19044,386535,1,11,1,0,0,79
19045,386535,1,11,2,1,0,80
19046,386535,1,11,3,1,0,81
19047,386535,1,11,4,0,0,81
19048,386535,1,11,5,4,0,85
19049,386535,1,11,6,1,0,86
19050,386535,1,12,1,1,0,87
19051,386535,1,12,2,0,1,87
19052,386535,1,12,3,0,0,87
19053,386535,1,12,4,0,0,87
19054,386535,1,12,5,1,0,88
19055,386535,1,12,6,1,0,89
19056,386535,1,13,1,1,0,90
19057,386535,1,13,2,2,0,92
19058,386535,1,13,3,4,0,96
19059,386535,1,13,4,1,0,97
19060,386535,1,13,5,1,0,98
19061,386535,1,13,6,4,0,102
19062,386535,1,14,1,1,0,103
19063,386535,1,14,2,4,0,107
19064,386535,1,14,3,0,1,107
19065,386535,1,14,4,1,0,108
19066,386535,1,14,5,1,0,109
19067,386535,1,14,6,4,0,113
19068,386535,1,15,1,4,0,117
19069,386535,1,15,2,2,0,119
19070,386535,1,15,3,1,0,120
19071,386535,1,15,4,0,0,120
19072,386535,1,15,5,0,0,120
19073,386535,1,15,6,1,0,121
19074,386535,1,16,1,0,0,121
19075,386535,1,16,2,1,0,122
19076,386535,1,16,3,2,0,124
19077,386535,1,16,4,6,0,130
19078,386535,1,16,5,0,0,130
19079,386535,1,16,6,5,0,135
19080,386535,1,17,1,2,0,137
19081,386535,1,17,2,1,0,138
19082,386535,1,17,3,4,0,142
19083,386535,1,17,4,4,0,146
19084,386535,1,17,5,6,0,152
19085,386535,1,17,6,0,1,152
19086,386535,1,18,1,1,0,153
19087,386535,1,18,2,4,0,157
19088,386535,1,18,3,1,0,158
19089,386535,1,18,4,0,0,158
19090,386535,1,18,5,2,0,160
19091,386535,1,18,6,0,0,160
19092,386535,1,19,1,1,0,161
19093,386535,1,19,2,4,0,165
19094,386535,1,19,3,0,0,165
19095,386535,1,19,4,1,0,166
19096,386535,1,19,5,2,0,168
19097,386535,1,19,6,0,0,168
19098,386535,1,20,1,1,0,169
19099,386535,1,20,2,1,0,170
19100,386535,1,20,3,0,0,170
19101,386535,1,20,4,1,0,171
19102,386535,1,20,5,0,0,171
19103,386535,1,20,6,0,0,171
19220,387563,1,1,1,0,1,0
19221,387563,1,1,2,1,0,1
19222,387563,1,1,3,0,0,1
19223,387563,1,1,4,1,0,2
19224,387563,1,1,5,0,0,2
19225,387563,1,1,6,0,0,2
19226,387563,1,2,1,0,0,2
19227,387563,1,2,2,1,0,3
19228,387563,1,2,3,1,0,4
19229,387563,1,2,4,5,0,9
19230,387563,1,2,5,0,0,9
19231,387563,1,2,6,0,0,9
19232,387563,1,3,1,0,0,9
19233,387563,1,3,2,4,0,13
19234,387563,1,3,3,0,0,13
19235,387563,1,3,4,3,0,16
19236,387563,1,3,5,3,0,19
19237,387563,1,3,6,1,0,20
19238,387563,1,4,1,1,0,21
19239,387563,1,4,2,3,0,24
19240,387563,1,4,3,1,0,25
19241,387563,1,4,4,0,1,25
19242,387563,1,4,5,0,0,25
19243,387563,1,4,6,2,0,27
19244,387563,1,5,1,0,0,27
19245,387563,1,5,2,2,0,29
19246,387563,1,5,3,4,0,33
19247,387563,1,5,4,4,0,37
19248,387563,1,5,5,4,0,41
19249,387563,1,5,6,4,0,45
19250,387563,1,6,1,1,0,46
19251,387563,1,6,2,0,0,46
19252,387563,1,6,3,1,0,47
19253,387563,1,6,4,6,0,53
19254,387563,1,6,5,1,0,54
19255,387563,1,6,6,2,0,56
19256,387563,1,7,1,2,0,58
19257,387563,1,7,2,1,0,59
19258,387563,1,7,3,0,0,59
19259,387563,1,7,4,1,0,60
19260,387563,1,7,5,1,0,61
19261,387563,1,7,6,0,1,61
19262,387563,1,8,1,1,0,62
19263,387563,1,8,2,0,0,62
19264,387563,1,8,3,1,0,63
19265,387563,1,8,4,1,0,64
19266,387563,1,8,5,0,0,64
19267,387563,1,8,6,2,0,66
19268,387563,1,9,1,1,0,67
19269,387563,1,9,2,2,0,69
19270,387563,1,9,3,4,0,73
19271,387563,1,9,4,0,0,73
19272,387563,1,9,5,2,0,75
19273,387563,1,9,6,0,0,75
19274,387563,1,10,1,1,0,76
19275,387563,1,10,2,1,0,77
19276,387563,1,10,3,0,0,77
19277,387563,1,10,4,6,0,83
19278,387563,1,10,5,0,0,83
19279,387563,1,10,6,4,0,87
19280,387563,1,11,1,0,0,87
19281,387563,1,11,2,1,0,88
19282,387563,1,11,3,5,0,93
19283,387563,1,11,4,1,0,94
19284,387563,1,11,5,2,0,96
19285,387563,1,11,6,1,0,97
19286,387563,1,12,1,4,0,101
19287,387563,1,12,2,1,0,102
19288,387563,1,12,3,1,0,103
19289,387563,1,12,4,6,0,109
19290,387563,1,12,5,2,0,111
19291,387563,1,12,6,0,0,111
19292,387563,1,13,1,1,0,112
19293,387563,1,13,2,1,0,113
19294,387563,1,13,3,1,0,114
19295,387563,1,13,4,0,0,114
19296,387563,1,13,5,4,0,118
19297,387563,1,13,6,1,0,119
19298,387563,1,14,1,0,0,119
19299,387563,1,14,2,4,0,123
19300,387563,1,14,3,6,0,129
19301,387563,1,14,4,4,0,133
19302,387563,1,14,5,1,0,134
19303,387563,1,14,6,6,0,140
19304,387563,1,15,1,1,0,141
19305,387563,1,15,2,2,0,143
19306,387563,1,15,3,4,0,147
19307,387563,1,15,4,1,0,148
19308,387563,1,15,5,0,0,148
19309,387563,1,15,6,1,0,149
19310,387563,1,16,1,1,0,150
19311,387563,1,16,2,0,0,150
19312,387563,1,16,3,6,0,156
19313,387563,1,16,4,1,0,157
19314,387563,1,16,5,1,0,158
19315,387563,1,16,6,1,0,159
19316,387563,1,17,1,0,1,159
19317,387563,1,17,2,1,0,160
19318,387563,1,17,3,0,0,160
19319,387563,1,17,4,1,0,161
19320,387563,1,17,5,1,0,162
19321,387563,1,17,6,1,0,163
19322,387563,1,18,1,1,0,164
19323,387563,1,18,2,2,0,166
19324,387563,1,18,3,1,0,167
19325,387563,1,18,4,0,1,167
19326,387563,1,18,5,0,0,167
19327,387563,1,18,6,1,0,168
19328,387563,1,19,1,1,0,169
19329,387563,1,19,2,0,1,169
19330,387563,1,19,3,1,0,170
19331,387563,1,19,4,4,0,174
19332,387563,1,19,5,7,0,181
19333,387563,1,19,6,4,0,185
19334,387563,1,20,1,1,0,186
19335,387563,1,20,2,1,0,187
19336,387563,1,20,3,1,0,188
19337,387563,1,20,4,6,0,194
19338,387563,1,20,5,6,0,200
19339,387563,1,20,6,2,0,202
19418,387564,1,1,1,0,0,0
19419,387564,1,1,2,0,0,0
19420,387564,1,1,3,2,0,2
19421,387564,1,1,4,0,0,2
19422,387564,1,1,5,0,0,2
19423,387564,1,1,6,0,0,2
19424,387564,1,2,1,4,0,6
19425,387564,1,2,2,0,0,6
19426,387564,1,2,3,1,0,7
19427,387564,1,2,4,0,0,7
19428,387564,1,2,5,0,0,7
19429,387564,1,2,6,1,0,8
19430,387564,1,3,1,4,0,12
19431,387564,1,3,2,0,0,12
19432,387564,1,3,3,1,0,13
19433,387564,1,3,4,0,0,13
19434,387564,1,3,5,1,0,14
19435,387564,1,3,6,0,0,14
19436,387564,1,4,1,4,0,18
19437,387564,1,4,2,4,0,22
19438,387564,1,4,3,5,0,27
19439,387564,1,4,4,0,0,27
19440,387564,1,4,5,1,0,28
19441,387564,1,4,6,7,0,35
19442,387564,1,5,1,0,0,35
19443,387564,1,5,2,4,0,39
19444,387564,1,5,3,4,0,43
19445,387564,1,5,4,1,0,44
19446,387564,1,5,5,6,0,50
19447,387564,1,5,6,1,0,51
19448,387564,1,6,1,6,0,57
19449,387564,1,6,2,1,0,58
19450,387564,1,6,3,6,0,64
19451,387564,1,6,4,4,0,68
19452,387564,1,6,5,1,0,69
19453,387564,1,6,6,0,0,69
19454,387564,1,7,1,1,0,70
19455,387564,1,7,2,1,0,71
19456,387564,1,7,3,1,0,72
19457,387564,1,7,4,0,0,72
19458,387564,1,7,5,4,0,76
19459,387564,1,7,6,6,0,82
19460,387564,1,8,1,6,0,88
19461,387564,1,8,2,6,0,94
19462,387564,1,8,3,0,0,94
19463,387564,1,8,4,1,0,95
19464,387564,1,8,5,6,0,101
19465,387564,1,8,6,6,0,107
19466,387564,1,9,1,0,0,107
19467,387564,1,9,2,1,0,108
19468,387564,1,9,3,1,0,109
19469,387564,1,9,4,4,0,113
19470,387564,1,9,5,1,0,114
19471,387564,1,9,6,2,0,116
19472,387564,1,10,1,6,0,122
19473,387564,1,10,2,6,0,128
19474,387564,1,10,3,0,0,128
19475,387564,1,10,4,1,0,129
19476,387564,1,10,5,1,0,130
19477,387564,1,10,6,1,0,131
19478,387564,1,11,1,1,0,132
19479,387564,1,11,2,1,0,133
19480,387564,1,11,3,1,0,134
19481,387564,1,11,4,2,0,136
19482,387564,1,11,5,2,0,138
19483,387564,1,11,6,0,0,138
19484,387564,1,12,1,6,0,144
19485,387564,1,12,2,2,0,146
19486,387564,1,12,3,1,0,147
19487,387564,1,12,4,2,0,149
19488,387564,1,12,5,4,0,153
19489,387564,1,12,6,4,0,157
19490,387564,1,13,1,1,0,158
19491,387564,1,13,2,6,0,164
19492,387564,1,13,3,4,0,168
19493,387564,1,13,4,0,0,168
19494,387564,1,13,5,1,0,169
19495,387564,1,13,6,1,0,170
19496,387564,1,14,1,0,1,170
19497,387564,1,14,2,1,0,171
19498,387564,1,14,3,0,0,171
19499,387564,1,14,4,4,0,175
19500,387564,1,14,5,0,0,175
19501,387564,1,14,6,4,0,179
19502,387564,1,15,1,6,0,185
19503,387564,1,15,2,1,0,186
19504,387564,1,15,3,6,0,192
19505,387564,1,15,4,0,1,192
19506,387564,1,15,5,2,0,194
19507,387564,1,15,6,1,0,195
19508,387564,1,16,1,1,0,196
19509,387564,1,16,2,6,0,202
19510,387564,1,16,3,0,0,202
19511,387564,1,16,4,1,0,203
19512,387564,1,16,5,0,1,203
19513,387564,1,16,6,1,0,204
19514,387564,1,17,1,0,1,204
19515,387564,1,17,2,1,0,205
19516,387564,1,17,3,0,0,205
19517,387564,1,17,4,1,0,206
19518,387564,1,17,5,1,0,207
19519,387564,1,17,6,4,0,211
19520,387564,1,18,1,1,0,212
19521,387564,1,18,2,2,0,214
19522,387564,1,18,3,0,1,214
19523,387564,1,18,4,1,0,215
19524,387564,1,18,5,4,0,219
19525,387564,1,18,6,0,0,219
19526,387564,1,19,1,1,0,220
19527,387564,1,19,2,2,0,222
19528,387564,1,19,3,0,0,222
19529,387564,1,19,4,0,0,222
19530,387564,1,19,5,4,0,226
19531,387564,1,19,6,4,0,230
19532,387564,1,20,1,1,0,231
19533,387564,1,20,2,6,0,237
19534,387564,1,20,3,0,0,237
19535,387564,1,20,4,1,1,238
19536,387564,1,20,5,1,0,239
19537,387564,1,20,6,2,0,241
19658,392615,1,1,1,4,0,4
19659,392615,1,1,2,1,0,5
19660,392615,1,1,3,0,0,5
19661,392615,1,1,4,0,0,5
19662,392615,1,1,5,0,0,5
19663,392615,1,1,6,1,0,6
19664,392615,1,2,1,0,0,6
19665,392615,1,2,2,0,0,6
19666,392615,1,2,3,4,0,10
19667,392615,1,2,4,0,0,10
19668,392615,1,2,5,2,0,12
19669,392615,1,2,6,2,0,14
19670,392615,1,3,1,1,0,15
19671,392615,1,3,2,2,0,17
19672,392615,1,3,3,4,0,21
19673,392615,1,3,4,4,0,25
19674,392615,1,3,5,2,0,27
19675,392615,1,3,6,0,0,27
19676,392615,1,4,1,2,0,29
19677,392615,1,4,2,4,0,33
19678,392615,1,4,3,4,0,37
19679,392615,1,4,4,4,0,41
19680,392615,1,4,5,1,0,42
19681,392615,1,4,6,0,0,42
19682,392615,1,5,1,0,1,42
19683,392615,1,5,2,0,0,42
19684,392615,1,5,3,0,0,42
19685,392615,1,5,4,0,0,42
19686,392615,1,5,5,1,0,43
19687,392615,1,5,6,1,0,44
19688,392615,1,6,1,1,0,45
19689,392615,1,6,2,1,0,46
19690,392615,1,6,3,1,0,47
19691,392615,1,6,4,2,0,49
19692,392615,1,6,5,1,0,50
19693,392615,1,6,6,3,0,53
19694,392615,1,7,1,1,0,54
19695,392615,1,7,2,1,0,55
19696,392615,1,7,3,0,0,55
19697,392615,1,7,4,4,0,59
19698,392615,1,7,5,0,0,59
19699,392615,1,7,6,2,0,61
19700,392615,1,8,1,0,1,61
19701,392615,1,8,2,0,1,61
19702,392615,1,8,3,0,0,61
19703,392615,1,8,4,0,0,61
19704,392615,1,8,5,0,0,61
19705,392615,1,8,6,0,0,61
19706,392615,1,9,1,2,0,63
19707,392615,1,9,2,1,0,64
19708,392615,1,9,3,0,0,64
19709,392615,1,9,4,2,0,66
19710,392615,1,9,5,0,0,66
19711,392615,1,9,6,1,0,67
19712,392615,1,10,1,2,0,69
19713,392615,1,10,2,0,0,69
19714,392615,1,10,3,0,1,69
19715,392615,1,10,4,0,0,69
19716,392615,1,10,5,1,0,70
19717,392615,1,10,6,1,0,71
19718,392615,1,11,1,1,0,72
19719,392615,1,11,2,1,0,73
19720,392615,1,11,3,0,1,73
19721,392615,1,11,4,1,0,74
19722,392615,1,11,5,1,0,75
19723,392615,1,11,6,2,0,77
19724,392615,1,12,1,0,0,77
19725,392615,1,12,2,1,0,78
19726,392615,1,12,3,1,0,79
19727,392615,1,12,4,1,0,80
19728,392615,1,12,5,1,0,81
19729,392615,1,12,6,1,0,82
19730,392615,1,13,1,1,0,83
19731,392615,1,13,2,1,0,84
19732,392615,1,13,3,1,0,85
19733,392615,1,13,4,0,1,85
19734,392615,1,13,5,0,0,85
19735,392615,1,13,6,1,0,86
19736,392615,1,14,1,1,0,87
19737,392615,1,14,2,0,0,87
19738,392615,1,14,3,2,0,89
19739,392615,1,14,4,2,0,91
19740,392615,1,14,5,1,0,92
19741,392615,1,14,6,1,0,93
19742,392615,1,15,1,1,0,94
19743,392615,1,15,2,0,0,94
19744,392615,1,15,3,0,1,94
19745,392615,1,15,4,0,0,94
19746,392615,1,15,5,0,0,94
19747,392615,1,15,6,0,1,94
19748,392615,1,16,1,1,0,95
19749,392615,1,16,2,1,0,96
19750,392615,1,16,3,1,0,97
19751,392615,1,16,4,0,0,97
19752,392615,1,16,5,0,0,97
19753,392615,1,16,6,0,0,97
19754,392615,1,17,1,0,0,97
19755,392615,1,17,2,1,0,98
19756,392615,1,17,3,0,0,98
19757,392615,1,17,4,1,0,99
19758,392615,1,17,5,0,0,99
19759,392615,1,17,6,1,0,100
19760,392615,1,18,1,0,0,100
19761,392615,1,18,2,4,0,104
19762,392615,1,18,3,1,0,105
19763,392615,1,18,4,0,0,105
19764,392615,1,18,5,0,0,105
19765,392615,1,18,6,0,0,105
19766,392615,1,19,1,0,1,105
19767,392615,1,19,2,0,0,105
19768,392615,1,19,3,0,0,105
19769,392615,1,19,4,0,0,105
19770,392615,1,19,5,0,0,105
19771,392615,1,19,6,2,0,107
19772,392615,1,20,1,0,0,107
19773,392615,1,20,2,1,0,108
19774,392615,1,20,3,0,0,108
19775,392615,1,20,4,0,0,108
19776,392615,1,20,5,0,1,108
19876,401076,1,1,1,1,0,1
19877,401076,1,1,2,1,0,2
19878,401076,1,1,3,4,0,6
19879,401076,1,1,4,1,0,7
19880,401076,1,1,5,0,0,7
19881,401076,1,1,6,4,0,11
19882,401076,1,2,1,1,0,12
19883,401076,1,2,2,0,0,12
19884,401076,1,2,3,0,0,12
19885,401076,1,2,4,0,1,12
19886,401076,1,2,5,0,1,12
19887,401076,1,2,6,0,0,12
19888,401076,1,3,1,0,0,12
19889,401076,1,3,2,0,1,12
19890,401076,1,3,3,0,0,12
19891,401076,1,3,4,0,0,12
19892,401076,1,3,5,0,0,12
19893,401076,1,3,6,1,0,13
19894,401076,1,4,1,1,0,14
19895,401076,1,4,2,6,0,20
19896,401076,1,4,3,1,0,21
19897,401076,1,4,4,0,0,21
19898,401076,1,4,5,0,0,21
19899,401076,1,4,6,4,0,25
19900,401076,1,5,1,6,0,31
19901,401076,1,5,2,0,0,31
19902,401076,1,5,3,1,0,32
19903,401076,1,5,4,0,0,32
19904,401076,1,5,5,2,0,34
19905,401076,1,5,6,1,0,35
19906,401076,1,6,1,0,0,35
19907,401076,1,6,2,0,0,35
19908,401076,1,6,3,4,0,39
19909,401076,1,6,4,4,0,43
19910,401076,1,6,5,0,1,43
19911,401076,1,6,6,0,0,43
19912,401076,1,7,1,1,0,44
19913,401076,1,7,2,0,0,44
19914,401076,1,7,3,1,0,45
19915,401076,1,7,4,0,0,45
19916,401076,1,7,5,1,0,46
19917,401076,1,7,6,0,0,46
19918,401076,1,8,1,0,0,46
19919,401076,1,8,2,4,0,50
19920,401076,1,8,3,0,0,50
19921,401076,1,8,4,1,0,51
19922,401076,1,8,5,0,0,51
19923,401076,1,8,6,0,0,51
19924,401076,1,9,1,2,0,53
19925,401076,1,9,2,0,0,53
19926,401076,1,9,3,4,0,57
19927,401076,1,9,4,0,0,57
19928,401076,1,9,5,0,1,57
19929,401076,1,9,6,1,0,58
19930,401076,1,10,1,1,0,59
19931,401076,1,10,2,1,0,60
19932,401076,1,10,3,1,0,61
19933,401076,1,10,4,0,0,61
19934,401076,1,10,5,1,0,62
19935,401076,1,10,6,0,1,62
19936,401076,1,11,1,0,0,62
19937,401076,1,11,2,1,0,63
19938,401076,1,11,3,0,0,63
19939,401076,1,11,4,1,0,64
19940,401076,1,11,5,1,0,65
19941,401076,1,11,6,1,0,66
19942,401076,1,12,1,0,1,66
19943,401076,1,12,2,1,0,67
19944,401076,1,12,3,1,0,68
19945,401076,1,12,4,3,0,71
19946,401076,1,12,5,0,0,71
19947,401076,1,12,6,0,0,71
19948,401076,1,13,1,3,0,74
19949,401076,1,13,2,0,0,74
19950,401076,1,13,3,0,0,74
19951,401076,1,13,4,1,0,75
19952,401076,1,13,5,0,0,75
19953,401076,1,13,6,2,0,77
19954,401076,1,14,1,0,0,77
19955,401076,1,14,2,1,0,78
19956,401076,1,14,3,1,0,79
19957,401076,1,14,4,0,0,79
19958,401076,1,14,5,1,0,80
19959,401076,1,14,6,0,0,80
19960,401076,1,15,1,0,0,80
19961,401076,1,15,2,5,0,85
19962,401076,1,15,3,0,0,85
19963,401076,1,15,4,1,0,86
19964,401076,1,15,5,0,0,86
19965,401076,1,15,6,0,0,86
19966,401076,1,16,1,1,0,87
19967,401076,1,16,2,4,0,91
19968,401076,1,16,3,1,0,92
19969,401076,1,16,4,0,0,92
19970,401076,1,16,5,0,1,92
19971,401076,1,16,6,0,0,92
19972,401076,1,17,1,0,0,92
19973,401076,1,17,2,4,0,96
19974,401076,1,17,3,0,0,96
19975,401076,1,17,4,0,0,96
19976,401076,1,17,5,0,0,96
19977,401076,1,17,6,4,0,100
19978,401076,1,18,1,0,0,100
19979,401076,1,18,2,0,0,100
19980,401076,1,18,3,0,0,100
19981,401076,1,18,4,1,0,101
19982,401076,1,18,5,0,0,101
19983,401076,1,18,6,1,0,102
19984,401076,1,19,1,1,0,103
19985,401076,1,19,2,0,0,103
19986,401076,1,19,3,0,0,103
19987,401076,1,19,4,0,1,103
19988,401076,1,19,5,1,0,104
19989,401076,1,19,6,0,0,104
19990,401076,1,20,1,1,0,105
19991,401076,1,20,2,1,0,106
19992,401076,1,20,3,4,0,110
19993,401076,1,20,4,1,0,111
19994,401076,1,20,5,6,0,117
19995,401076,1,20,6,1,0,118
20097,403375,1,1,1,0,1,0
20098,403375,1,1,2,0,0,0
20099,403375,1,1,3,1,0,1
20100,403375,1,1,4,1,0,2
20101,403375,1,1,5,0,0,2
20102,403375,1,1,6,0,0,2
20103,403375,1,2,1,4,0,6
20104,403375,1,2,2,1,0,7
20105,403375,1,2,3,0,0,7
20106,403375,1,2,4,4,0,11
20107,403375,1,2,5,4,0,15
20108,403375,1,2,6,4,0,19
20109,403375,1,3,1,4,0,23
20110,403375,1,3,2,2,0,25
20111,403375,1,3,3,1,0,26
20112,403375,1,3,4,1,0,27
20113,403375,1,3,5,0,0,27
20114,403375,1,3,6,1,0,28
20115,403375,1,4,1,0,0,28
20116,403375,1,4,2,4,0,32
20117,403375,1,4,3,0,0,32
20118,403375,1,4,4,3,0,35
20119,403375,1,4,5,0,1,35
20120,403375,1,4,6,0,0,35
20121,403375,1,5,1,2,0,37
20122,403375,1,5,2,4,0,41
20123,403375,1,5,3,0,0,41
20124,403375,1,5,4,0,0,41
20125,403375,1,5,5,6,0,47
20126,403375,1,5,6,1,0,48
20127,403375,1,6,1,0,0,48
20128,403375,1,6,2,0,0,48
20129,403375,1,6,3,0,0,48
20130,403375,1,6,4,1,0,49
20131,403375,1,6,5,0,0,49
20132,403375,1,6,6,0,0,49
20133,403375,1,7,1,4,0,53
20134,403375,1,7,2,1,0,54
20135,403375,1,7,3,0,0,54
20136,403375,1,7,4,1,0,55
20137,403375,1,7,5,1,0,56
20138,403375,1,7,6,0,0,56
20139,403375,1,8,1,1,0,57
20140,403375,1,8,2,1,0,58
20141,403375,1,8,3,0,0,58
20142,403375,1,8,4,1,0,59
20143,403375,1,8,5,0,1,59
20144,403375,1,8,6,1,0,60
20145,403375,1,9,1,1,0,61
20146,403375,1,9,2,1,0,62
20147,403375,1,9,3,1,0,63
20148,403375,1,9,4,1,0,64
20149,403375,1,9,5,0,0,64
20150,403375,1,9,6,2,0,66
20151,403375,1,10,1,2,0,68
20152,403375,1,10,2,2,0,70
20153,403375,1,10,3,1,0,71
20154,403375,1,10,4,0,0,71
20155,403375,1,10,5,1,0,72
20156,403375,1,10,6,4,0,76
20157,403375,1,11,1,1,0,77
20158,403375,1,11,2,1,0,78
20159,403375,1,11,3,6,0,84
20160,403375,1,11,4,1,0,85
20161,403375,1,11,5,4,0,89
20162,403375,1,11,6,1,0,90
20163,403375,1,12,1,1,0,91
20164,403375,1,12,2,1,0,92
20165,403375,1,12,3,1,0,93
20166,403375,1,12,4,1,0,94
20167,403375,1,12,5,1,0,95
20168,403375,1,12,6,1,0,96
20169,403375,1,13,1,4,0,100
20170,403375,1,13,2,1,0,101
20171,403375,1,13,3,0,0,101
20172,403375,1,13,4,4,0,105
20173,403375,1,13,5,0,0,105
20174,403375,1,13,6,4,0,109
20175,403375,1,14,1,1,0,110
20176,403375,1,14,2,0,0,110
20177,403375,1,14,3,1,0,111
20178,403375,1,14,4,4,0,115
20179,403375,1,14,5,4,0,119
20180,403375,1,14,6,1,0,120
20181,403375,1,15,1,2,0,122
20182,403375,1,15,2,0,0,122
20183,403375,1,15,3,1,0,123
20184,403375,1,15,4,1,0,124
20185,403375,1,15,5,1,0,125
20186,403375,1,15,6,0,1,125
20187,403375,1,16,1,1,0,126
20188,403375,1,16,2,0,0,126
20189,403375,1,16,3,1,0,127
20190,403375,1,16,4,5,0,132
20191,403375,1,16,5,6,0,138
20192,403375,1,16,6,1,0,139
20193,403375,1,17,1,0,0,139
20194,403375,1,17,2,0,1,139
20195,403375,1,17,3,0,0,139
20196,403375,1,17,4,1,0,140
20197,403375,1,17,5,1,0,141
20198,403375,1,17,6,1,0,142
20199,403375,1,18,1,1,0,143
20200,403375,1,18,2,1,0,144
20201,403375,1,18,3,1,0,145
20202,403375,1,18,4,3,0,148
20203,403375,1,18,5,2,0,150
20204,403375,1,18,6,1,0,151
20205,403375,1,19,1,2,0,153
20206,403375,1,19,2,4,0,157
20207,403375,1,19,3,4,0,161
20208,403375,1,19,4,2,0,163
20209,403375,1,19,5,1,0,164
20210,403375,1,19,6,1,0,165
20211,403375,1,20,1,1,0,166
20212,403375,1,20,2,4,0,170
20213,403375,1,20,3,0,0,170
20214,403375,1,20,4,1,0,171
20215,403375,1,20,5,0,0,171
20216,403375,1,20,6,1,0,172
20326,403385,1,1,1,0,0,0
20327,403385,1,1,2,1,0,1
20328,403385,1,1,3,1,0,2
20329,403385,1,1,4,0,0,2
20330,403385,1,1,5,2,0,4
20331,403385,1,1,6,0,0,4
20332,403385,1,2,1,1,0,5
20333,403385,1,2,2,0,0,5
20334,403385,1,2,3,6,0,11
20335,403385,1,2,4,1,0,12
20336,403385,1,2,5,2,0,14
20337,403385,1,2,6,0,0,14
20338,403385,1,3,1,0,1,14
20339,403385,1,3,2,0,0,14
20340,403385,1,3,3,0,0,14
20341,403385,1,3,4,4,0,18
20342,403385,1,3,5,1,0,19
20343,403385,1,3,6,0,0,19
20344,403385,1,4,1,0,0,19
20345,403385,1,4,2,0,0,19
20346,403385,1,4,3,4,0,23
20347,403385,1,4,4,1,0,24
20348,403385,1,4,5,0,0,24
20349,403385,1,4,6,1,0,25
20350,403385,1,5,1,1,0,26
20351,403385,1,5,2,0,0,26
20352,403385,1,5,3,0,1,26
20353,403385,1,5,4,1,0,27
20354,403385,1,5,5,0,0,27
20355,403385,1,5,6,1,0,28
20356,403385,1,6,1,0,0,28
20357,403385,1,6,2,0,0,28
20358,403385,1,6,3,1,0,29
20359,403385,1,6,4,1,0,30
20360,403385,1,6,5,4,0,34
20361,403385,1,6,6,4,0,38
20362,403385,1,7,1,1,0,39
20363,403385,1,7,2,1,0,40
20364,403385,1,7,3,4,0,44
20365,403385,1,7,4,0,0,44
20366,403385,1,7,5,0,0,44
20367,403385,1,7,6,2,0,46
20368,403385,1,8,1,0,0,46
20369,403385,1,8,2,1,0,47
20370,403385,1,8,3,0,0,47
20371,403385,1,8,4,0,0,47
20372,403385,1,8,5,0,0,47
20373,403385,1,8,6,1,0,48
20374,403385,1,9,1,1,0,49
20375,403385,1,9,2,0,0,49
20376,403385,1,9,3,1,0,50
20377,403385,1,9,4,2,0,52
20378,403385,1,9,5,1,0,53
20379,403385,1,9,6,4,0,57
20380,403385,1,10,1,1,0,58
20381,403385,1,10,2,1,0,59
20382,403385,1,10,3,1,0,60
20383,403385,1,10,4,0,0,60
20384,403385,1,10,5,2,0,62
20385,403385,1,10,6,1,0,63
20386,403385,1,11,1,2,0,65
20387,403385,1,11,2,1,0,66
20388,403385,1,11,3,0,0,66
20389,403385,1,11,4,4,0,70
20390,403385,1,11,5,1,0,71
20391,403385,1,11,6,2,0,73
20392,403385,1,12,1,6,0,79
20393,403385,1,12,2,0,1,79
20394,403385,1,12,3,3,0,82
20395,403385,1,12,4,2,0,84
20396,403385,1,12,5,1,0,85
20397,403385,1,12,6,0,0,85
20398,403385,1,13,1,1,0,86
20399,403385,1,13,2,1,0,87
20400,403385,1,13,3,1,0,88
20401,403385,1,13,4,0,0,88
20402,403385,1,13,5,1,0,89
20403,403385,1,13,6,0,0,89
20404,403385,1,14,1,1,0,90
20405,403385,1,14,2,1,0,91
20406,403385,1,14,3,1,0,92
20407,403385,1,14,4,1,0,93
20408,403385,1,14,5,1,0,94
20409,403385,1,14,6,0,0,94
20410,403385,1,15,1,2,0,96
20411,403385,1,15,2,1,0,97
20412,403385,1,15,3,1,0,98
20413,403385,1,15,4,0,0,98
20414,403385,1,15,5,4,0,102
20415,403385,1,15,6,6,0,108
20416,403385,1,16,1,1,0,109
20417,403385,1,16,2,1,0,110
20418,403385,1,16,3,1,0,111
20419,403385,1,16,4,0,0,111
20420,403385,1,16,5,1,0,112
20421,403385,1,16,6,0,0,112
20422,403385,1,17,1,2,0,114
20423,403385,1,17,2,2,0,116
20424,403385,1,17,3,1,0,117
20425,403385,1,17,4,0,1,117
20426,403385,1,17,5,0,0,117
20427,403385,1,17,6,0,0,117
20428,403385,1,18,1,1,0,118
20429,403385,1,18,2,2,0,120
20430,403385,1,18,3,1,0,121
20431,403385,1,18,4,1,0,122
20432,403385,1,18,5,4,0,126
20433,403385,1,18,6,0,1,126
20434,403385,1,19,1,1,1,127
20435,403385,1,19,2,0,0,127
20436,403385,1,19,3,2,0,129
20437,403385,1,19,4,4,0,133
20438,403385,1,19,5,1,0,134
20439,403385,1,19,6,1,0,135
20440,403385,1,20,1,1,0,136
20441,403385,1,20,2,0,1,136
20442,403385,1,20,3,0,1,136
20443,403385,1,20,4,1,0,137
20444,403385,1,20,5,1,0,138
20445,403385,1,20,6,3,0,141
20566,403386,1,1,1,3,0,3
20567,403386,1,1,2,0,0,3
20568,403386,1,1,3,2,0,5
20569,403386,1,1,4,4,0,9
20570,403386,1,1,5,0,0,9
20571,403386,1,1,6,0,0,9
20572,403386,1,2,1,1,0,10
20573,403386,1,2,2,1,0,11
20574,403386,1,2,3,1,0,12
20575,403386,1,2,4,0,0,12
20576,403386,1,2,5,1,0,13
20577,403386,1,2,6,0,0,13
20578,403386,1,3,1,0,0,13
20579,403386,1,3,2,0,0,13
20580,403386,1,3,3,0,0,13
20581,403386,1,3,4,4,0,17
20582,403386,1,3,5,0,0,17
20583,403386,1,3,6,4,0,21
20584,403386,1,4,1,1,0,22
20585,403386,1,4,2,1,0,23
20586,403386,1,4,3,1,0,24
20587,403386,1,4,4,2,0,26
20588,403386,1,4,5,6,0,32
20589,403386,1,4,6,8,0,40
20590,403386,1,5,1,0,0,40
20591,403386,1,5,2,2,0,42
20592,403386,1,5,3,0,0,42
20593,403386,1,5,4,0,0,42
20594,403386,1,5,5,4,0,46
20595,403386,1,5,6,0,0,46
20596,403386,1,6,1,0,0,46
20597,403386,1,6,2,1,0,47
20598,403386,1,6,3,0,0,47
20599,403386,1,6,4,0,0,47
20600,403386,1,6,5,1,0,48
20601,403386,1,6,6,1,0,49
20602,403386,1,7,1,2,0,51
20603,403386,1,7,2,0,0,51
20604,403386,1,7,3,1,0,52
20605,403386,1,7,4,1,0,53
20606,403386,1,7,5,1,0,54
20607,403386,1,7,6,0,0,54
20608,403386,1,8,1,1,0,55
20609,403386,1,8,2,1,0,56
20610,403386,1,8,3,6,0,62
20611,403386,1,8,4,0,0,62
20612,403386,1,8,5,1,0,63
20613,403386,1,8,6,2,0,65
20614,403386,1,9,1,1,0,66
20615,403386,1,9,2,0,0,66
20616,403386,1,9,3,1,0,67
20617,403386,1,9,4,4,0,71
20618,403386,1,9,5,0,0,71
20619,403386,1,9,6,1,0,72
20620,403386,1,10,1,1,0,73
20621,403386,1,10,2,1,0,74
20622,403386,1,10,3,1,0,75
20623,403386,1,10,4,6,0,81
20624,403386,1,10,5,1,0,82
20625,403386,1,10,6,1,0,83
20626,403386,1,11,1,1,0,84
20627,403386,1,11,2,0,1,84
20628,403386,1,11,3,0,0,84
20629,403386,1,11,4,0,0,84
20630,403386,1,11,5,1,0,85
20631,403386,1,11,6,1,0,86
20632,403386,1,12,1,6,0,92
20633,403386,1,12,2,1,0,93
20634,403386,1,12,3,1,0,94
20635,403386,1,12,4,4,0,98
20636,403386,1,12,5,6,0,104
20637,403386,1,12,6,2,0,106
20638,403386,1,13,1,0,0,106
20639,403386,1,13,2,2,0,108
20640,403386,1,13,3,0,0,108
20641,403386,1,13,4,1,0,109
20642,403386,1,13,5,0,0,109
20643,403386,1,13,6,0,1,109
20644,403386,1,14,1,0,0,109
20645,403386,1,14,2,1,0,110
20646,403386,1,14,3,1,0,111
20647,403386,1,14,4,2,0,113
20648,403386,1,14,5,4,0,117
20649,403386,1,14,6,1,0,118
20650,403386,1,15,1,1,0,119
20651,403386,1,15,2,2,0,121
20652,403386,1,15,3,1,0,122
20653,403386,1,15,4,0,0,122
20654,403386,1,15,5,1,0,123
20655,403386,1,15,6,1,0,124
20656,403386,1,16,1,1,0,125
20657,403386,1,16,2,2,0,127
20658,403386,1,16,3,0,1,127
20659,403386,1,16,4,1,0,128
20660,403386,1,16,5,1,0,129
20661,403386,1,16,6,2,0,131
20662,403386,1,17,1,6,0,137
20663,403386,1,17,2,4,0,141
20664,403386,1,17,3,2,0,143
20665,403386,1,17,4,2,0,145
20666,403386,1,17,5,1,0,146
20667,403386,1,17,6,2,0,148
20668,403386,1,18,1,1,0,149
20669,403386,1,18,2,2,0,151
20670,403386,1,18,3,1,0,152
20671,403386,1,18,4,1,0,153
20672,403386,1,18,5,1,0,154
20673,403386,1,18,6,0,0,154
20674,403386,1,19,1,1,0,155
20675,403386,1,19,2,4,0,159
20676,403386,1,19,3,0,0,159
20677,403386,1,19,4,2,0,161
20678,403386,1,19,5,1,0,162
20679,403386,1,19,6,1,0,163
20680,403386,1,20,1,4,0,167
20681,403386,1,20,2,1,0,168
20682,403386,1,20,3,1,0,169
20683,403386,1,20,4,0,0,169
20684,403386,1,20,5,1,0,170
20685,403386,1,20,6,0,1,170
20806,406197,1,1,1,1,0,1
20807,406197,1,1,2,0,0,1
20808,406197,1,1,3,0,0,1
20809,406197,1,1,4,0,0,1
20810,406197,1,1,5,0,0,1
20811,406197,1,1,6,0,0,1
20812,406197,1,2,1,0,0,1
20813,406197,1,2,2,0,0,1
20814,406197,1,2,3,0,0,1
20815,406197,1,2,4,1,0,2
20816,406197,1,2,5,4,0,6
20817,406197,1,2,6,0,0,6
20818,406197,1,3,1,0,0,6
20819,406197,1,3,2,1,0,7
20820,406197,1,3,3,0,0,7
20821,406197,1,3,4,4,0,11
20822,406197,1,3,5,0,0,11
20823,406197,1,3,6,4,0,15
20824,406197,1,4,1,1,0,16
20825,406197,1,4,2,4,0,20
20826,406197,1,4,3,6,0,26
20827,406197,1,4,4,0,0,26
20828,406197,1,4,5,4,0,30
20829,406197,1,4,6,1,0,31
20830,406197,1,5,1,0,0,31
20831,406197,1,5,2,1,0,32
20832,406197,1,5,3,1,0,33
20833,406197,1,5,4,1,0,34
20834,406197,1,5,5,6,0,40
20835,406197,1,5,6,4,0,44
20836,406197,1,6,1,0,0,44
20837,406197,1,6,2,6,0,50
20838,406197,1,6,3,1,0,51
20839,406197,1,6,4,1,0,52
20840,406197,1,6,5,4,0,56
20841,406197,1,6,6,2,0,58
20842,406197,1,7,1,1,0,59
20843,406197,1,7,2,1,0,60
20844,406197,1,7,3,6,0,66
20845,406197,1,7,4,1,0,67
20846,406197,1,7,5,1,0,68
20847,406197,1,7,6,6,0,74
20848,406197,1,8,1,1,0,75
20849,406197,1,8,2,1,0,76
20850,406197,1,8,3,1,0,77
20851,406197,1,8,4,6,0,83
20852,406197,1,8,5,0,1,83
20853,406197,1,8,6,1,0,84
20854,406197,1,9,1,0,0,84
20855,406197,1,9,2,2,0,86
20856,406197,1,9,3,0,1,86
20857,406197,1,9,4,1,0,87
20858,406197,1,9,5,4,0,91
20859,406197,1,9,6,1,0,92
20860,406197,1,10,1,2,0,94
20861,406197,1,10,2,1,0,95
20862,406197,1,10,3,0,0,95
20863,406197,1,10,4,0,1,95
20864,406197,1,10,5,1,0,96
20865,406197,1,10,6,1,0,97
20866,406197,1,11,1,2,0,99
20867,406197,1,11,2,0,0,99
20868,406197,1,11,3,1,0,100
20869,406197,1,11,4,1,0,101
20870,406197,1,11,5,0,0,101
20871,406197,1,11,6,1,0,102
20872,406197,1,12,1,0,0,102
20873,406197,1,12,2,1,0,103
20874,406197,1,12,3,1,0,104
20875,406197,1,12,4,1,0,105
20876,406197,1,12,5,1,0,106
20877,406197,1,12,6,0,0,106
20878,406197,1,13,1,0,1,106
20879,406197,1,13,2,1,0,107
20880,406197,1,13,3,0,0,107
20881,406197,1,13,4,0,0,107
20882,406197,1,13,5,1,0,108
20883,406197,1,13,6,1,0,109
20884,406197,1,14,1,2,0,111
20885,406197,1,14,2,0,0,111
20886,406197,1,14,3,1,0,112
20887,406197,1,14,4,1,0,113
20888,406197,1,14,5,1,0,114
20889,406197,1,14,6,2,0,116
20890,406197,1,15,1,0,0,116
20891,406197,1,15,2,1,0,117
20892,406197,1,15,3,4,0,121
20893,406197,1,15,4,4,0,125
20894,406197,1,15,5,1,0,126
20895,406197,1,15,6,1,0,127
20896,406197,1,16,1,1,0,128
20897,406197,1,16,2,0,1,128
20898,406197,1,16,3,1,0,129
20899,406197,1,16,4,0,1,129
20900,406197,1,16,5,1,0,130
20901,406197,1,16,6,1,0,131
20902,406197,1,17,1,1,0,132
20903,406197,1,17,2,1,0,133
20904,406197,1,17,3,0,0,133
20905,406197,1,17,4,1,0,134
20906,406197,1,17,5,1,0,135
20907,406197,1,17,6,0,0,135
20908,406197,1,18,1,2,0,137
20909,406197,1,18,2,3,0,140
20910,406197,1,18,3,1,0,141
20911,406197,1,18,4,3,0,144
20912,406197,1,18,5,5,0,149
20913,406197,1,18,6,2,0,151
20914,406197,1,19,1,0,1,151
20915,406197,1,19,2,2,0,153
20916,406197,1,19,3,1,0,154
20917,406197,1,19,4,1,0,155
20918,406197,1,19,5,4,0,159
20919,406197,1,19,6,6,0,165
20920,406197,1,20,1,1,0,166
20921,406197,1,20,2,6,0,172
20922,406197,1,20,3,1,0,173
20923,406197,1,20,4,2,0,175
20924,406197,1,20,5,4,0,179
20925,406197,1,20,6,0,1,179
21046,406198,1,1,1,0,0,0
21047,406198,1,1,2,1,0,1
21048,406198,1,1,3,1,0,2
21049,406198,1,1,4,6,0,8
21050,406198,1,1,5,2,0,10
21051,406198,1,1,6,0,0,10
21052,406198,1,2,1,1,0,11
21053,406198,1,2,2,0,0,11
21054,406198,1,2,3,1,0,12
21055,406198,1,2,4,0,0,12
21056,406198,1,2,5,0,0,12
21057,406198,1,2,6,2,0,14
21058,406198,1,3,1,0,0,14
21059,406198,1,3,2,0,0,14
21060,406198,1,3,3,1,0,15
21061,406198,1,3,4,0,0,15
21062,406198,1,3,5,0,0,15
21063,406198,1,3,6,0,0,15
21064,406198,1,4,1,1,0,16
21065,406198,1,4,2,4,0,20
21066,406198,1,4,3,6,0,26
21067,406198,1,4,4,0,1,26
21068,406198,1,4,5,1,0,27
21069,406198,1,4,6,0,1,27
21070,406198,1,5,1,0,0,27
21071,406198,1,5,2,2,0,29
21072,406198,1,5,3,0,0,29
21073,406198,1,5,4,4,0,33
21074,406198,1,5,5,0,0,33
21075,406198,1,5,6,1,0,34
21076,406198,1,6,1,0,0,34
21077,406198,1,6,2,0,0,34
21078,406198,1,6,3,1,0,35
21079,406198,1,6,4,0,0,35
21080,406198,1,6,5,0,0,35
21081,406198,1,6,6,0,0,35
21082,406198,1,7,1,1,0,36
21083,406198,1,7,2,0,0,36
21084,406198,1,7,3,1,0,37
21085,406198,1,7,4,0,0,37
21086,406198,1,7,5,1,0,38
21087,406198,1,7,6,4,0,42
21088,406198,1,8,1,1,0,43
21089,406198,1,8,2,1,0,44
21090,406198,1,8,3,2,0,46
21091,406198,1,8,4,1,0,47
21092,406198,1,8,5,3,0,50
21093,406198,1,8,6,0,1,50
21094,406198,1,9,1,1,0,51
21095,406198,1,9,2,0,0,51
21096,406198,1,9,3,0,1,51
21097,406198,1,9,4,0,0,51
21098,406198,1,9,5,1,0,52
21099,406198,1,9,6,0,0,52
21100,406198,1,10,1,1,0,53
21101,406198,1,10,2,2,0,55
21102,406198,1,10,3,1,0,56
21103,406198,1,10,4,1,0,57
21104,406198,1,10,5,2,0,59
21105,406198,1,10,6,0,0,59
21106,406198,1,11,1,1,0,60
21107,406198,1,11,2,0,0,60
21108,406198,1,11,3,1,0,61
21109,406198,1,11,4,2,0,63
21110,406198,1,11,5,0,1,63
21111,406198,1,11,6,1,0,64
21112,406198,1,12,1,1,0,65
21113,406198,1,12,2,0,0,65
21114,406198,1,12,3,2,0,67
21115,406198,1,12,4,4,0,71
21116,406198,1,12,5,2,0,73
21117,406198,1,12,6,4,0,77
21118,406198,1,13,1,0,1,77
21119,406198,1,13,2,1,0,78
21120,406198,1,13,3,0,0,78
21121,406198,1,13,4,1,0,79
21122,406198,1,13,5,1,0,80
21123,406198,1,13,6,0,0,80
21124,406198,1,14,1,1,0,81
21125,406198,1,14,2,1,0,82
21126,406198,1,14,3,0,0,82
21127,406198,1,14,4,1,0,83
21128,406198,1,14,5,2,0,85
21129,406198,1,14,6,1,0,86
21130,406198,1,15,1,0,0,86
21131,406198,1,15,2,1,0,87
21132,406198,1,15,3,1,0,88
21133,406198,1,15,4,1,0,89
21134,406198,1,15,5,0,0,89
21135,406198,1,15,6,0,0,89
21136,406198,1,16,1,1,0,90
21137,406198,1,16,2,0,0,90
21138,406198,1,16,3,1,0,91
21139,406198,1,16,4,1,0,92
21140,406198,1,16,5,0,0,92
21141,406198,1,16,6,1,0,93
21142,406198,1,17,1,4,0,97
21143,406198,1,17,2,1,0,98
21144,406198,1,17,3,0,1,98
21145,406198,1,17,4,2,0,100
21146,406198,1,17,5,0,0,100
21147,406198,1,17,6,1,0,101
21148,406198,1,18,1,2,0,103
21149,406198,1,18,2,1,0,104
21150,406198,1,18,3,1,0,105
21151,406198,1,18,4,1,0,106
21152,406198,1,18,5,1,0,107
21153,406198,1,18,6,4,0,111
21154,406198,1,19,1,2,0,113
21155,406198,1,19,2,1,0,114
21156,406198,1,19,3,1,0,115
21157,406198,1,19,4,4,0,119
21158,406198,1,19,5,1,0,120
21159,406198,1,19,6,0,0,120
21160,406198,1,20,1,2,0,122
21161,406198,1,20,2,1,0,123
21162,406198,1,20,3,2,0,125
21163,406198,1,20,4,1,0,126
21164,406198,1,20,5,6,0,132
21165,406198,1,20,6,6,0,138
21236,406207,1,1,1,0,0,0
21237,406207,1,1,2,4,0,4
21238,406207,1,1,3,0,0,4
21239,406207,1,1,4,0,0,4
21240,406207,1,1,5,2,0,6
21241,406207,1,1,6,1,0,7
21242,406207,1,2,1,0,0,7
21243,406207,1,2,2,1,0,8
21244,406207,1,2,3,4,0,12
21245,406207,1,2,4,0,0,12
21246,406207,1,2,5,2,1,14
21247,406207,1,2,6,2,0,16
21248,406207,1,3,1,1,0,17
21249,406207,1,3,2,4,0,21
21250,406207,1,3,3,0,0,21
21251,406207,1,3,4,0,0,21
21252,406207,1,3,5,2,0,23
21253,406207,1,3,6,2,0,25
21254,406207,1,4,1,1,0,26
21255,406207,1,4,2,0,0,26
21256,406207,1,4,3,1,0,27
21257,406207,1,4,4,1,0,28
21258,406207,1,4,5,2,0,30
21259,406207,1,4,6,1,0,31
21260,406207,1,5,1,0,0,31
21261,406207,1,5,2,2,0,33
21262,406207,1,5,3,1,0,34
21263,406207,1,5,4,6,0,40
21264,406207,1,5,5,1,0,41
21265,406207,1,5,6,0,0,41
21266,406207,1,6,1,1,0,42
21267,406207,1,6,2,2,0,44
21268,406207,1,6,3,1,0,45
21269,406207,1,6,4,3,0,48
21270,406207,1,6,5,1,0,49
21271,406207,1,6,6,1,0,50
21272,406207,1,7,1,1,0,51
21273,406207,1,7,2,0,0,51
21274,406207,1,7,3,1,0,52
21275,406207,1,7,4,2,0,54
21276,406207,1,7,5,0,1,54
21277,406207,1,7,6,1,0,55
21278,406207,1,8,1,4,0,59
21279,406207,1,8,2,1,0,60
21280,406207,1,8,3,1,0,61
21281,406207,1,8,4,2,0,63
21282,406207,1,8,5,1,0,64
21283,406207,1,8,6,1,0,65
21284,406207,1,9,1,1,0,66
21285,406207,1,9,2,1,0,67
21286,406207,1,9,3,1,0,68
21287,406207,1,9,4,0,1,68
21288,406207,1,9,5,0,0,68
21289,406207,1,9,6,2,0,70
21290,406207,1,10,1,1,0,71
21291,406207,1,10,2,0,0,71
21292,406207,1,10,3,1,0,72
21293,406207,1,10,4,1,0,73
21294,406207,1,10,5,1,0,74
21295,406207,1,10,6,0,0,74
21296,406207,1,11,1,1,0,75
21297,406207,1,11,2,0,0,75
21298,406207,1,11,3,1,0,76
21299,406207,1,11,4,1,0,77
21300,406207,1,11,5,0,1,77
21301,406207,1,11,6,1,0,78
21302,406207,1,12,1,0,1,78
21303,406207,1,12,2,0,0,78
21304,406207,1,12,3,0,0,78
21305,406207,1,12,4,1,0,79
21306,406207,1,12,5,1,0,80
21307,406207,1,12,6,2,1,82
21308,406207,1,13,1,1,0,83
21309,406207,1,13,2,1,0,84
21310,406207,1,13,3,1,0,85
21311,406207,1,13,4,0,0,85
21312,406207,1,13,5,1,0,86
21313,406207,1,13,6,0,0,86
21314,406207,1,14,1,1,0,87
21315,406207,1,14,2,0,0,87
21316,406207,1,14,3,4,0,91
21317,406207,1,14,4,1,0,92
21318,406207,1,14,5,6,0,98
21319,406207,1,14,6,1,0,99
21320,406207,1,15,1,0,0,99
21321,406207,1,15,2,0,0,99
21322,406207,1,15,3,2,0,101
21323,406207,1,15,4,1,0,102
21324,406207,1,15,5,0,1,102
21325,406207,1,15,6,0,0,102
21326,406207,1,16,1,1,0,103
21327,406207,1,16,2,0,0,103
21328,406207,1,16,3,0,0,103
21329,406207,1,16,4,0,0,103
21330,406207,1,16,5,2,0,105
21331,406207,1,16,6,0,0,105
21332,406207,1,17,1,1,0,106
21333,406207,1,17,2,0,1,106
21334,406207,1,17,3,1,0,107
21335,406207,1,17,4,4,0,111
21336,406207,1,17,5,2,0,113
21337,406207,1,17,6,1,0,114
21338,406207,1,18,1,1,0,115
21339,406207,1,18,2,0,0,115
21340,406207,1,18,3,3,0,118
21341,406207,1,18,4,1,1,119
21342,406207,1,18,5,0,0,119
21343,406207,1,18,6,6,0,125
21344,406207,1,19,1,1,0,126
21345,406207,1,19,2,0,0,126
21346,406207,1,19,3,1,0,127
21347,406207,1,19,4,0,1,127
21468,412677,1,1,1,1,0,1
21469,412677,1,1,2,0,0,1
21470,412677,1,1,3,3,0,4
21471,412677,1,1,4,2,0,6
21472,412677,1,1,5,0,0,6
21473,412677,1,1,6,1,0,7
21474,412677,1,2,1,0,0,7
21475,412677,1,2,2,1,0,8
21476,412677,1,2,3,0,0,8
21477,412677,1,2,4,0,0,8
21478,412677,1,2,5,0,0,8
21479,412677,1,2,6,1,0,9
21480,412677,1,3,1,0,0,9
21481,412677,1,3,2,2,0,11
21482,412677,1,3,3,0,0,11
21483,412677,1,3,4,4,0,15
21484,412677,1,3,5,4,0,19
21485,412677,1,3,6,0,1,19
21486,412677,1,4,1,0,0,19
21487,412677,1,4,2,1,0,20
21488,412677,1,4,3,1,0,21
21489,412677,1,4,4,2,0,23
21490,412677,1,4,5,0,0,23
21491,412677,1,4,6,6,0,29
21492,412677,1,5,1,4,0,33
21493,412677,1,5,2,0,0,33
21494,412677,1,5,3,1,0,34
21495,412677,1,5,4,2,0,36
21496,412677,1,5,5,0,0,36
21497,412677,1,5,6,1,0,37
21498,412677,1,6,1,6,0,43
21499,412677,1,6,2,0,1,43
21500,412677,1,6,3,0,0,43
21501,412677,1,6,4,0,0,43
21502,412677,1,6,5,0,0,43
21503,412677,1,6,6,0,0,43
21504,412677,1,7,1,1,0,44
21505,412677,1,7,2,1,0,45
21506,412677,1,7,3,0,0,45
21507,412677,1,7,4,0,0,45
21508,412677,1,7,5,1,0,46
21509,412677,1,7,6,1,0,47
21510,412677,1,8,1,1,0,48
21511,412677,1,8,2,1,0,49
21512,412677,1,8,3,2,0,51
21513,412677,1,8,4,0,0,51
21514,412677,1,8,5,0,0,51
21515,412677,1,8,6,1,0,52
21516,412677,1,9,1,2,0,54
21517,412677,1,9,2,2,0,56
21518,412677,1,9,3,1,0,57
21519,412677,1,9,4,2,0,59
21520,412677,1,9,5,0,0,59
21521,412677,1,9,6,4,0,63
21522,412677,1,10,1,0,0,63
21523,412677,1,10,2,1,0,64
21524,412677,1,10,3,2,0,66
21525,412677,1,10,4,2,0,68
21526,412677,1,10,5,0,0,68
21527,412677,1,10,6,1,0,69
21528,412677,1,11,1,1,0,70
21529,412677,1,11,2,1,0,71
21530,412677,1,11,3,1,0,72
21531,412677,1,11,4,2,0,74
21532,412677,1,11,5,1,0,75
21533,412677,1,11,6,1,0,76
21534,412677,1,12,1,1,0,77
21535,412677,1,12,2,0,1,77
21536,412677,1,12,3,0,0,77
21537,412677,1,12,4,0,1,77
21538,412677,1,12,5,0,0,77
21539,412677,1,12,6,1,0,78
21540,412677,1,13,1,1,0,79
21541,412677,1,13,2,1,0,80
21542,412677,1,13,3,0,0,80
21543,412677,1,13,4,2,0,82
21544,412677,1,13,5,1,0,83
21545,412677,1,13,6,0,1,83
21546,412677,1,14,1,3,0,86
21547,412677,1,14,2,0,0,86
21548,412677,1,14,3,1,0,87
21549,412677,1,14,4,1,0,88
21550,412677,1,14,5,1,0,89
21551,412677,1,14,6,1,0,90
21552,412677,1,15,1,0,0,90
21553,412677,1,15,2,0,0,90
21554,412677,1,15,3,0,0,90
21555,412677,1,15,4,0,0,90
21556,412677,1,15,5,1,0,91
21557,412677,1,15,6,1,0,92
21558,412677,1,16,1,0,0,92
21559,412677,1,16,2,0,0,92
21560,412677,1,16,3,0,0,92
21561,412677,1,16,4,1,0,93
21562,412677,1,16,5,0,0,93
21563,412677,1,16,6,0,1,93
21564,412677,1,17,1,0,0,93
21565,412677,1,17,2,1,0,94
21566,412677,1,17,3,4,0,98
21567,412677,1,17,4,4,0,102
21568,412677,1,17,5,1,0,103
21569,412677,1,17,6,4,0,107
21570,412677,1,18,1,6,0,113
21571,412677,1,18,2,2,0,115
21572,412677,1,18,3,1,0,116
21573,412677,1,18,4,2,0,118
21574,412677,1,18,5,1,0,119
21575,412677,1,18,6,6,0,125
21576,412677,1,19,1,0,1,125
21577,412677,1,19,2,2,0,127
21578,412677,1,19,3,0,1,127
21579,412677,1,19,4,1,0,128
21580,412677,1,19,5,0,0,128
21581,412677,1,19,6,2,0,130
21582,412677,1,20,1,1,0,131
21583,412677,1,20,2,0,0,131
21584,412677,1,20,3,0,0,131
21585,412677,1,20,4,5,0,136
21586,412677,1,20,5,2,0,138
21587,412677,1,20,6,0,1,138
21688,412678,1,1,1,1,0,1
21689,412678,1,1,2,1,0,2
21690,412678,1,1,3,0,0,2
21691,412678,1,1,4,0,0,2
21692,412678,1,1,5,0,0,2
21693,412678,1,1,6,0,0,2
21694,412678,1,2,1,0,0,2
21695,412678,1,2,2,2,0,4
21696,412678,1,2,3,1,0,5
21697,412678,1,2,4,0,0,5
21698,412678,1,2,5,1,0,6
21699,412678,1,2,6,6,0,12
21700,412678,1,3,1,0,0,12
21701,412678,1,3,2,0,0,12
21702,412678,1,3,3,1,0,13
21703,412678,1,3,4,4,0,17
21704,412678,1,3,5,1,0,18
21705,412678,1,3,6,0,0,18
21706,412678,1,4,1,0,0,18
21707,412678,1,4,2,4,0,22
21708,412678,1,4,3,1,0,23
21709,412678,1,4,4,0,0,23
21710,412678,1,4,5,1,0,24
21711,412678,1,4,6,4,0,28
21712,412678,1,5,1,0,0,28
21713,412678,1,5,2,0,0,28
21714,412678,1,5,3,1,0,29
21715,412678,1,5,4,0,0,29
21716,412678,1,5,5,1,0,30
21717,412678,1,5,6,0,0,30
21718,412678,1,6,1,4,0,34
21719,412678,1,6,2,1,0,35
21720,412678,1,6,3,0,0,35
21721,412678,1,6,4,0,1,35
21722,412678,1,6,5,0,0,35
21723,412678,1,6,6,1,0,36
21724,412678,1,7,1,1,0,37
21725,412678,1,7,2,1,0,38
21726,412678,1,7,3,1,0,39
21727,412678,1,7,4,0,0,39
21728,412678,1,7,5,1,0,40
21729,412678,1,7,6,0,0,40
21730,412678,1,8,1,1,0,41
21731,412678,1,8,2,0,0,41
21732,412678,1,8,3,0,0,41
21733,412678,1,8,4,1,0,42
21734,412678,1,8,5,1,0,43
21735,412678,1,8,6,1,0,44
21736,412678,1,9,1,0,0,44
21737,412678,1,9,2,0,1,44
21738,412678,1,9,3,0,0,44
21739,412678,1,9,4,0,0,44
21740,412678,1,9,5,3,0,47
21741,412678,1,9,6,1,0,48
21742,412678,1,10,1,1,0,49
21743,412678,1,10,2,1,0,50
21744,412678,1,10,3,1,0,51
21745,412678,1,10,4,1,0,52
21746,412678,1,10,5,1,0,53
21747,412678,1,10,6,1,0,54
21748,412678,1,11,1,0,0,54
21749,412678,1,11,2,0,0,54
21750,412678,1,11,3,1,0,55
21751,412678,1,11,4,1,0,56
21752,412678,1,11,5,2,0,58
21753,412678,1,11,6,6,0,64
21754,412678,1,12,1,2,0,66
21755,412678,1,12,2,1,0,67
21756,412678,1,12,3,1,0,68
21757,412678,1,12,4,1,0,69
21758,412678,1,12,5,2,0,71
21759,412678,1,12,6,0,0,71
21760,412678,1,13,1,0,0,71
21761,412678,1,13,2,6,0,77
21762,412678,1,13,3,1,0,78
21763,412678,1,13,4,1,0,79
21764,412678,1,13,5,0,0,79
21765,412678,1,13,6,1,0,80
21766,412678,1,14,1,1,0,81
21767,412678,1,14,2,1,0,82
21768,412678,1,14,3,4,0,86
21769,412678,1,14,4,1,0,87
21770,412678,1,14,5,2,0,89
21771,412678,1,14,6,0,0,89
21772,412678,1,15,1,1,0,90
21773,412678,1,15,2,1,0,91
21774,412678,1,15,3,0,0,91
21775,412678,1,15,4,4,0,95
21776,412678,1,15,5,1,0,96
21777,412678,1,15,6,1,0,97
21778,412678,1,16,1,4,0,101
21779,412678,1,16,2,1,0,102
21780,412678,1,16,3,1,0,103
21781,412678,1,16,4,0,1,103
21782,412678,1,16,5,2,0,105
21783,412678,1,16,6,1,0,106
21784,412678,1,17,1,4,0,110
21785,412678,1,17,2,1,0,111
21786,412678,1,17,3,1,0,112
21787,412678,1,17,4,1,0,113
21788,412678,1,17,5,1,0,114
21789,412678,1,17,6,4,0,118
21790,412678,1,18,1,0,0,118
21791,412678,1,18,2,1,0,119
21792,412678,1,18,3,2,0,121
21793,412678,1,18,4,2,0,123
21794,412678,1,18,5,1,0,124
21795,412678,1,18,6,0,0,124
21796,412678,1,19,1,0,1,124
21797,412678,1,19,2,0,0,124
21798,412678,1,19,3,1,0,125
21799,412678,1,19,4,1,0,126
21800,412678,1,19,5,1,0,127
21801,412678,1,19,6,1,0,128
21802,412678,1,20,1,0,0,128
21803,412678,1,20,2,1,0,129
21804,412678,1,20,3,6,0,135
21805,412678,1,20,4,0,1,135
21806,412678,1,20,5,0,0,135
21807,412678,1,20,6,0,1,135
21927,412679,1,1,1,0,0,0
21928,412679,1,1,2,0,0,0
21929,412679,1,1,3,2,0,2
21930,412679,1,1,4,1,0,3
21931,412679,1,1,5,0,0,3
21932,412679,1,1,6,0,0,3
21933,412679,1,2,1,2,0,5
21934,412679,1,2,2,1,0,6
21935,412679,1,2,3,0,0,6
21936,412679,1,2,4,0,1,6
21937,412679,1,2,5,2,0,8
21938,412679,1,2,6,0,0,8
21939,412679,1,3,1,2,0,10
21940,412679,1,3,2,0,0,10
21941,412679,1,3,3,4,0,14
21942,412679,1,3,4,0,0,14
21943,412679,1,3,5,0,0,14
21944,412679,1,3,6,4,0,18
21945,412679,1,4,1,4,0,22
21946,412679,1,4,2,0,0,22
21947,412679,1,4,3,0,1,22
21948,412679,1,4,4,0,0,22
21949,412679,1,4,5,0,0,22
21950,412679,1,4,6,0,0,22
21951,412679,1,5,1,0,0,22
21952,412679,1,5,2,1,0,23
21953,412679,1,5,3,1,0,24
21954,412679,1,5,4,0,0,24
21955,412679,1,5,5,4,0,28
21956,412679,1,5,6,1,0,29
21957,412679,1,6,1,0,0,29
21958,412679,1,6,2,0,0,29
21959,412679,1,6,3,0,0,29
21960,412679,1,6,4,0,1,29
21961,412679,1,6,5,0,0,29
21962,412679,1,6,6,0,0,29
21963,412679,1,7,1,1,0,30
21964,412679,1,7,2,0,0,30
21965,412679,1,7,3,0,0,30
21966,412679,1,7,4,1,0,31
21967,412679,1,7,5,0,0,31
21968,412679,1,7,6,2,0,33
21969,412679,1,8,1,0,0,33
21970,412679,1,8,2,0,0,33
21971,412679,1,8,3,1,0,34
21972,412679,1,8,4,0,0,34
21973,412679,1,8,5,0,0,34
21974,412679,1,8,6,1,0,35
21975,412679,1,9,1,4,0,39
21976,412679,1,9,2,1,0,40
21977,412679,1,9,3,0,0,40
21978,412679,1,9,4,0,0,40
21979,412679,1,9,5,0,0,40
21980,412679,1,9,6,0,0,40
21981,412679,1,10,1,1,0,41
21982,412679,1,10,2,1,0,42
21983,412679,1,10,3,1,0,43
21984,412679,1,10,4,0,0,43
21985,412679,1,10,5,0,0,43
21986,412679,1,10,6,0,0,43
21987,412679,1,11,1,1,0,44
21988,412679,1,11,2,6,0,50
21989,412679,1,11,3,1,0,51
21990,412679,1,11,4,0,0,51
21991,412679,1,11,5,1,0,52
21992,412679,1,11,6,0,0,52
21993,412679,1,12,1,2,0,54
21994,412679,1,12,2,1,0,55
21995,412679,1,12,3,1,0,56
21996,412679,1,12,4,1,0,57
21997,412679,1,12,5,0,0,57
21998,412679,1,12,6,0,0,57
21999,412679,1,13,1,2,0,59
22000,412679,1,13,2,0,0,59
22001,412679,1,13,3,2,0,61
22002,412679,1,13,4,1,0,62
22003,412679,1,13,5,1,0,63
22004,412679,1,13,6,6,0,69
22005,412679,1,14,1,4,0,73
22006,412679,1,14,2,1,0,74
22007,412679,1,14,3,1,0,75
22008,412679,1,14,4,1,0,76
22009,412679,1,14,5,1,0,77
22010,412679,1,14,6,2,0,79
22011,412679,1,15,1,1,0,80
22012,412679,1,15,2,0,0,80
22013,412679,1,15,3,0,0,80
22014,412679,1,15,4,0,0,80
22015,412679,1,15,5,0,0,80
22016,412679,1,15,6,1,0,81
22017,412679,1,16,1,2,0,83
22018,412679,1,16,2,1,0,84
22019,412679,1,16,3,6,0,90
22020,412679,1,16,4,2,0,92
22021,412679,1,16,5,2,0,94
22022,412679,1,16,6,1,0,95
22023,412679,1,17,1,0,0,95
22024,412679,1,17,2,1,0,96
22025,412679,1,17,3,1,0,97
22026,412679,1,17,4,0,1,97
22027,412679,1,17,5,0,0,97
22028,412679,1,17,6,0,0,97
22029,412679,1,18,1,0,1,97
22030,412679,1,18,2,0,1,97
22031,412679,1,18,3,1,0,98
22032,412679,1,18,4,0,0,98
22033,412679,1,18,5,1,0,99
22034,412679,1,18,6,1,0,100
22035,412679,1,19,1,1,0,101
22036,412679,1,19,2,0,0,101
22037,412679,1,19,3,2,0,103
22038,412679,1,19,4,4,0,107
22039,412679,1,19,5,0,1,107
22040,412679,1,19,6,1,0,108
22041,412679,1,20,1,1,0,109
22042,412679,1,20,2,1,0,110
22043,412679,1,20,3,0,0,110
22044,412679,1,20,4,4,0,114
22045,412679,1,20,5,0,1,114
22046,412679,1,20,6,1,0,115
22136,412680,1,1,1,0,0,0
22137,412680,1,1,2,2,0,2
22138,412680,1,1,3,1,0,3
22139,412680,1,1,4,4,0,7
22140,412680,1,1,5,1,0,8
22141,412680,1,1,6,2,0,10
22142,412680,1,2,1,0,0,10
22143,412680,1,2,2,4,0,14
22144,412680,1,2,3,4,0,18
22145,412680,1,2,4,0,0,18
22146,412680,1,2,5,0,0,18
22147,412680,1,2,6,1,0,19
22148,412680,1,3,1,0,0,19
22149,412680,1,3,2,1,0,20
22150,412680,1,3,3,1,0,21
22151,412680,1,3,4,2,0,23
22152,412680,1,3,5,1,0,24
22153,412680,1,3,6,4,0,28
22154,412680,1,4,1,1,0,29
22155,412680,1,4,2,0,0,29
22156,412680,1,4,3,1,0,30
22157,412680,1,4,4,0,0,30
22158,412680,1,4,5,4,0,34
22159,412680,1,4,6,1,0,35
22160,412680,1,5,1,2,0,37
22161,412680,1,5,2,1,0,38
22162,412680,1,5,3,0,0,38
22163,412680,1,5,4,4,0,42
22164,412680,1,5,5,0,0,42
22165,412680,1,5,6,0,0,42
22166,412680,1,6,1,0,0,42
22167,412680,1,6,2,0,0,42
22168,412680,1,6,3,0,0,42
22169,412680,1,6,4,0,0,42
22170,412680,1,6,5,4,0,46
22171,412680,1,6,6,1,0,47
22172,412680,1,7,1,0,0,47
22173,412680,1,7,2,1,0,48
22174,412680,1,7,3,1,0,49
22175,412680,1,7,4,1,0,50
22176,412680,1,7,5,4,0,54
22177,412680,1,7,6,1,0,55
22178,412680,1,8,1,0,0,55
22179,412680,1,8,2,1,0,56
22180,412680,1,8,3,1,0,57
22181,412680,1,8,4,0,0,57
22182,412680,1,8,5,0,0,57
22183,412680,1,8,6,4,0,61
22184,412680,1,9,1,4,0,65
22185,412680,1,9,2,2,0,67
22186,412680,1,9,3,2,0,69
22187,412680,1,9,4,1,0,70
22188,412680,1,9,5,1,0,71
22189,412680,1,9,6,0,0,71
22190,412680,1,10,1,4,0,75
22191,412680,1,10,2,2,0,77
22192,412680,1,10,3,0,0,77
22193,412680,1,10,4,1,0,78
22194,412680,1,10,5,1,0,79
22195,412680,1,10,6,1,0,80
22196,412680,1,11,1,6,0,86
22197,412680,1,11,2,1,0,87
22198,412680,1,11,3,1,0,88
22199,412680,1,11,4,1,0,89
22200,412680,1,11,5,2,0,91
22201,412680,1,11,6,1,0,92
22202,412680,1,12,1,0,0,92
22203,412680,1,12,2,1,0,93
22204,412680,1,12,3,6,0,99
22205,412680,1,12,4,1,0,100
22206,412680,1,12,5,0,0,100
22207,412680,1,12,6,4,0,104
22208,412680,1,13,1,0,0,104
22209,412680,1,13,2,1,0,105
22210,412680,1,13,3,1,0,106
22211,412680,1,13,4,1,0,107
22212,412680,1,13,5,4,0,111
22213,412680,1,13,6,1,0,112
22214,412680,1,14,1,1,0,113
22215,412680,1,14,2,4,0,117
22216,412680,1,14,3,1,0,118
22217,412680,1,14,4,1,0,119
22218,412680,1,14,5,1,0,120
22219,412680,1,14,6,4,0,124
22220,412680,1,15,1,1,0,125
22221,412680,1,15,2,6,0,131
22222,412680,1,15,3,1,0,132
22223,412680,1,15,4,1,0,133
22224,412680,1,15,5,1,0,134
22225,412680,1,15,6,4,0,138
22226,412680,1,16,1,1,0,139
22227,412680,1,16,2,1,0,140
22228,412680,1,16,3,1,0,141
22229,412680,1,16,4,1,0,142
22230,412680,1,16,5,0,1,142
22231,412680,1,16,6,1,0,143
22232,412680,1,17,1,1,0,144
22233,412680,1,17,2,1,0,145
22234,412680,1,17,3,0,0,145
22235,412680,1,17,4,0,0,145
22236,412680,1,17,5,2,0,147
22237,412680,1,17,6,2,0,149
22238,412680,1,18,1,2,0,151
22239,412680,1,18,2,1,0,152
22240,412680,1,18,3,2,0,154
22241,412680,1,18,4,1,0,155
22242,412680,1,18,5,1,0,156
22243,412680,1,18,6,0,1,156
22244,412680,1,19,1,2,0,158
22245,412680,1,19,2,0,1,158
22246,412680,1,19,3,1,0,159
22247,412680,1,19,4,1,0,160
22248,412680,1,19,5,2,0,162
22249,412680,1,19,6,2,0,164
22250,412680,1,20,1,0,0,164
22251,412680,1,20,2,2,0,166
22252,412680,1,20,3,1,0,167
22253,412680,1,20,4,2,0,169
22254,412680,1,20,5,1,0,170
22255,412680,1,20,6,2,0,172
22376,412682,1,1,1,4,0,4
22377,412682,1,1,2,0,1,4
22378,412682,1,1,3,0,0,4
22379,412682,1,1,4,1,0,5
22380,412682,1,1,5,0,0,5
22381,412682,1,1,6,0,0,5
22382,412682,1,2,1,0,0,5
22383,412682,1,2,2,0,0,5
22384,412682,1,2,3,2,0,7
22385,412682,1,2,4,1,0,8
22386,412682,1,2,5,1,0,9
22387,412682,1,2,6,0,0,9
22388,412682,1,3,1,1,0,10
22389,412682,1,3,2,0,0,10
22390,412682,1,3,3,0,0,10
22391,412682,1,3,4,0,0,10
22392,412682,1,3,5,0,0,10
22393,412682,1,3,6,4,0,14
22394,412682,1,4,1,0,0,14
22395,412682,1,4,2,1,0,15
22396,412682,1,4,3,4,0,19
22397,412682,1,4,4,0,0,19
22398,412682,1,4,5,2,0,21
22399,412682,1,4,6,0,0,21
22400,412682,1,5,1,3,0,24
22401,412682,1,5,2,1,0,25
22402,412682,1,5,3,1,0,26
22403,412682,1,5,4,0,0,26
22404,412682,1,5,5,0,0,26
22405,412682,1,5,6,4,0,30
22406,412682,1,6,1,1,0,31
22407,412682,1,6,2,1,0,32
22408,412682,1,6,3,0,1,32
22409,412682,1,6,4,0,0,32
22410,412682,1,6,5,4,0,36
22411,412682,1,6,6,0,0,36
22412,412682,1,7,1,0,0,36
22413,412682,1,7,2,0,0,36
22414,412682,1,7,3,0,0,36
22415,412682,1,7,4,2,0,38
22416,412682,1,7,5,1,0,39
22417,412682,1,7,6,0,0,39
22418,412682,1,8,1,0,0,39
22419,412682,1,8,2,0,0,39
22420,412682,1,8,3,1,0,40
22421,412682,1,8,4,1,0,41
22422,412682,1,8,5,1,0,42
22423,412682,1,8,6,1,0,43
22424,412682,1,9,1,2,0,45
22425,412682,1,9,2,4,0,49
22426,412682,1,9,3,1,0,50
22427,412682,1,9,4,0,0,50
22428,412682,1,9,5,6,0,56
22429,412682,1,9,6,0,0,56
22430,412682,1,10,1,6,0,62
22431,412682,1,10,2,0,0,62
22432,412682,1,10,3,0,0,62
22433,412682,1,10,4,2,0,64
22434,412682,1,10,5,2,0,66
22435,412682,1,10,6,1,0,67
22436,412682,1,11,1,0,0,67
22437,412682,1,11,2,4,0,71
22438,412682,1,11,3,0,0,71
22439,412682,1,11,4,2,0,73
22440,412682,1,11,5,1,0,74
22441,412682,1,11,6,6,0,80
22442,412682,1,12,1,1,0,81
22443,412682,1,12,2,1,0,82
22444,412682,1,12,3,1,0,83
22445,412682,1,12,4,0,0,83
22446,412682,1,12,5,5,0,88
22447,412682,1,12,6,1,0,89
22448,412682,1,13,1,0,0,89
22449,412682,1,13,2,4,0,93
22450,412682,1,13,3,1,0,94
22451,412682,1,13,4,1,0,95
22452,412682,1,13,5,0,0,95
22453,412682,1,13,6,1,0,96
22454,412682,1,14,1,4,0,100
22455,412682,1,14,2,0,0,100
22456,412682,1,14,3,1,0,101
22457,412682,1,14,4,1,0,102
22458,412682,1,14,5,1,0,103
22459,412682,1,14,6,1,0,104
22460,412682,1,15,1,1,0,105
22461,412682,1,15,2,0,0,105
22462,412682,1,15,3,1,0,106
22463,412682,1,15,4,4,0,110
22464,412682,1,15,5,0,0,110
22465,412682,1,15,6,1,0,111
22466,412682,1,16,1,1,0,112
22467,412682,1,16,2,1,0,113
22468,412682,1,16,3,6,0,119
22469,412682,1,16,4,1,0,120
22470,412682,1,16,5,0,1,120
22471,412682,1,16,6,6,0,126
22472,412682,1,17,1,1,0,127
22473,412682,1,17,2,2,0,129
22474,412682,1,17,3,1,0,130
22475,412682,1,17,4,4,0,134
22476,412682,1,17,5,1,0,135
22477,412682,1,17,6,1,0,136
22478,412682,1,18,1,6,0,142
22479,412682,1,18,2,1,0,143
22480,412682,1,18,3,4,0,147
22481,412682,1,18,4,4,0,151
22482,412682,1,18,5,4,0,155
22483,412682,1,18,6,6,0,161
22484,412682,1,19,1,1,0,162
22485,412682,1,19,2,1,0,163
22486,412682,1,19,3,0,1,163
22487,412682,1,19,4,1,0,164
22488,412682,1,19,5,2,0,166
22489,412682,1,19,6,1,0,167
22490,412682,1,20,1,4,0,171
22491,412682,1,20,2,1,0,172
22492,412682,1,20,3,6,0,178
22493,412682,1,20,4,0,1,178
22494,412682,1,20,5,2,0,180
22495,412682,1,20,6,6,0,186
22616,412683,1,1,1,0,0,0
22617,412683,1,1,2,4,0,4
22618,412683,1,1,3,0,0,4
22619,412683,1,1,4,0,0,4
22620,412683,1,1,5,0,0,4
22621,412683,1,1,6,1,0,5
22622,412683,1,2,1,0,0,5
22623,412683,1,2,2,1,0,6
22624,412683,1,2,3,0,0,6
22625,412683,1,2,4,0,0,6
22626,412683,1,2,5,1,0,7
22627,412683,1,2,6,6,0,13
22628,412683,1,3,1,1,0,14
22629,412683,1,3,2,1,0,15
22630,412683,1,3,3,2,0,17
22631,412683,1,3,4,2,0,19
22632,412683,1,3,5,1,0,20
22633,412683,1,3,6,0,0,20
22634,412683,1,4,1,4,0,24
22635,412683,1,4,2,2,0,26
22636,412683,1,4,3,6,0,32
22637,412683,1,4,4,1,0,33
22638,412683,1,4,5,4,0,37
22639,412683,1,4,6,0,0,37
22640,412683,1,5,1,0,0,37
22641,412683,1,5,2,2,0,39
22642,412683,1,5,3,1,0,40
22643,412683,1,5,4,4,0,44
22644,412683,1,5,5,4,0,48
22645,412683,1,5,6,0,0,48
22646,412683,1,6,1,1,0,49
22647,412683,1,6,2,1,0,50
22648,412683,1,6,3,1,0,51
22649,412683,1,6,4,0,1,51
22650,412683,1,6,5,0,0,51
22651,412683,1,6,6,4,0,55
22652,412683,1,7,1,1,0,56
22653,412683,1,7,2,0,0,56
22654,412683,1,7,3,0,0,56
22655,412683,1,7,4,0,0,56
22656,412683,1,7,5,0,0,56
22657,412683,1,7,6,0,0,56
22658,412683,1,8,1,1,0,57
22659,412683,1,8,2,4,0,61
22660,412683,1,8,3,2,0,63
22661,412683,1,8,4,1,0,64
22662,412683,1,8,5,0,1,64
22663,412683,1,8,6,0,0,64
22664,412683,1,9,1,1,0,65
22665,412683,1,9,2,0,0,65
22666,412683,1,9,3,0,0,65
22667,412683,1,9,4,1,0,66
22668,412683,1,9,5,4,0,70
22669,412683,1,9,6,2,0,72
22670,412683,1,10,1,1,0,73
22671,412683,1,10,2,6,0,79
22672,412683,1,10,3,6,0,85
22673,412683,1,10,4,0,0,85
22674,412683,1,10,5,1,0,86
22675,412683,1,10,6,0,0,86
22676,412683,1,11,1,1,0,87
22677,412683,1,11,2,1,0,88
22678,412683,1,11,3,2,0,90
22679,412683,1,11,4,4,0,94
22680,412683,1,11,5,0,0,94
22681,412683,1,11,6,1,0,95
22682,412683,1,12,1,0,0,95
22683,412683,1,12,2,0,0,95
22684,412683,1,12,3,4,0,99
22685,412683,1,12,4,1,0,100
22686,412683,1,12,5,0,0,100
22687,412683,1,12,6,1,0,101
22688,412683,1,13,1,6,0,107
22689,412683,1,13,2,1,0,108
22690,412683,1,13,3,6,0,114
22691,412683,1,13,4,1,0,115
22692,412683,1,13,5,1,0,116
22693,412683,1,13,6,0,0,116
22694,412683,1,14,1,0,0,116
22695,412683,1,14,2,2,0,118
22696,412683,1,14,3,4,0,122
22697,412683,1,14,4,0,0,122
22698,412683,1,14,5,1,0,123
22699,412683,1,14,6,0,0,123
22700,412683,1,15,1,0,0,123
22701,412683,1,15,2,4,0,127
22702,412683,1,15,3,2,0,129
22703,412683,1,15,4,0,0,129
22704,412683,1,15,5,1,0,130
22705,412683,1,15,6,4,0,134
22706,412683,1,16,1,6,0,140
22707,412683,1,16,2,2,0,142
22708,412683,1,16,3,7,0,149
22709,412683,1,16,4,6,0,155
22710,412683,1,16,5,6,0,161
22711,412683,1,16,6,1,0,162
22712,412683,1,17,1,0,1,162
22713,412683,1,17,2,1,0,163
22714,412683,1,17,3,1,0,164
22715,412683,1,17,4,0,1,164
22716,412683,1,17,5,1,0,165
22717,412683,1,17,6,2,0,167
22718,412683,1,18,1,1,0,168
22719,412683,1,18,2,1,0,169
22720,412683,1,18,3,5,0,174
22721,412683,1,18,4,1,0,175
22722,412683,1,18,5,0,0,175
22723,412683,1,18,6,4,0,179
22724,412683,1,19,1,2,0,181
22725,412683,1,19,2,0,1,181
22726,412683,1,19,3,1,0,182
22727,412683,1,19,4,1,0,183
22728,412683,1,19,5,2,0,185
22729,412683,1,19,6,6,0,191
22730,412683,1,20,1,0,1,191
22731,412683,1,20,2,0,1,191
22732,412683,1,20,3,0,1,191
22733,412683,1,20,4,0,1,191
22734,412683,1,20,5,0,0,191
22735,412683,1,20,6,0,1,191
22856,412684,1,1,1,1,0,1
22857,412684,1,1,2,2,0,3
22858,412684,1,1,3,4,0,7
22859,412684,1,1,4,0,0,7
22860,412684,1,1,5,1,0,8
22861,412684,1,1,6,0,0,8
22862,412684,1,2,1,0,0,8
22863,412684,1,2,2,0,0,8
22864,412684,1,2,3,0,0,8
22865,412684,1,2,4,1,0,9
22866,412684,1,2,5,1,0,10
22867,412684,1,2,6,4,0,14
22868,412684,1,3,1,1,0,15
22869,412684,1,3,2,1,0,16
22870,412684,1,3,3,2,0,18
22871,412684,1,3,4,1,0,19
22872,412684,1,3,5,0,0,19
22873,412684,1,3,6,1,0,20
22874,412684,1,4,1,1,0,21
22875,412684,1,4,2,4,0,25
22876,412684,1,4,3,2,0,27
22877,412684,1,4,4,0,0,27
22878,412684,1,4,5,1,0,28
22879,412684,1,4,6,0,0,28
22880,412684,1,5,1,4,0,32
22881,412684,1,5,2,2,0,34
22882,412684,1,5,3,2,0,36
22883,412684,1,5,4,0,1,36
22884,412684,1,5,5,1,0,37
22885,412684,1,5,6,4,0,41
22886,412684,1,6,1,1,0,42
22887,412684,1,6,2,0,0,42
22888,412684,1,6,3,1,0,43
22889,412684,1,6,4,4,0,47
22890,412684,1,6,5,1,0,48
22891,412684,1,6,6,6,0,54
22892,412684,1,7,1,1,0,55
22893,412684,1,7,2,1,0,56
22894,412684,1,7,3,1,0,57
22895,412684,1,7,4,1,1,58
22896,412684,1,7,5,1,0,59
22897,412684,1,7,6,0,0,59
22898,412684,1,8,1,1,0,60
22899,412684,1,8,2,0,1,60
22900,412684,1,8,3,0,0,60
22901,412684,1,8,4,1,0,61
22902,412684,1,8,5,1,0,62
22903,412684,1,8,6,0,0,62
22904,412684,1,9,1,0,1,62
22905,412684,1,9,2,0,0,62
22906,412684,1,9,3,0,1,62
22907,412684,1,9,4,1,0,63
22908,412684,1,9,5,0,0,63
22909,412684,1,9,6,0,1,63
22910,412684,1,10,1,1,0,64
22911,412684,1,10,2,0,0,64
22912,412684,1,10,3,1,0,65
22913,412684,1,10,4,0,0,65
22914,412684,1,10,5,0,0,65
22915,412684,1,10,6,1,0,66
22916,412684,1,11,1,1,0,67
22917,412684,1,11,2,0,0,67
22918,412684,1,11,3,0,0,67
22919,412684,1,11,4,0,0,67
22920,412684,1,11,5,1,0,68
22921,412684,1,11,6,0,0,68
22922,412684,1,12,1,1,0,69
22923,412684,1,12,2,1,0,70
22924,412684,1,12,3,1,0,71
22925,412684,1,12,4,1,0,72
22926,412684,1,12,5,0,0,72
22927,412684,1,12,6,0,0,72
22928,412684,1,13,1,0,0,72
22929,412684,1,13,2,1,0,73
22930,412684,1,13,3,0,1,73
22931,412684,1,13,4,1,0,74
22932,412684,1,13,5,0,1,74
22933,412684,1,13,6,0,1,74
22934,412684,1,14,1,0,0,74
22935,412684,1,14,2,1,0,75
22936,412684,1,14,3,2,0,77
22937,412684,1,14,4,1,0,78
22938,412684,1,14,5,1,0,79
22939,412684,1,14,6,1,0,80
22940,412684,1,15,1,0,0,80
22941,412684,1,15,2,0,0,80
22942,412684,1,15,3,1,0,81
22943,412684,1,15,4,1,0,82
22944,412684,1,15,5,1,0,83
22945,412684,1,15,6,1,0,84
22946,412684,1,16,1,0,1,84
22996,412685,1,1,1,0,0,0
22997,412685,1,1,2,0,0,0
22998,412685,1,1,3,2,0,2
22999,412685,1,1,4,2,0,4
23000,412685,1,1,5,0,0,4
23001,412685,1,1,6,1,0,5
23002,412685,1,2,1,5,0,10
23003,412685,1,2,2,5,0,15
23004,412685,1,2,3,3,0,18
23005,412685,1,2,4,0,0,18
23006,412685,1,2,5,2,0,20
23007,412685,1,2,6,1,0,21
23008,412685,1,3,1,4,0,25
23009,412685,1,3,2,4,0,29
23010,412685,1,3,3,1,0,30
23011,412685,1,3,4,0,0,30
23012,412685,1,3,5,0,0,30
23013,412685,1,3,6,0,0,30
23014,412685,1,4,1,1,0,31
23015,412685,1,4,2,4,0,35
23016,412685,1,4,3,1,0,36
23017,412685,1,4,4,0,1,36
23018,412685,1,4,5,4,0,40
23019,412685,1,4,6,1,0,41
23020,412685,1,5,1,0,0,41
23021,412685,1,5,2,2,0,43
23022,412685,1,5,3,1,0,44
23023,412685,1,5,4,6,0,50
23024,412685,1,5,5,1,0,51
23025,412685,1,5,6,0,0,51
23026,412685,1,6,1,0,0,51
23027,412685,1,6,2,6,0,57
23028,412685,1,6,3,1,0,58
23029,412685,1,6,4,1,0,59
23030,412685,1,6,5,1,0,60
23031,412685,1,6,6,0,0,60
23032,412685,1,7,1,0,0,60
23033,412685,1,7,2,6,0,66
23034,412685,1,7,3,0,1,66
23035,412685,1,7,4,0,0,66
23036,412685,1,7,5,3,0,69
23037,412685,1,7,6,2,0,71
23038,412685,1,8,1,1,0,72
23039,412685,1,8,2,1,0,73
23040,412685,1,8,3,1,0,74
23041,412685,1,8,4,0,0,74
23042,412685,1,8,5,0,0,74
23043,412685,1,8,6,1,0,75
23044,412685,1,9,1,0,0,75
23045,412685,1,9,2,1,0,76
23046,412685,1,9,3,1,0,77
23047,412685,1,9,4,2,0,79
23048,412685,1,9,5,1,0,80
23049,412685,1,9,6,0,0,80
23050,412685,1,10,1,1,0,81
23051,412685,1,10,2,0,0,81
23052,412685,1,10,3,0,1,81
23053,412685,1,10,4,1,0,82
23054,412685,1,10,5,6,0,88
23055,412685,1,10,6,0,1,88
23056,412685,1,11,1,1,0,89
23057,412685,1,11,2,0,0,89
23058,412685,1,11,3,0,0,89
23059,412685,1,11,4,0,0,89
23060,412685,1,11,5,1,0,90
23061,412685,1,11,6,1,0,91
23062,412685,1,12,1,2,0,93
23063,412685,1,12,2,1,0,94
23064,412685,1,12,3,1,0,95
23065,412685,1,12,4,0,0,95
23066,412685,1,12,5,1,0,96
23067,412685,1,12,6,1,0,97
23068,412685,1,13,1,0,0,97
23069,412685,1,13,2,6,0,103
23070,412685,1,13,3,0,0,103
23071,412685,1,13,4,1,0,104
23072,412685,1,13,5,0,0,104
23073,412685,1,13,6,1,0,105
23074,412685,1,14,1,1,0,106
23075,412685,1,14,2,1,0,107
23076,412685,1,14,3,1,0,108
23077,412685,1,14,4,0,0,108
23078,412685,1,14,5,0,0,108
23079,412685,1,14,6,1,0,109
23080,412685,1,15,1,0,0,109
23081,412685,1,15,2,1,0,110
23082,412685,1,15,3,1,0,111
23083,412685,1,15,4,2,0,113
23084,412685,1,15,5,1,0,114
23085,412685,1,15,6,1,0,115
23086,412685,1,16,1,6,0,121
23087,412685,1,16,2,1,0,122
23088,412685,1,16,3,2,0,124
23089,412685,1,16,4,1,0,125
23090,412685,1,16,5,6,0,131
23091,412685,1,16,6,0,0,131
23092,412685,1,17,1,0,0,131
23093,412685,1,17,2,4,0,135
23094,412685,1,17,3,1,0,136
23095,412685,1,17,4,1,0,137
23096,412685,1,17,5,2,0,139
23097,412685,1,17,6,6,0,145
23098,412685,1,18,1,6,0,151
23099,412685,1,18,2,6,0,157
23100,412685,1,18,3,8,0,165
23101,412685,1,18,4,4,0,169
23102,412685,1,18,5,2,0,171
23103,412685,1,18,6,1,0,172
23104,412685,1,19,1,1,0,173
23105,412685,1,19,2,1,0,174
23106,412685,1,19,3,2,0,176
23107,412685,1,19,4,4,0,180
23108,412685,1,19,5,1,0,181
23109,412685,1,19,6,1,0,182
23110,412685,1,20,1,1,0,183
23111,412685,1,20,2,0,1,183
23112,412685,1,20,3,2,0,185
23113,412685,1,20,4,0,0,185
23114,412685,1,20,5,4,0,189
23115,412685,1,20,6,2,0,191
23151,412686,1,1,1,0,0,0
23152,412686,1,1,2,4,0,4
23153,412686,1,1,3,6,0,10
23154,412686,1,1,4,0,0,10
23155,412686,1,1,5,0,0,10
23156,412686,1,1,6,4,0,14
23157,412686,1,2,1,2,0,16
23158,412686,1,2,2,1,0,17
23159,412686,1,2,3,0,0,17
23160,412686,1,2,4,1,0,18
23161,412686,1,2,5,0,0,18
23162,412686,1,2,6,6,0,24
23163,412686,1,3,1,0,1,24
23164,412686,1,3,2,0,0,24
23165,412686,1,3,3,0,0,24
23166,412686,1,3,4,0,0,24
23167,412686,1,3,5,4,0,28
23168,412686,1,3,6,1,0,29
23169,412686,1,4,1,1,0,30
23170,412686,1,4,2,0,0,30
23171,412686,1,4,3,0,0,30
23172,412686,1,4,4,1,0,31
23173,412686,1,4,5,1,0,32
23174,412686,1,4,6,1,0,33
23175,412686,1,5,1,6,0,39
23176,412686,1,5,2,1,0,40
23177,412686,1,5,3,1,0,41
23178,412686,1,5,4,0,0,41
23179,412686,1,5,5,4,0,45
23180,412686,1,5,6,4,0,49
23181,412686,1,6,1,1,0,50
23182,412686,1,6,2,0,0,50
23183,412686,1,6,3,4,0,54
23184,412686,1,6,4,1,0,55
23185,412686,1,6,5,4,0,59
23186,412686,1,6,6,0,0,59
23187,412686,1,7,1,1,0,60
23188,412686,1,7,2,0,0,60
23189,412686,1,7,3,0,0,60
23190,412686,1,7,4,0,0,60
23191,412686,1,7,5,6,0,66
23192,412686,1,7,6,1,0,67
23193,412686,1,8,1,2,0,69
23194,412686,1,8,2,0,0,69
23195,412686,1,8,3,1,0,70
23196,412686,1,8,4,1,0,71
23197,412686,1,8,5,1,0,72
23198,412686,1,8,6,1,0,73
23199,412686,1,9,1,1,0,74
23200,412686,1,9,2,6,0,80
23201,412686,1,9,3,0,0,80
23202,412686,1,9,4,0,1,80
23203,412686,1,9,5,0,0,80
23204,412686,1,9,6,0,0,80
23205,412686,1,10,1,2,0,82
23206,412686,1,10,2,0,0,82
23207,412686,1,10,3,1,0,83
23208,412686,1,10,4,1,0,84
23209,412686,1,10,5,1,0,85
23210,412686,1,10,6,1,0,86
23211,412686,1,11,1,1,0,87
23212,412686,1,11,2,2,0,89
23213,412686,1,11,3,2,0,91
23214,412686,1,11,4,2,0,93
23215,412686,1,11,5,1,0,94
23216,412686,1,11,6,0,0,94
23217,412686,1,12,1,2,1,96
23218,412686,1,12,2,0,0,96
23219,412686,1,12,3,1,0,97
23220,412686,1,12,4,0,0,97
23221,412686,1,12,5,2,0,99
23222,412686,1,12,6,1,0,100
23223,412686,1,13,1,0,0,100
23224,412686,1,13,2,1,0,101
23225,412686,1,13,3,5,0,106
23226,412686,1,13,4,1,0,107
23227,412686,1,13,5,6,0,113
23228,412686,1,13,6,0,1,113
23229,412686,1,14,1,1,0,114
23230,412686,1,14,2,0,0,114
23231,412686,1,14,3,0,0,114
23232,412686,1,14,4,0,0,114
23233,412686,1,14,5,2,0,116
23234,412686,1,14,6,1,0,117
23235,412686,1,15,1,1,0,118
23236,412686,1,15,2,1,0,119
23237,412686,1,15,3,2,0,121
23238,412686,1,15,4,2,0,123
23239,412686,1,15,5,1,0,124
23240,412686,1,15,6,0,0,124
23241,412686,1,16,1,6,0,130
23242,412686,1,16,2,2,0,132
23243,412686,1,16,3,0,0,132
23244,412686,1,16,4,0,0,132
23245,412686,1,16,5,4,0,136
23246,412686,1,16,6,1,0,137
23247,412686,1,17,1,1,0,138
23248,412686,1,17,2,0,1,138
23249,412686,1,17,3,1,0,139
23250,412686,1,17,4,4,0,143
23251,412686,1,17,5,4,0,147
23252,412686,1,17,6,1,0,148
23253,412686,1,18,1,0,0,148
23254,412686,1,18,2,1,0,149
23255,412686,1,18,3,6,0,155
23256,412686,1,18,4,1,0,156
23257,412686,1,18,5,0,0,156
23258,412686,1,18,6,1,0,157
23259,412686,1,19,1,1,0,158
23260,412686,1,19,2,6,0,164
23261,412686,1,19,3,1,0,165
23262,412686,1,19,4,1,0,166
23263,412686,1,19,5,0,1,166
23264,412686,1,19,6,0,1,166
23265,412686,1,20,1,1,0,167
23266,412686,1,20,2,2,0,169
23267,412686,1,20,3,1,0,170
23268,412686,1,20,4,0,0,170
23269,412686,1,20,5,1,0,171
23270,412686,1,20,6,2,0,173
23301,412687,1,1,1,0,0,0
23302,412687,1,1,2,4,0,4
23303,412687,1,1,3,4,0,8
23304,412687,1,1,4,0,0,8
23305,412687,1,1,5,0,0,8
23306,412687,1,1,6,4,0,12
23307,412687,1,2,1,1,1,13
23308,412687,1,2,2,0,0,13
23309,412687,1,2,3,1,0,14
23310,412687,1,2,4,1,0,15
23311,412687,1,2,5,0,0,15
23312,412687,1,2,6,2,0,17
23313,412687,1,3,1,1,0,18
23314,412687,1,3,2,0,0,18
23315,412687,1,3,3,1,0,19
23316,412687,1,3,4,4,0,23
23317,412687,1,3,5,2,0,25
23318,412687,1,3,6,6,0,31
23319,412687,1,4,1,0,0,31
23320,412687,1,4,2,1,0,32
23321,412687,1,4,3,1,0,33
23322,412687,1,4,4,6,0,39
23323,412687,1,4,5,0,0,39
23324,412687,1,4,6,6,0,45
23325,412687,1,5,1,0,0,45
23326,412687,1,5,2,0,1,45
23327,412687,1,5,3,0,0,45
23328,412687,1,5,4,1,0,46
23329,412687,1,5,5,0,0,46
23330,412687,1,5,6,1,0,47
23331,412687,1,6,1,1,0,48
23332,412687,1,6,2,1,0,49
23333,412687,1,6,3,0,0,49
23334,412687,1,6,4,0,0,49
23335,412687,1,6,5,0,0,49
23336,412687,1,6,6,0,0,49
23337,412687,1,7,1,1,0,50
23338,412687,1,7,2,1,0,51
23339,412687,1,7,3,0,0,51
23340,412687,1,7,4,2,0,53
23341,412687,1,7,5,1,0,54
23342,412687,1,7,6,0,0,54
23343,412687,1,8,1,2,0,56
23344,412687,1,8,2,0,0,56
23345,412687,1,8,3,1,0,57
23346,412687,1,8,4,0,0,57
23347,412687,1,8,5,1,0,58
23348,412687,1,8,6,1,0,59
23349,412687,1,9,1,3,0,62
23350,412687,1,9,2,0,0,62
23351,412687,1,9,3,1,0,63
23352,412687,1,9,4,6,0,69
23353,412687,1,9,5,1,0,70
23354,412687,1,9,6,1,0,71
23355,412687,1,10,1,0,0,71
23356,412687,1,10,2,1,0,72
23357,412687,1,10,3,0,0,72
23358,412687,1,10,4,0,0,72
23359,412687,1,10,5,0,0,72
23360,412687,1,10,6,1,0,73
23361,412687,1,11,1,0,0,73
23362,412687,1,11,2,4,0,77
23363,412687,1,11,3,0,1,77
23364,412687,1,11,4,0,0,77
23365,412687,1,11,5,1,0,78
23366,412687,1,11,6,1,0,79
23367,412687,1,12,1,1,0,80
23368,412687,1,12,2,0,0,80
23369,412687,1,12,3,1,0,81
23370,412687,1,12,4,0,0,81
23371,412687,1,12,5,2,0,83
23372,412687,1,12,6,1,0,84
23373,412687,1,13,1,0,1,84
23374,412687,1,13,2,1,0,85
23375,412687,1,13,3,0,0,85
23376,412687,1,13,4,1,0,86
23377,412687,1,13,5,1,0,87
23378,412687,1,13,6,0,0,87
23379,412687,1,14,1,0,0,87
23380,412687,1,14,2,1,0,88
23381,412687,1,14,3,0,0,88
23382,412687,1,14,4,0,0,88
23383,412687,1,14,5,1,0,89
23384,412687,1,14,6,1,0,90
23385,412687,1,15,1,0,1,90
23386,412687,1,15,2,0,0,90
23387,412687,1,15,3,1,0,91
23388,412687,1,15,4,3,0,94
23389,412687,1,15,5,1,0,95
23390,412687,1,15,6,1,0,96
23391,412687,1,16,1,1,0,97
23392,412687,1,16,2,1,0,98
23393,412687,1,16,3,1,0,99
23394,412687,1,16,4,0,0,99
23395,412687,1,16,5,6,0,105
23396,412687,1,16,6,1,0,106
23397,412687,1,17,1,0,0,106
23398,412687,1,17,2,4,0,110
23399,412687,1,17,3,1,0,111
23400,412687,1,17,4,0,0,111
23401,412687,1,17,5,1,0,112
23402,412687,1,17,6,4,0,116
23403,412687,1,18,1,6,0,122
23404,412687,1,18,2,1,0,123
23405,412687,1,18,3,1,0,124
23406,412687,1,18,4,1,0,125
23407,412687,1,18,5,1,0,126
23408,412687,1,18,6,6,0,132
23409,412687,1,19,1,1,0,133
23410,412687,1,19,2,0,1,133
23411,412687,1,19,3,0,0,133
23412,412687,1,19,4,0,0,133
23413,412687,1,19,5,1,0,134
23414,412687,1,19,6,1,0,135
23415,412687,1,20,1,1,0,136
23416,412687,1,20,2,0,0,136
23417,412687,1,20,3,1,0,137
23418,412687,1,20,4,0,1,137
23419,412687,1,20,5,1,0,138
23420,412687,1,20,6,1,0,139
23517,412688,1,1,1,0,0,0
23518,412688,1,1,2,0,0,0
23519,412688,1,1,3,1,0,1
23520,412688,1,1,4,0,0,1
23521,412688,1,1,5,1,0,2
23522,412688,1,1,6,0,0,2
23523,412688,1,2,1,0,0,2
23524,412688,1,2,2,1,0,3
23525,412688,1,2,3,2,0,5
23526,412688,1,2,4,1,0,6
23527,412688,1,2,5,6,0,12
23528,412688,1,2,6,4,0,16
23529,412688,1,3,1,0,1,16
23530,412688,1,3,2,0,0,16
23531,412688,1,3,3,4,0,20
23532,412688,1,3,4,1,0,21
23533,412688,1,3,5,0,0,21
23534,412688,1,3,6,0,0,21
23535,412688,1,4,1,0,0,21
23536,412688,1,4,2,0,1,21
23537,412688,1,4,3,0,0,21
23538,412688,1,4,4,0,0,21
23539,412688,1,4,5,0,0,21
23540,412688,1,4,6,6,0,27
23541,412688,1,5,1,0,0,27
23542,412688,1,5,2,1,0,28
23543,412688,1,5,3,0,0,28
23544,412688,1,5,4,0,0,28
23545,412688,1,5,5,1,0,29
23546,412688,1,5,6,1,0,30
23547,412688,1,6,1,1,0,31
23548,412688,1,6,2,1,0,32
23549,412688,1,6,3,1,0,33
23550,412688,1,6,4,0,0,33
23551,412688,1,6,5,1,0,34
23552,412688,1,6,6,1,0,35
23553,412688,1,7,1,0,0,35
23554,412688,1,7,2,2,0,37
23555,412688,1,7,3,0,1,37
23556,412688,1,7,4,1,0,38
23557,412688,1,7,5,0,0,38
23558,412688,1,7,6,1,0,39
23559,412688,1,8,1,1,0,40
23560,412688,1,8,2,2,0,42
23561,412688,1,8,3,1,0,43
23562,412688,1,8,4,0,0,43
23563,412688,1,8,5,0,0,43
23564,412688,1,8,6,2,0,45
23565,412688,1,9,1,2,0,47
23566,412688,1,9,2,1,0,48
23567,412688,1,9,3,0,0,48
23568,412688,1,9,4,0,0,48
23569,412688,1,9,5,1,0,49
23570,412688,1,9,6,0,0,49
23571,412688,1,10,1,1,0,50
23572,412688,1,10,2,1,0,51
23573,412688,1,10,3,1,0,52
23574,412688,1,10,4,0,1,52
23575,412688,1,10,5,1,0,53
23576,412688,1,10,6,1,0,54
23577,412688,1,11,1,1,0,55
23578,412688,1,11,2,1,0,56
23579,412688,1,11,3,0,0,56
23580,412688,1,11,4,1,0,57
23581,412688,1,11,5,0,1,57
23582,412688,1,11,6,1,0,58
23583,412688,1,12,1,0,0,58
23584,412688,1,12,2,1,0,59
23585,412688,1,12,3,1,0,60
23586,412688,1,12,4,1,0,61
23587,412688,1,12,5,1,0,62
23588,412688,1,12,6,1,0,63
23589,412688,1,13,1,1,0,64
23590,412688,1,13,2,0,0,64
23591,412688,1,13,3,0,0,64
23592,412688,1,13,4,1,0,65
23593,412688,1,13,5,0,1,65
23594,412688,1,13,6,1,0,66
23595,412688,1,14,1,1,0,67
23596,412688,1,14,2,2,0,69
23597,412688,1,14,3,1,0,70
23598,412688,1,14,4,1,0,71
23599,412688,1,14,5,2,0,73
23600,412688,1,14,6,1,0,74
23601,412688,1,15,1,0,0,74
23602,412688,1,15,2,2,0,76
23603,412688,1,15,3,4,0,80
23604,412688,1,15,4,2,0,82
23605,412688,1,15,5,0,0,82
23606,412688,1,15,6,0,0,82
23607,412688,1,16,1,2,0,84
23608,412688,1,16,2,0,0,84
23609,412688,1,16,3,1,0,85
23610,412688,1,16,4,1,0,86
23611,412688,1,16,5,1,0,87
23612,412688,1,16,6,2,0,89
23613,412688,1,17,1,6,0,95
23614,412688,1,17,2,1,0,96
23615,412688,1,17,3,1,0,97
23616,412688,1,17,4,4,0,101
23617,412688,1,17,5,4,0,105
23618,412688,1,17,6,1,0,106
23619,412688,1,18,1,4,0,110
23620,412688,1,18,2,1,0,111
23621,412688,1,18,3,4,0,115
23622,412688,1,18,4,1,0,116
23623,412688,1,18,5,1,0,117
23624,412688,1,18,6,1,0,118
23625,412688,1,19,1,6,0,124
23626,412688,1,19,2,1,0,125
23627,412688,1,19,3,1,0,126
23628,412688,1,19,4,6,0,132
23629,412688,1,19,5,0,0,132
23630,412688,1,19,6,0,0,132
23631,412688,1,20,1,1,0,133
23632,412688,1,20,2,1,0,134
23633,412688,1,20,3,1,0,135
23634,412688,1,20,4,1,0,136
23635,412688,1,20,5,2,0,138
23636,412688,1,20,6,3,1,141
23749,412689,1,1,1,6,0,6
23750,412689,1,1,2,1,0,7
23751,412689,1,1,3,0,0,7
23752,412689,1,1,4,0,0,7
23753,412689,1,1,5,0,0,7
23754,412689,1,1,6,4,0,11
23755,412689,1,2,1,5,0,16
23756,412689,1,2,2,0,0,16
23757,412689,1,2,3,0,0,16
23758,412689,1,2,4,0,0,16
23759,412689,1,2,5,0,0,16
23760,412689,1,2,6,0,0,16
23761,412689,1,3,1,0,0,16
23762,412689,1,3,2,2,0,18
23763,412689,1,3,3,1,0,19
23764,412689,1,3,4,4,0,23
23765,412689,1,3,5,0,0,23
23766,412689,1,3,6,0,0,23
23767,412689,1,4,1,4,0,27
23768,412689,1,4,2,1,0,28
23769,412689,1,4,3,0,0,28
23770,412689,1,4,4,0,0,28
23771,412689,1,4,5,0,0,28
23772,412689,1,4,6,0,0,28
23773,412689,1,5,1,1,0,29
23774,412689,1,5,2,0,0,29
23775,412689,1,5,3,1,0,30
23776,412689,1,5,4,1,0,31
23777,412689,1,5,5,0,1,31
23778,412689,1,5,6,2,0,33
23779,412689,1,6,1,4,0,37
23780,412689,1,6,2,2,0,39
23781,412689,1,6,3,1,0,40
23782,412689,1,6,4,1,0,41
23783,412689,1,6,5,0,0,41
23784,412689,1,6,6,3,0,44
23785,412689,1,7,1,1,0,45
23786,412689,1,7,2,1,0,46
23787,412689,1,7,3,1,0,47
23788,412689,1,7,4,4,0,51
23789,412689,1,7,5,4,0,55
23790,412689,1,7,6,1,0,56
23791,412689,1,8,1,0,0,56
23792,412689,1,8,2,1,0,57
23793,412689,1,8,3,1,0,58
23794,412689,1,8,4,0,0,58
23795,412689,1,8,5,1,0,59
23796,412689,1,8,6,1,0,60
23797,412689,1,9,1,1,0,61
23798,412689,1,9,2,1,0,62
23799,412689,1,9,3,0,0,62
23800,412689,1,9,4,1,0,63
23801,412689,1,9,5,1,0,64
23802,412689,1,9,6,6,0,70
23803,412689,1,10,1,1,0,71
23804,412689,1,10,2,0,1,71
23805,412689,1,10,3,0,0,71
23806,412689,1,10,4,0,0,71
23807,412689,1,10,5,4,0,75
23808,412689,1,10,6,1,0,76
23809,412689,1,11,1,0,0,76
23810,412689,1,11,2,1,0,77
23811,412689,1,11,3,0,1,77
23812,412689,1,11,4,0,1,77
23813,412689,1,11,5,1,0,78
23814,412689,1,11,6,0,0,78
23815,412689,1,12,1,1,0,79
23816,412689,1,12,2,2,0,81
23817,412689,1,12,3,2,0,83
23818,412689,1,12,4,1,0,84
23819,412689,1,12,5,1,0,85
23820,412689,1,12,6,1,0,86
23821,412689,1,13,1,0,0,86
23822,412689,1,13,2,0,0,86
23823,412689,1,13,3,1,0,87
23824,412689,1,13,4,0,0,87
23825,412689,1,13,5,1,0,88
23826,412689,1,13,6,0,0,88
23827,412689,1,14,1,1,0,89
23828,412689,1,14,2,8,0,97
23829,412689,1,14,3,0,0,97
23830,412689,1,14,4,0,0,97
23831,412689,1,14,5,1,0,98
23832,412689,1,14,6,1,0,99
23833,412689,1,15,1,1,0,100
23834,412689,1,15,2,1,0,101
23835,412689,1,15,3,1,0,102
23836,412689,1,15,4,0,0,102
23837,412689,1,15,5,0,0,102
23838,412689,1,15,6,0,1,102
23839,412689,1,16,1,1,0,103
23840,412689,1,16,2,0,0,103
23841,412689,1,16,3,0,0,103
23842,412689,1,16,4,1,0,104
23843,412689,1,16,5,6,0,110
23844,412689,1,16,6,2,0,112
23845,412689,1,17,1,2,0,114
23846,412689,1,17,2,4,0,118
23847,412689,1,17,3,0,0,118
23848,412689,1,17,4,0,1,118
23849,412689,1,17,5,1,0,119
23850,412689,1,17,6,1,0,120
23851,412689,1,18,1,0,0,120
23852,412689,1,18,2,0,1,120
23853,412689,1,18,3,1,0,121
23854,412689,1,18,4,0,0,121
23855,412689,1,18,5,1,0,122
23856,412689,1,18,6,1,0,123
23857,412689,1,19,1,0,0,123
23858,412689,1,19,2,0,0,123
23859,412689,1,19,3,0,0,123
23860,412689,1,19,4,1,0,124
23861,412689,1,19,5,8,0,132
23862,412689,1,19,6,0,1,132
23863,412689,1,20,1,0,1,132
23864,412689,1,20,2,1,0,133
23865,412689,1,20,3,4,0,137
23866,412689,1,20,4,2,0,139
23867,412689,1,20,5,7,0,146
23868,412689,1,20,6,1,0,147
23986,412690,1,1,1,1,0,1
23987,412690,1,1,2,0,0,1
23988,412690,1,1,3,1,0,2
23989,412690,1,1,4,1,0,3
23990,412690,1,1,5,2,0,5
23991,412690,1,1,6,1,0,6
23992,412690,1,2,1,0,0,6
23993,412690,1,2,2,6,0,12
23994,412690,1,2,3,1,0,13
23995,412690,1,2,4,1,0,14
23996,412690,1,2,5,4,0,18
23997,412690,1,2,6,1,0,19
23998,412690,1,3,1,0,0,19
23999,412690,1,3,2,0,0,19
24000,412690,1,3,3,1,0,20
24001,412690,1,3,4,1,0,21
24002,412690,1,3,5,0,0,21
24003,412690,1,3,6,6,0,27
24004,412690,1,4,1,0,0,27
24005,412690,1,4,2,1,0,28
24006,412690,1,4,3,1,0,29
24007,412690,1,4,4,0,0,29
24008,412690,1,4,5,0,0,29
24009,412690,1,4,6,4,0,33
24010,412690,1,5,1,0,0,33
24011,412690,1,5,2,1,0,34
24012,412690,1,5,3,4,0,38
24013,412690,1,5,4,2,0,40
24014,412690,1,5,5,0,1,40
24015,412690,1,5,6,1,0,41
24016,412690,1,6,1,0,0,41
24017,412690,1,6,2,1,0,42
24018,412690,1,6,3,0,0,42
24019,412690,1,6,4,4,0,46
24020,412690,1,6,5,1,0,47
24021,412690,1,6,6,1,0,48
24022,412690,1,7,1,1,0,49
24023,412690,1,7,2,0,0,49
24024,412690,1,7,3,0,0,49
24025,412690,1,7,4,0,0,49
24026,412690,1,7,5,1,0,50
24027,412690,1,7,6,1,0,51
24028,412690,1,8,1,1,0,52
24029,412690,1,8,2,1,0,53
24030,412690,1,8,3,1,0,54
24031,412690,1,8,4,1,0,55
24032,412690,1,8,5,0,1,55
24033,412690,1,8,6,0,0,55
24034,412690,1,9,1,0,0,55
24035,412690,1,9,2,1,0,56
24036,412690,1,9,3,2,0,58
24037,412690,1,9,4,1,0,59
24038,412690,1,9,5,2,0,61
24039,412690,1,9,6,0,0,61
24040,412690,1,10,1,0,0,61
24041,412690,1,10,2,1,0,62
24042,412690,1,10,3,1,0,63
24043,412690,1,10,4,1,0,64
24044,412690,1,10,5,1,0,65
24045,412690,1,10,6,1,0,66
24046,412690,1,11,1,0,0,66
24047,412690,1,11,2,1,0,67
24048,412690,1,11,3,1,0,68
24049,412690,1,11,4,1,0,69
24050,412690,1,11,5,0,0,69
24051,412690,1,11,6,1,0,70
24052,412690,1,12,1,1,0,71
24053,412690,1,12,2,1,0,72
24054,412690,1,12,3,2,0,74
24055,412690,1,12,4,4,0,78
24056,412690,1,12,5,0,0,78
24057,412690,1,12,6,1,0,79
24058,412690,1,13,1,2,0,81
24059,412690,1,13,2,1,0,82
24060,412690,1,13,3,6,0,88
24061,412690,1,13,4,1,0,89
24062,412690,1,13,5,0,0,89
24063,412690,1,13,6,1,0,90
24064,412690,1,14,1,1,0,91
24065,412690,1,14,2,6,0,97
24066,412690,1,14,3,0,1,97
24067,412690,1,14,4,1,0,98
24068,412690,1,14,5,1,0,99
24069,412690,1,14,6,1,0,100
24070,412690,1,15,1,1,0,101
24071,412690,1,15,2,0,0,101
24072,412690,1,15,3,6,0,107
24073,412690,1,15,4,0,0,107
24074,412690,1,15,5,1,0,108
24075,412690,1,15,6,0,0,108
24076,412690,1,16,1,1,0,109
24077,412690,1,16,2,6,0,115
24078,412690,1,16,3,0,0,115
24079,412690,1,16,4,1,0,116
24080,412690,1,16,5,1,0,117
24081,412690,1,16,6,2,0,119
24082,412690,1,17,1,6,0,125
24083,412690,1,17,2,1,0,126
24084,412690,1,17,3,4,0,130
24085,412690,1,17,4,1,0,131
24086,412690,1,17,5,1,0,132
24087,412690,1,17,6,1,0,133
24088,412690,1,18,1,1,0,134
24089,412690,1,18,2,1,0,135
24090,412690,1,18,3,1,0,136
24091,412690,1,18,4,1,0,137
24092,412690,1,18,5,6,0,143
24093,412690,1,18,6,1,0,144
24094,412690,1,19,1,1,0,145
24095,412690,1,19,2,6,0,151
24096,412690,1,19,3,2,0,153
24097,412690,1,19,4,6,0,159
24098,412690,1,19,5,0,0,159
24099,412690,1,19,6,6,0,165
24100,412690,1,20,1,1,0,166
24101,412690,1,20,2,1,0,167
24102,412690,1,20,3,2,0,169
24103,412690,1,20,4,0,0,169
24104,412690,1,20,5,0,1,169
24105,412690,1,20,6,1,0,170
24226,412691,1,1,1,0,0,0
24227,412691,1,1,2,0,0,0
24228,412691,1,1,3,0,0,0
24229,412691,1,1,4,0,0,0
24230,412691,1,1,5,0,0,0
24231,412691,1,1,6,0,0,0
24232,412691,1,2,1,4,0,4
24233,412691,1,2,2,0,0,4
24234,412691,1,2,3,1,0,5
24235,412691,1,2,4,0,0,5
24236,412691,1,2,5,6,0,11
24237,412691,1,2,6,1,0,12
24238,412691,1,3,1,0,0,12
24239,412691,1,3,2,2,0,14
24240,412691,1,3,3,0,0,14
24241,412691,1,3,4,1,0,15
24242,412691,1,3,5,0,0,15
24243,412691,1,3,6,1,0,16
24244,412691,1,4,1,0,0,16
24245,412691,1,4,2,1,0,17
24246,412691,1,4,3,0,0,17
24247,412691,1,4,4,6,0,23
24248,412691,1,4,5,6,0,29
24249,412691,1,4,6,6,0,35
24250,412691,1,5,1,1,0,36
24251,412691,1,5,2,4,0,40
24252,412691,1,5,3,0,0,40
24253,412691,1,5,4,1,0,41
24254,412691,1,5,5,1,0,42
24255,412691,1,5,6,1,0,43
24256,412691,1,6,1,1,0,44
24257,412691,1,6,2,2,0,46
24258,412691,1,6,3,6,0,52
24259,412691,1,6,4,0,0,52
24260,412691,1,6,5,0,0,52
24261,412691,1,6,6,1,0,53
24262,412691,1,7,1,1,0,54
24263,412691,1,7,2,1,0,55
24264,412691,1,7,3,1,0,56
24265,412691,1,7,4,1,0,57
24266,412691,1,7,5,1,0,58
24267,412691,1,7,6,0,0,58
24268,412691,1,8,1,0,0,58
24269,412691,1,8,2,4,0,62
24270,412691,1,8,3,1,0,63
24271,412691,1,8,4,6,0,69
24272,412691,1,8,5,1,0,70
24273,412691,1,8,6,1,0,71
24274,412691,1,9,1,0,0,71
24275,412691,1,9,2,0,0,71
24276,412691,1,9,3,1,0,72
24277,412691,1,9,4,1,0,73
24278,412691,1,9,5,1,0,74
24279,412691,1,9,6,2,0,76
24280,412691,1,10,1,6,0,82
24281,412691,1,10,2,6,0,88
24282,412691,1,10,3,6,0,94
24283,412691,1,10,4,0,0,94
24284,412691,1,10,5,0,0,94
24285,412691,1,10,6,1,0,95
24286,412691,1,11,1,1,0,96
24287,412691,1,11,2,1,0,97
24288,412691,1,11,3,1,0,98
24289,412691,1,11,4,6,0,104
24290,412691,1,11,5,0,1,104
24291,412691,1,11,6,1,0,105
24292,412691,1,12,1,1,0,106
24293,412691,1,12,2,1,0,107
24294,412691,1,12,3,6,0,113
24295,412691,1,12,4,0,0,113
24296,412691,1,12,5,0,0,113
24297,412691,1,12,6,0,0,113
24298,412691,1,13,1,6,0,119
24299,412691,1,13,2,1,0,120
24300,412691,1,13,3,6,0,126
24301,412691,1,13,4,0,0,126
24302,412691,1,13,5,1,0,127
24303,412691,1,13,6,1,0,128
24304,412691,1,14,1,6,0,134
24305,412691,1,14,2,0,0,134
24306,412691,1,14,3,6,0,140
24307,412691,1,14,4,1,0,141
24308,412691,1,14,5,1,0,142
24309,412691,1,14,6,0,1,142
24310,412691,1,15,1,1,0,143
24311,412691,1,15,2,1,0,144
24312,412691,1,15,3,1,0,145
24313,412691,1,15,4,0,0,145
24314,412691,1,15,5,0,0,145
24315,412691,1,15,6,0,0,145
24316,412691,1,16,1,4,0,149
24317,412691,1,16,2,1,0,150
24318,412691,1,16,3,1,0,151
24319,412691,1,16,4,2,0,153
24320,412691,1,16,5,2,0,155
24321,412691,1,16,6,6,0,161
24322,412691,1,17,1,4,0,165
24323,412691,1,17,2,1,0,166
24324,412691,1,17,3,0,1,166
24325,412691,1,17,4,1,0,167
24326,412691,1,17,5,0,0,167
24327,412691,1,17,6,0,0,167
24328,412691,1,18,1,0,0,167
24329,412691,1,18,2,1,0,168
24330,412691,1,18,3,4,0,172
24331,412691,1,18,4,0,1,172
24332,412691,1,18,5,1,0,173
24333,412691,1,18,6,0,0,173
24334,412691,1,19,1,1,0,174
24335,412691,1,19,2,2,0,176
24336,412691,1,19,3,1,0,177
24337,412691,1,19,4,1,0,178
24338,412691,1,19,5,0,0,178
24339,412691,1,19,6,1,0,179
24340,412691,1,20,1,2,0,181
24341,412691,1,20,2,2,0,183
24342,412691,1,20,3,0,0,183
24343,412691,1,20,4,0,0,183
24344,412691,1,20,5,0,1,183
24345,412691,1,20,6,1,0,184
24452,412692,1,1,1,0,0,0
24453,412692,1,1,2,1,0,1
24454,412692,1,1,3,0,0,1
24455,412692,1,1,4,0,0,1
24456,412692,1,1,5,1,0,2
24457,412692,1,1,6,0,0,2
24458,412692,1,2,1,4,0,6
24459,412692,1,2,2,0,0,6
24460,412692,1,2,3,0,0,6
24461,412692,1,2,4,0,0,6
24462,412692,1,2,5,0,0,6
24463,412692,1,2,6,1,0,7
24464,412692,1,3,1,0,1,7
24465,412692,1,3,2,0,0,7
24466,412692,1,3,3,0,0,7
24467,412692,1,3,4,0,0,7
24468,412692,1,3,5,1,0,8
24469,412692,1,3,6,2,0,10
24470,412692,1,4,1,1,0,11
24471,412692,1,4,2,6,0,17
24472,412692,1,4,3,4,0,21
24473,412692,1,4,4,1,0,22
24474,412692,1,4,5,1,0,23
24475,412692,1,4,6,1,0,24
24476,412692,1,5,1,1,0,25
24477,412692,1,5,2,4,0,29
24478,412692,1,5,3,0,0,29
24479,412692,1,5,4,1,0,30
24480,412692,1,5,5,4,0,34
24481,412692,1,5,6,4,0,38
24482,412692,1,6,1,0,0,38
24483,412692,1,6,2,0,0,38
24484,412692,1,6,3,4,0,42
24485,412692,1,6,4,1,0,43
24486,412692,1,6,5,1,0,44
24487,412692,1,6,6,3,0,47
24488,412692,1,7,1,1,0,48
24489,412692,1,7,2,1,0,49
24490,412692,1,7,3,0,0,49
24491,412692,1,7,4,6,0,55
24492,412692,1,7,5,0,0,55
24493,412692,1,7,6,0,0,55
24494,412692,1,8,1,1,0,56
24495,412692,1,8,2,0,0,56
24496,412692,1,8,3,1,0,57
24497,412692,1,8,4,1,0,58
24498,412692,1,8,5,0,0,58
24499,412692,1,8,6,6,0,64
24500,412692,1,9,1,2,0,66
24501,412692,1,9,2,4,0,70
24502,412692,1,9,3,4,0,74
24503,412692,1,9,4,0,0,74
24504,412692,1,9,5,0,0,74
24505,412692,1,9,6,0,0,74
24506,412692,1,10,1,1,0,75
24507,412692,1,10,2,1,0,76
24508,412692,1,10,3,1,0,77
24509,412692,1,10,4,1,0,78
24510,412692,1,10,5,0,0,78
24511,412692,1,10,6,4,0,82
24512,412692,1,11,1,6,0,88
24513,412692,1,11,2,1,0,89
24514,412692,1,11,3,1,0,90
24515,412692,1,11,4,4,0,94
24516,412692,1,11,5,1,0,95
24517,412692,1,11,6,0,0,95
24518,412692,1,12,1,1,0,96
24519,412692,1,12,2,3,0,99
24520,412692,1,12,3,1,0,100
24521,412692,1,12,4,1,0,101
24522,412692,1,12,5,4,0,105
24523,412692,1,12,6,1,0,106
24524,412692,1,13,1,2,0,108
24525,412692,1,13,2,1,0,109
24526,412692,1,13,3,4,0,113
24527,412692,1,13,4,1,0,114
24528,412692,1,13,5,1,0,115
24529,412692,1,13,6,0,0,115
24530,412692,1,14,1,1,0,116
24531,412692,1,14,2,1,0,117
24532,412692,1,14,3,0,0,117
24533,412692,1,14,4,1,0,118
24534,412692,1,14,5,2,0,120
24535,412692,1,14,6,4,0,124
24536,412692,1,15,1,1,0,125
24537,412692,1,15,2,2,0,127
24538,412692,1,15,3,1,0,128
24539,412692,1,15,4,1,0,129
24540,412692,1,15,5,1,0,130
24541,412692,1,15,6,2,0,132
24542,412692,1,16,1,1,0,133
24543,412692,1,16,2,1,0,134
24544,412692,1,16,3,1,0,135
24545,412692,1,16,4,0,0,135
24546,412692,1,16,5,1,0,136
24547,412692,1,16,6,6,0,142
24548,412692,1,17,1,2,0,144
24549,412692,1,17,2,2,0,146
24550,412692,1,17,3,6,0,152
24551,412692,1,17,4,0,0,152
24552,412692,1,17,5,1,0,153
24553,412692,1,17,6,4,0,157
24554,412692,1,18,1,2,0,159
24555,412692,1,18,2,6,0,165
24556,412692,1,18,3,0,0,165
24557,412692,1,18,4,2,0,167
24558,412692,1,18,5,1,0,168
24559,412692,1,18,6,1,0,169
24560,412692,1,19,1,2,0,171
24561,412692,1,19,2,1,0,172
24562,412692,1,19,3,1,0,173
24563,412692,1,19,4,0,1,173
24564,412692,1,19,5,6,0,179
24565,412692,1,19,6,4,0,183
24566,412692,1,20,1,1,0,184
24567,412692,1,20,2,1,0,185
24568,412692,1,20,3,2,0,187
24569,412692,1,20,4,4,0,191
24570,412692,1,20,5,0,1,191
24571,412692,1,20,6,4,0,195
24692,412693,1,1,1,1,0,1
24693,412693,1,1,2,0,0,1
24694,412693,1,1,3,0,0,1
24695,412693,1,1,4,1,0,2
24696,412693,1,1,5,0,0,2
24697,412693,1,1,6,5,0,7
24698,412693,1,2,1,2,0,9
24699,412693,1,2,2,0,0,9
24700,412693,1,2,3,4,0,13
24701,412693,1,2,4,5,0,18
24702,412693,1,2,5,1,0,19
24703,412693,1,2,6,1,0,20
24704,412693,1,3,1,0,0,20
24705,412693,1,3,2,1,0,21
24706,412693,1,3,3,0,0,21
24707,412693,1,3,4,1,0,22
24708,412693,1,3,5,1,0,23
24709,412693,1,3,6,2,0,25
24710,412693,1,4,1,4,0,29
24711,412693,1,4,2,4,0,33
24712,412693,1,4,3,1,0,34
24713,412693,1,4,4,0,0,34
24714,412693,1,4,5,0,1,34
24715,412693,1,4,6,0,0,34
24716,412693,1,5,1,1,0,35
24717,412693,1,5,2,0,0,35
24718,412693,1,5,3,1,0,36
24719,412693,1,5,4,0,0,36
24720,412693,1,5,5,0,0,36
24721,412693,1,5,6,4,0,40
24722,412693,1,6,1,0,0,40
24723,412693,1,6,2,0,0,40
24724,412693,1,6,3,0,0,40
24725,412693,1,6,4,0,0,40
24726,412693,1,6,5,0,0,40
24727,412693,1,6,6,1,0,41
24728,412693,1,7,1,0,1,41
24729,412693,1,7,2,1,0,42
24730,412693,1,7,3,1,0,43
24731,412693,1,7,4,1,0,44
24732,412693,1,7,5,1,0,45
24733,412693,1,7,6,1,0,46
24734,412693,1,8,1,0,0,46
24735,412693,1,8,2,1,0,47
24736,412693,1,8,3,1,0,48
24737,412693,1,8,4,0,0,48
24738,412693,1,8,5,1,0,49
24739,412693,1,8,6,0,0,49
24740,412693,1,9,1,2,0,51
24741,412693,1,9,2,4,0,55
24742,412693,1,9,3,0,1,55
24743,412693,1,9,4,1,0,56
24744,412693,1,9,5,1,0,57
24745,412693,1,9,6,0,0,57
24746,412693,1,10,1,1,0,58
24747,412693,1,10,2,0,1,58
24748,412693,1,10,3,1,0,59
24749,412693,1,10,4,1,0,60
24750,412693,1,10,5,1,0,61
24751,412693,1,10,6,0,0,61
24752,412693,1,11,1,0,0,61
24753,412693,1,11,2,1,0,62
24754,412693,1,11,3,1,0,63
24755,412693,1,11,4,1,0,64
24756,412693,1,11,5,1,0,65
24757,412693,1,11,6,2,0,67
24758,412693,1,12,1,4,0,71
24759,412693,1,12,2,0,0,71
24760,412693,1,12,3,1,0,72
24761,412693,1,12,4,1,0,73
24762,412693,1,12,5,1,0,74
24763,412693,1,12,6,0,0,74
24764,412693,1,13,1,1,0,75
24765,412693,1,13,2,1,0,76
24766,412693,1,13,3,1,0,77
24767,412693,1,13,4,6,0,83
24768,412693,1,13,5,1,0,84
24769,412693,1,13,6,1,0,85
24770,412693,1,14,1,0,0,85
24771,412693,1,14,2,1,0,86
24772,412693,1,14,3,1,0,87
24773,412693,1,14,4,1,0,88
24774,412693,1,14,5,0,0,88
24775,412693,1,14,6,0,0,88
24776,412693,1,15,1,6,0,94
24777,412693,1,15,2,4,0,98
24778,412693,1,15,3,0,0,98
24779,412693,1,15,4,0,1,98
24780,412693,1,15,5,0,0,98
24781,412693,1,15,6,1,0,99
24782,412693,1,16,1,1,0,100
24783,412693,1,16,2,0,0,100
24784,412693,1,16,3,2,0,102
24785,412693,1,16,4,0,0,102
24786,412693,1,16,5,1,0,103
24787,412693,1,16,6,0,0,103
24788,412693,1,17,1,1,0,104
24789,412693,1,17,2,0,0,104
24790,412693,1,17,3,0,0,104
24791,412693,1,17,4,0,1,104
24792,412693,1,17,5,0,0,104
24793,412693,1,17,6,1,0,105
24794,412693,1,18,1,0,0,105
24795,412693,1,18,2,1,0,106
24796,412693,1,18,3,1,0,107
24797,412693,1,18,4,0,0,107
24798,412693,1,18,5,6,0,113
24799,412693,1,18,6,1,0,114
24800,412693,1,19,1,2,0,116
24801,412693,1,19,2,2,0,118
24802,412693,1,19,3,0,0,118
24803,412693,1,19,4,2,0,120
24804,412693,1,19,5,0,0,120
24805,412693,1,19,6,2,0,122
24806,412693,1,20,1,3,0,125
24807,412693,1,20,2,1,0,126
24808,412693,1,20,3,0,0,126
24809,412693,1,20,4,0,0,126
24810,412693,1,20,5,1,1,127
24811,412693,1,20,6,6,0,133
24932,412694,1,1,1,1,0,1
24933,412694,1,1,2,1,0,2
24934,412694,1,1,3,0,0,2
24935,412694,1,1,4,2,0,4
24936,412694,1,1,5,0,1,4
24937,412694,1,1,6,0,0,4
24938,412694,1,2,1,0,0,4
24939,412694,1,2,2,4,0,8
24940,412694,1,2,3,1,0,9
24941,412694,1,2,4,4,0,13
24942,412694,1,2,5,0,0,13
24943,412694,1,2,6,4,0,17
24944,412694,1,3,1,2,0,19
24945,412694,1,3,2,4,0,23
24946,412694,1,3,3,0,0,23
24947,412694,1,3,4,1,0,24
24948,412694,1,3,5,2,0,26
24949,412694,1,3,6,4,0,30
24950,412694,1,4,1,0,0,30
24951,412694,1,4,2,0,0,30
24952,412694,1,4,3,1,0,31
24953,412694,1,4,4,1,0,32
24954,412694,1,4,5,5,0,37
24955,412694,1,4,6,0,0,37
24956,412694,1,5,1,0,0,37
24957,412694,1,5,2,4,0,41
24958,412694,1,5,3,2,0,43
24959,412694,1,5,4,4,0,47
24960,412694,1,5,5,1,0,48
24961,412694,1,5,6,1,0,49
24962,412694,1,6,1,6,0,55
24963,412694,1,6,2,1,0,56
24964,412694,1,6,3,1,0,57
24965,412694,1,6,4,4,0,61
24966,412694,1,6,5,0,0,61
24967,412694,1,6,6,4,0,65
24968,412694,1,7,1,1,0,66
24969,412694,1,7,2,0,0,66
24970,412694,1,7,3,0,0,66
24971,412694,1,7,4,2,0,68
24972,412694,1,7,5,0,0,68
24973,412694,1,7,6,1,0,69
24974,412694,1,8,1,0,0,69
24975,412694,1,8,2,0,0,69
24976,412694,1,8,3,1,0,70
24977,412694,1,8,4,2,0,72
24978,412694,1,8,5,0,0,72
24979,412694,1,8,6,1,0,73
24980,412694,1,9,1,1,0,74
24981,412694,1,9,2,0,0,74
24982,412694,1,9,3,1,0,75
24983,412694,1,9,4,0,0,75
24984,412694,1,9,5,0,0,75
24985,412694,1,9,6,2,0,77
24986,412694,1,10,1,1,0,78
24987,412694,1,10,2,1,0,79
24988,412694,1,10,3,1,0,80
24989,412694,1,10,4,1,0,81
24990,412694,1,10,5,0,0,81
24991,412694,1,10,6,1,0,82
24992,412694,1,11,1,1,0,83
24993,412694,1,11,2,4,0,87
24994,412694,1,11,3,6,0,93
24995,412694,1,11,4,0,0,93
24996,412694,1,11,5,4,0,97
24997,412694,1,11,6,1,0,98
24998,412694,1,12,1,0,0,98
24999,412694,1,12,2,0,1,98
25000,412694,1,12,3,1,0,99
25001,412694,1,12,4,1,0,100
25002,412694,1,12,5,0,0,100
25003,412694,1,12,6,0,0,100
25004,412694,1,13,1,0,0,100
25005,412694,1,13,2,0,0,100
25006,412694,1,13,3,0,0,100
25007,412694,1,13,4,0,0,100
25008,412694,1,13,5,1,0,101
25009,412694,1,13,6,6,0,107
25010,412694,1,14,1,6,0,113
25011,412694,1,14,2,0,0,113
25012,412694,1,14,3,0,1,113
25013,412694,1,14,4,1,0,114
25014,412694,1,14,5,0,0,114
25015,412694,1,14,6,4,0,118
25016,412694,1,15,1,0,0,118
25017,412694,1,15,2,6,0,124
25018,412694,1,15,3,0,0,124
25019,412694,1,15,4,0,1,124
25020,412694,1,15,5,1,0,125
25021,412694,1,15,6,0,0,125
25022,412694,1,16,1,0,0,125
25023,412694,1,16,2,2,0,127
25024,412694,1,16,3,2,0,129
25025,412694,1,16,4,2,0,131
25026,412694,1,16,5,2,0,133
25027,412694,1,16,6,4,0,137
25028,412694,1,17,1,0,1,137
25029,412694,1,17,2,0,0,137
25030,412694,1,17,3,1,0,138
25031,412694,1,17,4,1,0,139
25032,412694,1,17,5,0,0,139
25033,412694,1,17,6,0,0,139
25034,412694,1,18,1,4,0,143
25035,412694,1,18,2,1,0,144
25036,412694,1,18,3,0,0,144
25037,412694,1,18,4,2,0,146
25038,412694,1,18,5,1,0,147
25039,412694,1,18,6,1,0,148
25040,412694,1,19,1,0,1,148
25041,412694,1,19,2,1,0,149
25042,412694,1,19,3,1,0,150
25043,412694,1,19,4,2,0,152
25044,412694,1,19,5,2,0,154
25045,412694,1,19,6,4,0,158
25046,412694,1,20,1,1,0,159
25047,412694,1,20,2,3,0,162
25048,412694,1,20,3,0,1,162
25049,412694,1,20,4,1,0,163
25050,412694,1,20,5,4,0,167
25051,412694,1,20,6,1,0,168
25166,412695,1,1,1,1,0,1
25167,412695,1,1,2,1,0,2
25168,412695,1,1,3,0,0,2
25169,412695,1,1,4,0,0,2
25170,412695,1,1,5,0,0,2
25171,412695,1,1,6,0,0,2
25172,412695,1,2,1,2,0,4
25173,412695,1,2,2,0,0,4
25174,412695,1,2,3,0,0,4
25175,412695,1,2,4,0,0,4
25176,412695,1,2,5,0,0,4
25177,412695,1,2,6,0,0,4
25178,412695,1,3,1,2,0,6
25179,412695,1,3,2,6,0,12
25180,412695,1,3,3,0,0,12
25181,412695,1,3,4,1,0,13
25182,412695,1,3,5,0,0,13
25183,412695,1,3,6,0,0,13
25184,412695,1,4,1,0,0,13
25185,412695,1,4,2,2,0,15
25186,412695,1,4,3,4,0,19
25187,412695,1,4,4,1,0,20
25188,412695,1,4,5,1,0,21
25189,412695,1,4,6,4,0,25
25190,412695,1,5,1,0,0,25
25191,412695,1,5,2,1,0,26
25192,412695,1,5,3,0,0,26
25193,412695,1,5,4,0,0,26
25194,412695,1,5,5,0,0,26
25195,412695,1,5,6,0,0,26
25196,412695,1,6,1,0,0,26
25197,412695,1,6,2,1,0,27
25198,412695,1,6,3,2,0,29
25199,412695,1,6,4,1,0,30
25200,412695,1,6,5,0,0,30
25201,412695,1,6,6,1,0,31
25202,412695,1,7,1,0,0,31
25203,412695,1,7,2,1,0,32
25204,412695,1,7,3,2,0,34
25205,412695,1,7,4,0,0,34
25206,412695,1,7,5,0,0,34
25207,412695,1,7,6,4,0,38
25208,412695,1,8,1,0,0,38
25209,412695,1,8,2,1,0,39
25210,412695,1,8,3,1,0,40
25211,412695,1,8,4,1,0,41
25212,412695,1,8,5,2,0,43
25213,412695,1,8,6,2,0,45
25214,412695,1,9,1,1,0,46
25215,412695,1,9,2,1,0,47
25216,412695,1,9,3,6,0,53
25217,412695,1,9,4,1,0,54
25218,412695,1,9,5,0,0,54
25219,412695,1,9,6,4,0,58
25220,412695,1,10,1,0,0,58
25221,412695,1,10,2,6,0,64
25222,412695,1,10,3,0,0,64
25223,412695,1,10,4,1,0,65
25224,412695,1,10,5,1,0,66
25225,412695,1,10,6,1,0,67
25226,412695,1,11,1,0,0,67
25227,412695,1,11,2,2,0,69
25228,412695,1,11,3,1,0,70
25229,412695,1,11,4,0,0,70
25230,412695,1,11,5,1,0,71
25231,412695,1,11,6,1,0,72
25232,412695,1,12,1,2,0,74
25233,412695,1,12,2,1,0,75
25234,412695,1,12,3,4,0,79
25235,412695,1,12,4,1,0,80
25236,412695,1,12,5,0,1,80
25237,412695,1,12,6,0,0,80
25238,412695,1,13,1,1,0,81
25239,412695,1,13,2,6,0,87
25240,412695,1,13,3,1,0,88
25241,412695,1,13,4,6,0,94
25242,412695,1,13,5,1,0,95
25243,412695,1,13,6,1,0,96
25244,412695,1,14,1,0,0,96
25245,412695,1,14,2,4,0,100
25246,412695,1,14,3,1,0,101
25247,412695,1,14,4,4,0,105
25248,412695,1,14,5,0,0,105
25249,412695,1,14,6,1,0,106
25250,412695,1,15,1,1,0,107
25251,412695,1,15,2,4,0,111
25252,412695,1,15,3,0,0,111
25253,412695,1,15,4,1,0,112
25254,412695,1,15,5,1,0,113
25255,412695,1,15,6,1,0,114
25256,412695,1,16,1,1,0,115
25257,412695,1,16,2,4,0,119
25258,412695,1,16,3,0,1,119
25259,412695,1,16,4,0,0,119
25260,412695,1,16,5,6,0,125
25261,412695,1,16,6,0,0,125
25262,412695,1,17,1,6,0,131
25263,412695,1,17,2,1,0,132
25264,412695,1,17,3,1,0,133
25265,412695,1,17,4,6,0,139
25266,412695,1,17,5,1,0,140
25267,412695,1,17,6,1,0,141
25268,412695,1,18,1,0,0,141
25269,412695,1,18,2,1,0,142
25270,412695,1,18,3,2,0,144
25271,412695,1,18,4,1,0,145
25272,412695,1,18,5,6,0,151
25273,412695,1,18,6,1,0,152
25274,412695,1,19,1,1,0,153
25275,412695,1,19,2,6,0,159
25276,412695,1,19,3,0,0,159
25277,412695,1,19,4,1,0,160
25278,412695,1,19,5,0,1,160
25279,412695,1,19,6,3,0,163
25280,412695,1,20,1,0,1,163
25281,412695,1,20,2,1,0,164
25282,412695,1,20,3,0,1,164
25283,412695,1,20,4,1,1,165
25284,412695,1,20,5,0,0,165
25285,412695,1,20,6,4,0,169
25406,412696,1,1,1,0,0,0
25407,412696,1,1,2,1,0,1
25408,412696,1,1,3,1,0,2
25409,412696,1,1,4,0,0,2
25410,412696,1,1,5,0,1,2
25411,412696,1,1,6,0,0,2
25412,412696,1,2,1,2,0,4
25413,412696,1,2,2,0,0,4
25414,412696,1,2,3,7,0,11
25415,412696,1,2,4,4,0,15
25416,412696,1,2,5,0,0,15
25417,412696,1,2,6,1,0,16
25418,412696,1,3,1,4,0,20
25419,412696,1,3,2,0,0,20
25420,412696,1,3,3,0,1,20
25421,412696,1,3,4,0,0,20
25422,412696,1,3,5,0,0,20
25423,412696,1,3,6,1,0,21
25424,412696,1,4,1,4,0,25
25425,412696,1,4,2,2,0,27
25426,412696,1,4,3,1,0,28
25427,412696,1,4,4,0,0,28
25428,412696,1,4,5,1,0,29
25429,412696,1,4,6,1,0,30
25430,412696,1,5,1,0,0,30
25431,412696,1,5,2,0,0,30
25432,412696,1,5,3,0,1,30
25433,412696,1,5,4,0,1,30
25434,412696,1,5,5,0,0,30
25435,412696,1,5,6,1,0,31
25436,412696,1,6,1,0,0,31
25437,412696,1,6,2,1,0,32
25438,412696,1,6,3,0,0,32
25439,412696,1,6,4,0,0,32
25440,412696,1,6,5,0,0,32
25441,412696,1,6,6,1,0,33
25442,412696,1,7,1,1,0,34
25443,412696,1,7,2,4,0,38
25444,412696,1,7,3,1,0,39
25445,412696,1,7,4,3,0,42
25446,412696,1,7,5,1,0,43
25447,412696,1,7,6,1,0,44
25448,412696,1,8,1,1,0,45
25449,412696,1,8,2,0,0,45
25450,412696,1,8,3,0,0,45
25451,412696,1,8,4,6,0,51
25452,412696,1,8,5,1,0,52
25453,412696,1,8,6,2,0,54
25454,412696,1,9,1,0,0,54
25455,412696,1,9,2,0,0,54
25456,412696,1,9,3,0,0,54
25457,412696,1,9,4,1,0,55
25458,412696,1,9,5,1,0,56
25459,412696,1,9,6,4,0,60
25460,412696,1,10,1,1,0,61
25461,412696,1,10,2,1,0,62
25462,412696,1,10,3,0,0,62
25463,412696,1,10,4,0,0,62
25464,412696,1,10,5,1,0,63
25465,412696,1,10,6,2,0,65
25466,412696,1,11,1,0,0,65
25467,412696,1,11,2,1,0,66
25468,412696,1,11,3,0,0,66
25469,412696,1,11,4,1,0,67
25470,412696,1,11,5,0,0,67
25471,412696,1,11,6,0,1,67
25472,412696,1,12,1,2,0,69
25473,412696,1,12,2,4,0,73
25474,412696,1,12,3,1,0,74
25475,412696,1,12,4,0,0,74
25476,412696,1,12,5,1,0,75
25477,412696,1,12,6,1,0,76
25478,412696,1,13,1,1,0,77
25479,412696,1,13,2,0,0,77
25480,412696,1,13,3,0,0,77
25481,412696,1,13,4,0,0,77
25482,412696,1,13,5,0,0,77
25483,412696,1,13,6,1,0,78
25484,412696,1,14,1,1,0,79
25485,412696,1,14,2,1,0,80
25486,412696,1,14,3,1,0,81
25487,412696,1,14,4,4,0,85
25488,412696,1,14,5,1,0,86
25489,412696,1,14,6,1,0,87
25490,412696,1,15,1,0,0,87
25491,412696,1,15,2,1,0,88
25492,412696,1,15,3,4,0,92
25493,412696,1,15,4,6,0,98
25494,412696,1,15,5,0,0,98
25495,412696,1,15,6,1,0,99
25496,412696,1,16,1,4,0,103
25497,412696,1,16,2,1,0,104
25498,412696,1,16,3,1,0,105
25499,412696,1,16,4,0,0,105
25500,412696,1,16,5,0,0,105
25501,412696,1,16,6,1,0,106
25502,412696,1,17,1,1,0,107
25503,412696,1,17,2,1,0,108
25504,412696,1,17,3,1,0,109
25505,412696,1,17,4,1,0,110
25506,412696,1,17,5,6,0,116
25507,412696,1,17,6,6,0,122
25508,412696,1,18,1,4,0,126
25509,412696,1,18,2,2,0,128
25510,412696,1,18,3,4,0,132
25511,412696,1,18,4,1,0,133
25512,412696,1,18,5,1,0,134
25513,412696,1,18,6,4,0,138
25514,412696,1,19,1,6,0,144
25515,412696,1,19,2,0,0,144
25516,412696,1,19,3,1,0,145
25517,412696,1,19,4,6,0,151
25518,412696,1,19,5,1,0,152
25519,412696,1,19,6,1,0,153
25520,412696,1,20,1,6,0,159
25521,412696,1,20,2,4,0,163
25522,412696,1,20,3,2,0,165
25523,412696,1,20,4,1,0,166
25524,412696,1,20,5,1,0,167
25525,412696,1,20,6,1,0,168
25624,412697,1,1,1,0,0,0
25625,412697,1,1,2,4,0,4
25626,412697,1,1,3,0,0,4
25627,412697,1,1,4,0,0,4
25628,412697,1,1,5,0,0,4
25629,412697,1,1,6,0,0,4
25630,412697,1,2,1,2,0,6
25631,412697,1,2,2,0,0,6
25632,412697,1,2,3,0,0,6
25633,412697,1,2,4,0,1,6
25634,412697,1,2,5,1,0,7
25635,412697,1,2,6,0,0,7
25636,412697,1,3,1,0,0,7
25637,412697,1,3,2,0,0,7
25638,412697,1,3,3,2,0,9
25639,412697,1,3,4,0,0,9
25640,412697,1,3,5,1,0,10
25641,412697,1,3,6,0,0,10
25642,412697,1,4,1,4,0,14
25643,412697,1,4,2,0,0,14
25644,412697,1,4,3,0,0,14
25645,412697,1,4,4,0,1,14
25646,412697,1,4,5,2,0,16
25647,412697,1,4,6,0,0,16
25648,412697,1,5,1,0,0,16
25649,412697,1,5,2,1,0,17
25650,412697,1,5,3,1,0,18
25651,412697,1,5,4,0,0,18
25652,412697,1,5,5,0,0,18
25653,412697,1,5,6,0,1,18
25654,412697,1,6,1,0,0,18
25655,412697,1,6,2,0,0,18
25656,412697,1,6,3,0,0,18
25657,412697,1,6,4,1,0,19
25658,412697,1,6,5,0,0,19
25659,412697,1,6,6,0,0,19
25660,412697,1,7,1,1,0,20
25661,412697,1,7,2,1,0,21
25662,412697,1,7,3,0,0,21
25663,412697,1,7,4,0,0,21
25664,412697,1,7,5,2,0,23
25665,412697,1,7,6,0,0,23
25666,412697,1,8,1,1,0,24
25667,412697,1,8,2,1,0,25
25668,412697,1,8,3,4,0,29
25669,412697,1,8,4,1,0,30
25670,412697,1,8,5,6,0,36
25671,412697,1,8,6,1,0,37
25672,412697,1,9,1,2,0,39
25673,412697,1,9,2,4,0,43
25674,412697,1,9,3,2,0,45
25675,412697,1,9,4,0,0,45
25676,412697,1,9,5,1,0,46
25677,412697,1,9,6,0,0,46
25678,412697,1,10,1,1,0,47
25679,412697,1,10,2,1,0,48
25680,412697,1,10,3,0,0,48
25681,412697,1,10,4,1,0,49
25682,412697,1,10,5,0,0,49
25683,412697,1,10,6,1,0,50
25684,412697,1,11,1,6,0,56
25685,412697,1,11,2,0,0,56
25686,412697,1,11,3,1,0,57
25687,412697,1,11,4,6,0,63
25688,412697,1,11,5,6,0,69
25689,412697,1,11,6,0,1,69
25690,412697,1,12,1,2,0,71
25691,412697,1,12,2,0,0,71
25692,412697,1,12,3,1,0,72
25693,412697,1,12,4,0,0,72
25694,412697,1,12,5,0,0,72
25695,412697,1,12,6,1,0,73
25696,412697,1,13,1,4,0,77
25697,412697,1,13,2,4,0,81
25698,412697,1,13,3,1,0,82
25699,412697,1,13,4,0,0,82
25700,412697,1,13,5,4,0,86
25701,412697,1,13,6,0,0,86
25702,412697,1,14,1,1,0,87
25703,412697,1,14,2,6,0,93
25704,412697,1,14,3,1,0,94
25705,412697,1,14,4,6,0,100
25706,412697,1,14,5,1,0,101
25707,412697,1,14,6,1,0,102
25708,412697,1,15,1,1,0,103
25709,412697,1,15,2,1,0,104
25710,412697,1,15,3,1,0,105
25711,412697,1,15,4,1,0,106
25712,412697,1,15,5,2,0,108
25713,412697,1,15,6,2,0,110
25714,412697,1,16,1,0,0,110
25715,412697,1,16,2,1,0,111
25716,412697,1,16,3,4,0,115
25717,412697,1,16,4,1,0,116
25718,412697,1,16,5,4,0,120
25719,412697,1,16,6,4,0,124
25720,412697,1,17,1,6,0,130
25721,412697,1,17,2,0,0,130
25722,412697,1,17,3,0,1,130
25723,412697,1,17,4,2,0,132
25724,412697,1,17,5,0,0,132
25725,412697,1,17,6,0,1,132
25726,412697,1,18,1,1,0,133
25727,412697,1,18,2,0,0,133
25728,412697,1,18,3,1,0,134
25729,412697,1,18,4,1,0,135
25730,412697,1,18,5,1,0,136
25731,412697,1,18,6,1,0,137
25732,412697,1,19,1,0,0,137
25733,412697,1,19,2,1,0,138
25734,412697,1,19,3,1,0,139
25735,412697,1,19,4,2,0,141
25736,412697,1,19,5,1,0,142
25737,412697,1,19,6,0,0,142
25738,412697,1,20,1,1,0,143
25739,412697,1,20,2,0,0,143
25740,412697,1,20,3,0,1,143
25741,412697,1,20,4,2,0,145
25742,412697,1,20,5,1,0,146
25743,412697,1,20,6,2,0,148
25864,412698,1,1,1,0,0,0
25865,412698,1,1,2,0,0,0
25866,412698,1,1,3,0,0,0
25867,412698,1,1,4,0,0,0
25868,412698,1,1,5,1,0,1
25869,412698,1,1,6,0,0,1
25870,412698,1,2,1,4,0,5
25871,412698,1,2,2,1,0,6
25872,412698,1,2,3,1,0,7
25873,412698,1,2,4,1,0,8
25874,412698,1,2,5,1,0,9
25875,412698,1,2,6,0,0,9
25876,412698,1,3,1,4,0,13
25877,412698,1,3,2,4,0,17
25878,412698,1,3,3,1,0,18
25879,412698,1,3,4,1,0,19
25880,412698,1,3,5,0,0,19
25881,412698,1,3,6,1,0,20
25882,412698,1,4,1,1,0,21
25883,412698,1,4,2,0,0,21
25884,412698,1,4,3,0,0,21
25885,412698,1,4,4,4,0,25
25886,412698,1,4,5,0,0,25
25887,412698,1,4,6,4,0,29
25888,412698,1,5,1,0,0,29
25889,412698,1,5,2,1,0,30
25890,412698,1,5,3,0,0,30
25891,412698,1,5,4,0,1,30
25892,412698,1,5,5,0,0,30
25893,412698,1,5,6,2,0,32
25894,412698,1,6,1,1,0,33
25895,412698,1,6,2,0,0,33
25896,412698,1,6,3,1,0,34
25897,412698,1,6,4,1,0,35
25898,412698,1,6,5,4,0,39
25899,412698,1,6,6,0,0,39
25900,412698,1,7,1,1,0,40
25901,412698,1,7,2,0,0,40
25902,412698,1,7,3,1,0,41
25903,412698,1,7,4,1,0,42
25904,412698,1,7,5,1,0,43
25905,412698,1,7,6,1,0,44
25906,412698,1,8,1,0,0,44
25907,412698,1,8,2,1,0,45
25908,412698,1,8,3,1,0,46
25909,412698,1,8,4,1,0,47
25910,412698,1,8,5,2,0,49
25911,412698,1,8,6,1,0,50
25912,412698,1,9,1,1,0,51
25913,412698,1,9,2,2,0,53
25914,412698,1,9,3,0,0,53
25915,412698,1,9,4,6,0,59
25916,412698,1,9,5,0,0,59
25917,412698,1,9,6,0,1,59
25918,412698,1,10,1,0,0,59
25919,412698,1,10,2,1,0,60
25920,412698,1,10,3,1,0,61
25921,412698,1,10,4,0,0,61
25922,412698,1,10,5,1,0,62
25923,412698,1,10,6,1,0,63
25924,412698,1,11,1,1,0,64
25925,412698,1,11,2,1,0,65
25926,412698,1,11,3,0,1,65
25927,412698,1,11,4,1,0,66
25928,412698,1,11,5,1,0,67
25929,412698,1,11,6,1,0,68
25930,412698,1,12,1,1,0,69
25931,412698,1,12,2,1,0,70
25932,412698,1,12,3,3,0,73
25933,412698,1,12,4,1,0,74
25934,412698,1,12,5,2,0,76
25935,412698,1,12,6,1,0,77
25936,412698,1,13,1,6,0,83
25937,412698,1,13,2,1,0,84
25938,412698,1,13,3,1,0,85
25939,412698,1,13,4,1,0,86
25940,412698,1,13,5,2,0,88
25941,412698,1,13,6,1,0,89
25942,412698,1,14,1,4,0,93
25943,412698,1,14,2,1,0,94
25944,412698,1,14,3,2,0,96
25945,412698,1,14,4,2,0,98
25946,412698,1,14,5,2,0,100
25947,412698,1,14,6,1,0,101
25948,412698,1,15,1,0,0,101
25949,412698,1,15,2,1,0,102
25950,412698,1,15,3,4,0,106
25951,412698,1,15,4,0,0,106
25952,412698,1,15,5,4,0,110
25953,412698,1,15,6,2,0,112
25954,412698,1,16,1,1,0,113
25955,412698,1,16,2,1,0,114
25956,412698,1,16,3,2,0,116
25957,412698,1,16,4,0,0,116
25958,412698,1,16,5,1,0,117
25959,412698,1,16,6,1,0,118
25960,412698,1,17,1,6,0,124
25961,412698,1,17,2,0,0,124
25962,412698,1,17,3,0,0,124
25963,412698,1,17,4,1,0,125
25964,412698,1,17,5,0,0,125
25965,412698,1,17,6,1,0,126
25966,412698,1,18,1,1,0,127
25967,412698,1,18,2,0,1,127
25968,412698,1,18,3,2,0,129
25969,412698,1,18,4,1,0,130
25970,412698,1,18,5,1,0,131
25971,412698,1,18,6,2,1,133
25972,412698,1,19,1,1,0,134
25973,412698,1,19,2,1,0,135
25974,412698,1,19,3,6,0,141
25975,412698,1,19,4,0,1,141
25976,412698,1,19,5,1,0,142
25977,412698,1,19,6,0,0,142
25978,412698,1,20,1,1,0,143
25979,412698,1,20,2,1,0,144
25980,412698,1,20,3,1,0,145
25981,412698,1,20,4,1,0,146
25982,412698,1,20,5,1,0,147
25983,412698,1,20,6,2,0,149
26099,412699,1,1,1,4,0,4
26100,412699,1,1,2,1,0,5
26101,412699,1,1,3,0,0,5
26102,412699,1,1,4,3,0,8
26103,412699,1,1,5,0,0,8
26104,412699,1,1,6,0,0,8
26105,412699,1,2,1,1,0,9
26106,412699,1,2,2,1,0,10
26107,412699,1,2,3,0,0,10
26108,412699,1,2,4,1,0,11
26109,412699,1,2,5,0,0,11
26110,412699,1,2,6,0,0,11
26111,412699,1,3,1,0,0,11
26112,412699,1,3,2,1,0,12
26113,412699,1,3,3,4,0,16
26114,412699,1,3,4,1,0,17
26115,412699,1,3,5,2,0,19
26116,412699,1,3,6,0,0,19
26117,412699,1,4,1,1,0,20
26118,412699,1,4,2,4,0,24
26119,412699,1,4,3,2,0,26
26120,412699,1,4,4,1,0,27
26121,412699,1,4,5,1,0,28
26122,412699,1,4,6,1,0,29
26123,412699,1,5,1,1,0,30
26124,412699,1,5,2,0,1,30
26125,412699,1,5,3,0,0,30
26126,412699,1,5,4,1,0,31
26127,412699,1,5,5,0,0,31
26128,412699,1,5,6,4,0,35
26129,412699,1,6,1,2,0,37
26130,412699,1,6,2,4,0,41
26131,412699,1,6,3,2,0,43
26132,412699,1,6,4,5,0,48
26133,412699,1,6,5,4,0,52
26134,412699,1,6,6,0,0,52
26135,412699,1,7,1,1,0,53
26136,412699,1,7,2,4,0,57
26137,412699,1,7,3,0,0,57
26138,412699,1,7,4,6,0,63
26139,412699,1,7,5,1,0,64
26140,412699,1,7,6,1,0,65
26141,412699,1,8,1,0,0,65
26142,412699,1,8,2,1,0,66
26143,412699,1,8,3,2,0,68
26144,412699,1,8,4,1,0,69
26145,412699,1,8,5,1,0,70
26146,412699,1,8,6,1,0,71
26147,412699,1,9,1,2,0,73
26148,412699,1,9,2,1,0,74
26149,412699,1,9,3,1,0,75
26150,412699,1,9,4,2,0,77
26151,412699,1,9,5,2,0,79
26152,412699,1,9,6,1,0,80
26153,412699,1,10,1,1,0,81
26154,412699,1,10,2,2,0,83
26155,412699,1,10,3,1,0,84
26156,412699,1,10,4,1,0,85
26157,412699,1,10,5,4,0,89
26158,412699,1,10,6,1,0,90
26159,412699,1,11,1,1,0,91
26160,412699,1,11,2,1,0,92
26161,412699,1,11,3,1,0,93
26162,412699,1,11,4,1,0,94
26163,412699,1,11,5,1,0,95
26164,412699,1,11,6,1,0,96
26165,412699,1,12,1,0,1,96
26166,412699,1,12,2,1,0,97
26167,412699,1,12,3,0,0,97
26168,412699,1,12,4,0,0,97
26169,412699,1,12,5,1,0,98
26170,412699,1,12,6,0,0,98
26171,412699,1,13,1,2,0,100
26172,412699,1,13,2,1,0,101
26173,412699,1,13,3,6,0,107
26174,412699,1,13,4,2,0,109
26175,412699,1,13,5,1,0,110
26176,412699,1,13,6,0,0,110
26177,412699,1,14,1,1,0,111
26178,412699,1,14,2,6,0,117
26179,412699,1,14,3,0,0,117
26180,412699,1,14,4,0,0,117
26181,412699,1,14,5,0,0,117
26182,412699,1,14,6,2,0,119
26183,412699,1,15,1,2,0,121
26184,412699,1,15,2,0,0,121
26185,412699,1,15,3,1,0,122
26186,412699,1,15,4,2,0,124
26187,412699,1,15,5,1,0,125
26188,412699,1,15,6,1,0,126
26189,412699,1,16,1,4,0,130
26190,412699,1,16,2,1,0,131
26191,412699,1,16,3,1,0,132
26192,412699,1,16,4,1,0,133
26193,412699,1,16,5,1,0,134
26194,412699,1,16,6,0,0,134
26195,412699,1,17,1,1,0,135
26196,412699,1,17,2,1,0,136
26197,412699,1,17,3,0,0,136
26198,412699,1,17,4,1,0,137
26199,412699,1,17,5,1,0,138
26200,412699,1,17,6,1,0,139
26201,412699,1,18,1,5,0,144
26202,412699,1,18,2,0,1,144
26203,412699,1,18,3,1,0,145
26204,412699,1,18,4,1,0,146
26205,412699,1,18,5,1,0,147
26206,412699,1,18,6,0,1,147
26207,412699,1,19,1,1,0,148
26208,412699,1,19,2,4,0,152
26209,412699,1,19,3,0,0,152
26210,412699,1,19,4,0,0,152
26211,412699,1,19,5,2,0,154
26212,412699,1,19,6,2,0,156
26213,412699,1,20,1,1,0,157
26214,412699,1,20,2,4,0,161
26215,412699,1,20,3,0,0,161
26216,412699,1,20,4,1,0,162
26217,412699,1,20,5,1,0,163
26218,412699,1,20,6,0,1,163
26339,412700,1,1,1,5,0,5
26340,412700,1,1,2,0,1,5
26341,412700,1,1,3,1,0,6
26342,412700,1,1,4,4,0,10
26343,412700,1,1,5,1,0,11
26344,412700,1,1,6,1,0,12
26345,412700,1,2,1,0,0,12
26346,412700,1,2,2,1,0,13
26347,412700,1,2,3,4,0,17
26348,412700,1,2,4,0,0,17
26349,412700,1,2,5,2,0,19
26350,412700,1,2,6,1,0,20
26351,412700,1,3,1,0,0,20
26352,412700,1,3,2,2,0,22
26353,412700,1,3,3,0,0,22
26354,412700,1,3,4,0,0,22
26355,412700,1,3,5,1,0,23
26356,412700,1,3,6,1,0,24
26357,412700,1,4,1,0,0,24
26358,412700,1,4,2,4,0,28
26359,412700,1,4,3,0,0,28
26360,412700,1,4,4,1,0,29
26361,412700,1,4,5,1,0,30
26362,412700,1,4,6,0,0,30
26363,412700,1,5,1,0,0,30
26364,412700,1,5,2,5,0,35
26365,412700,1,5,3,0,0,35
26366,412700,1,5,4,0,0,35
26367,412700,1,5,5,4,0,39
26368,412700,1,5,6,0,1,39
26369,412700,1,6,1,0,0,39
26370,412700,1,6,2,0,0,39
26371,412700,1,6,3,0,0,39
26372,412700,1,6,4,0,0,39
26373,412700,1,6,5,1,0,40
26374,412700,1,6,6,0,0,40
26375,412700,1,7,1,1,0,41
26376,412700,1,7,2,0,0,41
26377,412700,1,7,3,1,0,42
26378,412700,1,7,4,2,0,44
26379,412700,1,7,5,1,0,45
26380,412700,1,7,6,1,0,46
26381,412700,1,8,1,4,0,50
26382,412700,1,8,2,1,0,51
26383,412700,1,8,3,1,0,52
26384,412700,1,8,4,0,0,52
26385,412700,1,8,5,0,1,52
26386,412700,1,8,6,1,0,53
26387,412700,1,9,1,2,0,55
26388,412700,1,9,2,1,0,56
26389,412700,1,9,3,0,0,56
26390,412700,1,9,4,0,1,56
26391,412700,1,9,5,1,0,57
26392,412700,1,9,6,1,0,58
26393,412700,1,10,1,0,0,58
26394,412700,1,10,2,1,0,59
26395,412700,1,10,3,1,1,60
26396,412700,1,10,4,0,0,60
26397,412700,1,10,5,0,0,60
26398,412700,1,10,6,1,0,61
26399,412700,1,11,1,0,0,61
26400,412700,1,11,2,1,0,62
26401,412700,1,11,3,1,0,63
26402,412700,1,11,4,4,0,67
26403,412700,1,11,5,0,0,67
26404,412700,1,11,6,0,0,67
26405,412700,1,12,1,1,0,68
26406,412700,1,12,2,1,0,69
26407,412700,1,12,3,1,0,70
26408,412700,1,12,4,0,0,70
26409,412700,1,12,5,0,0,70
26410,412700,1,12,6,6,0,76
26411,412700,1,13,1,1,0,77
26412,412700,1,13,2,0,0,77
26413,412700,1,13,3,0,1,77
26414,412700,1,13,4,0,1,77
26415,412700,1,13,5,0,0,77
26416,412700,1,13,6,2,0,79
26417,412700,1,14,1,1,0,80
26418,412700,1,14,2,0,0,80
26419,412700,1,14,3,1,0,81
26420,412700,1,14,4,1,0,82
26421,412700,1,14,5,0,0,82
26422,412700,1,14,6,0,0,82
26423,412700,1,15,1,0,1,82
26424,412700,1,15,2,2,0,84
26425,412700,1,15,3,1,0,85
26426,412700,1,15,4,0,1,85
26427,412700,1,15,5,1,0,86
26428,412700,1,15,6,0,0,86
26429,412700,1,16,1,0,0,86
26430,412700,1,16,2,0,0,86
26431,412700,1,16,3,1,0,87
26432,412700,1,16,4,1,0,88
26433,412700,1,16,5,3,0,91
26434,412700,1,16,6,0,0,91
26435,412700,1,17,1,0,0,91
26436,412700,1,17,2,2,0,93
26437,412700,1,17,3,0,0,93
26438,412700,1,17,4,1,0,94
26439,412700,1,17,5,0,0,94
26440,412700,1,17,6,0,0,94
26441,412700,1,18,1,2,0,96
26442,412700,1,18,2,1,0,97
26443,412700,1,18,3,1,0,98
26444,412700,1,18,4,0,0,98
26445,412700,1,18,5,0,0,98
26446,412700,1,18,6,0,0,98
26447,412700,1,19,1,0,0,98
26448,412700,1,19,2,1,0,99
26449,412700,1,19,3,0,0,99
26450,412700,1,19,4,6,0,105
26451,412700,1,19,5,0,0,105
26452,412700,1,19,6,0,1,105
26552,412701,1,1,1,4,0,4
26553,412701,1,1,2,0,0,4
26554,412701,1,1,3,1,0,5
26555,412701,1,1,4,0,0,5
26556,412701,1,1,5,1,0,6
26557,412701,1,1,6,1,0,7
26558,412701,1,2,1,0,1,7
26559,412701,1,2,2,4,0,11
26560,412701,1,2,3,0,0,11
26561,412701,1,2,4,0,0,11
26562,412701,1,2,5,0,0,11
26563,412701,1,2,6,0,0,11
26564,412701,1,3,1,2,0,13
26565,412701,1,3,2,1,0,14
26566,412701,1,3,3,4,0,18
26567,412701,1,3,4,1,0,19
26568,412701,1,3,5,1,0,20
26569,412701,1,3,6,0,1,20
26570,412701,1,4,1,4,0,24
26571,412701,1,4,2,0,0,24
26572,412701,1,4,3,0,0,24
26573,412701,1,4,4,1,0,25
26574,412701,1,4,5,0,0,25
26575,412701,1,4,6,1,0,26
26576,412701,1,5,1,0,1,26
26577,412701,1,5,2,0,0,26
26578,412701,1,5,3,0,0,26
26579,412701,1,5,4,0,0,26
26580,412701,1,5,5,0,0,26
26581,412701,1,5,6,4,0,30
26582,412701,1,6,1,4,0,34
26583,412701,1,6,2,0,0,34
26584,412701,1,6,3,1,0,35
26585,412701,1,6,4,1,0,36
26586,412701,1,6,5,1,0,37
26587,412701,1,6,6,1,0,38
26588,412701,1,7,1,0,0,38
26589,412701,1,7,2,1,0,39
26590,412701,1,7,3,0,0,39
26591,412701,1,7,4,0,0,39
26592,412701,1,7,5,0,0,39
26593,412701,1,7,6,0,0,39
26594,412701,1,8,1,0,0,39
26595,412701,1,8,2,1,0,40
26596,412701,1,8,3,0,0,40
26597,412701,1,8,4,0,0,40
26598,412701,1,8,5,2,0,42
26599,412701,1,8,6,1,0,43
26600,412701,1,9,1,1,0,44
26601,412701,1,9,2,1,0,45
26602,412701,1,9,3,1,0,46
26603,412701,1,9,4,0,0,46
26604,412701,1,9,5,1,0,47
26605,412701,1,9,6,0,1,47
26606,412701,1,10,1,0,0,47
26607,412701,1,10,2,1,0,48
26608,412701,1,10,3,1,0,49
26609,412701,1,10,4,1,0,50
26610,412701,1,10,5,4,0,54
26611,412701,1,10,6,1,0,55
26612,412701,1,11,1,1,0,56
26613,412701,1,11,2,0,0,56
26614,412701,1,11,3,1,0,57
26615,412701,1,11,4,2,0,59
26616,412701,1,11,5,1,0,60
26617,412701,1,11,6,1,0,61
26618,412701,1,12,1,1,0,62
26619,412701,1,12,2,2,0,64
26620,412701,1,12,3,0,0,64
26621,412701,1,12,4,0,0,64
26622,412701,1,12,5,1,0,65
26623,412701,1,12,6,0,0,65
26624,412701,1,13,1,6,0,71
26625,412701,1,13,2,1,0,72
26626,412701,1,13,3,1,0,73
26627,412701,1,13,4,0,0,73
26628,412701,1,13,5,1,0,74
26629,412701,1,13,6,1,0,75
26630,412701,1,14,1,0,0,75
26631,412701,1,14,2,0,0,75
26632,412701,1,14,3,0,0,75
26633,412701,1,14,4,0,0,75
26634,412701,1,14,5,4,0,79
26635,412701,1,14,6,1,0,80
26636,412701,1,15,1,1,0,81
26637,412701,1,15,2,0,0,81
26638,412701,1,15,3,2,0,83
26639,412701,1,15,4,2,0,85
26640,412701,1,15,5,1,0,86
26641,412701,1,15,6,0,0,86
26642,412701,1,16,1,1,0,87
26643,412701,1,16,2,0,0,87
26644,412701,1,16,3,0,0,87
26645,412701,1,16,4,1,0,88
26646,412701,1,16,5,4,0,92
26647,412701,1,16,6,0,0,92
26648,412701,1,17,1,1,0,93
26649,412701,1,17,2,0,0,93
26650,412701,1,17,3,0,1,93
26651,412701,1,17,4,1,0,94
26652,412701,1,17,5,1,0,95
26653,412701,1,17,6,1,0,96
26654,412701,1,18,1,4,0,100
26655,412701,1,18,2,2,0,102
26656,412701,1,18,3,4,0,106
26657,412701,1,18,4,3,0,109
26658,412701,1,18,5,2,0,111
26659,412701,1,18,6,2,0,113
26660,412701,1,19,1,2,0,115
26661,412701,1,19,2,1,0,116
26662,412701,1,19,3,1,0,117
26663,412701,1,19,4,0,0,117
26664,412701,1,19,5,1,0,118
26665,412701,1,19,6,2,0,120
26666,412701,1,20,1,1,0,121
26667,412701,1,20,2,1,0,122
26668,412701,1,20,3,1,0,123
26669,412701,1,20,4,2,0,125
26670,412701,1,20,5,1,1,126
26671,412701,1,20,6,2,0,128
26768,412702,1,1,1,0,0,0
26769,412702,1,1,2,0,0,0
26770,412702,1,1,3,0,0,0
26771,412702,1,1,4,0,0,0
26772,412702,1,1,5,0,0,0
26773,412702,1,1,6,0,0,0
26774,412702,1,2,1,1,0,1
26775,412702,1,2,2,0,0,1
26776,412702,1,2,3,1,0,2
26777,412702,1,2,4,0,0,2
26778,412702,1,2,5,1,0,3
26779,412702,1,2,6,0,0,3
26780,412702,1,3,1,0,0,3
26781,412702,1,3,2,0,0,3
26782,412702,1,3,3,4,0,7
26783,412702,1,3,4,4,0,11
26784,412702,1,3,5,3,0,14
26785,412702,1,3,6,0,0,14
26786,412702,1,4,1,0,0,14
26787,412702,1,4,2,0,0,14
26788,412702,1,4,3,4,0,18
26789,412702,1,4,4,4,0,22
26790,412702,1,4,5,1,0,23
26791,412702,1,4,6,4,0,27
26792,412702,1,5,1,0,0,27
26793,412702,1,5,2,0,0,27
26794,412702,1,5,3,4,0,31
26795,412702,1,5,4,0,0,31
26796,412702,1,5,5,1,0,32
26797,412702,1,5,6,0,0,32
26798,412702,1,5,7,0,0,32
26799,412702,1,6,2,0,0,32
26800,412702,1,6,3,2,0,34
26801,412702,1,6,4,3,0,37
26802,412702,1,6,5,1,0,38
26803,412702,1,6,6,1,0,39
26804,412702,1,6,7,1,0,40
26805,412702,1,7,2,1,0,41
26806,412702,1,7,3,2,0,43
26807,412702,1,7,4,4,0,47
26808,412702,1,7,5,0,0,47
26809,412702,1,7,6,6,0,53
26810,412702,1,7,7,2,0,55
26811,412702,1,8,2,4,0,59
26812,412702,1,8,3,1,0,60
26813,412702,1,8,4,0,0,60
26814,412702,1,8,5,2,0,62
26815,412702,1,8,6,0,0,62
26816,412702,1,8,7,1,0,63
26817,412702,1,9,2,6,0,69
26818,412702,1,9,3,2,0,71
26819,412702,1,9,4,1,0,72
26820,412702,1,9,5,1,0,73
26821,412702,1,9,6,4,0,77
26822,412702,1,9,7,4,0,81
26823,412702,1,10,2,0,0,81
26824,412702,1,10,3,1,0,82
26825,412702,1,10,4,0,0,82
26826,412702,1,10,5,0,1,82
26827,412702,1,10,6,2,0,84
26828,412702,1,10,7,1,0,85
26829,412702,1,11,2,1,0,86
26830,412702,1,11,3,1,0,87
26831,412702,1,11,4,0,0,87
26832,412702,1,11,5,1,0,88
26833,412702,1,11,6,0,0,88
26834,412702,1,11,7,1,0,89
26835,412702,1,12,2,0,1,89
26836,412702,1,12,3,4,0,93
26837,412702,1,12,4,1,0,94
26838,412702,1,12,5,1,0,95
26839,412702,1,12,6,1,0,96
26840,412702,1,12,7,1,0,97
26841,412702,1,13,2,2,0,99
26842,412702,1,13,3,1,0,100
26843,412702,1,13,4,1,0,101
26844,412702,1,13,5,2,0,103
26845,412702,1,13,6,1,0,104
26846,412702,1,13,7,1,0,105
26847,412702,1,14,2,1,0,106
26848,412702,1,14,3,4,0,110
26849,412702,1,14,4,0,0,110
26850,412702,1,14,5,1,0,111
26851,412702,1,14,6,0,0,111
26852,412702,1,14,7,2,0,113
26853,412702,1,15,2,1,0,114
26854,412702,1,15,3,0,1,114
26855,412702,1,15,4,2,0,116
26856,412702,1,15,5,1,0,117
26857,412702,1,15,6,1,0,118
26858,412702,1,15,7,0,0,118
26859,412702,1,16,2,1,0,119
26860,412702,1,16,3,1,0,120
26861,412702,1,16,4,1,0,121
26862,412702,1,16,5,1,0,122
26863,412702,1,16,6,6,0,128
26864,412702,1,16,7,4,0,132
26865,412702,1,17,2,6,0,138
26866,412702,1,17,3,4,0,142
26867,412702,1,17,4,2,0,144
26868,412702,1,17,5,0,0,144
26869,412702,1,17,6,1,0,145
26870,412702,1,17,7,0,1,145
26871,412702,1,18,2,6,0,151
26872,412702,1,18,3,4,0,155
26873,412702,1,18,4,6,0,161
26874,412702,1,18,5,1,0,162
26875,412702,1,18,6,1,0,163
26876,412702,1,18,7,6,0,169
26877,412702,1,19,2,1,0,170
26878,412702,1,19,3,1,0,171
26879,412702,1,19,4,6,0,177
26880,412702,1,19,5,3,0,180
26881,412702,1,19,6,2,0,182
26882,412702,1,19,7,2,0,184
26883,412702,1,20,2,1,0,185
26884,412702,1,20,3,1,0,186
26885,412702,1,20,4,1,0,187
26886,412702,1,20,5,1,0,188
26887,412702,1,20,6,3,1,191
26888,412702,1,20,7,0,1,191
27009,412703,1,1,1,2,0,2
27010,412703,1,1,2,0,0,2
27011,412703,1,1,3,0,1,2
27012,412703,1,1,4,2,0,4
27013,412703,1,1,5,1,0,5
27014,412703,1,1,6,1,0,6
27015,412703,1,2,1,0,0,6
27016,412703,1,2,2,0,0,6
27017,412703,1,2,3,1,0,7
27018,412703,1,2,4,0,0,7
27019,412703,1,2,5,0,1,7
27020,412703,1,2,6,1,0,8
27021,412703,1,3,1,0,1,8
27022,412703,1,3,2,1,0,9
27023,412703,1,3,3,1,0,10
27024,412703,1,3,4,0,0,10
27025,412703,1,3,5,0,0,10
27026,412703,1,3,6,0,0,10
27027,412703,1,4,1,0,0,10
27028,412703,1,4,2,1,0,11
27029,412703,1,4,3,1,0,12
27030,412703,1,4,4,2,0,14
27031,412703,1,4,5,1,0,15
27032,412703,1,4,6,1,0,16
27033,412703,1,5,1,4,0,20
27034,412703,1,5,2,1,0,21
27035,412703,1,5,3,1,0,22
27036,412703,1,5,4,0,0,22
27037,412703,1,5,5,1,0,23
27038,412703,1,5,6,0,0,23
27039,412703,1,6,1,1,0,24
27040,412703,1,6,2,0,0,24
27041,412703,1,6,3,0,0,24
27042,412703,1,6,4,0,0,24
27043,412703,1,6,5,0,0,24
27044,412703,1,6,6,0,0,24
27045,412703,1,7,1,1,0,25
27046,412703,1,7,2,1,0,26
27047,412703,1,7,3,2,0,28
27048,412703,1,7,4,1,0,29
27049,412703,1,7,5,1,0,30
27050,412703,1,7,6,4,0,34
27051,412703,1,8,1,1,0,35
27052,412703,1,8,2,1,0,36
27053,412703,1,8,3,1,0,37
27054,412703,1,8,4,0,0,37
27055,412703,1,8,5,1,0,38
27056,412703,1,8,6,0,0,38
27057,412703,1,9,1,1,0,39
27058,412703,1,9,2,1,0,40
27059,412703,1,9,3,0,0,40
27060,412703,1,9,4,2,0,42
27061,412703,1,9,5,1,0,43
27062,412703,1,9,6,1,0,44
27063,412703,1,10,1,1,0,45
27064,412703,1,10,2,0,1,45
27065,412703,1,10,3,1,0,46
27066,412703,1,10,4,1,0,47
27067,412703,1,10,5,0,0,47
27068,412703,1,10,6,0,0,47
27069,412703,1,11,1,1,0,48
27070,412703,1,11,2,1,0,49
27071,412703,1,11,3,2,0,51
27072,412703,1,11,4,1,0,52
27073,412703,1,11,5,1,0,53
27074,412703,1,11,6,1,0,54
27075,412703,1,12,1,0,0,54
27076,412703,1,12,2,1,0,55
27077,412703,1,12,3,2,0,57
27078,412703,1,12,4,1,0,58
27079,412703,1,12,5,0,0,58
27080,412703,1,12,6,1,0,59
27081,412703,1,13,1,0,0,59
27082,412703,1,13,2,6,0,65
27083,412703,1,13,3,1,0,66
27084,412703,1,13,4,4,0,70
27085,412703,1,13,5,6,0,76
27086,412703,1,13,6,4,0,80
27087,412703,1,14,1,0,0,80
27088,412703,1,14,2,1,0,81
27089,412703,1,14,3,0,0,81
27090,412703,1,14,4,0,0,81
27091,412703,1,14,5,4,0,85
27092,412703,1,14,6,0,0,85
27093,412703,1,15,1,1,0,86
27094,412703,1,15,2,4,0,90
27095,412703,1,15,3,0,0,90
27096,412703,1,15,4,1,0,91
27097,412703,1,15,5,0,0,91
27098,412703,1,15,6,1,0,92
27099,412703,1,16,1,1,0,93
27100,412703,1,16,2,1,0,94
27101,412703,1,16,3,1,0,95
27102,412703,1,16,4,0,1,95
27103,412703,1,16,5,1,0,96
27104,412703,1,16,6,1,0,97
27105,412703,1,17,1,1,0,98
27106,412703,1,17,2,1,0,99
27107,412703,1,17,3,4,0,103
27108,412703,1,17,4,1,0,104
27109,412703,1,17,5,9,0,113
27110,412703,1,17,6,1,0,114
27111,412703,1,18,1,1,0,115
27112,412703,1,18,2,4,0,119
27113,412703,1,18,3,1,0,120
27114,412703,1,18,4,4,0,124
27115,412703,1,18,5,2,0,126
27116,412703,1,18,6,2,0,128
27117,412703,1,19,1,1,0,129
27118,412703,1,19,2,2,0,131
27119,412703,1,19,3,0,0,131
27120,412703,1,19,4,4,0,135
27121,412703,1,19,5,2,0,137
27122,412703,1,19,6,3,0,140
27123,412703,1,20,1,1,0,141
27124,412703,1,20,2,1,1,142
27125,412703,1,20,3,1,0,143
27126,412703,1,20,4,1,0,144
27127,412703,1,20,5,1,0,145
27128,412703,1,20,6,2,0,147
27231,423782,1,1,1,1,0,1
27232,423782,1,1,2,0,0,1
27233,423782,1,1,3,1,0,2
27234,423782,1,1,4,1,0,3
27235,423782,1,1,5,0,0,3
27236,423782,1,1,6,1,0,4
27237,423782,1,2,1,1,0,5
27238,423782,1,2,2,4,0,9
27239,423782,1,2,3,4,0,13
27240,423782,1,2,4,0,0,13
27241,423782,1,2,5,4,0,17
27242,423782,1,2,6,0,0,17
27243,423782,1,3,1,1,0,18
27244,423782,1,3,2,0,0,18
27245,423782,1,3,3,0,1,18
27246,423782,1,3,4,0,0,18
27247,423782,1,3,5,0,0,18
27248,423782,1,3,6,0,0,18
27249,423782,1,4,1,1,0,19
27250,423782,1,4,2,0,0,19
27251,423782,1,4,3,0,0,19
27252,423782,1,4,4,0,0,19
27253,423782,1,4,5,1,0,20
27254,423782,1,4,6,1,0,21
27255,423782,1,5,1,1,0,22
27256,423782,1,5,2,0,0,22
27257,423782,1,5,3,4,0,26
27258,423782,1,5,4,1,0,27
27259,423782,1,5,5,4,0,31
27260,423782,1,5,6,0,0,31
27261,423782,1,6,1,0,0,31
27262,423782,1,6,2,6,0,37
27263,423782,1,6,3,0,0,37
27264,423782,1,6,4,0,1,37
27265,423782,1,6,5,0,0,37
27266,423782,1,6,6,2,0,39
27267,423782,1,7,1,0,0,39
27268,423782,1,7,2,1,0,40
27269,423782,1,7,3,1,0,41
27270,423782,1,7,4,0,1,41
27271,423782,1,7,5,1,0,42
27272,423782,1,7,6,0,1,42
27273,423782,1,8,1,0,1,42
27274,423782,1,8,2,1,0,43
27275,423782,1,8,3,0,0,43
27276,423782,1,8,4,0,0,43
27277,423782,1,8,5,0,0,43
27278,423782,1,8,6,0,0,43
27279,423782,1,9,1,1,0,44
27280,423782,1,9,2,0,0,44
27281,423782,1,9,3,1,0,45
27282,423782,1,9,4,0,0,45
27283,423782,1,9,5,1,0,46
27284,423782,1,9,6,0,0,46
27285,423782,1,10,1,1,0,47
27286,423782,1,10,2,4,0,51
27287,423782,1,10,3,0,0,51
27288,423782,1,10,4,0,0,51
27289,423782,1,10,5,1,0,52
27290,423782,1,10,6,0,0,52
27291,423782,1,11,1,0,0,52
27292,423782,1,11,2,0,0,52
27293,423782,1,11,3,0,0,52
27294,423782,1,11,4,1,0,53
27295,423782,1,11,5,0,0,53
27296,423782,1,11,6,0,0,53
27297,423782,1,12,1,0,0,53
27298,423782,1,12,2,0,0,53
27299,423782,1,12,3,1,0,54
27300,423782,1,12,4,0,0,54
27301,423782,1,12,5,1,0,55
27302,423782,1,12,6,1,0,56
27303,423782,1,13,1,1,0,57
27304,423782,1,13,2,0,1,57
27305,423782,1,13,3,0,0,57
27306,423782,1,13,4,0,0,57
27307,423782,1,13,5,1,0,58
27308,423782,1,13,6,1,0,59
27309,423782,1,14,1,0,0,59
27310,423782,1,14,2,0,1,59
27311,423782,1,14,3,1,0,60
27312,423782,1,14,4,0,0,60
27313,423782,1,14,5,0,0,60
27314,423782,1,14,6,4,0,64
27315,423782,1,15,1,0,0,64
27316,423782,1,15,2,0,1,64
27317,423782,1,15,3,0,0,64
27318,423782,1,15,4,0,0,64
27319,423782,1,15,5,0,0,64
27320,423782,1,15,6,0,0,64
27321,423782,1,16,1,4,0,68
27322,423782,1,16,2,1,0,69
27323,423782,1,16,3,0,0,69
27324,423782,1,16,4,1,0,70
27325,423782,1,16,5,1,0,71
27326,423782,1,16,6,0,0,71
27327,423782,1,17,1,1,0,72
27328,423782,1,17,2,0,0,72
27329,423782,1,17,3,0,1,72
27330,423782,1,17,4,0,0,72
27331,423782,1,17,5,0,0,72
27332,423782,1,17,6,0,0,72
27333,423782,1,18,1,6,0,78
27334,423782,1,18,2,0,0,78
27335,423782,1,18,3,0,1,78
27386,423787,1,1,1,2,0,2
27387,423787,1,1,2,0,0,2
27388,423787,1,1,3,0,0,2
27389,423787,1,1,4,0,1,2
27390,423787,1,1,5,0,0,2
27391,423787,1,1,6,0,0,2
27392,423787,1,2,1,1,0,3
27393,423787,1,2,2,0,0,3
27394,423787,1,2,3,0,0,3
27395,423787,1,2,4,0,0,3
27396,423787,1,2,5,4,0,7
27397,423787,1,2,6,0,0,7
27398,423787,1,3,1,0,0,7
27399,423787,1,3,2,0,0,7
27400,423787,1,3,3,0,0,7
27401,423787,1,3,4,0,0,7
27402,423787,1,3,5,0,0,7
27403,423787,1,3,6,1,0,8
27404,423787,1,4,1,0,0,8
27405,423787,1,4,2,1,0,9
27406,423787,1,4,3,0,0,9
27407,423787,1,4,4,0,0,9
27408,423787,1,4,5,4,0,13
27409,423787,1,4,6,0,0,13
27410,423787,1,5,1,0,1,13
27411,423787,1,5,2,0,0,13
27412,423787,1,5,3,0,0,13
27413,423787,1,5,4,4,0,17
27414,423787,1,5,5,1,0,18
27415,423787,1,5,6,0,0,18
27416,423787,1,6,1,0,0,18
27417,423787,1,6,2,1,0,19
27418,423787,1,6,3,4,0,23
27419,423787,1,6,4,0,0,23
27420,423787,1,6,5,4,0,27
27421,423787,1,6,6,2,0,29
27422,423787,1,7,1,1,0,30
27423,423787,1,7,2,1,0,31
27424,423787,1,7,3,2,0,33
27425,423787,1,7,4,0,1,33
27426,423787,1,7,5,1,0,34
27427,423787,1,7,6,0,0,34
27428,423787,1,8,1,1,0,35
27429,423787,1,8,2,0,0,35
27430,423787,1,8,3,1,0,36
27431,423787,1,8,4,0,0,36
27432,423787,1,8,5,0,0,36
27433,423787,1,8,6,1,0,37
27434,423787,1,9,1,2,0,39
27435,423787,1,9,2,1,0,40
27436,423787,1,9,3,1,0,41
27437,423787,1,9,4,0,0,41
27438,423787,1,9,5,1,0,42
27439,423787,1,9,6,1,0,43
27440,423787,1,10,1,1,0,44
27441,423787,1,10,2,0,0,44
27442,423787,1,10,3,1,0,45
27443,423787,1,10,4,0,0,45
27444,423787,1,10,5,2,0,47
27445,423787,1,10,6,2,0,49
27446,423787,1,11,1,1,0,50
27447,423787,1,11,2,2,0,52
27448,423787,1,11,3,1,0,53
27449,423787,1,11,4,1,0,54
27450,423787,1,11,5,0,1,54
27451,423787,1,11,6,0,0,54
27452,423787,1,12,1,0,0,54
27453,423787,1,12,2,1,0,55
27454,423787,1,12,3,1,0,56
27455,423787,1,12,4,1,0,57
27456,423787,1,12,5,0,0,57
27457,423787,1,12,6,1,0,58
27458,423787,1,13,1,1,0,59
27459,423787,1,13,2,1,0,60
27460,423787,1,13,3,1,0,61
27461,423787,1,13,4,4,0,65
27462,423787,1,13,5,1,0,66
27463,423787,1,13,6,6,0,72
27464,423787,1,14,1,0,0,72
27465,423787,1,14,2,1,0,73
27466,423787,1,14,3,0,0,73
27467,423787,1,14,4,1,0,74
27468,423787,1,14,5,1,0,75
27469,423787,1,14,6,6,0,81
27470,423787,1,15,1,6,0,87
27471,423787,1,15,2,1,0,88
27472,423787,1,15,3,0,0,88
27473,423787,1,15,4,4,0,92
27474,423787,1,15,5,1,0,93
27475,423787,1,15,6,4,0,97
27476,423787,1,16,1,2,0,99
27477,423787,1,16,2,0,0,99
27478,423787,1,16,3,4,0,103
27479,423787,1,16,4,0,0,103
27480,423787,1,16,5,1,0,104
27481,423787,1,16,6,0,1,104
27482,423787,1,17,1,0,0,104
27483,423787,1,17,2,0,0,104
27484,423787,1,17,3,2,0,106
27485,423787,1,17,4,0,0,106
27486,423787,1,17,5,1,0,107
27487,423787,1,17,6,2,0,109
27488,423787,1,18,1,0,1,109
27489,423787,1,18,2,1,0,110
27490,423787,1,18,3,0,0,110
27491,423787,1,18,4,0,0,110
27492,423787,1,18,5,1,0,111
27493,423787,1,18,6,0,1,111
27494,423787,1,19,1,0,0,111
27495,423787,1,19,2,1,0,112
27496,423787,1,19,3,1,0,113
27497,423787,1,19,4,0,1,113
27498,423787,1,19,5,0,0,113
27499,423787,1,19,6,1,0,114
27500,423787,1,20,1,1,0,115
27501,423787,1,20,2,1,0,116
27502,423787,1,20,3,1,0,117
27503,423787,1,20,4,0,1,117
27504,423787,1,20,5,1,0,118
27505,423787,1,20,6,0,1,118
27602,426392,1,1,1,0,0,0
27603,426392,1,1,2,0,0,0
27604,426392,1,1,3,2,0,2
27605,426392,1,1,4,0,1,2
27606,426392,1,1,5,0,0,2
27607,426392,1,1,6,1,0,3
27608,426392,1,2,1,1,0,4
27609,426392,1,2,2,2,0,6
27610,426392,1,2,3,0,0,6
27611,426392,1,2,4,0,0,6
27612,426392,1,2,5,0,0,6
27613,426392,1,2,6,0,0,6
27614,426392,1,3,1,1,0,7
27615,426392,1,3,2,6,0,13
27616,426392,1,3,3,6,0,19
27617,426392,1,3,4,0,0,19
27618,426392,1,3,5,0,0,19
27619,426392,1,3,6,4,0,23
27620,426392,1,4,1,1,0,24
27621,426392,1,4,2,1,0,25
27622,426392,1,4,3,0,0,25
27623,426392,1,4,4,1,0,26
27624,426392,1,4,5,2,0,28
27625,426392,1,4,6,0,0,28
27626,426392,1,5,1,1,0,29
27627,426392,1,5,2,0,0,29
27628,426392,1,5,3,1,0,30
27629,426392,1,5,4,2,0,32
27630,426392,1,5,5,4,0,36
27631,426392,1,5,6,0,0,36
27632,426392,1,6,1,0,0,36
27633,426392,1,6,2,0,0,36
27634,426392,1,6,3,4,0,40
27635,426392,1,6,4,0,0,40
27636,426392,1,6,5,2,0,42
27637,426392,1,6,6,1,0,43
27638,426392,1,7,1,1,0,44
27639,426392,1,7,2,0,0,44
27640,426392,1,7,3,1,0,45
27641,426392,1,7,4,0,1,45
27642,426392,1,7,5,0,1,45
27643,426392,1,7,6,1,0,46
27644,426392,1,8,1,0,0,46
27645,426392,1,8,2,0,0,46
27646,426392,1,8,3,1,0,47
27647,426392,1,8,4,0,1,47
27648,426392,1,8,5,0,0,47
27649,426392,1,8,6,1,0,48
27650,426392,1,9,1,1,0,49
27651,426392,1,9,2,0,0,49
27652,426392,1,9,3,1,0,50
27653,426392,1,9,4,1,0,51
27654,426392,1,9,5,0,0,51
27655,426392,1,9,6,1,0,52
27656,426392,1,10,1,1,0,53
27657,426392,1,10,2,1,0,54
27658,426392,1,10,3,1,0,55
27659,426392,1,10,4,6,0,61
27660,426392,1,10,5,6,0,67
27661,426392,1,10,6,0,0,67
27662,426392,1,11,1,4,0,71
27663,426392,1,11,2,4,0,75
27664,426392,1,11,3,1,0,76
27665,426392,1,11,4,4,0,80
27666,426392,1,11,5,4,0,84
27667,426392,1,11,6,3,0,87
27668,426392,1,12,1,0,0,87
27669,426392,1,12,2,1,0,88
27670,426392,1,12,3,5,0,93
27671,426392,1,12,4,1,0,94
27672,426392,1,12,5,4,0,98
27673,426392,1,12,6,0,1,98
27674,426392,1,13,1,0,0,98
27675,426392,1,13,2,1,0,99
27676,426392,1,13,3,0,0,99
27677,426392,1,13,4,1,0,100
27678,426392,1,13,5,4,0,104
27679,426392,1,13,6,2,0,106
27680,426392,1,14,1,1,0,107
27681,426392,1,14,2,1,0,108
27682,426392,1,14,3,0,0,108
27683,426392,1,14,4,0,0,108
27684,426392,1,14,5,1,0,109
27685,426392,1,14,6,4,0,113
27686,426392,1,15,1,1,0,114
27687,426392,1,15,2,6,0,120
27688,426392,1,15,3,4,0,124
27689,426392,1,15,4,2,0,126
27690,426392,1,15,5,0,0,126
27691,426392,1,15,6,1,0,127
27692,426392,1,16,1,1,0,128
27693,426392,1,16,2,1,0,129
27694,426392,1,16,3,1,0,130
27695,426392,1,16,4,2,0,132
27696,426392,1,16,5,1,0,133
27697,426392,1,16,6,4,0,137
27698,426392,1,17,1,0,1,137
27699,426392,1,17,2,0,0,137
27700,426392,1,17,3,0,0,137
27701,426392,1,17,4,1,0,138
27702,426392,1,17,5,6,0,144
27703,426392,1,17,6,1,0,145
27704,426392,1,18,1,2,0,147
27705,426392,1,18,2,2,0,149
27706,426392,1,18,3,0,0,149
27707,426392,1,18,4,1,0,150
27708,426392,1,18,5,1,0,151
27709,426392,1,18,6,0,0,151
27710,426392,1,19,1,1,0,152
27711,426392,1,19,2,1,0,153
27712,426392,1,19,3,0,1,153
27713,426392,1,19,4,2,0,155
27714,426392,1,19,5,1,0,156
27715,426392,1,19,6,1,0,157
27716,426392,1,20,1,1,0,158
27717,426392,1,20,2,1,0,159
27718,426392,1,20,3,6,0,165
27719,426392,1,20,4,0,0,165
27720,426392,1,20,5,1,0,166
27721,426392,1,20,6,1,1,167
27834,426393,1,1,1,0,0,0
27835,426393,1,1,2,0,0,0
27836,426393,1,1,3,0,0,0
27837,426393,1,1,4,0,1,0
27838,426393,1,1,5,0,0,0
27839,426393,1,1,6,0,0,0
27840,426393,1,2,1,2,0,2
27841,426393,1,2,2,0,0,2
27842,426393,1,2,3,0,0,2
27843,426393,1,2,4,4,0,6
27844,426393,1,2,5,0,0,6
27845,426393,1,2,6,1,0,7
27846,426393,1,3,1,1,0,8
27847,426393,1,3,2,0,0,8
27848,426393,1,3,3,0,0,8
27849,426393,1,3,4,4,0,12
27850,426393,1,3,5,2,0,14
27851,426393,1,3,6,0,0,14
27852,426393,1,4,1,4,0,18
27853,426393,1,4,2,1,0,19
27854,426393,1,4,3,4,0,23
27855,426393,1,4,4,0,0,23
27856,426393,1,4,5,4,0,27
27857,426393,1,4,6,1,0,28
27858,426393,1,5,1,0,0,28
27859,426393,1,5,2,0,0,28
27860,426393,1,5,3,4,0,32
27861,426393,1,5,4,1,0,33
27862,426393,1,5,5,0,0,33
27863,426393,1,5,6,4,0,37
27864,426393,1,6,1,0,0,37
27865,426393,1,6,2,0,0,37
27866,426393,1,6,3,4,0,41
27867,426393,1,6,4,3,0,44
27868,426393,1,6,5,4,0,48
27869,426393,1,6,6,2,0,50
27870,426393,1,7,1,1,0,51
27871,426393,1,7,2,5,0,56
27872,426393,1,7,3,0,0,56
27873,426393,1,7,4,1,0,57
27874,426393,1,7,5,4,0,61
27875,426393,1,7,6,0,1,61
27876,426393,1,8,1,1,0,62
27877,426393,1,8,2,1,0,63
27878,426393,1,8,3,1,0,64
27879,426393,1,8,4,0,0,64
27880,426393,1,8,5,0,0,64
27881,426393,1,8,6,1,0,65
27882,426393,1,9,1,0,0,65
27883,426393,1,9,2,1,0,66
27884,426393,1,9,3,2,0,68
27885,426393,1,9,4,1,0,69
27886,426393,1,9,5,1,0,70
27887,426393,1,9,6,0,0,70
27888,426393,1,10,1,2,0,72
27889,426393,1,10,2,0,0,72
27890,426393,1,10,3,6,0,78
27891,426393,1,10,4,0,1,78
27892,426393,1,10,5,1,0,79
27893,426393,1,10,6,0,0,79
27894,426393,1,11,1,0,0,79
27895,426393,1,11,2,2,0,81
27896,426393,1,11,3,1,0,82
27897,426393,1,11,4,1,0,83
27898,426393,1,11,5,1,0,84
27899,426393,1,11,6,1,0,85
27900,426393,1,12,1,0,0,85
27901,426393,1,12,2,0,0,85
27902,426393,1,12,3,0,0,85
27903,426393,1,12,4,2,0,87
27904,426393,1,12,5,0,0,87
27905,426393,1,12,6,4,0,91
27906,426393,1,13,1,1,0,92
27907,426393,1,13,2,0,0,92
27908,426393,1,13,3,1,0,93
27909,426393,1,13,4,1,0,94
27910,426393,1,13,5,4,0,98
27911,426393,1,13,6,2,0,100
27912,426393,1,14,1,0,1,100
27913,426393,1,14,2,0,0,100
27914,426393,1,14,3,4,0,104
27915,426393,1,14,4,0,0,104
27916,426393,1,14,5,1,0,105
27917,426393,1,14,6,1,0,106
27918,426393,1,15,1,4,0,110
27919,426393,1,15,2,0,0,110
27920,426393,1,15,3,0,0,110
27921,426393,1,15,4,4,0,114
27922,426393,1,15,5,1,0,115
27923,426393,1,15,6,1,0,116
27924,426393,1,16,1,0,0,116
27925,426393,1,16,2,1,0,117
27926,426393,1,16,3,1,0,118
27927,426393,1,16,4,6,0,124
27928,426393,1,16,5,0,0,124
27929,426393,1,16,6,1,0,125
27930,426393,1,17,1,4,0,129
27931,426393,1,17,2,1,0,130
27932,426393,1,17,3,0,1,130
27933,426393,1,17,4,0,1,130
27934,426393,1,17,5,4,0,134
27935,426393,1,17,6,0,0,134
27936,426393,1,18,1,1,0,135
27937,426393,1,18,2,1,0,136
27938,426393,1,18,3,1,0,137
27939,426393,1,18,4,1,0,138
27940,426393,1,18,5,1,0,139
27941,426393,1,18,6,7,1,146
27942,426393,1,19,1,0,1,146
27943,426393,1,19,2,1,0,147
27944,426393,1,19,3,6,0,153
27945,426393,1,19,4,1,0,154
27946,426393,1,19,5,0,1,154
27947,426393,1,19,6,0,0,154
27948,426393,1,20,1,0,0,154
27949,426393,1,20,2,1,0,155
27950,426393,1,20,3,4,0,159
27951,426393,1,20,4,1,0,160
27952,426393,1,20,5,1,0,161
27953,426393,1,20,6,1,0,162
28072,426417,1,1,1,3,0,3
28073,426417,1,1,2,4,0,7
28074,426417,1,1,3,1,0,8
28075,426417,1,1,4,3,0,11
28076,426417,1,1,5,1,0,12
28077,426417,1,1,6,0,0,12
28078,426417,1,2,1,1,0,13
28079,426417,1,2,2,0,1,13
28080,426417,1,2,3,1,0,14
28081,426417,1,2,4,0,0,14
28082,426417,1,2,5,0,0,14
28083,426417,1,2,6,1,0,15
28084,426417,1,3,1,1,0,16
28085,426417,1,3,2,0,0,16
28086,426417,1,3,3,2,0,18
28087,426417,1,3,4,0,0,18
28088,426417,1,3,5,2,0,20
28089,426417,1,3,6,1,0,21
28090,426417,1,4,1,0,0,21
28091,426417,1,4,2,3,0,24
28092,426417,1,4,3,1,0,25
28093,426417,1,4,4,4,0,29
28094,426417,1,4,5,1,0,30
28095,426417,1,4,6,0,0,30
28096,426417,1,5,1,0,0,30
28097,426417,1,5,2,4,0,34
28098,426417,1,5,3,4,0,38
28099,426417,1,5,4,2,0,40
28100,426417,1,5,5,1,0,41
28101,426417,1,5,6,2,0,43
28102,426417,1,6,1,1,0,44
28103,426417,1,6,2,0,0,44
28104,426417,1,6,3,0,0,44
28105,426417,1,6,4,0,0,44
28106,426417,1,6,5,4,0,48
28107,426417,1,6,6,1,0,49
28108,426417,1,7,1,0,0,49
28109,426417,1,7,2,0,0,49
28110,426417,1,7,3,1,0,50
28111,426417,1,7,4,0,0,50
28112,426417,1,7,5,0,1,50
28113,426417,1,7,6,0,0,50
28114,426417,1,8,1,0,0,50
28115,426417,1,8,2,0,0,50
28116,426417,1,8,3,1,0,51
28117,426417,1,8,4,0,0,51
28118,426417,1,8,5,0,0,51
28119,426417,1,8,6,0,0,51
28120,426417,1,9,1,1,0,52
28121,426417,1,9,2,3,0,55
28122,426417,1,9,3,0,0,55
28123,426417,1,9,4,1,0,56
28124,426417,1,9,5,0,1,56
28125,426417,1,9,6,0,0,56
28126,426417,1,10,1,0,0,56
28127,426417,1,10,2,2,0,58
28128,426417,1,10,3,0,0,58
28129,426417,1,10,4,2,0,60
28130,426417,1,10,5,0,0,60
28131,426417,1,10,6,1,0,61
28132,426417,1,11,1,0,0,61
28133,426417,1,11,2,0,0,61
28134,426417,1,11,3,1,0,62
28135,426417,1,11,4,1,0,63
28136,426417,1,11,5,0,0,63
28137,426417,1,11,6,0,0,63
28138,426417,1,12,1,4,0,67
28139,426417,1,12,2,0,0,67
28140,426417,1,12,3,0,0,67
28141,426417,1,12,4,1,0,68
28142,426417,1,12,5,2,0,70
28143,426417,1,12,6,1,0,71
28144,426417,1,13,1,2,0,73
28145,426417,1,13,2,2,0,75
28146,426417,1,13,3,0,0,75
28147,426417,1,13,4,1,0,76
28148,426417,1,13,5,0,0,76
28149,426417,1,13,6,1,0,77
28150,426417,1,14,1,2,0,79
28151,426417,1,14,2,0,0,79
28152,426417,1,14,3,0,0,79
28153,426417,1,14,4,2,0,81
28154,426417,1,14,5,2,0,83
28155,426417,1,14,6,1,0,84
28156,426417,1,15,1,1,0,85
28157,426417,1,15,2,0,0,85
28158,426417,1,15,3,0,0,85
28159,426417,1,15,4,0,0,85
28160,426417,1,15,5,2,0,87
28161,426417,1,15,6,1,0,88
28162,426417,1,16,1,0,1,88
28163,426417,1,16,2,1,0,89
28164,426417,1,16,3,0,0,89
28165,426417,1,16,4,1,0,90
28166,426417,1,16,5,2,0,92
28167,426417,1,16,6,4,0,96
28168,426417,1,17,1,1,0,97
28169,426417,1,17,2,1,0,98
28170,426417,1,17,3,1,0,99
28171,426417,1,17,4,1,0,100
28172,426417,1,17,5,1,0,101
28173,426417,1,17,6,1,0,102
28174,426417,1,18,1,0,0,102
28175,426417,1,18,2,2,0,104
28176,426417,1,18,3,0,0,104
28177,426417,1,18,4,1,0,105
28178,426417,1,18,5,2,0,107
28179,426417,1,18,6,1,0,108
28180,426417,1,19,1,1,0,109
28181,426417,1,19,2,1,0,110
28182,426417,1,19,3,1,0,111
28183,426417,1,19,4,1,0,112
28184,426417,1,19,5,4,0,116
28185,426417,1,19,6,2,0,118
28186,426417,1,20,1,2,0,120
28187,426417,1,20,2,1,0,121
28188,426417,1,20,3,1,0,122
28189,426417,1,20,4,1,0,123
28190,426417,1,20,5,1,0,124
28191,426417,1,20,6,2,0,126
28295,426418,1,1,1,0,0,0
28296,426418,1,1,2,4,0,4
28297,426418,1,1,3,2,0,6
28298,426418,1,1,4,0,0,6
28299,426418,1,1,5,4,0,10
28300,426418,1,1,6,1,0,11
28301,426418,1,2,1,0,0,11
28302,426418,1,2,2,0,0,11
28303,426418,1,2,3,0,0,11
28304,426418,1,2,4,0,1,11
28305,426418,1,2,5,1,0,12
28306,426418,1,2,6,1,0,13
28307,426418,1,3,1,0,0,13
28308,426418,1,3,2,0,0,13
28309,426418,1,3,3,1,0,14
28310,426418,1,3,4,2,0,16
28311,426418,1,3,5,0,0,16
28312,426418,1,3,6,0,0,16
28313,426418,1,4,1,2,0,18
28314,426418,1,4,2,0,1,18
28315,426418,1,4,3,1,0,19
28316,426418,1,4,4,0,0,19
28317,426418,1,4,5,0,0,19
28318,426418,1,4,6,0,0,19
28319,426418,1,5,1,1,0,20
28320,426418,1,5,2,0,1,20
28321,426418,1,5,3,0,0,20
28322,426418,1,5,4,0,0,20
28323,426418,1,5,5,2,0,22
28324,426418,1,5,6,0,1,22
28325,426418,1,6,1,0,0,22
28326,426418,1,6,2,0,0,22
28327,426418,1,6,3,0,0,22
28328,426418,1,6,4,0,0,22
28329,426418,1,6,5,0,0,22
28330,426418,1,6,6,1,0,23
28331,426418,1,7,1,0,0,23
28332,426418,1,7,2,0,0,23
28333,426418,1,7,3,1,0,24
28334,426418,1,7,4,1,0,25
28335,426418,1,7,5,1,0,26
28336,426418,1,7,6,0,0,26
28337,426418,1,8,1,0,0,26
28338,426418,1,8,2,0,0,26
28339,426418,1,8,3,0,0,26
28340,426418,1,8,4,0,0,26
28341,426418,1,8,5,0,0,26
28342,426418,1,8,6,1,0,27
28343,426418,1,9,1,0,0,27
28344,426418,1,9,2,0,0,27
28345,426418,1,9,3,1,0,28
28346,426418,1,9,4,6,0,34
28347,426418,1,9,5,1,0,35
28348,426418,1,9,6,0,0,35
28349,426418,1,10,1,0,0,35
28350,426418,1,10,2,0,0,35
28351,426418,1,10,3,1,0,36
28352,426418,1,10,4,1,0,37
28353,426418,1,10,5,0,0,37
28354,426418,1,10,6,0,0,37
28355,426418,1,11,1,1,0,38
28356,426418,1,11,2,6,0,44
28357,426418,1,11,3,0,1,44
28358,426418,1,11,4,0,0,44
28359,426418,1,11,5,1,0,45
28360,426418,1,11,6,0,0,45
28361,426418,1,12,1,0,0,45
28362,426418,1,12,2,2,0,47
28363,426418,1,12,3,0,0,47
28364,426418,1,12,4,0,0,47
28365,426418,1,12,5,0,0,47
28366,426418,1,12,6,0,0,47
28367,426418,1,13,1,1,0,48
28368,426418,1,13,2,0,0,48
28369,426418,1,13,3,0,0,48
28370,426418,1,13,4,1,0,49
28371,426418,1,13,5,1,0,50
28372,426418,1,13,6,0,0,50
28373,426418,1,14,1,0,0,50
28374,426418,1,14,2,0,0,50
28375,426418,1,14,3,4,0,54
28376,426418,1,14,4,0,0,54
28377,426418,1,14,5,0,0,54
28378,426418,1,14,6,1,0,55
28379,426418,1,15,1,0,1,55
28380,426418,1,15,2,1,0,56
28381,426418,1,15,3,0,1,56
28382,426418,1,15,4,1,0,57
28383,426418,1,15,5,2,0,59
28384,426418,1,15,6,4,0,63
28385,426418,1,16,1,1,0,64
28386,426418,1,16,2,1,0,65
28387,426418,1,16,3,0,0,65
28388,426418,1,16,4,1,0,66
28389,426418,1,16,5,4,0,70
28390,426418,1,16,6,1,0,71
28391,426418,1,17,1,0,0,71
28392,426418,1,17,2,6,0,77
28393,426418,1,17,3,1,0,78
28394,426418,1,17,4,1,0,79
28395,426418,1,17,5,1,0,80
28396,426418,1,17,6,0,0,80
28397,426418,1,18,1,0,0,80
28398,426418,1,18,2,1,0,81
28399,426418,1,18,3,4,0,85
28400,426418,1,18,4,0,1,85
28401,426418,1,18,5,0,1,85
28402,426418,1,18,6,0,0,85
28403,426418,1,19,1,0,0,85
28404,426418,1,19,2,4,0,89
28405,426418,1,19,3,0,0,89
28406,426418,1,19,4,0,1,89
28491,426723,1,1,1,0,0,0
28492,426723,1,1,2,0,0,0
28493,426723,1,1,3,0,0,0
28494,426723,1,1,4,0,0,0
28495,426723,1,1,5,0,0,0
28496,426723,1,1,6,0,0,0
28497,426723,1,2,1,0,0,0
28498,426723,1,2,2,1,0,1
28499,426723,1,2,3,2,0,3
28500,426723,1,2,4,0,0,3
28501,426723,1,2,5,0,0,3
28502,426723,1,2,6,0,0,3
28503,426723,1,3,1,0,0,3
28504,426723,1,3,2,0,0,3
28505,426723,1,3,3,4,0,7
28506,426723,1,3,4,4,0,11
28507,426723,1,3,5,0,0,11
28508,426723,1,3,6,0,0,11
28509,426723,1,4,1,1,0,12
28510,426723,1,4,2,1,0,13
28511,426723,1,4,3,4,0,17
28512,426723,1,4,4,1,0,18
28513,426723,1,4,5,0,0,18
28514,426723,1,4,6,2,0,20
28515,426723,1,5,1,6,0,26
28516,426723,1,5,2,6,0,32
28517,426723,1,5,3,0,0,32
28518,426723,1,5,4,0,0,32
28519,426723,1,5,5,0,0,32
28520,426723,1,5,6,0,0,32
28521,426723,1,6,1,0,0,32
28522,426723,1,6,2,1,0,33
28523,426723,1,6,3,1,0,34
28524,426723,1,6,4,0,0,34
28525,426723,1,6,5,0,1,34
28526,426723,1,6,6,1,0,35
28527,426723,1,7,1,4,0,39
28528,426723,1,7,2,0,0,39
28529,426723,1,7,3,4,0,43
28530,426723,1,7,4,8,0,51
28531,426723,1,7,5,2,0,53
28532,426723,1,7,6,0,0,53
28533,426723,1,8,1,1,0,54
28534,426723,1,8,2,0,0,54
28535,426723,1,8,3,1,0,55
28536,426723,1,8,4,1,0,56
28537,426723,1,8,5,0,0,56
28538,426723,1,8,6,0,1,56
28539,426723,1,9,1,2,0,58
28540,426723,1,9,2,1,0,59
28541,426723,1,9,3,4,0,63
28542,426723,1,9,4,1,0,64
28543,426723,1,9,5,0,0,64
28544,426723,1,9,6,1,0,65
28545,426723,1,10,1,1,0,66
28546,426723,1,10,2,1,0,67
28547,426723,1,10,3,4,0,71
28548,426723,1,10,4,1,0,72
28549,426723,1,10,5,1,0,73
28550,426723,1,10,6,6,0,79
28551,426723,1,11,1,0,0,79
28552,426723,1,11,2,6,0,85
28553,426723,1,11,3,1,0,86
28554,426723,1,11,4,1,0,87
28555,426723,1,11,5,1,0,88
28556,426723,1,11,6,0,0,88
28557,426723,1,12,1,4,0,92
28558,426723,1,12,2,0,1,92
28559,426723,1,12,3,1,0,93
28560,426723,1,12,4,0,0,93
28561,426723,1,12,5,1,0,94
28562,426723,1,12,6,0,0,94
28563,426723,1,13,1,0,0,94
28564,426723,1,13,2,4,0,98
28565,426723,1,13,3,3,0,101
28566,426723,1,13,4,0,1,101
28567,426723,1,13,5,1,0,102
28568,426723,1,13,6,2,0,104
28569,426723,1,14,1,2,0,106
28570,426723,1,14,2,1,0,107
28571,426723,1,14,3,1,0,108
28572,426723,1,14,4,1,0,109
28573,426723,1,14,5,1,0,110
28574,426723,1,14,6,1,0,111
28575,426723,1,15,1,2,0,113
28576,426723,1,15,2,1,0,114
28577,426723,1,15,3,1,0,115
28578,426723,1,15,4,1,0,116
28579,426723,1,15,5,0,1,116
28580,426723,1,15,6,0,0,116
28581,426723,1,16,1,1,0,117
28582,426723,1,16,2,4,0,121
28583,426723,1,16,3,0,0,121
28584,426723,1,16,4,1,0,122
28585,426723,1,16,5,1,0,123
28586,426723,1,16,6,1,0,124
28587,426723,1,17,1,4,0,128
28588,426723,1,17,2,1,0,129
28589,426723,1,17,3,2,0,131
28590,426723,1,17,4,1,0,132
28591,426723,1,17,5,1,0,133
28592,426723,1,17,6,0,0,133
28593,426723,1,18,1,1,0,134
28594,426723,1,18,2,0,1,134
28595,426723,1,18,3,0,0,134
28596,426723,1,18,4,1,0,135
28597,426723,1,18,5,0,0,135
28598,426723,1,18,6,1,0,136
28599,426723,1,19,1,1,0,137
28600,426723,1,19,2,0,0,137
28601,426723,1,19,3,0,0,137
28602,426723,1,19,4,1,0,138
28603,426723,1,19,5,6,0,144
28604,426723,1,19,6,4,0,148
28605,426723,1,20,1,4,0,152
28606,426723,1,20,2,6,0,158
28607,426723,1,20,3,0,1,158
28608,426723,1,20,4,1,0,159
28609,426723,1,20,5,2,0,161
28610,426723,1,20,6,0,1,161
28722,426724,1,1,1,0,0,0
28723,426724,1,1,2,0,0,0
28724,426724,1,1,3,0,0,0
28725,426724,1,1,4,4,0,4
28726,426724,1,1,5,4,0,8
28727,426724,1,1,6,0,0,8
28728,426724,1,2,1,0,0,8
28729,426724,1,2,2,0,0,8
28730,426724,1,2,3,0,0,8
28731,426724,1,2,4,0,0,8
28732,426724,1,2,5,0,0,8
28733,426724,1,2,6,1,0,9
28734,426724,1,3,1,1,0,10
28735,426724,1,3,2,0,0,10
28736,426724,1,3,3,4,0,14
28737,426724,1,3,4,1,0,15
28738,426724,1,3,5,4,0,19
28739,426724,1,3,6,1,0,20
28740,426724,1,4,1,1,0,21
28741,426724,1,4,2,0,0,21
28742,426724,1,4,3,4,0,25
28743,426724,1,4,4,0,0,25
28744,426724,1,4,5,4,0,29
28745,426724,1,4,6,4,0,33
28746,426724,1,5,1,7,0,40
28747,426724,1,5,2,0,0,40
28748,426724,1,5,3,0,1,40
28749,426724,1,5,4,0,0,40
28750,426724,1,5,5,1,0,41
28751,426724,1,5,6,0,0,41
28752,426724,1,6,1,0,0,41
28753,426724,1,6,2,0,0,41
28754,426724,1,6,3,1,0,42
28755,426724,1,6,4,0,0,42
28756,426724,1,6,5,6,0,48
28757,426724,1,6,6,0,0,48
28758,426724,1,7,1,1,0,49
28759,426724,1,7,2,1,0,50
28760,426724,1,7,3,1,0,51
28761,426724,1,7,4,0,0,51
28762,426724,1,7,5,0,1,51
28763,426724,1,7,6,2,0,53
28764,426724,1,8,1,1,0,54
28765,426724,1,8,2,0,0,54
28766,426724,1,8,3,4,0,58
28767,426724,1,8,4,0,0,58
28768,426724,1,8,5,1,0,59
28769,426724,1,8,6,1,0,60
28770,426724,1,9,1,4,0,64
28771,426724,1,9,2,2,0,66
28772,426724,1,9,3,2,0,68
28773,426724,1,9,4,0,0,68
28774,426724,1,9,5,2,0,70
28775,426724,1,9,6,1,0,71
28776,426724,1,10,1,0,0,71
28777,426724,1,10,2,0,0,71
28778,426724,1,10,3,1,0,72
28779,426724,1,10,4,0,0,72
28780,426724,1,10,5,0,0,72
28781,426724,1,10,6,1,0,73
28782,426724,1,11,1,1,0,74
28783,426724,1,11,2,1,0,75
28784,426724,1,11,3,1,0,76
28785,426724,1,11,4,2,0,78
28786,426724,1,11,5,1,0,79
28787,426724,1,11,6,0,0,79
28788,426724,1,12,1,3,0,82
28789,426724,1,12,2,7,0,89
28790,426724,1,12,3,1,0,90
28791,426724,1,12,4,0,0,90
28792,426724,1,12,5,0,0,90
28793,426724,1,12,6,6,0,96
28794,426724,1,13,1,0,1,96
28795,426724,1,13,2,0,0,96
28796,426724,1,13,3,0,0,96
28797,426724,1,13,4,1,0,97
28798,426724,1,13,5,1,0,98
28799,426724,1,13,6,4,0,102
28800,426724,1,14,1,1,0,103
28801,426724,1,14,2,2,0,105
28802,426724,1,14,3,2,0,107
28803,426724,1,14,4,1,0,108
28804,426724,1,14,5,1,0,109
28805,426724,1,14,6,0,0,109
28806,426724,1,15,1,0,0,109
28807,426724,1,15,2,0,0,109
28808,426724,1,15,3,5,0,114
28809,426724,1,15,4,0,1,114
28810,426724,1,15,5,0,0,114
28811,426724,1,15,6,0,0,114
28812,426724,1,16,1,0,1,114
28813,426724,1,16,2,1,0,115
28814,426724,1,16,3,4,0,119
28815,426724,1,16,4,1,0,120
28816,426724,1,16,5,1,0,121
28817,426724,1,16,6,1,0,122
28818,426724,1,17,1,1,0,123
28819,426724,1,17,2,1,0,124
28820,426724,1,17,3,0,0,124
28821,426724,1,17,4,1,0,125
28822,426724,1,17,5,0,0,125
28823,426724,1,17,6,1,0,126
28824,426724,1,18,1,0,0,126
28825,426724,1,18,2,0,0,126
28826,426724,1,18,3,2,0,128
28827,426724,1,18,4,4,0,132
28828,426724,1,18,5,1,0,133
28829,426724,1,18,6,0,0,133
28830,426724,1,19,1,1,0,134
28831,426724,1,19,2,1,0,135
28832,426724,1,19,3,1,0,136
28833,426724,1,19,4,6,0,142
28834,426724,1,19,5,1,0,143
28835,426724,1,19,6,0,0,143
28836,426724,1,20,1,1,0,144
28837,426724,1,20,2,4,0,148
28838,426724,1,20,3,1,0,149
28839,426724,1,20,4,2,0,151
28840,426724,1,20,5,1,0,152
28841,426724,1,20,6,1,0,153
28962,430884,1,1,1,1,0,1
28963,430884,1,1,2,1,0,2
28964,430884,1,1,3,1,0,3
28965,430884,1,1,4,1,0,4
28966,430884,1,1,5,4,0,8
28967,430884,1,1,6,1,0,9
28968,430884,1,2,1,0,0,9
28969,430884,1,2,2,0,0,9
28970,430884,1,2,3,1,0,10
28971,430884,1,2,4,0,0,10
28972,430884,1,2,5,0,0,10
28973,430884,1,2,6,0,0,10
28974,430884,1,3,1,0,0,10
28975,430884,1,3,2,1,0,11
28976,430884,1,3,3,0,0,11
28977,430884,1,3,4,1,0,12
28978,430884,1,3,5,1,0,13
28979,430884,1,3,6,1,0,14
28980,430884,1,4,1,0,0,14
28981,430884,1,4,2,0,0,14
28982,430884,1,4,3,1,0,15
28983,430884,1,4,4,0,0,15
28984,430884,1,4,5,1,0,16
28985,430884,1,4,6,1,0,17
28986,430884,1,5,1,5,0,22
28987,430884,1,5,2,4,0,26
28988,430884,1,5,3,0,0,26
28989,430884,1,5,4,4,0,30
28990,430884,1,5,5,5,0,35
28991,430884,1,5,6,4,0,39
28992,430884,1,6,1,0,0,39
28993,430884,1,6,2,4,0,43
28994,430884,1,6,3,0,0,43
28995,430884,1,6,4,0,0,43
28996,430884,1,6,5,0,0,43
28997,430884,1,6,6,0,0,43
28998,430884,1,7,1,0,0,43
28999,430884,1,7,2,0,1,43
29000,430884,1,7,3,4,0,47
29001,430884,1,7,4,4,0,51
29002,430884,1,7,5,0,0,51
29003,430884,1,7,6,1,0,52
29004,430884,1,8,1,1,0,53
29005,430884,1,8,2,1,0,54
29006,430884,1,8,3,4,0,58
29007,430884,1,8,4,1,0,59
29008,430884,1,8,5,1,0,60
29009,430884,1,8,6,0,0,60
29010,430884,1,9,1,4,0,64
29011,430884,1,9,2,4,0,68
29012,430884,1,9,3,6,0,74
29013,430884,1,9,4,1,0,75
29014,430884,1,9,5,1,0,76
29015,430884,1,9,6,1,0,77
29016,430884,1,10,1,1,0,78
29017,430884,1,10,2,1,0,79
29018,430884,1,10,3,4,0,83
29019,430884,1,10,4,1,0,84
29020,430884,1,10,5,1,0,85
29021,430884,1,10,6,4,0,89
29022,430884,1,11,1,1,0,90
29023,430884,1,11,2,1,0,91
29024,430884,1,11,3,1,0,92
29025,430884,1,11,4,1,0,93
29026,430884,1,11,5,1,0,94
29027,430884,1,11,6,1,0,95
29028,430884,1,12,1,2,0,97
29029,430884,1,12,2,4,0,101
29030,430884,1,12,3,4,0,105
29031,430884,1,12,4,2,0,107
29032,430884,1,12,5,2,0,109
29033,430884,1,12,6,1,0,110
29034,430884,1,13,1,6,0,116
29035,430884,1,13,2,1,0,117
29036,430884,1,13,3,0,1,117
29037,430884,1,13,4,2,0,119
29038,430884,1,13,5,0,0,119
29039,430884,1,13,6,1,0,120
29040,430884,1,14,1,4,0,124
29041,430884,1,14,2,2,0,126
29042,430884,1,14,3,0,1,126
29043,430884,1,14,4,4,0,130
29044,430884,1,14,5,2,0,132
29045,430884,1,14,6,2,0,134
29046,430884,1,15,1,1,0,135
29047,430884,1,15,2,1,0,136
29048,430884,1,15,3,1,0,137
29049,430884,1,15,4,4,0,141
29050,430884,1,15,5,0,0,141
29051,430884,1,15,6,1,0,142
29052,430884,1,16,1,0,0,142
29053,430884,1,16,2,0,0,142
29054,430884,1,16,3,1,0,143
29055,430884,1,16,4,1,0,144
29056,430884,1,16,5,6,0,150
29057,430884,1,16,6,2,0,152
29058,430884,1,17,1,0,0,152
29059,430884,1,17,2,4,0,156
29060,430884,1,17,3,4,0,160
29061,430884,1,17,4,1,0,161
29062,430884,1,17,5,4,0,165
29063,430884,1,17,6,2,0,167
29064,430884,1,18,1,4,0,171
29065,430884,1,18,2,0,0,171
29066,430884,1,18,3,0,0,171
29067,430884,1,18,4,4,0,175
29068,430884,1,18,5,2,0,177
29069,430884,1,18,6,0,0,177
29070,430884,1,19,1,4,0,181
29071,430884,1,19,2,4,0,185
29072,430884,1,19,3,4,0,189
29073,430884,1,19,4,4,0,193
29074,430884,1,19,5,2,0,195
29075,430884,1,19,6,0,1,195
29076,430884,1,20,1,4,0,199
29077,430884,1,20,2,1,0,200
29078,430884,1,20,3,2,0,202
29079,430884,1,20,4,6,0,208
29080,430884,1,20,5,6,0,214
29081,430884,1,20,6,1,1,215
29202,430885,1,1,1,1,0,1
29203,430885,1,1,2,4,0,5
29204,430885,1,1,3,1,0,6
29205,430885,1,1,4,4,0,10
29206,430885,1,1,5,0,0,10
29207,430885,1,1,6,0,0,10
29208,430885,1,2,1,0,0,10
29209,430885,1,2,2,0,1,10
29210,430885,1,2,3,4,0,14
29211,430885,1,2,4,1,0,15
29212,430885,1,2,5,1,0,16
29213,430885,1,2,6,2,0,18
29214,430885,1,3,1,0,0,18
29215,430885,1,3,2,1,0,19
29216,430885,1,3,3,0,0,19
29217,430885,1,3,4,6,0,25
29218,430885,1,3,5,4,0,29
29219,430885,1,3,6,0,0,29
29220,430885,1,4,1,0,0,29
29221,430885,1,4,2,1,0,30
29222,430885,1,4,3,4,0,34
29223,430885,1,4,4,4,0,38
29224,430885,1,4,5,4,0,42
29225,430885,1,4,6,1,0,43
29226,430885,1,5,1,0,0,43
29227,430885,1,5,2,4,0,47
29228,430885,1,5,3,4,0,51
29229,430885,1,5,4,6,0,57
29230,430885,1,5,5,4,0,61
29231,430885,1,5,6,0,0,61
29232,430885,1,6,1,0,0,61
29233,430885,1,6,2,1,0,62
29234,430885,1,6,3,1,0,63
29235,430885,1,6,4,1,0,64
29236,430885,1,6,5,5,0,69
29237,430885,1,6,6,4,0,73
29238,430885,1,7,1,5,0,78
29239,430885,1,7,2,0,0,78
29240,430885,1,7,3,1,0,79
29241,430885,1,7,4,1,0,80
29242,430885,1,7,5,2,0,82
29243,430885,1,7,6,1,0,83
29244,430885,1,8,1,1,0,84
29245,430885,1,8,2,2,0,86
29246,430885,1,8,3,4,0,90
29247,430885,1,8,4,1,0,91
29248,430885,1,8,5,0,1,91
29249,430885,1,8,6,1,0,92
29250,430885,1,9,1,1,0,93
29251,430885,1,9,2,1,0,94
29252,430885,1,9,3,1,0,95
29253,430885,1,9,4,1,0,96
29254,430885,1,9,5,0,0,96
29255,430885,1,9,6,1,0,97
29256,430885,1,10,1,2,0,99
29257,430885,1,10,2,1,0,100
29258,430885,1,10,3,1,0,101
29259,430885,1,10,4,4,0,105
29260,430885,1,10,5,2,0,107
29261,430885,1,10,6,0,0,107
29262,430885,1,11,1,1,0,108
29263,430885,1,11,2,1,0,109
29264,430885,1,11,3,2,0,111
29265,430885,1,11,4,6,0,117
29266,430885,1,11,5,4,0,121
29267,430885,1,11,6,0,1,121
29268,430885,1,12,1,4,0,125
29269,430885,1,12,2,1,0,126
29270,430885,1,12,3,0,0,126
29271,430885,1,12,4,2,0,128
29272,430885,1,12,5,0,0,128
29273,430885,1,12,6,4,0,132
29274,430885,1,13,1,1,0,133
29275,430885,1,13,2,1,0,134
29276,430885,1,13,3,1,0,135
29277,430885,1,13,4,6,0,141
29278,430885,1,13,5,0,1,141
29279,430885,1,13,6,1,0,142
29280,430885,1,14,1,6,0,148
29281,430885,1,14,2,0,0,148
29282,430885,1,14,3,1,0,149
29283,430885,1,14,4,0,0,149
29284,430885,1,14,5,1,0,150
29285,430885,1,14,6,2,0,152
29286,430885,1,15,1,1,0,153
29287,430885,1,15,2,1,0,154
29288,430885,1,15,3,1,1,155
29289,430885,1,15,4,1,0,156
29290,430885,1,15,5,0,0,156
29291,430885,1,15,6,1,0,157
29292,430885,1,16,1,1,0,158
29293,430885,1,16,2,2,0,160
29294,430885,1,16,3,4,0,164
29295,430885,1,16,4,1,0,165
29296,430885,1,16,5,1,0,166
29297,430885,1,16,6,1,0,167
29298,430885,1,17,1,0,1,167
29299,430885,1,17,2,0,1,167
29300,430885,1,17,3,1,0,168
29301,430885,1,17,4,1,0,169
29302,430885,1,17,5,0,0,169
29303,430885,1,17,6,2,0,171
29304,430885,1,18,1,1,0,172
29305,430885,1,18,2,1,0,173
29306,430885,1,18,3,1,0,174
29307,430885,1,18,4,2,0,176
29308,430885,1,18,5,1,0,177
29309,430885,1,18,6,1,0,178
29310,430885,1,19,1,2,0,180
29311,430885,1,19,2,6,0,186
29312,430885,1,19,3,1,0,187
29313,430885,1,19,4,0,0,187
29314,430885,1,19,5,1,0,188
29315,430885,1,19,6,2,0,190
29316,430885,1,20,1,1,0,191
29317,430885,1,20,2,1,0,192
29318,430885,1,20,3,2,0,194
29319,430885,1,20,4,4,0,198
29320,430885,1,20,5,2,0,200
29321,430885,1,20,6,6,0,206
29437,439139,1,1,1,0,1,0
29438,439139,1,1,2,0,0,0
29439,439139,1,1,3,0,0,0
29440,439139,1,1,4,0,0,0
29441,439139,1,1,5,0,0,0
29442,439139,1,1,6,0,0,0
29443,439139,1,2,1,0,0,0
29444,439139,1,2,2,0,0,0
29445,439139,1,2,3,0,0,0
29446,439139,1,2,4,0,0,0
29447,439139,1,2,5,0,0,0
29448,439139,1,2,6,0,0,0
29449,439139,1,3,1,0,0,0
29450,439139,1,3,2,0,1,0
29451,439139,1,3,3,0,0,0
29452,439139,1,3,4,0,1,0
29453,439139,1,3,5,0,0,0
29454,439139,1,3,6,0,0,0
29455,439139,1,4,1,0,0,0
29456,439139,1,4,2,0,0,0
29457,439139,1,4,3,2,0,2
29458,439139,1,4,4,4,0,6
29459,439139,1,4,5,1,0,7
29460,439139,1,4,6,1,0,8
29461,439139,1,5,1,0,0,8
29462,439139,1,5,2,3,0,11
29463,439139,1,5,3,0,1,11
29464,439139,1,5,4,0,0,11
29465,439139,1,5,5,0,0,11
29466,439139,1,5,6,0,0,11
29467,439139,1,6,1,1,0,12
29468,439139,1,6,2,1,0,13
29469,439139,1,6,3,0,0,13
29470,439139,1,6,4,0,0,13
29471,439139,1,6,5,0,0,13
29472,439139,1,6,6,0,0,13
29473,439139,1,7,1,0,0,13
29474,439139,1,7,2,1,0,14
29475,439139,1,7,3,1,0,15
29476,439139,1,7,4,0,0,15
29477,439139,1,7,5,1,0,16
29478,439139,1,7,6,0,0,16
29479,439139,1,8,1,0,0,16
29480,439139,1,8,2,0,0,16
29481,439139,1,8,3,4,0,20
29482,439139,1,8,4,0,0,20
29483,439139,1,8,5,0,0,20
29484,439139,1,8,6,1,0,21
29485,439139,1,9,1,1,0,22
29486,439139,1,9,2,0,0,22
29487,439139,1,9,3,0,0,22
29488,439139,1,9,4,2,0,24
29489,439139,1,9,5,0,0,24
29490,439139,1,9,6,1,0,25
29491,439139,1,10,1,0,0,25
29492,439139,1,10,2,0,0,25
29493,439139,1,10,3,4,0,29
29494,439139,1,10,4,0,0,29
29495,439139,1,10,5,1,0,30
29496,439139,1,10,6,0,0,30
29497,439139,1,11,1,1,0,31
29498,439139,1,11,2,0,0,31
29499,439139,1,11,3,1,0,32
29500,439139,1,11,4,1,0,33
29501,439139,1,11,5,1,0,34
29502,439139,1,11,6,1,0,35
29503,439139,1,12,1,0,0,35
29504,439139,1,12,2,1,0,36
29505,439139,1,12,3,0,0,36
29506,439139,1,12,4,1,0,37
29507,439139,1,12,5,0,0,37
29508,439139,1,12,6,0,0,37
29509,439139,1,13,1,1,0,38
29510,439139,1,13,2,0,0,38
29511,439139,1,13,3,1,0,39
29512,439139,1,13,4,1,0,40
29513,439139,1,13,5,1,0,41
29514,439139,1,13,6,1,0,42
29515,439139,1,14,1,0,0,42
29516,439139,1,14,2,6,0,48
29517,439139,1,14,3,1,0,49
29518,439139,1,14,4,1,0,50
29519,439139,1,14,5,1,0,51
29520,439139,1,14,6,0,1,51
29521,439139,1,15,1,1,0,52
29522,439139,1,15,2,2,0,54
29523,439139,1,15,3,2,0,56
29524,439139,1,15,4,1,0,57
29525,439139,1,15,5,4,0,61
29526,439139,1,15,6,0,0,61
29527,439139,1,16,1,1,0,62
29528,439139,1,16,2,1,0,63
29529,439139,1,16,3,1,0,64
29530,439139,1,16,4,1,0,65
29531,439139,1,16,5,1,0,66
29532,439139,1,16,6,1,0,67
29533,439139,1,17,1,1,0,68
29534,439139,1,17,2,1,0,69
29535,439139,1,17,3,0,0,69
29536,439139,1,17,4,1,0,70
29537,439139,1,17,5,0,0,70
29538,439139,1,17,6,2,0,72
29539,439139,1,18,1,0,0,72
29540,439139,1,18,2,1,0,73
29541,439139,1,18,3,1,0,74
29542,439139,1,18,4,0,1,74
29543,439139,1,18,5,1,0,75
29544,439139,1,18,6,1,0,76
29545,439139,1,19,1,4,0,80
29546,439139,1,19,2,5,0,85
29547,439139,1,19,3,1,0,86
29548,439139,1,19,4,11,0,97
29549,439139,1,19,5,1,0,98
29550,439139,1,19,6,0,1,98
29551,439139,1,20,1,6,0,104
29552,439139,1,20,2,0,1,104
29553,439139,1,20,3,0,0,104
29554,439139,1,20,4,0,1,104
29555,439139,1,20,5,1,1,105
29676,439146,1,1,1,0,0,0
29677,439146,1,1,2,1,0,1
29678,439146,1,1,3,7,0,8
29679,439146,1,1,4,0,0,8
29680,439146,1,1,5,2,0,10
29681,439146,1,1,6,0,0,10
29682,439146,1,2,1,0,0,10
29683,439146,1,2,2,0,0,10
29684,439146,1,2,3,0,0,10
29685,439146,1,2,4,0,0,10
29686,439146,1,2,5,0,0,10
29687,439146,1,2,6,2,0,12
29688,439146,1,3,1,0,0,12
29689,439146,1,3,2,2,0,14
29690,439146,1,3,3,0,0,14
29691,439146,1,3,4,0,0,14
29692,439146,1,3,5,0,0,14
29693,439146,1,3,6,1,0,15
29694,439146,1,4,1,0,1,15
29695,439146,1,4,2,1,0,16
29696,439146,1,4,3,1,0,17
29697,439146,1,4,4,0,0,17
29698,439146,1,4,5,0,0,17
29699,439146,1,4,6,0,0,17
29700,439146,1,5,1,1,0,18
29701,439146,1,5,2,0,0,18
29702,439146,1,5,3,1,0,19
29703,439146,1,5,4,0,0,19
29704,439146,1,5,5,1,0,20
29705,439146,1,5,6,0,0,20
29706,439146,1,6,1,0,0,20
29707,439146,1,6,2,4,0,24
29708,439146,1,6,3,4,0,28
29709,439146,1,6,4,1,0,29
29710,439146,1,6,5,0,0,29
29711,439146,1,6,6,4,0,33
29712,439146,1,7,1,1,0,34
29713,439146,1,7,2,2,0,36
29714,439146,1,7,3,0,0,36
29715,439146,1,7,4,2,0,38
29716,439146,1,7,5,0,0,38
29717,439146,1,7,6,1,0,39
29718,439146,1,8,1,1,0,40
29719,439146,1,8,2,1,0,41
29720,439146,1,8,3,0,0,41
29721,439146,1,8,4,1,0,42
29722,439146,1,8,5,0,0,42
29723,439146,1,8,6,4,0,46
29724,439146,1,9,1,2,0,48
29725,439146,1,9,2,0,0,48
29726,439146,1,9,3,6,0,54
29727,439146,1,9,4,1,0,55
29728,439146,1,9,5,1,0,56
29729,439146,1,9,6,1,0,57
29730,439146,1,10,1,1,0,58
29731,439146,1,10,2,1,0,59
29732,439146,1,10,3,0,0,59
29733,439146,1,10,4,0,0,59
29734,439146,1,10,5,1,0,60
29735,439146,1,10,6,1,0,61
29736,439146,1,11,1,2,0,63
29737,439146,1,11,2,1,0,64
29738,439146,1,11,3,6,0,70
29739,439146,1,11,4,3,0,73
29740,439146,1,11,5,1,0,74
29741,439146,1,11,6,2,0,76
29742,439146,1,12,1,1,0,77
29743,439146,1,12,2,6,0,83
29744,439146,1,12,3,2,0,85
29745,439146,1,12,4,1,0,86
29746,439146,1,12,5,1,0,87
29747,439146,1,12,6,1,0,88
29748,439146,1,13,1,0,1,88
29749,439146,1,13,2,0,0,88
29750,439146,1,13,3,0,0,88
29751,439146,1,13,4,1,0,89
29752,439146,1,13,5,1,0,90
29753,439146,1,13,6,0,0,90
29754,439146,1,14,1,1,0,91
29755,439146,1,14,2,1,0,92
29756,439146,1,14,3,1,0,93
29757,439146,1,14,4,2,0,95
29758,439146,1,14,5,0,0,95
29759,439146,1,14,6,1,0,96
29760,439146,1,15,1,0,0,96
29761,439146,1,15,2,1,0,97
29762,439146,1,15,3,1,0,98
29763,439146,1,15,4,6,0,104
29764,439146,1,15,5,2,0,106
29765,439146,1,15,6,1,0,107
29766,439146,1,16,1,0,0,107
29767,439146,1,16,2,2,0,109
29768,439146,1,16,3,1,0,110
29769,439146,1,16,4,1,0,111
29770,439146,1,16,5,0,1,111
29771,439146,1,16,6,3,0,114
29772,439146,1,17,1,1,1,115
29773,439146,1,17,2,0,0,115
29774,439146,1,17,3,0,1,115
29775,439146,1,17,4,1,0,116
29776,439146,1,17,5,1,0,117
29777,439146,1,17,6,2,0,119
29778,439146,1,18,1,0,0,119
29779,439146,1,18,2,1,0,120
29780,439146,1,18,3,1,0,121
29781,439146,1,18,4,1,0,122
29782,439146,1,18,5,0,0,122
29783,439146,1,18,6,0,1,122
29784,439146,1,19,1,1,0,123
29785,439146,1,19,2,0,0,123
29786,439146,1,19,3,4,0,127
29787,439146,1,19,4,0,1,127
29788,439146,1,19,5,1,0,128
29789,439146,1,19,6,2,0,130
29790,439146,1,20,1,1,0,131
29791,439146,1,20,2,0,0,131
29792,439146,1,20,3,0,0,131
29793,439146,1,20,4,2,0,133
29794,439146,1,20,5,1,0,134
29795,439146,1,20,6,2,0,136
29915,439495,1,1,1,0,0,0
29916,439495,1,1,2,0,0,0
29917,439495,1,1,3,1,0,1
29918,439495,1,1,4,0,0,1
29919,439495,1,1,5,0,0,1
29920,439495,1,1,6,4,0,5
29921,439495,1,2,1,1,0,6
29922,439495,1,2,2,0,0,6
29923,439495,1,2,3,0,1,6
29924,439495,1,2,4,1,0,7
29925,439495,1,2,5,0,0,7
29926,439495,1,2,6,0,0,7
29927,439495,1,3,1,1,0,8
29928,439495,1,3,2,0,0,8
29929,439495,1,3,3,0,0,8
29930,439495,1,3,4,0,0,8
29931,439495,1,3,5,2,0,10
29932,439495,1,3,6,1,0,11
29933,439495,1,4,1,1,0,12
29934,439495,1,4,2,1,0,13
29935,439495,1,4,3,1,0,14
29936,439495,1,4,4,0,0,14
29937,439495,1,4,5,0,0,14
29938,439495,1,4,6,0,1,14
29939,439495,1,5,1,6,0,20
29940,439495,1,5,2,1,0,21
29941,439495,1,5,3,1,0,22
29942,439495,1,5,4,0,0,22
29943,439495,1,5,5,0,0,22
29944,439495,1,5,6,1,0,23
29945,439495,1,6,1,0,0,23
29946,439495,1,6,2,1,0,24
29947,439495,1,6,3,1,0,25
29948,439495,1,6,4,4,0,29
29949,439495,1,6,5,4,0,33
29950,439495,1,6,6,0,0,33
29951,439495,1,7,1,0,0,33
29952,439495,1,7,2,1,0,34
29953,439495,1,7,3,0,0,34
29954,439495,1,7,4,1,0,35
29955,439495,1,7,5,0,0,35
29956,439495,1,7,6,0,0,35
29957,439495,1,8,1,0,0,35
29958,439495,1,8,2,1,0,36
29959,439495,1,8,3,1,0,37
29960,439495,1,8,4,0,0,37
29961,439495,1,8,5,1,0,38
29962,439495,1,8,6,1,0,39
29963,439495,1,9,1,0,0,39
29964,439495,1,9,2,4,0,43
29965,439495,1,9,3,1,0,44
29966,439495,1,9,4,1,0,45
29967,439495,1,9,5,1,0,46
29968,439495,1,9,6,2,0,48
29969,439495,1,10,1,1,0,49
29970,439495,1,10,2,1,0,50
29971,439495,1,10,3,4,0,54
29972,439495,1,10,4,1,0,55
29973,439495,1,10,5,2,0,57
29974,439495,1,10,6,0,0,57
29975,439495,1,11,1,2,0,59
29976,439495,1,11,2,1,0,60
29977,439495,1,11,3,0,0,60
29978,439495,1,11,4,1,1,61
29979,439495,1,11,5,1,0,62
29980,439495,1,11,6,0,0,62
29981,439495,1,12,1,0,0,62
29982,439495,1,12,2,0,0,62
29983,439495,1,12,3,1,0,63
29984,439495,1,12,4,1,0,64
29985,439495,1,12,5,1,0,65
29986,439495,1,12,6,1,0,66
29987,439495,1,13,1,0,0,66
29988,439495,1,13,2,0,0,66
29989,439495,1,13,3,0,0,66
29990,439495,1,13,4,1,0,67
29991,439495,1,13,5,1,0,68
29992,439495,1,13,6,1,0,69
29993,439495,1,14,1,0,1,69
29994,439495,1,14,2,1,0,70
29995,439495,1,14,3,1,0,71
29996,439495,1,14,4,1,0,72
29997,439495,1,14,5,0,0,72
29998,439495,1,14,6,0,0,72
29999,439495,1,15,1,1,0,73
30000,439495,1,15,2,6,0,79
30001,439495,1,15,3,6,0,85
30002,439495,1,15,4,8,0,93
30003,439495,1,15,5,0,1,93
30004,439495,1,15,6,2,0,95
30005,439495,1,16,1,2,0,97
30006,439495,1,16,2,0,0,97
30007,439495,1,16,3,0,0,97
30008,439495,1,16,4,0,1,97
30009,439495,1,16,5,4,0,101
30010,439495,1,16,6,1,0,102
30011,439495,1,17,1,0,0,102
30012,439495,1,17,2,1,0,103
30013,439495,1,17,3,1,0,104
30014,439495,1,17,4,2,0,106
30015,439495,1,17,5,1,0,107
30016,439495,1,17,6,6,0,113
30017,439495,1,18,1,1,0,114
30018,439495,1,18,2,1,0,115
30019,439495,1,18,3,4,0,119
30020,439495,1,18,4,0,0,119
30021,439495,1,18,5,1,0,120
30022,439495,1,18,6,2,0,122
30023,439495,1,19,1,2,0,124
30024,439495,1,19,2,3,0,127
30025,439495,1,19,3,2,0,129
30026,439495,1,19,4,1,0,130
30027,439495,1,19,5,0,1,130
30028,439495,1,19,6,1,1,131
30029,439495,1,20,1,0,0,131
30030,439495,1,20,2,2,0,133
30031,439495,1,20,3,0,0,133
30032,439495,1,20,4,1,0,134
30033,439495,1,20,5,1,0,135
30034,439495,1,20,6,4,0,139
30151,439507,1,1,1,2,0,2
30152,439507,1,1,2,0,0,2
30153,439507,1,1,3,1,0,3
30154,439507,1,1,4,3,0,6
30155,439507,1,1,5,1,0,7
30156,439507,1,1,6,0,0,7
30157,439507,1,2,1,4,0,11
30158,439507,1,2,2,1,0,12
30159,439507,1,2,3,1,0,13
30160,439507,1,2,4,2,0,15
30161,439507,1,2,5,1,0,16
30162,439507,1,2,6,1,0,17
30163,439507,1,3,1,0,0,17
30164,439507,1,3,2,1,0,18
30165,439507,1,3,3,1,0,19
30166,439507,1,3,4,2,0,21
30167,439507,1,3,5,0,0,21
30168,439507,1,3,6,2,0,23
30169,439507,1,4,1,0,0,23
30170,439507,1,4,2,2,0,25
30171,439507,1,4,3,1,0,26
30172,439507,1,4,4,0,0,26
30173,439507,1,4,5,4,0,30
30174,439507,1,4,6,0,0,30
30175,439507,1,5,1,0,1,30
30176,439507,1,5,2,0,0,30
30177,439507,1,5,3,1,0,31
30178,439507,1,5,4,0,1,31
30179,439507,1,5,5,0,0,31
30180,439507,1,5,6,1,0,32
30181,439507,1,6,1,0,1,32
30182,439507,1,6,2,0,0,32
30183,439507,1,6,3,0,0,32
30184,439507,1,6,4,0,0,32
30185,439507,1,6,5,1,0,33
30186,439507,1,6,6,4,0,37
30187,439507,1,7,1,1,0,38
30188,439507,1,7,2,1,0,39
30189,439507,1,7,3,1,0,40
30190,439507,1,7,4,1,0,41
30191,439507,1,7,5,6,0,47
30192,439507,1,7,6,0,0,47
30193,439507,1,8,1,1,0,48
30194,439507,1,8,2,1,0,49
30195,439507,1,8,3,1,0,50
30196,439507,1,8,4,1,1,51
30197,439507,1,8,5,0,0,51
30198,439507,1,8,6,0,0,51
30199,439507,1,9,1,0,0,51
30200,439507,1,9,2,0,0,51
30201,439507,1,9,3,0,0,51
30202,439507,1,9,4,1,0,52
30203,439507,1,9,5,1,0,53
30204,439507,1,9,6,0,0,53
30205,439507,1,10,1,1,0,54
30206,439507,1,10,2,1,0,55
30207,439507,1,10,3,1,0,56
30208,439507,1,10,4,2,0,58
30209,439507,1,10,5,1,0,59
30210,439507,1,10,6,0,0,59
30211,439507,1,11,1,0,0,59
30212,439507,1,11,2,2,0,61
30213,439507,1,11,3,1,0,62
30214,439507,1,11,4,1,0,63
30215,439507,1,11,5,0,0,63
30216,439507,1,11,6,0,0,63
30217,439507,1,12,1,4,0,67
30218,439507,1,12,2,0,0,67
30219,439507,1,12,3,1,0,68
30220,439507,1,12,4,1,0,69
30221,439507,1,12,5,1,0,70
30222,439507,1,12,6,1,0,71
30223,439507,1,13,1,1,0,72
30224,439507,1,13,2,0,0,72
30225,439507,1,13,3,1,0,73
30226,439507,1,13,4,0,0,73
30227,439507,1,13,5,1,0,74
30228,439507,1,13,6,1,0,75
30229,439507,1,14,1,2,0,77
30230,439507,1,14,2,1,0,78
30231,439507,1,14,3,1,0,79
30232,439507,1,14,4,1,0,80
30233,439507,1,14,5,2,0,82
30234,439507,1,14,6,0,0,82
30235,439507,1,15,1,0,1,82
30236,439507,1,15,2,0,0,82
30237,439507,1,15,3,1,0,83
30238,439507,1,15,4,1,0,84
30239,439507,1,15,5,2,0,86
30240,439507,1,15,6,0,0,86
30241,439507,1,16,1,0,0,86
30242,439507,1,16,2,0,1,86
30243,439507,1,16,3,1,0,87
30244,439507,1,16,4,0,0,87
30245,439507,1,16,5,1,0,88
30246,439507,1,16,6,1,0,89
30247,439507,1,17,1,2,0,91
30248,439507,1,17,2,1,0,92
30249,439507,1,17,3,0,1,92
30250,439507,1,17,4,4,0,96
30251,439507,1,17,5,1,0,97
30252,439507,1,17,6,1,0,98
30253,439507,1,18,1,1,0,99
30254,439507,1,18,2,1,0,100
30255,439507,1,18,3,2,0,102
30256,439507,1,18,4,1,0,103
30257,439507,1,18,5,0,0,103
30258,439507,1,18,6,1,0,104
30259,439507,1,19,1,1,0,105
30260,439507,1,19,2,1,0,106
30261,439507,1,19,3,2,0,108
30262,439507,1,19,4,2,0,110
30263,439507,1,19,5,1,0,111
30264,439507,1,19,6,6,0,117
30265,439507,1,20,1,1,1,118
30266,439507,1,20,2,1,0,119
30267,439507,1,20,3,6,0,125
30268,439507,1,20,4,1,0,126
30269,439507,1,20,5,1,0,127
30270,439507,1,20,6,1,1,128
30384,439510,1,1,1,0,0,0
30385,439510,1,1,2,4,0,4
30386,439510,1,1,3,0,0,4
30387,439510,1,1,4,4,0,8
30388,439510,1,1,5,0,0,8
30389,439510,1,1,6,1,0,9
30390,439510,1,2,1,0,0,9
30391,439510,1,2,2,0,0,9
30392,439510,1,2,3,0,0,9
30393,439510,1,2,4,1,0,10
30394,439510,1,2,5,1,0,11
30395,439510,1,2,6,0,1,11
30396,439510,1,3,1,0,0,11
30397,439510,1,3,2,0,0,11
30398,439510,1,3,3,0,0,11
30399,439510,1,3,4,1,0,12
30400,439510,1,3,5,1,0,13
30401,439510,1,3,6,2,0,15
30402,439510,1,4,1,0,0,15
30403,439510,1,4,2,2,0,17
30404,439510,1,4,3,0,0,17
30405,439510,1,4,4,1,0,18
30406,439510,1,4,5,4,0,22
30407,439510,1,4,6,1,0,23
30408,439510,1,5,1,0,0,23
30409,439510,1,5,2,2,0,25
30410,439510,1,5,3,4,0,29
30411,439510,1,5,4,1,0,30
30412,439510,1,5,5,1,0,31
30413,439510,1,5,6,0,0,31
30414,439510,1,6,1,1,0,32
30415,439510,1,6,2,0,0,32
30416,439510,1,6,3,0,0,32
30417,439510,1,6,4,2,0,34
30418,439510,1,6,5,3,0,37
30419,439510,1,6,6,0,0,37
30420,439510,1,7,1,1,0,38
30421,439510,1,7,2,1,0,39
30422,439510,1,7,3,1,0,40
30423,439510,1,7,4,1,0,41
30424,439510,1,7,5,4,0,45
30425,439510,1,7,6,1,0,46
30426,439510,1,8,1,1,0,47
30427,439510,1,8,2,1,0,48
30428,439510,1,8,3,1,0,49
30429,439510,1,8,4,1,0,50
30430,439510,1,8,5,6,0,56
30431,439510,1,8,6,1,0,57
30432,439510,1,9,1,3,0,60
30433,439510,1,9,2,0,0,60
30434,439510,1,9,3,0,1,60
30435,439510,1,9,4,1,0,61
30436,439510,1,9,5,0,0,61
30437,439510,1,9,6,1,0,62
30438,439510,1,10,1,1,0,63
30439,439510,1,10,2,0,0,63
30440,439510,1,10,3,1,0,64
30441,439510,1,10,4,1,0,65
30442,439510,1,10,5,0,1,65
30443,439510,1,10,6,0,0,65
30444,439510,1,11,1,1,0,66
30445,439510,1,11,2,6,0,72
30446,439510,1,11,3,2,0,74
30447,439510,1,11,4,0,0,74
30448,439510,1,11,5,1,0,75
30449,439510,1,11,6,4,0,79
30450,439510,1,12,1,1,0,80
30451,439510,1,12,2,0,0,80
30452,439510,1,12,3,1,0,81
30453,439510,1,12,4,2,0,83
30454,439510,1,12,5,6,0,89
30455,439510,1,12,6,1,0,90
30456,439510,1,13,1,1,0,91
30457,439510,1,13,2,0,0,91
30458,439510,1,13,3,1,0,92
30459,439510,1,13,4,2,0,94
30460,439510,1,13,5,0,0,94
30461,439510,1,13,6,1,0,95
30462,439510,1,14,1,1,0,96
30463,439510,1,14,2,1,0,97
30464,439510,1,14,3,0,1,97
30465,439510,1,14,4,1,0,98
30466,439510,1,14,5,0,0,98
30467,439510,1,14,6,0,1,98
30468,439510,1,15,1,0,0,98
30469,439510,1,15,2,4,0,102
30470,439510,1,15,3,0,0,102
30471,439510,1,15,4,4,0,106
30472,439510,1,15,5,2,0,108
30473,439510,1,15,6,0,0,108
30474,439510,1,16,1,1,0,109
30475,439510,1,16,2,4,0,113
30476,439510,1,16,3,1,0,114
30477,439510,1,16,4,1,0,115
30478,439510,1,16,5,2,0,117
30479,439510,1,16,6,1,0,118
30480,439510,1,17,1,1,0,119
30481,439510,1,17,2,1,0,120
30482,439510,1,17,3,4,0,124
30483,439510,1,17,4,0,0,124
30484,439510,1,17,5,1,0,125
30485,439510,1,17,6,1,0,126
30486,439510,1,18,1,1,0,127
30487,439510,1,18,2,1,0,128
30488,439510,1,18,3,0,0,128
30489,439510,1,18,4,1,0,129
30490,439510,1,18,5,1,0,130
30491,439510,1,18,6,0,1,130
30492,439510,1,19,1,1,0,131
30493,439510,1,19,2,2,0,133
30494,439510,1,19,3,4,0,137
30495,439510,1,19,4,1,0,138
30496,439510,1,19,5,1,0,139
30497,439510,1,19,6,1,0,140
30498,439510,1,20,1,2,0,142
30499,439510,1,20,2,2,0,144
30500,439510,1,20,3,1,0,145
30501,439510,1,20,4,1,0,146
30502,439510,1,20,5,1,0,147
30503,439510,1,20,6,4,0,151
30597,439511,1,1,1,0,0,0
30598,439511,1,1,2,4,0,4
30599,439511,1,1,3,0,0,4
30600,439511,1,1,4,4,0,8
30601,439511,1,1,5,1,0,9
30602,439511,1,1,6,0,0,9
30603,439511,1,2,1,1,0,10
30604,439511,1,2,2,0,0,10
30605,439511,1,2,3,0,0,10
30606,439511,1,2,4,0,0,10
30607,439511,1,2,5,1,0,11
30608,439511,1,2,6,2,0,13
30609,439511,1,3,1,4,0,17
30610,439511,1,3,2,1,0,18
30611,439511,1,3,3,1,0,19
30612,439511,1,3,4,1,0,20
30613,439511,1,3,5,2,0,22
30614,439511,1,3,6,4,0,26
30615,439511,1,4,1,3,0,29
30616,439511,1,4,2,0,0,29
30617,439511,1,4,3,2,0,31
30618,439511,1,4,4,0,0,31
30619,439511,1,4,5,1,0,32
30620,439511,1,4,6,4,0,36
30621,439511,1,5,1,4,0,40
30622,439511,1,5,2,0,0,40
30623,439511,1,5,3,1,0,41
30624,439511,1,5,4,0,0,41
30625,439511,1,5,5,0,0,41
30626,439511,1,5,6,1,0,42
30627,439511,1,6,1,0,1,42
30628,439511,1,6,2,1,0,43
30629,439511,1,6,3,0,0,43
30630,439511,1,6,4,2,0,45
30631,439511,1,6,5,0,0,45
30632,439511,1,6,6,4,0,49
30633,439511,1,7,1,2,0,51
30634,439511,1,7,2,2,0,53
30635,439511,1,7,3,1,0,54
30636,439511,1,7,4,3,0,57
30637,439511,1,7,5,1,0,58
30638,439511,1,7,6,2,0,60
30639,439511,1,8,1,0,0,60
30640,439511,1,8,2,0,0,60
30641,439511,1,8,3,1,0,61
30642,439511,1,8,4,1,0,62
30643,439511,1,8,5,2,0,64
30644,439511,1,8,6,2,0,66
30645,439511,1,9,1,1,0,67
30646,439511,1,9,2,0,0,67
30647,439511,1,9,3,2,0,69
30648,439511,1,9,4,1,0,70
30649,439511,1,9,5,1,0,71
30650,439511,1,9,6,0,0,71
30651,439511,1,10,1,1,0,72
30652,439511,1,10,2,1,0,73
30653,439511,1,10,3,1,0,74
30654,439511,1,10,4,6,0,80
30655,439511,1,10,5,1,0,81
30656,439511,1,10,6,0,1,81
30657,439511,1,11,1,1,0,82
30658,439511,1,11,2,1,0,83
30659,439511,1,11,3,1,0,84
30660,439511,1,11,4,1,0,85
30661,439511,1,11,5,2,0,87
30662,439511,1,11,6,0,1,87
30663,439511,1,12,1,0,1,87
30664,439511,1,12,2,1,0,88
30665,439511,1,12,3,1,0,89
30666,439511,1,12,4,0,0,89
30667,439511,1,12,5,1,0,90
30668,439511,1,12,6,1,0,91
30669,439511,1,13,1,0,0,91
30670,439511,1,13,2,1,0,92
30671,439511,1,13,3,0,0,92
30672,439511,1,13,4,0,0,92
30673,439511,1,13,5,0,0,92
30674,439511,1,13,6,4,0,96
30675,439511,1,14,1,0,0,96
30676,439511,1,14,2,1,0,97
30677,439511,1,14,3,0,1,97
30678,439511,1,14,4,2,0,99
30679,439511,1,14,5,5,0,104
30680,439511,1,14,6,1,0,105
30681,439511,1,15,1,3,0,108
30682,439511,1,15,2,1,0,109
30683,439511,1,15,3,0,0,109
30684,439511,1,15,4,0,0,109
30685,439511,1,15,5,1,0,110
30686,439511,1,15,6,1,0,111
30687,439511,1,16,1,0,1,111
30688,439511,1,16,2,1,0,112
30689,439511,1,16,3,0,0,112
30690,439511,1,16,4,1,0,113
30691,439511,1,16,5,1,0,114
30692,439511,1,16,6,1,0,115
30693,439511,1,17,1,1,0,116
30694,439511,1,17,2,1,0,117
30695,439511,1,17,3,0,1,117
30696,439511,1,17,4,2,0,119
30697,439511,1,17,5,1,0,120
30698,439511,1,17,6,1,0,121
30699,439511,1,18,1,1,0,122
30700,439511,1,18,2,1,0,123
30701,439511,1,18,3,1,0,124
30702,439511,1,18,4,1,0,125
30703,439511,1,18,5,1,0,126
30704,439511,1,18,6,1,0,127
30705,439511,1,19,1,5,0,132
30706,439511,1,19,2,1,0,133
30707,439511,1,19,3,1,0,134
30708,439511,1,19,4,2,0,136
30709,439511,1,19,5,1,0,137
30710,439511,1,19,6,0,0,137
30711,439511,1,20,1,0,1,137
30712,439511,1,20,2,0,0,137
30713,439511,1,20,3,0,0,137
30714,439511,1,20,4,3,0,140
30715,439511,1,20,5,1,0,141
30716,439511,1,20,6,1,0,142
30822,440945,1,1,1,0,0,0
30823,440945,1,1,2,1,0,1
30824,440945,1,1,3,0,0,1
30825,440945,1,1,4,0,0,1
30826,440945,1,1,5,4,0,5
30827,440945,1,1,6,0,0,5
30828,440945,1,2,1,0,0,5
30829,440945,1,2,2,0,0,5
30830,440945,1,2,3,0,0,5
30831,440945,1,2,4,0,0,5
30832,440945,1,2,5,0,0,5
30833,440945,1,2,6,1,0,6
30834,440945,1,3,1,0,0,6
30835,440945,1,3,2,1,0,7
30836,440945,1,3,3,0,0,7
30837,440945,1,3,4,1,0,8
30838,440945,1,3,5,0,0,8
30839,440945,1,3,6,0,0,8
30840,440945,1,4,1,1,0,9
30841,440945,1,4,2,0,0,9
30842,440945,1,4,3,0,0,9
30843,440945,1,4,4,0,1,9
30844,440945,1,4,5,0,0,9
30845,440945,1,4,6,0,0,9
30846,440945,1,5,1,0,0,9
30847,440945,1,5,2,3,0,12
30848,440945,1,5,3,4,0,16
30849,440945,1,5,4,4,0,20
30850,440945,1,5,5,0,0,20
30851,440945,1,5,6,0,1,20
30852,440945,1,6,1,0,0,20
30853,440945,1,6,2,0,0,20
30854,440945,1,6,3,2,0,22
30855,440945,1,6,4,1,0,23
30856,440945,1,6,5,1,0,24
30857,440945,1,6,6,1,0,25
30858,440945,1,7,1,1,0,26
30859,440945,1,7,2,0,1,26
30860,440945,1,7,3,0,0,26
30861,440945,1,7,4,1,0,27
30862,440945,1,7,5,1,0,28
30863,440945,1,7,6,0,0,28
30864,440945,1,8,1,0,0,28
30865,440945,1,8,2,2,0,30
30866,440945,1,8,3,2,0,32
30867,440945,1,8,4,1,0,33
30868,440945,1,8,5,1,0,34
30869,440945,1,8,6,4,0,38
30870,440945,1,9,1,0,0,38
30871,440945,1,9,2,1,0,39
30872,440945,1,9,3,0,1,39
30873,440945,1,9,4,0,0,39
30874,440945,1,9,5,1,0,40
30875,440945,1,9,6,2,0,42
30876,440945,1,10,1,1,0,43
30877,440945,1,10,2,0,0,43
30878,440945,1,10,3,3,0,46
30879,440945,1,10,4,1,0,47
30880,440945,1,10,5,1,0,48
30881,440945,1,10,6,0,0,48
30882,440945,1,11,1,4,0,52
30883,440945,1,11,2,1,0,53
30884,440945,1,11,3,1,0,54
30885,440945,1,11,4,2,0,56
30886,440945,1,11,5,1,0,57
30887,440945,1,11,6,1,0,58
30888,440945,1,12,1,0,0,58
30889,440945,1,12,2,2,0,60
30890,440945,1,12,3,0,0,60
30891,440945,1,12,4,1,0,61
30892,440945,1,12,5,2,0,63
30893,440945,1,12,6,1,0,64
30894,440945,1,13,1,0,0,64
30895,440945,1,13,2,1,0,65
30896,440945,1,13,3,6,0,71
30897,440945,1,13,4,1,0,72
30898,440945,1,13,5,0,0,72
30899,440945,1,13,6,1,0,73
30900,440945,1,14,1,0,0,73
30901,440945,1,14,2,2,0,75
30902,440945,1,14,3,1,0,76
30903,440945,1,14,4,1,0,77
30904,440945,1,14,5,4,0,81
30905,440945,1,14,6,4,0,85
30906,440945,1,15,1,1,0,86
30907,440945,1,15,2,0,1,86
30908,440945,1,15,3,1,0,87
30909,440945,1,15,4,1,0,88
30910,440945,1,15,5,0,0,88
30911,440945,1,15,6,1,0,89
30912,440945,1,16,1,1,0,90
30913,440945,1,16,2,0,0,90
30914,440945,1,16,3,1,0,91
30915,440945,1,16,4,0,0,91
30916,440945,1,16,5,6,0,97
30917,440945,1,16,6,2,0,99
30918,440945,1,17,1,1,0,100
30919,440945,1,17,2,0,0,100
30920,440945,1,17,3,1,0,101
30921,440945,1,17,4,1,0,102
30922,440945,1,17,5,1,0,103
30923,440945,1,17,6,1,0,104
30924,440945,1,18,1,1,0,105
30925,440945,1,18,2,1,0,106
30926,440945,1,18,3,0,1,106
30927,440945,1,18,4,0,0,106
30928,440945,1,18,5,1,0,107
30929,440945,1,18,6,4,0,111
30930,440945,1,19,1,4,0,115
30931,440945,1,19,2,0,0,115
30932,440945,1,19,3,0,1,115
30933,440945,1,19,4,2,0,117
30934,440945,1,19,5,2,0,119
30935,440945,1,19,6,0,1,119
30936,440945,1,20,1,0,0,119
30937,440945,1,20,2,4,0,123
30938,440945,1,20,3,1,0,124
30939,440945,1,20,4,0,0,124
30940,440945,1,20,5,1,0,125
30941,440945,1,20,6,4,0,129
31053,440946,1,1,1,2,0,2
31054,440946,1,1,2,0,0,2
31055,440946,1,1,3,0,0,2
31056,440946,1,1,4,0,0,2
31057,440946,1,1,5,0,0,2
31058,440946,1,1,6,2,0,4
31059,440946,1,2,1,2,0,6
31060,440946,1,2,2,0,0,6
31061,440946,1,2,3,0,0,6
31062,440946,1,2,4,0,0,6
31063,440946,1,2,5,0,0,6
31064,440946,1,2,6,2,0,8
31065,440946,1,3,1,0,0,8
31066,440946,1,3,2,0,0,8
31067,440946,1,3,3,0,0,8
31068,440946,1,3,4,0,0,8
31069,440946,1,3,5,2,0,10
31070,440946,1,3,6,0,0,10
31071,440946,1,4,1,0,0,10
31072,440946,1,4,2,1,0,11
31073,440946,1,4,3,1,0,12
31074,440946,1,4,4,0,0,12
31075,440946,1,4,5,0,1,12
31076,440946,1,4,6,6,0,18
31077,440946,1,5,1,1,0,19
31078,440946,1,5,2,1,0,20
31079,440946,1,5,3,1,0,21
31080,440946,1,5,4,1,0,22
31081,440946,1,5,5,4,0,26
31082,440946,1,5,6,0,0,26
31083,440946,1,6,1,4,0,30
31084,440946,1,6,2,1,0,31
31085,440946,1,6,3,4,0,35
31086,440946,1,6,4,3,0,38
31087,440946,1,6,5,0,0,38
31088,440946,1,6,6,1,0,39
31089,440946,1,7,1,0,0,39
31090,440946,1,7,2,0,0,39
31091,440946,1,7,3,1,0,40
31092,440946,1,7,4,1,0,41
31093,440946,1,7,5,1,0,42
31094,440946,1,7,6,0,0,42
31095,440946,1,8,1,0,0,42
31096,440946,1,8,2,1,0,43
31097,440946,1,8,3,1,0,44
31098,440946,1,8,4,0,0,44
31099,440946,1,8,5,0,0,44
31100,440946,1,8,6,0,0,44
31101,440946,1,9,1,3,0,47
31102,440946,1,9,2,1,0,48
31103,440946,1,9,3,6,0,54
31104,440946,1,9,4,1,0,55
31105,440946,1,9,5,0,0,55
31106,440946,1,9,6,0,0,55
31107,440946,1,10,1,0,0,55
31108,440946,1,10,2,4,0,59
31109,440946,1,10,3,0,0,59
31110,440946,1,10,4,4,0,63
31111,440946,1,10,5,1,0,64
31112,440946,1,10,6,1,0,65
31113,440946,1,11,1,1,0,66
31114,440946,1,11,2,1,0,67
31115,440946,1,11,3,1,0,68
31116,440946,1,11,4,1,0,69
31117,440946,1,11,5,0,0,69
31118,440946,1,11,6,4,0,73
31119,440946,1,12,1,6,0,79
31120,440946,1,12,2,1,0,80
31121,440946,1,12,3,0,0,80
31122,440946,1,12,4,0,0,80
31123,440946,1,12,5,2,0,82
31124,440946,1,12,6,0,0,82
31125,440946,1,13,1,0,0,82
31126,440946,1,13,2,1,0,83
31127,440946,1,13,3,1,0,84
31128,440946,1,13,4,0,0,84
31129,440946,1,13,5,1,0,85
31130,440946,1,13,6,1,0,86
31131,440946,1,14,1,0,0,86
31132,440946,1,14,2,1,0,87
31133,440946,1,14,3,2,0,89
31134,440946,1,14,4,2,0,91
31135,440946,1,14,5,0,0,91
31136,440946,1,14,6,1,0,92
31137,440946,1,15,1,0,0,92
31138,440946,1,15,2,6,0,98
31139,440946,1,15,3,2,0,100
31140,440946,1,15,4,0,0,100
31141,440946,1,15,5,4,0,104
31142,440946,1,15,6,0,0,104
31143,440946,1,16,1,1,0,105
31144,440946,1,16,2,1,0,106
31145,440946,1,16,3,0,0,106
31146,440946,1,16,4,1,0,107
31147,440946,1,16,5,2,0,109
31148,440946,1,16,6,1,0,110
31149,440946,1,17,1,0,1,110
31150,440946,1,17,2,1,0,111
31151,440946,1,17,3,0,0,111
31152,440946,1,17,4,1,0,112
31153,440946,1,17,5,2,0,114
31154,440946,1,17,6,6,0,120
31155,440946,1,18,1,0,1,120
31156,440946,1,18,2,0,0,120
31157,440946,1,18,3,1,0,121
31158,440946,1,18,4,1,0,122
31159,440946,1,18,5,1,0,123
31160,440946,1,18,6,1,0,124
31161,440946,1,19,1,1,1,125
31162,440946,1,19,2,1,0,126
31163,440946,1,19,3,6,0,132
31164,440946,1,19,4,1,0,133
31165,440946,1,19,5,2,0,135
31166,440946,1,19,6,6,0,141
31167,440946,1,20,1,1,0,142
31168,440946,1,20,2,2,0,144
31169,440946,1,20,3,0,1,144
31170,440946,1,20,4,0,1,144
31171,440946,1,20,5,3,0,147
31172,440946,1,20,6,1,0,148
31287,446956,1,1,1,0,0,0
31288,446956,1,1,2,1,0,1
31289,446956,1,1,3,0,0,1
31290,446956,1,1,4,1,0,2
31291,446956,1,1,5,0,0,2
31292,446956,1,1,6,0,0,2
31293,446956,1,2,1,0,0,2
31294,446956,1,2,2,2,0,4
31295,446956,1,2,3,1,0,5
31296,446956,1,2,4,0,0,5
31297,446956,1,2,5,1,0,6
31298,446956,1,2,6,1,0,7
31299,446956,1,3,1,0,0,7
31300,446956,1,3,2,0,0,7
31301,446956,1,3,3,4,0,11
31302,446956,1,3,4,0,0,11
31303,446956,1,3,5,1,0,12
31304,446956,1,3,6,0,1,12
31305,446956,1,4,1,1,0,13
31306,446956,1,4,2,6,0,19
31307,446956,1,4,3,0,0,19
31308,446956,1,4,4,0,0,19
31309,446956,1,4,5,1,0,20
31310,446956,1,4,6,0,0,20
31311,446956,1,5,1,0,0,20
31312,446956,1,5,2,0,0,20
31313,446956,1,5,3,1,0,21
31314,446956,1,5,4,0,0,21
31315,446956,1,5,5,1,0,22
31316,446956,1,5,6,0,1,22
31317,446956,1,6,1,0,0,22
31318,446956,1,6,2,0,0,22
31319,446956,1,6,3,3,0,25
31320,446956,1,6,4,1,0,26
31321,446956,1,6,5,0,0,26
31322,446956,1,6,6,1,0,27
31323,446956,1,7,1,0,0,27
31324,446956,1,7,2,1,0,28
31325,446956,1,7,3,1,0,29
31326,446956,1,7,4,1,0,30
31327,446956,1,7,5,0,1,30
31328,446956,1,7,6,1,0,31
31329,446956,1,8,1,0,1,31
31330,446956,1,8,2,1,0,32
31331,446956,1,8,3,1,0,33
31332,446956,1,8,4,0,0,33
31333,446956,1,8,5,1,0,34
31334,446956,1,8,6,1,0,35
31335,446956,1,9,1,0,0,35
31336,446956,1,9,2,1,0,36
31337,446956,1,9,3,0,0,36
31338,446956,1,9,4,1,0,37
31339,446956,1,9,5,1,0,38
31340,446956,1,9,6,0,0,38
31341,446956,1,10,1,1,0,39
31342,446956,1,10,2,0,0,39
31343,446956,1,10,3,1,0,40
31344,446956,1,10,4,2,0,42
31345,446956,1,10,5,0,0,42
31346,446956,1,10,6,1,0,43
31347,446956,1,11,1,0,1,43
31348,446956,1,11,2,0,0,43
31349,446956,1,11,3,0,0,43
31350,446956,1,11,4,0,0,43
31351,446956,1,11,5,1,0,44
31352,446956,1,11,6,0,0,44
31353,446956,1,12,1,1,0,45
31354,446956,1,12,2,0,0,45
31355,446956,1,12,3,1,0,46
31356,446956,1,12,4,1,0,47
31357,446956,1,12,5,4,0,51
31358,446956,1,12,6,2,0,53
31359,446956,1,13,1,2,0,55
31360,446956,1,13,2,1,0,56
31361,446956,1,13,3,1,0,57
31362,446956,1,13,4,6,0,63
31363,446956,1,13,5,1,0,64
31364,446956,1,13,6,2,0,66
31365,446956,1,14,1,1,0,67
31366,446956,1,14,2,5,0,72
31367,446956,1,14,3,0,0,72
31368,446956,1,14,4,0,0,72
31369,446956,1,14,5,4,0,76
31370,446956,1,14,6,0,0,76
31371,446956,1,15,1,1,0,77
31372,446956,1,15,2,6,0,83
31373,446956,1,15,3,0,0,83
31374,446956,1,15,4,0,0,83
31375,446956,1,15,5,1,0,84
31376,446956,1,15,6,1,0,85
31377,446956,1,16,1,1,0,86
31378,446956,1,16,2,1,0,87
31379,446956,1,16,3,0,0,87
31380,446956,1,16,4,4,0,91
31381,446956,1,16,5,1,0,92
31382,446956,1,16,6,1,0,93
31383,446956,1,17,1,2,0,95
31384,446956,1,17,2,1,0,96
31385,446956,1,17,3,4,0,100
31386,446956,1,17,4,1,0,101
31387,446956,1,17,5,1,0,102
31388,446956,1,17,6,1,0,103
31389,446956,1,18,1,2,0,105
31390,446956,1,18,2,4,0,109
31391,446956,1,18,3,0,1,109
31392,446956,1,18,4,1,0,110
31393,446956,1,18,5,0,1,110
31394,446956,1,18,6,0,0,110
31395,446956,1,19,1,2,0,112
31396,446956,1,19,2,0,0,112
31397,446956,1,19,3,2,0,114
31398,446956,1,19,4,1,0,115
31399,446956,1,19,5,0,0,115
31400,446956,1,19,6,5,0,120
31401,446956,1,20,1,2,0,122
31402,446956,1,20,2,1,0,123
31403,446956,1,20,3,1,0,124
31404,446956,1,20,4,4,0,128
31405,446956,1,20,5,4,0,132
31406,446956,1,20,6,1,1,133
31506,446960,1,1,1,1,0,1
31507,446960,1,1,2,2,0,3
31508,446960,1,1,3,0,0,3
31509,446960,1,1,4,0,0,3
31510,446960,1,1,5,1,0,4
31511,446960,1,1,6,0,0,4
31512,446960,1,2,1,0,0,4
31513,446960,1,2,2,1,0,5
31514,446960,1,2,3,0,0,5
31515,446960,1,2,4,0,0,5
31516,446960,1,2,5,1,0,6
31517,446960,1,2,6,0,0,6
31518,446960,1,3,1,0,0,6
31519,446960,1,3,2,4,0,10
31520,446960,1,3,3,4,0,14
31521,446960,1,3,4,1,0,15
31522,446960,1,3,5,4,0,19
31523,446960,1,3,6,1,0,20
31524,446960,1,4,1,0,0,20
31525,446960,1,4,2,0,0,20
31526,446960,1,4,3,4,0,24
31527,446960,1,4,4,0,0,24
31528,446960,1,4,5,4,0,28
31529,446960,1,4,6,1,0,29
31530,446960,1,5,1,1,0,30
31531,446960,1,5,2,0,0,30
31532,446960,1,5,3,1,0,31
31533,446960,1,5,4,4,0,35
31534,446960,1,5,5,1,0,36
31535,446960,1,5,6,1,0,37
31536,446960,1,6,1,1,0,38
31537,446960,1,6,2,1,0,39
31538,446960,1,6,3,0,0,39
31539,446960,1,6,4,0,0,39
31540,446960,1,6,5,1,0,40
31541,446960,1,6,6,1,0,41
31542,446960,1,7,1,0,0,41
31543,446960,1,7,2,1,0,42
31544,446960,1,7,3,0,0,42
31545,446960,1,7,4,4,0,46
31546,446960,1,7,5,0,0,46
31547,446960,1,7,6,4,0,50
31548,446960,1,8,1,6,0,56
31549,446960,1,8,2,6,0,62
31550,446960,1,8,3,6,0,68
31551,446960,1,8,4,2,0,70
31552,446960,1,8,5,4,0,74
31553,446960,1,8,6,2,0,76
31554,446960,1,9,1,1,0,77
31555,446960,1,9,2,4,0,81
31556,446960,1,9,3,2,0,83
31557,446960,1,9,4,0,1,83
31558,446960,1,9,5,1,0,84
31559,446960,1,9,6,0,0,84
31560,446960,1,10,1,0,0,84
31561,446960,1,10,2,0,0,84
31562,446960,1,10,3,0,0,84
31563,446960,1,10,4,1,0,85
31564,446960,1,10,5,1,0,86
31565,446960,1,10,6,0,0,86
31566,446960,1,11,1,2,0,88
31567,446960,1,11,2,0,0,88
31568,446960,1,11,3,4,0,92
31569,446960,1,11,4,0,0,92
31570,446960,1,11,5,0,1,92
31571,446960,1,11,6,0,0,92
31572,446960,1,12,1,0,0,92
31573,446960,1,12,2,1,0,93
31574,446960,1,12,3,1,0,94
31575,446960,1,12,4,0,0,94
31576,446960,1,12,5,1,0,95
31577,446960,1,12,6,0,0,95
31578,446960,1,13,1,2,0,97
31579,446960,1,13,2,0,0,97
31580,446960,1,13,3,1,0,98
31581,446960,1,13,4,1,0,99
31582,446960,1,13,5,1,0,100
31583,446960,1,13,6,1,0,101
31584,446960,1,14,1,0,0,101
31585,446960,1,14,2,0,0,101
31586,446960,1,14,3,0,0,101
31587,446960,1,14,4,2,0,103
31588,446960,1,14,5,2,0,105
31589,446960,1,14,6,0,0,105
31590,446960,1,15,1,1,0,106
31591,446960,1,15,2,2,0,108
31592,446960,1,15,3,4,0,112
31593,446960,1,15,4,1,0,113
31594,446960,1,15,5,2,0,115
31595,446960,1,15,6,0,1,115
31596,446960,1,16,1,1,0,116
31597,446960,1,16,2,1,0,117
31598,446960,1,16,3,1,0,118
31599,446960,1,16,4,2,0,120
31600,446960,1,16,5,1,0,121
31601,446960,1,16,6,1,0,122
31602,446960,1,17,1,0,0,122
31603,446960,1,17,2,4,0,126
31604,446960,1,17,3,1,0,127
31605,446960,1,17,4,6,0,133
31606,446960,1,17,5,0,1,133
31607,446960,1,17,6,2,0,135
31608,446960,1,18,1,1,0,136
31609,446960,1,18,2,1,0,137
31610,446960,1,18,3,1,0,138
31611,446960,1,18,4,0,0,138
31612,446960,1,18,5,1,0,139
31613,446960,1,18,6,1,0,140
31614,446960,1,19,1,1,0,141
31615,446960,1,19,2,1,0,142
31616,446960,1,19,3,0,0,142
31617,446960,1,19,4,1,0,143
31618,446960,1,19,5,0,0,143
31619,446960,1,19,6,1,0,144
31620,446960,1,20,1,1,0,145
31621,446960,1,20,2,2,0,147
31622,446960,1,20,3,2,0,149
31623,446960,1,20,4,2,0,151
31624,446960,1,20,5,4,0,155
31625,446960,1,20,6,2,0,157
31746,446961,1,1,1,0,0,0
31747,446961,1,1,2,0,0,0
31748,446961,1,1,3,0,0,0
31749,446961,1,1,4,1,0,1
31750,446961,1,1,5,1,0,2
31751,446961,1,1,6,0,0,2
31752,446961,1,2,1,0,0,2
31753,446961,1,2,2,0,0,2
31754,446961,1,2,3,1,0,3
31755,446961,1,2,4,2,0,5
31756,446961,1,2,5,2,0,7
31757,446961,1,2,6,4,0,11
31758,446961,1,3,1,6,0,17
31759,446961,1,3,2,1,0,18
31760,446961,1,3,3,2,0,20
31761,446961,1,3,4,1,0,21
31762,446961,1,3,5,1,0,22
31763,446961,1,3,6,4,0,26
31764,446961,1,4,1,6,0,32
31765,446961,1,4,2,1,0,33
31766,446961,1,4,3,0,0,33
31767,446961,1,4,4,0,0,33
31768,446961,1,4,5,4,0,37
31769,446961,1,4,6,0,0,37
31770,446961,1,5,1,0,1,37
31771,446961,1,5,2,2,0,39
31772,446961,1,5,3,0,0,39
31773,446961,1,5,4,6,0,45
31774,446961,1,5,5,2,0,47
31775,446961,1,5,6,2,0,49
31776,446961,1,6,1,1,0,50
31777,446961,1,6,2,1,0,51
31778,446961,1,6,3,1,0,52
31779,446961,1,6,4,4,0,56
31780,446961,1,6,5,0,0,56
31781,446961,1,6,6,1,0,57
31782,446961,1,7,1,0,0,57
31783,446961,1,7,2,4,0,61
31784,446961,1,7,3,1,0,62
31785,446961,1,7,4,1,0,63
31786,446961,1,7,5,0,1,63
31787,446961,1,7,6,0,0,63
31788,446961,1,8,1,0,0,63
31789,446961,1,8,2,1,0,64
31790,446961,1,8,3,3,0,67
31791,446961,1,8,4,0,0,67
31792,446961,1,8,5,1,0,68
31793,446961,1,8,6,1,0,69
31794,446961,1,9,1,1,0,70
31795,446961,1,9,2,0,0,70
31796,446961,1,9,3,0,0,70
31797,446961,1,9,4,0,0,70
31798,446961,1,9,5,1,0,71
31799,446961,1,9,6,1,0,72
31800,446961,1,10,1,0,0,72
31801,446961,1,10,2,0,1,72
31802,446961,1,10,3,0,0,72
31803,446961,1,10,4,0,0,72
31804,446961,1,10,5,1,0,73
31805,446961,1,10,6,0,0,73
31806,446961,1,11,1,1,0,74
31807,446961,1,11,2,0,1,74
31808,446961,1,11,3,2,0,76
31809,446961,1,11,4,0,0,76
31810,446961,1,11,5,0,0,76
31811,446961,1,11,6,0,0,76
31812,446961,1,12,1,0,0,76
31813,446961,1,12,2,1,0,77
31814,446961,1,12,3,1,0,78
31815,446961,1,12,4,2,0,80
31816,446961,1,12,5,0,1,80
31817,446961,1,12,6,0,0,80
31818,446961,1,13,1,2,0,82
31819,446961,1,13,2,4,0,86
31820,446961,1,13,3,1,0,87
31821,446961,1,13,4,0,0,87
31822,446961,1,13,5,0,0,87
31823,446961,1,13,6,0,0,87
31824,446961,1,14,1,1,0,88
31825,446961,1,14,2,2,0,90
31826,446961,1,14,3,1,0,91
31827,446961,1,14,4,1,0,92
31828,446961,1,14,5,2,0,94
31829,446961,1,14,6,1,0,95
31830,446961,1,15,1,1,0,96
31831,446961,1,15,2,0,0,96
31832,446961,1,15,3,0,0,96
31833,446961,1,15,4,4,0,100
31834,446961,1,15,5,1,0,101
31835,446961,1,15,6,1,0,102
31836,446961,1,16,1,1,0,103
31837,446961,1,16,2,2,0,105
31838,446961,1,16,3,1,0,106
31839,446961,1,16,4,1,0,107
31840,446961,1,16,5,1,0,108
31841,446961,1,16,6,0,0,108
31842,446961,1,17,1,6,0,114
31843,446961,1,17,2,0,0,114
31844,446961,1,17,3,0,0,114
31845,446961,1,17,4,0,0,114
31846,446961,1,17,5,4,0,118
31847,446961,1,17,6,0,0,118
31848,446961,1,18,1,1,0,119
31849,446961,1,18,2,1,0,120
31850,446961,1,18,3,1,0,121
31851,446961,1,18,4,1,0,122
31852,446961,1,18,5,1,0,123
31853,446961,1,18,6,1,0,124
31854,446961,1,19,1,4,0,128
31855,446961,1,19,2,3,0,131
31856,446961,1,19,3,0,0,131
31857,446961,1,19,4,0,1,131
31858,446961,1,19,5,1,0,132
31859,446961,1,19,6,6,0,138
31860,446961,1,20,1,0,1,138
31861,446961,1,20,2,1,0,139
31862,446961,1,20,3,2,0,141
31863,446961,1,20,4,2,0,143
31864,446961,1,20,5,2,0,145
31865,446961,1,20,6,2,0,147
31986,447539,1,1,1,0,0,0
31987,447539,1,1,2,0,0,0
31988,447539,1,1,3,2,0,2
31989,447539,1,1,4,0,0,2
31990,447539,1,1,5,0,0,2
31991,447539,1,1,6,4,0,6
31992,447539,1,2,1,0,0,6
31993,447539,1,2,2,0,0,6
31994,447539,1,2,3,0,1,6
31995,447539,1,2,4,0,0,6
31996,447539,1,2,5,0,0,6
31997,447539,1,2,6,0,0,6
31998,447539,1,3,1,0,0,6
31999,447539,1,3,2,0,0,6
32000,447539,1,3,3,0,0,6
32001,447539,1,3,4,0,0,6
32002,447539,1,3,5,1,0,7
32003,447539,1,3,6,0,0,7
32004,447539,1,4,1,0,0,7
32005,447539,1,4,2,2,0,9
32006,447539,1,4,3,4,0,13
32007,447539,1,4,4,1,0,14
32008,447539,1,4,5,1,0,15
32009,447539,1,4,6,0,0,15
32010,447539,1,5,1,1,0,16
32011,447539,1,5,2,1,0,17
32012,447539,1,5,3,0,0,17
32013,447539,1,5,4,0,0,17
32014,447539,1,5,5,6,0,23
32015,447539,1,5,6,4,0,27
32016,447539,1,6,1,0,1,27
32017,447539,1,6,2,0,0,27
32018,447539,1,6,3,0,0,27
32019,447539,1,6,4,1,0,28
32020,447539,1,6,5,2,0,30
32021,447539,1,6,6,2,0,32
32022,447539,1,7,1,0,0,32
32023,447539,1,7,2,1,0,33
32024,447539,1,7,3,0,0,33
32025,447539,1,7,4,2,0,35
32026,447539,1,7,5,1,0,36
32027,447539,1,7,6,1,0,37
32028,447539,1,8,1,0,0,37
32029,447539,1,8,2,0,0,37
32030,447539,1,8,3,3,0,40
32031,447539,1,8,4,2,0,42
32032,447539,1,8,5,0,1,42
32033,447539,1,8,6,0,0,42
32034,447539,1,9,1,0,0,42
32035,447539,1,9,2,1,0,43
32036,447539,1,9,3,0,0,43
32037,447539,1,9,4,1,0,44
32038,447539,1,9,5,0,0,44
32039,447539,1,9,6,0,0,44
32040,447539,1,10,1,0,0,44
32041,447539,1,10,2,1,0,45
32042,447539,1,10,3,1,0,46
32043,447539,1,10,4,1,0,47
32044,447539,1,10,5,1,0,48
32045,447539,1,10,6,1,0,49
32046,447539,1,11,1,1,0,50
32047,447539,1,11,2,4,0,54
32048,447539,1,11,3,1,0,55
32049,447539,1,11,4,1,0,56
32050,447539,1,11,5,0,0,56
32051,447539,1,11,6,0,0,56
32052,447539,1,12,1,1,0,57
32053,447539,1,12,2,0,1,57
32054,447539,1,12,3,0,0,57
32055,447539,1,12,4,1,0,58
32056,447539,1,12,5,1,0,59
32057,447539,1,12,6,0,0,59
32058,447539,1,13,1,0,1,59
32059,447539,1,13,2,1,0,60
32060,447539,1,13,3,0,0,60
32061,447539,1,13,4,2,0,62
32062,447539,1,13,5,6,0,68
32063,447539,1,13,6,1,0,69
32064,447539,1,14,1,1,0,70
32065,447539,1,14,2,1,0,71
32066,447539,1,14,3,1,0,72
32067,447539,1,14,4,0,0,72
32068,447539,1,14,5,0,0,72
32069,447539,1,14,6,1,0,73
32070,447539,1,15,1,0,0,73
32071,447539,1,15,2,0,0,73
32072,447539,1,15,3,2,0,75
32073,447539,1,15,4,0,0,75
32074,447539,1,15,5,1,0,76
32075,447539,1,15,6,1,0,77
32076,447539,1,16,1,1,0,78
32077,447539,1,16,2,2,0,80
32078,447539,1,16,3,2,0,82
32079,447539,1,16,4,6,0,88
32080,447539,1,16,5,0,0,88
32081,447539,1,16,6,3,0,91
32082,447539,1,17,1,1,0,92
32083,447539,1,17,2,0,0,92
32084,447539,1,17,3,1,0,93
32085,447539,1,17,4,0,0,93
32086,447539,1,17,5,1,0,94
32087,447539,1,17,6,1,0,95
32088,447539,1,18,1,1,0,96
32089,447539,1,18,2,1,0,97
32090,447539,1,18,3,1,0,98
32091,447539,1,18,4,2,0,100
32092,447539,1,18,5,1,0,101
32093,447539,1,18,6,1,0,102
32094,447539,1,19,1,1,0,103
32095,447539,1,19,2,0,0,103
32096,447539,1,19,3,6,0,109
32097,447539,1,19,4,6,0,115
32098,447539,1,19,5,0,0,115
32099,447539,1,19,6,1,0,116
32100,447539,1,20,1,0,1,116
32101,447539,1,20,2,1,0,117
32102,447539,1,20,3,1,0,118
32103,447539,1,20,4,1,0,119
32104,447539,1,20,5,1,0,120
32105,447539,1,20,6,0,1,120
32226,452153,1,1,1,1,0,1
32227,452153,1,1,2,1,0,2
32228,452153,1,1,3,0,0,2
32229,452153,1,1,4,0,1,2
32230,452153,1,1,5,0,0,2
32231,452153,1,1,6,1,0,3
32232,452153,1,2,1,1,0,4
32233,452153,1,2,2,0,0,4
32234,452153,1,2,3,0,0,4
32235,452153,1,2,4,0,0,4
32236,452153,1,2,5,9,0,13
32237,452153,1,2,6,0,0,13
32238,452153,1,3,1,0,0,13
32239,452153,1,3,2,4,0,17
32240,452153,1,3,3,6,0,23
32241,452153,1,3,4,1,0,24
32242,452153,1,3,5,6,0,30
32243,452153,1,3,6,0,1,30
32244,452153,1,4,1,1,0,31
32245,452153,1,4,2,0,0,31
32246,452153,1,4,3,1,0,32
32247,452153,1,4,4,0,0,32
32248,452153,1,4,5,5,0,37
32249,452153,1,4,6,4,0,41
32250,452153,1,5,1,1,0,42
32251,452153,1,5,2,0,0,42
32252,452153,1,5,3,0,0,42
32253,452153,1,5,4,1,0,43
32254,452153,1,5,5,1,0,44
32255,452153,1,5,6,0,0,44
32256,452153,1,6,1,1,0,45
32257,452153,1,6,2,1,0,46
32258,452153,1,6,3,0,1,46
32259,452153,1,6,4,0,0,46
32260,452153,1,6,5,1,0,47
32261,452153,1,6,6,4,0,51
32262,452153,1,7,1,0,0,51
32263,452153,1,7,2,1,0,52
32264,452153,1,7,3,2,0,54
32265,452153,1,7,4,1,0,55
32266,452153,1,7,5,1,0,56
32267,452153,1,7,6,1,0,57
32268,452153,1,8,1,1,0,58
32269,452153,1,8,2,4,0,62
32270,452153,1,8,3,0,0,62
32271,452153,1,8,4,1,0,63
32272,452153,1,8,5,0,0,63
32273,452153,1,8,6,1,0,64
32274,452153,1,9,1,1,0,65
32275,452153,1,9,2,1,0,66
32276,452153,1,9,3,1,0,67
32277,452153,1,9,4,1,0,68
32278,452153,1,9,5,0,0,68
32279,452153,1,9,6,0,0,68
32280,452153,1,10,1,1,0,69
32281,452153,1,10,2,1,0,70
32282,452153,1,10,3,2,0,72
32283,452153,1,10,4,1,0,73
32284,452153,1,10,5,0,0,73
32285,452153,1,10,6,0,0,73
32286,452153,1,11,1,0,0,73
32287,452153,1,11,2,0,1,73
32288,452153,1,11,3,0,0,73
32289,452153,1,11,4,0,0,73
32290,452153,1,11,5,1,0,74
32291,452153,1,11,6,2,0,76
32292,452153,1,12,1,0,0,76
32293,452153,1,12,2,0,0,76
32294,452153,1,12,3,1,0,77
32295,452153,1,12,4,0,0,77
32296,452153,1,12,5,1,0,78
32297,452153,1,12,6,0,0,78
32298,452153,1,13,1,0,0,78
32299,452153,1,13,2,0,0,78
32300,452153,1,13,3,1,0,79
32301,452153,1,13,4,1,0,80
32302,452153,1,13,5,0,0,80
32303,452153,1,13,6,0,0,80
32304,452153,1,14,1,0,1,80
32305,452153,1,14,2,1,0,81
32306,452153,1,14,3,0,1,81
32307,452153,1,14,4,0,0,81
32308,452153,1,14,5,0,0,81
32309,452153,1,14,6,0,0,81
32310,452153,1,15,1,1,0,82
32311,452153,1,15,2,1,0,83
32312,452153,1,15,3,0,0,83
32313,452153,1,15,4,1,0,84
32314,452153,1,15,5,0,0,84
32315,452153,1,15,6,0,0,84
32316,452153,1,16,1,0,0,84
32317,452153,1,16,2,1,0,85
32318,452153,1,16,3,0,0,85
32319,452153,1,16,4,0,0,85
32320,452153,1,16,5,1,0,86
32321,452153,1,16,6,1,0,87
32322,452153,1,17,1,1,0,88
32323,452153,1,17,2,1,0,89
32324,452153,1,17,3,1,0,90
32325,452153,1,17,4,0,0,90
32326,452153,1,17,5,1,0,91
32327,452153,1,17,6,1,0,92
32328,452153,1,18,1,0,0,92
32329,452153,1,18,2,4,0,96
32330,452153,1,18,3,1,0,97
32331,452153,1,18,4,1,0,98
32332,452153,1,18,5,0,0,98
32333,452153,1,18,6,1,0,99
32334,452153,1,19,1,4,0,103
32335,452153,1,19,2,0,0,103
32336,452153,1,19,3,0,1,103
32337,452153,1,19,4,2,0,105
32338,452153,1,19,5,0,0,105
32339,452153,1,19,6,0,1,105
32340,452153,1,20,1,1,0,106
32341,452153,1,20,2,1,0,107
32342,452153,1,20,3,0,1,107
32343,452153,1,20,4,1,0,108
32344,452153,1,20,5,1,0,109
32345,452153,1,20,6,2,0,111
32436,452154,1,1,1,0,0,0
32437,452154,1,1,2,0,0,0
32438,452154,1,1,3,0,0,0
32439,452154,1,1,4,0,0,0
32440,452154,1,1,5,1,0,1
32441,452154,1,1,6,1,0,2
32442,452154,1,2,1,2,0,4
32443,452154,1,2,2,0,0,4
32444,452154,1,2,3,4,0,8
32445,452154,1,2,4,0,0,8
32446,452154,1,2,5,0,0,8
32447,452154,1,2,6,0,0,8
32448,452154,1,3,1,0,1,8
32449,452154,1,3,2,0,0,8
32450,452154,1,3,3,0,0,8
32451,452154,1,3,4,0,0,8
32452,452154,1,3,5,0,0,8
32453,452154,1,3,6,1,0,9
32454,452154,1,4,1,0,0,9
32455,452154,1,4,2,0,0,9
32456,452154,1,4,3,0,0,9
32457,452154,1,4,4,0,0,9
32458,452154,1,4,5,1,0,10
32459,452154,1,4,6,0,0,10
32460,452154,1,5,1,0,0,10
32461,452154,1,5,2,1,0,11
32462,452154,1,5,3,0,0,11
32463,452154,1,5,4,1,0,12
32464,452154,1,5,5,4,0,16
32465,452154,1,5,6,0,0,16
32466,452154,1,6,1,4,0,20
32467,452154,1,6,2,0,0,20
32468,452154,1,6,3,1,0,21
32469,452154,1,6,4,0,0,21
32470,452154,1,6,5,0,0,21
32471,452154,1,6,6,0,1,21
32472,452154,1,7,1,1,0,22
32473,452154,1,7,2,1,0,23
32474,452154,1,7,3,0,0,23
32475,452154,1,7,4,1,0,24
32476,452154,1,7,5,2,0,26
32477,452154,1,7,6,0,0,26
32478,452154,1,8,1,1,0,27
32479,452154,1,8,2,1,0,28
32480,452154,1,8,3,1,0,29
32481,452154,1,8,4,1,0,30
32482,452154,1,8,5,1,0,31
32483,452154,1,8,6,2,0,33
32484,452154,1,9,1,0,0,33
32485,452154,1,9,2,4,0,37
32486,452154,1,9,3,0,0,37
32487,452154,1,9,4,0,0,37
32488,452154,1,9,5,0,0,37
32489,452154,1,9,6,1,0,38
32490,452154,1,10,1,1,0,39
32491,452154,1,10,2,1,0,40
32492,452154,1,10,3,1,0,41
32493,452154,1,10,4,4,0,45
32494,452154,1,10,5,1,0,46
32495,452154,1,10,6,1,0,47
32496,452154,1,11,1,0,0,47
32497,452154,1,11,2,1,0,48
32498,452154,1,11,3,0,0,48
32499,452154,1,11,4,4,0,52
32500,452154,1,11,5,1,0,53
32501,452154,1,11,6,0,0,53
32502,452154,1,12,1,0,0,53
32503,452154,1,12,2,3,0,56
32504,452154,1,12,3,1,0,57
32505,452154,1,12,4,1,0,58
32506,452154,1,12,5,1,0,59
32507,452154,1,12,6,1,0,60
32508,452154,1,13,1,1,0,61
32509,452154,1,13,2,2,0,63
32510,452154,1,13,3,1,0,64
32511,452154,1,13,4,0,1,64
32512,452154,1,13,5,0,0,64
32513,452154,1,13,6,1,0,65
32514,452154,1,14,1,0,0,65
32515,452154,1,14,2,2,0,67
32516,452154,1,14,3,1,0,68
32517,452154,1,14,4,0,0,68
32518,452154,1,14,5,1,0,69
32519,452154,1,14,6,0,0,69
32520,452154,1,15,1,1,0,70
32521,452154,1,15,2,0,0,70
32522,452154,1,15,3,1,0,71
32523,452154,1,15,4,0,0,71
32524,452154,1,15,5,2,0,73
32525,452154,1,15,6,1,0,74
32526,452154,1,16,1,3,0,77
32527,452154,1,16,2,4,0,81
32528,452154,1,16,3,6,0,87
32529,452154,1,16,4,4,0,91
32530,452154,1,16,5,1,0,92
32531,452154,1,16,6,1,0,93
32532,452154,1,17,1,1,0,94
32533,452154,1,17,2,4,0,98
32534,452154,1,17,3,1,0,99
32535,452154,1,17,4,1,0,100
32536,452154,1,17,5,6,0,106
32537,452154,1,17,6,0,0,106
32538,452154,1,18,1,1,0,107
32539,452154,1,18,2,0,1,107
32540,452154,1,18,3,1,0,108
32541,452154,1,18,4,1,0,109
32542,452154,1,18,5,1,0,110
32543,452154,1,18,6,2,0,112
32544,452154,1,19,1,6,0,118
32545,452154,1,19,2,6,0,124
32546,452154,1,19,3,4,0,128
32547,452154,1,19,4,0,1,128
32548,452154,1,19,5,1,0,129
32549,452154,1,19,6,1,0,130
32550,452154,1,20,1,0,0,130
32551,452154,1,20,2,2,0,132
32552,452154,1,20,3,1,0,133
32553,452154,1,20,4,2,0,135
32554,452154,1,20,5,4,0,139
32555,452154,1,20,6,1,0,140
32664,456991,1,1,1,0,0,0
32665,456991,1,1,2,0,0,0
32666,456991,1,1,3,1,0,1
32667,456991,1,1,4,0,0,1
32668,456991,1,1,5,1,0,2
32669,456991,1,1,6,4,0,6
32670,456991,1,2,1,1,0,7
32671,456991,1,2,2,2,0,9
32672,456991,1,2,3,0,0,9
32673,456991,1,2,4,0,0,9
32674,456991,1,2,5,0,0,9
32675,456991,1,2,6,0,0,9
32676,456991,1,3,1,4,0,13
32677,456991,1,3,2,0,0,13
32678,456991,1,3,3,0,0,13
32679,456991,1,3,4,0,0,13
32680,456991,1,3,5,1,0,14
32681,456991,1,3,6,1,0,15
32682,456991,1,4,1,4,0,19
32683,456991,1,4,2,6,0,25
32684,456991,1,4,3,0,1,25
32685,456991,1,4,4,0,0,25
32686,456991,1,4,5,1,0,26
32687,456991,1,4,6,1,0,27
32688,456991,1,5,1,0,1,27
32689,456991,1,5,2,0,0,27
32690,456991,1,5,3,4,0,31
32691,456991,1,5,4,1,0,32
32692,456991,1,5,5,0,0,32
32693,456991,1,5,6,0,0,32
32694,456991,1,6,1,0,0,32
32695,456991,1,6,2,0,0,32
32696,456991,1,6,3,0,0,32
32697,456991,1,6,4,0,0,32
32698,456991,1,6,5,1,0,33
32699,456991,1,6,6,0,0,33
32700,456991,1,7,1,1,0,34
32701,456991,1,7,2,1,0,35
32702,456991,1,7,3,0,0,35
32703,456991,1,7,4,0,0,35
32704,456991,1,7,5,2,0,37
32705,456991,1,7,6,0,0,37
32706,456991,1,8,1,0,0,37
32707,456991,1,8,2,1,0,38
32708,456991,1,8,3,4,0,42
32709,456991,1,8,4,0,0,42
32710,456991,1,8,5,0,0,42
32711,456991,1,8,6,1,0,43
32712,456991,1,9,1,1,0,44
32713,456991,1,9,2,0,0,44
32714,456991,1,9,3,4,0,48
32715,456991,1,9,4,2,0,50
32716,456991,1,9,5,1,0,51
32717,456991,1,9,6,0,1,51
32718,456991,1,10,1,0,0,51
32719,456991,1,10,2,1,0,52
32720,456991,1,10,3,0,0,52
32721,456991,1,10,4,1,0,53
32722,456991,1,10,5,1,0,54
32723,456991,1,10,6,0,0,54
32724,456991,1,11,1,1,0,55
32725,456991,1,11,2,1,0,56
32726,456991,1,11,3,1,0,57
32727,456991,1,11,4,1,0,58
32728,456991,1,11,5,0,0,58
32729,456991,1,11,6,0,0,58
32730,456991,1,12,1,0,0,58
32731,456991,1,12,2,1,0,59
32732,456991,1,12,3,1,0,60
32733,456991,1,12,4,1,0,61
32734,456991,1,12,5,0,0,61
32735,456991,1,12,6,4,0,65
32736,456991,1,13,1,2,0,67
32737,456991,1,13,2,2,0,69
32738,456991,1,13,3,1,0,70
32739,456991,1,13,4,1,0,71
32740,456991,1,13,5,0,1,71
32741,456991,1,13,6,1,0,72
32742,456991,1,14,1,2,0,74
32743,456991,1,14,2,0,0,74
32744,456991,1,14,3,2,0,76
32745,456991,1,14,4,1,1,77
32746,456991,1,14,5,1,0,78
32747,456991,1,14,6,1,0,79
32748,456991,1,15,1,1,0,80
32749,456991,1,15,2,1,0,81
32750,456991,1,15,3,1,0,82
32751,456991,1,15,4,1,0,83
32752,456991,1,15,5,1,0,84
32753,456991,1,15,6,1,0,85
32754,456991,1,16,1,2,0,87
32755,456991,1,16,2,1,0,88
32756,456991,1,16,3,2,0,90
32757,456991,1,16,4,1,0,91
32758,456991,1,16,5,2,0,93
32759,456991,1,16,6,1,0,94
32760,456991,1,17,1,0,0,94
32761,456991,1,17,2,0,1,94
32762,456991,1,17,3,0,0,94
32763,456991,1,17,4,1,0,95
32764,456991,1,17,5,1,0,96
32765,456991,1,17,6,0,0,96
32766,456991,1,18,1,1,0,97
32767,456991,1,18,2,2,0,99
32768,456991,1,18,3,1,0,100
32769,456991,1,18,4,4,0,104
32770,456991,1,18,5,0,0,104
32771,456991,1,18,6,2,0,106
32772,456991,1,19,1,1,0,107
32773,456991,1,19,2,1,0,108
32774,456991,1,19,3,0,0,108
32775,456991,1,19,4,2,0,110
32776,456991,1,19,5,2,0,112
32777,456991,1,19,6,1,0,113
32778,456991,1,20,1,0,0,113
32779,456991,1,20,2,0,1,113
32780,456991,1,20,3,1,0,114
32781,456991,1,20,4,1,0,115
32782,456991,1,20,5,3,0,118
32783,456991,1,20,6,2,0,120
32902,456992,1,1,1,0,0,0
32903,456992,1,1,2,1,0,1
32904,456992,1,1,3,1,0,2
32905,456992,1,1,4,0,0,2
32906,456992,1,1,5,0,0,2
32907,456992,1,1,6,1,0,3
32908,456992,1,2,1,0,1,3
32909,456992,1,2,2,0,0,3
32910,456992,1,2,3,1,0,4
32911,456992,1,2,4,0,0,4
32912,456992,1,2,5,0,1,4
32913,456992,1,2,6,0,1,4
32914,456992,1,3,1,4,0,8
32915,456992,1,3,2,0,0,8
32916,456992,1,3,3,0,1,8
32917,456992,1,3,4,0,0,8
32918,456992,1,3,5,1,0,9
32919,456992,1,3,6,0,0,9
32920,456992,1,4,1,0,0,9
32921,456992,1,4,2,0,0,9
32922,456992,1,4,3,0,0,9
32923,456992,1,4,4,0,0,9
32924,456992,1,4,5,0,0,9
32925,456992,1,4,6,0,0,9
32926,456992,1,5,1,0,0,9
32927,456992,1,5,2,0,0,9
32928,456992,1,5,3,2,0,11
32929,456992,1,5,4,2,0,13
32930,456992,1,5,5,0,1,13
32931,456992,1,5,6,1,0,14
32932,456992,1,6,1,0,0,14
32933,456992,1,6,2,1,0,15
32934,456992,1,6,3,1,0,16
32935,456992,1,6,4,0,0,16
32936,456992,1,6,5,0,0,16
32937,456992,1,6,6,1,0,17
32938,456992,1,7,1,4,0,21
32939,456992,1,7,2,1,0,22
32940,456992,1,7,3,2,0,24
32941,456992,1,7,4,1,0,25
32942,456992,1,7,5,1,0,26
32943,456992,1,7,6,0,0,26
32944,456992,1,8,1,1,0,27
32945,456992,1,8,2,1,0,28
32946,456992,1,8,3,2,0,30
32947,456992,1,8,4,1,0,31
32948,456992,1,8,5,2,0,33
32949,456992,1,8,6,1,0,34
32950,456992,1,9,1,3,0,37
32951,456992,1,9,2,0,0,37
32952,456992,1,9,3,1,0,38
32953,456992,1,9,4,0,0,38
32954,456992,1,9,5,1,0,39
32955,456992,1,9,6,0,0,39
32956,456992,1,10,1,1,0,40
32957,456992,1,10,2,4,0,44
32958,456992,1,10,3,1,0,45
32959,456992,1,10,4,1,0,46
32960,456992,1,10,5,4,0,50
32961,456992,1,10,6,1,0,51
32962,456992,1,11,1,2,0,53
32963,456992,1,11,2,2,0,55
32964,456992,1,11,3,1,0,56
32965,456992,1,11,4,1,0,57
32966,456992,1,11,5,1,0,58
32967,456992,1,11,6,0,1,58
32968,456992,1,12,1,0,0,58
32969,456992,1,12,2,0,0,58
32970,456992,1,12,3,0,0,58
32971,456992,1,12,4,1,0,59
32972,456992,1,12,5,1,0,60
32973,456992,1,12,6,0,0,60
32974,456992,1,13,1,1,0,61
32975,456992,1,13,2,1,0,62
32976,456992,1,13,3,0,0,62
32977,456992,1,13,4,0,0,62
32978,456992,1,13,5,1,0,63
32979,456992,1,13,6,1,0,64
32980,456992,1,14,1,0,0,64
32981,456992,1,14,2,0,0,64
32982,456992,1,14,3,2,0,66
32983,456992,1,14,4,1,0,67
32984,456992,1,14,5,0,0,67
32985,456992,1,14,6,0,1,67
32986,456992,1,15,1,1,0,68
32987,456992,1,15,2,0,0,68
32988,456992,1,15,3,0,1,68
32989,456992,1,15,4,1,0,69
32990,456992,1,15,5,1,0,70
32991,456992,1,15,6,1,0,71
32992,456992,1,16,1,0,0,71
32993,456992,1,16,2,1,0,72
32994,456992,1,16,3,4,0,76
32995,456992,1,16,4,1,0,77
32996,456992,1,16,5,0,0,77
32997,456992,1,16,6,0,0,77
32998,456992,1,17,1,0,0,77
32999,456992,1,17,2,1,0,78
33000,456992,1,17,3,1,0,79
33001,456992,1,17,4,0,0,79
33002,456992,1,17,5,1,0,80
33003,456992,1,17,6,0,0,80
33004,456992,1,18,1,1,0,81
33005,456992,1,18,2,0,1,81
33006,456992,1,18,3,0,1,81
33101,461565,1,1,1,0,0,0
33102,461565,1,1,2,0,0,0
33103,461565,1,1,3,4,0,4
33104,461565,1,1,4,1,0,5
33105,461565,1,1,5,2,0,7
33106,461565,1,1,6,0,0,7
33107,461565,1,2,1,1,0,8
33108,461565,1,2,2,0,0,8
33109,461565,1,2,3,0,0,8
33110,461565,1,2,4,1,0,9
33111,461565,1,2,5,0,1,9
33112,461565,1,2,6,0,0,9
33113,461565,1,3,1,3,0,12
33114,461565,1,3,2,1,0,13
33115,461565,1,3,3,1,0,14
33116,461565,1,3,4,4,0,18
33117,461565,1,3,5,0,0,18
33118,461565,1,3,6,0,0,18
33119,461565,1,4,1,0,0,18
33120,461565,1,4,2,4,0,22
33121,461565,1,4,3,4,0,26
33122,461565,1,4,4,1,0,27
33123,461565,1,4,5,1,0,28
33124,461565,1,4,6,1,0,29
33125,461565,1,5,1,0,0,29
33126,461565,1,5,2,0,1,29
33127,461565,1,5,3,0,0,29
33128,461565,1,5,4,0,0,29
33129,461565,1,5,5,0,0,29
33130,461565,1,5,6,0,0,29
33131,461565,1,6,1,0,1,29
33132,461565,1,6,2,0,0,29
33133,461565,1,6,3,0,0,29
33134,461565,1,6,4,1,0,30
33135,461565,1,6,5,1,0,31
33136,461565,1,6,6,4,0,35
33137,461565,1,7,1,0,0,35
33138,461565,1,7,2,1,1,36
33139,461565,1,7,3,1,0,37
33140,461565,1,7,4,0,0,37
33141,461565,1,7,5,0,0,37
33142,461565,1,7,6,0,0,37
33143,461565,1,8,1,2,0,39
33144,461565,1,8,2,0,1,39
33145,461565,1,8,3,1,0,40
33146,461565,1,8,4,0,0,40
33147,461565,1,8,5,0,0,40
33148,461565,1,8,6,1,0,41
33149,461565,1,9,1,1,0,42
33150,461565,1,9,2,0,0,42
33151,461565,1,9,3,0,0,42
33152,461565,1,9,4,1,0,43
33153,461565,1,9,5,0,0,43
33154,461565,1,9,6,0,0,43
33155,461565,1,10,1,4,0,47
33156,461565,1,10,2,1,0,48
33157,461565,1,10,3,1,0,49
33158,461565,1,10,4,0,0,49
33159,461565,1,10,5,2,0,51
33160,461565,1,10,6,1,0,52
33161,461565,1,11,1,0,0,52
33162,461565,1,11,2,1,0,53
33163,461565,1,11,3,1,0,54
33164,461565,1,11,4,0,0,54
33165,461565,1,11,5,1,0,55
33166,461565,1,11,6,0,0,55
33167,461565,1,12,1,1,0,56
33168,461565,1,12,2,1,0,57
33169,461565,1,12,3,1,0,58
33170,461565,1,12,4,0,0,58
33171,461565,1,12,5,0,0,58
33172,461565,1,12,6,1,0,59
33173,461565,1,13,1,6,0,65
33174,461565,1,13,2,1,0,66
33175,461565,1,13,3,0,0,66
33176,461565,1,13,4,1,0,67
33177,461565,1,13,5,1,0,68
33178,461565,1,13,6,1,0,69
33179,461565,1,14,1,0,0,69
33180,461565,1,14,2,0,0,69
33181,461565,1,14,3,1,0,70
33182,461565,1,14,4,1,0,71
33183,461565,1,14,5,1,0,72
33184,461565,1,14,6,2,0,74
33185,461565,1,15,1,1,0,75
33186,461565,1,15,2,1,0,76
33187,461565,1,15,3,1,0,77
33188,461565,1,15,4,1,0,78
33189,461565,1,15,5,6,0,84
33190,461565,1,15,6,0,1,84
33191,461565,1,16,1,1,0,85
33192,461565,1,16,2,0,0,85
33193,461565,1,16,3,0,0,85
33194,461565,1,16,4,0,0,85
33195,461565,1,16,5,0,0,85
33196,461565,1,16,6,1,0,86
33197,461565,1,17,1,0,0,86
33198,461565,1,17,2,1,0,87
33199,461565,1,17,3,1,0,88
33200,461565,1,17,4,2,0,90
33201,461565,1,17,5,1,0,91
33202,461565,1,17,6,0,0,91
33203,461565,1,18,1,1,0,92
33204,461565,1,18,2,0,0,92
33205,461565,1,18,3,2,0,94
33206,461565,1,18,4,1,0,95
33207,461565,1,18,5,4,0,99
33208,461565,1,18,6,2,0,101
33209,461565,1,19,1,6,0,107
33210,461565,1,19,2,4,0,111
33211,461565,1,19,3,1,0,112
33212,461565,1,19,4,1,0,113
33213,461565,1,19,5,1,0,114
33214,461565,1,19,6,2,0,116
33215,461565,1,20,1,0,0,116
33216,461565,1,20,2,3,0,119
33217,461565,1,20,3,0,1,119
33218,461565,1,20,4,0,1,119
33219,461565,1,20,5,1,0,120
33220,461565,1,20,6,0,1,120
33333,463141,1,1,1,0,0,0
33334,463141,1,1,2,0,0,0
33335,463141,1,1,3,0,0,0
33336,463141,1,1,4,0,0,0
33337,463141,1,1,5,0,0,0
33338,463141,1,1,6,2,0,2
33339,463141,1,2,1,0,0,2
33340,463141,1,2,2,0,0,2
33341,463141,1,2,3,0,0,2
33342,463141,1,2,4,4,0,6
33343,463141,1,2,5,1,0,7
33344,463141,1,2,6,0,0,7
33345,463141,1,3,1,0,0,7
33346,463141,1,3,2,0,0,7
33347,463141,1,3,3,0,0,7
33348,463141,1,3,4,4,0,11
33349,463141,1,3,5,3,0,14
33350,463141,1,3,6,0,0,14
33351,463141,1,4,1,4,0,18
33352,463141,1,4,2,0,0,18
33353,463141,1,4,3,0,0,18
33354,463141,1,4,4,0,0,18
33355,463141,1,4,5,1,0,19
33356,463141,1,4,6,0,0,19
33357,463141,1,5,1,0,0,19
33358,463141,1,5,2,1,0,20
33359,463141,1,5,3,0,0,20
33360,463141,1,5,4,0,1,20
33361,463141,1,5,5,2,0,22
33362,463141,1,5,6,0,0,22
33363,463141,1,6,1,4,0,26
33364,463141,1,6,2,1,0,27
33365,463141,1,6,3,1,0,28
33366,463141,1,6,4,0,0,28
33367,463141,1,6,5,1,0,29
33368,463141,1,6,6,1,0,30
33369,463141,1,7,1,1,0,31
33370,463141,1,7,2,0,0,31
33371,463141,1,7,3,1,0,32
33372,463141,1,7,4,1,0,33
33373,463141,1,7,5,2,0,35
33374,463141,1,7,6,1,0,36
33375,463141,1,8,1,1,0,37
33376,463141,1,8,2,1,0,38
33377,463141,1,8,3,2,0,40
33378,463141,1,8,4,2,0,42
33379,463141,1,8,5,1,0,43
33380,463141,1,8,6,1,0,44
33381,463141,1,9,1,1,0,45
33382,463141,1,9,2,4,0,49
33383,463141,1,9,3,4,0,53
33384,463141,1,9,4,1,0,54
33385,463141,1,9,5,1,0,55
33386,463141,1,9,6,4,0,59
33387,463141,1,10,1,1,0,60
33388,463141,1,10,2,0,0,60
33389,463141,1,10,3,1,0,61
33390,463141,1,10,4,0,0,61
33391,463141,1,10,5,0,0,61
33392,463141,1,10,6,2,0,63
33393,463141,1,11,1,4,0,67
33394,463141,1,11,2,4,0,71
33395,463141,1,11,3,1,0,72
33396,463141,1,11,4,0,0,72
33397,463141,1,11,5,0,0,72
33398,463141,1,11,6,2,0,74
33399,463141,1,12,1,1,0,75
33400,463141,1,12,2,1,0,76
33401,463141,1,12,3,6,0,82
33402,463141,1,12,4,0,0,82
33403,463141,1,12,5,0,0,82
33404,463141,1,12,6,1,0,83
33405,463141,1,13,1,1,0,84
33406,463141,1,13,2,1,0,85
33407,463141,1,13,3,6,0,91
33408,463141,1,13,4,4,0,95
33409,463141,1,13,5,0,0,95
33410,463141,1,13,6,1,0,96
33411,463141,1,14,1,0,1,96
33412,463141,1,14,2,1,0,97
33413,463141,1,14,3,1,0,98
33414,463141,1,14,4,1,0,99
33415,463141,1,14,5,0,0,99
33416,463141,1,14,6,1,0,100
33417,463141,1,15,1,4,0,104
33418,463141,1,15,2,1,0,105
33419,463141,1,15,3,0,0,105
33420,463141,1,15,4,4,0,109
33421,463141,1,15,5,0,0,109
33422,463141,1,15,6,1,0,110
33423,463141,1,16,1,0,0,110
33424,463141,1,16,2,0,0,110
33425,463141,1,16,3,0,0,110
33426,463141,1,16,4,1,0,111
33427,463141,1,16,5,1,0,112
33428,463141,1,16,6,1,0,113
33429,463141,1,17,1,1,0,114
33430,463141,1,17,2,2,0,116
33431,463141,1,17,3,1,1,117
33432,463141,1,17,4,0,0,117
33433,463141,1,17,5,6,0,123
33434,463141,1,17,6,1,0,124
33435,463141,1,18,1,1,0,125
33436,463141,1,18,2,4,0,129
33437,463141,1,18,3,2,0,131
33438,463141,1,18,4,4,0,135
33439,463141,1,18,5,6,0,141
33440,463141,1,18,6,1,0,142
33441,463141,1,19,1,0,0,142
33442,463141,1,19,2,6,0,148
33443,463141,1,19,3,0,0,148
33444,463141,1,19,4,1,0,149
33445,463141,1,19,5,1,1,150
33446,463141,1,19,6,4,0,154
33447,463141,1,20,1,0,0,154
33448,463141,1,20,2,4,0,158
33449,463141,1,20,3,6,0,164
33450,463141,1,20,4,1,0,165
33451,463141,1,20,5,1,0,166
33452,463141,1,20,6,2,0,168
33548,463142,1,1,1,4,0,4
33549,463142,1,1,2,1,0,5
33550,463142,1,1,3,1,0,6
33551,463142,1,1,4,0,1,6
33552,463142,1,1,5,0,0,6
33553,463142,1,1,6,4,0,10
33554,463142,1,2,1,0,0,10
33555,463142,1,2,2,0,0,10
33556,463142,1,2,3,3,0,13
33557,463142,1,2,4,4,0,17
33558,463142,1,2,5,4,0,21
33559,463142,1,2,6,0,0,21
33560,463142,1,3,1,4,0,25
33561,463142,1,3,2,0,0,25
33562,463142,1,3,3,0,0,25
33563,463142,1,3,4,4,0,29
33564,463142,1,3,5,0,0,29
33565,463142,1,3,6,0,1,29
33566,463142,1,4,1,4,0,33
33567,463142,1,4,2,4,0,37
33568,463142,1,4,3,4,0,41
33569,463142,1,4,4,0,0,41
33570,463142,1,4,5,0,0,41
33571,463142,1,4,6,4,0,45
33572,463142,1,5,1,1,0,46
33573,463142,1,5,2,0,0,46
33574,463142,1,5,3,0,0,46
33575,463142,1,5,4,0,0,46
33576,463142,1,5,5,1,0,47
33577,463142,1,5,6,1,0,48
33578,463142,1,6,1,1,0,49
33579,463142,1,6,2,2,0,51
33580,463142,1,6,3,1,0,52
33581,463142,1,6,4,0,0,52
33582,463142,1,6,5,1,0,53
33583,463142,1,6,6,4,0,57
33584,463142,1,7,1,4,0,61
33585,463142,1,7,2,1,0,62
33586,463142,1,7,3,0,0,62
33587,463142,1,7,4,0,0,62
33588,463142,1,7,5,1,0,63
33589,463142,1,7,6,0,0,63
33590,463142,1,8,1,2,0,65
33591,463142,1,8,2,1,0,66
33592,463142,1,8,3,1,0,67
33593,463142,1,8,4,6,0,73
33594,463142,1,8,5,1,0,74
33595,463142,1,8,6,0,0,74
33596,463142,1,9,1,0,0,74
33597,463142,1,9,2,0,1,74
33598,463142,1,9,3,1,0,75
33599,463142,1,9,4,0,0,75
33600,463142,1,9,5,4,0,79
33601,463142,1,9,6,0,0,79
33602,463142,1,10,1,1,0,80
33603,463142,1,10,2,0,0,80
33604,463142,1,10,3,1,0,81
33605,463142,1,10,4,4,0,85
33606,463142,1,10,5,1,0,86
33607,463142,1,10,6,0,0,86
33608,463142,1,11,1,1,0,87
33609,463142,1,11,2,1,0,88
33610,463142,1,11,3,1,0,89
33611,463142,1,11,4,2,0,91
33612,463142,1,11,5,1,0,92
33613,463142,1,11,6,0,0,92
33614,463142,1,12,1,1,0,93
33615,463142,1,12,2,0,0,93
33616,463142,1,12,3,4,0,97
33617,463142,1,12,4,6,0,103
33618,463142,1,12,5,1,0,104
33619,463142,1,12,6,4,0,108
33620,463142,1,13,1,0,0,108
33621,463142,1,13,2,0,0,108
33622,463142,1,13,3,1,0,109
33623,463142,1,13,4,0,0,109
33624,463142,1,13,5,1,0,110
33625,463142,1,13,6,1,0,111
33626,463142,1,14,1,1,0,112
33627,463142,1,14,2,1,0,113
33628,463142,1,14,3,2,0,115
33629,463142,1,14,4,0,0,115
33630,463142,1,14,5,1,0,116
33631,463142,1,14,6,2,0,118
33632,463142,1,15,1,2,0,120
33633,463142,1,15,2,4,0,124
33634,463142,1,15,3,1,0,125
33635,463142,1,15,4,1,0,126
33636,463142,1,15,5,0,0,126
33637,463142,1,15,6,1,0,127
33638,463142,1,16,1,4,0,131
33639,463142,1,16,2,1,0,132
33640,463142,1,16,3,1,0,133
33641,463142,1,16,4,1,0,134
33642,463142,1,16,5,6,0,140
33643,463142,1,16,6,1,0,141
33644,463142,1,17,1,2,0,143
33645,463142,1,17,2,0,1,143
33646,463142,1,17,3,1,0,144
33647,463142,1,17,4,0,0,144
33648,463142,1,17,5,6,0,150
33649,463142,1,17,6,0,0,150
33650,463142,1,18,1,0,1,150
33651,463142,1,18,2,4,0,154
33652,463142,1,18,3,2,0,156
33653,463142,1,18,4,0,0,156
33654,463142,1,18,5,0,0,156
33655,463142,1,18,6,5,0,161
33656,463142,1,19,1,1,0,162
33657,463142,1,19,2,4,0,166
33658,463142,1,19,3,2,0,168
33659,463142,1,19,4,2,0,170
33660,463142,1,19,5,1,0,171
33661,463142,1,19,6,0,1,171
33662,463142,1,20,1,4,0,175
33663,463142,1,20,2,6,0,181
33664,463142,1,20,3,2,0,183
33665,463142,1,20,4,1,0,184
33666,463142,1,20,5,6,0,190
33667,463142,1,20,6,4,0,194
33788,463149,1,1,1,1,0,1
33789,463149,1,1,2,0,0,1
33790,463149,1,1,3,0,0,1
33791,463149,1,1,4,4,0,5
33792,463149,1,1,5,5,0,10
33793,463149,1,1,6,1,0,11
33794,463149,1,2,1,0,0,11
33795,463149,1,2,2,0,0,11
33796,463149,1,2,3,4,0,15
33797,463149,1,2,4,0,0,15
33798,463149,1,2,5,1,0,16
33799,463149,1,2,6,1,0,17
33800,463149,1,3,1,0,0,17
33801,463149,1,3,2,1,0,18
33802,463149,1,3,3,0,0,18
33803,463149,1,3,4,0,1,18
33804,463149,1,3,5,4,0,22
33805,463149,1,3,6,0,0,22
33806,463149,1,4,1,0,0,22
33807,463149,1,4,2,0,0,22
33808,463149,1,4,3,1,0,23
33809,463149,1,4,4,4,0,27
33810,463149,1,4,5,1,0,28
33811,463149,1,4,6,1,0,29
33812,463149,1,5,1,4,0,33
33813,463149,1,5,2,1,0,34
33814,463149,1,5,3,4,0,38
33815,463149,1,5,4,4,0,42
33816,463149,1,5,5,1,0,43
33817,463149,1,5,6,6,0,49
33818,463149,1,6,1,1,0,50
33819,463149,1,6,2,0,0,50
33820,463149,1,6,3,4,0,54
33821,463149,1,6,4,1,0,55
33822,463149,1,6,5,1,0,56
33823,463149,1,6,6,1,0,57
33824,463149,1,7,1,1,0,58
33825,463149,1,7,2,1,0,59
33826,463149,1,7,3,2,0,61
33827,463149,1,7,4,1,0,62
33828,463149,1,7,5,0,0,62
33829,463149,1,7,6,1,0,63
33830,463149,1,8,1,0,0,63
33831,463149,1,8,2,4,0,67
33832,463149,1,8,3,0,1,67
33833,463149,1,8,4,1,0,68
33834,463149,1,8,5,1,0,69
33835,463149,1,8,6,0,0,69
33836,463149,1,9,1,1,0,70
33837,463149,1,9,2,1,0,71
33838,463149,1,9,3,1,0,72
33839,463149,1,9,4,1,0,73
33840,463149,1,9,5,1,0,74
33841,463149,1,9,6,4,0,78
33842,463149,1,10,1,0,0,78
33843,463149,1,10,2,1,0,79
33844,463149,1,10,3,0,0,79
33845,463149,1,10,4,1,0,80
33846,463149,1,10,5,0,0,80
33847,463149,1,10,6,1,0,81
33848,463149,1,11,1,1,0,82
33849,463149,1,11,2,1,0,83
33850,463149,1,11,3,2,0,85
33851,463149,1,11,4,0,0,85
33852,463149,1,11,5,1,0,86
33853,463149,1,11,6,0,0,86
33854,463149,1,12,1,0,0,86
33855,463149,1,12,2,1,0,87
33856,463149,1,12,3,1,0,88
33857,463149,1,12,4,4,0,92
33858,463149,1,12,5,4,0,96
33859,463149,1,12,6,6,0,102
33860,463149,1,13,1,1,0,103
33861,463149,1,13,2,4,0,107
33862,463149,1,13,3,1,0,108
33863,463149,1,13,4,1,0,109
33864,463149,1,13,5,0,1,109
33865,463149,1,13,6,0,0,109
33866,463149,1,14,1,0,0,109
33867,463149,1,14,2,2,1,111
33868,463149,1,14,3,1,0,112
33869,463149,1,14,4,1,0,113
33870,463149,1,14,5,1,0,114
33871,463149,1,14,6,0,0,114
33872,463149,1,15,1,4,0,118
33873,463149,1,15,2,1,0,119
33874,463149,1,15,3,1,0,120
33875,463149,1,15,4,1,0,121
33876,463149,1,15,5,1,0,122
33877,463149,1,15,6,1,0,123
33878,463149,1,16,1,0,0,123
33879,463149,1,16,2,4,0,127
33880,463149,1,16,3,6,0,133
33881,463149,1,16,4,1,0,134
33882,463149,1,16,5,2,0,136
33883,463149,1,16,6,0,1,136
33884,463149,1,17,1,1,0,137
33885,463149,1,17,2,2,0,139
33886,463149,1,17,3,0,0,139
33887,463149,1,17,4,1,0,140
33888,463149,1,17,5,1,0,141
33889,463149,1,17,6,1,0,142
33890,463149,1,18,1,1,0,143
33891,463149,1,18,2,1,0,144
33892,463149,1,18,3,1,0,145
33893,463149,1,18,4,0,0,145
33894,463149,1,18,5,6,0,151
33895,463149,1,18,6,2,0,153
33896,463149,1,19,1,1,0,154
33897,463149,1,19,2,0,0,154
33898,463149,1,19,3,1,0,155
33899,463149,1,19,4,1,0,156
33900,463149,1,19,5,1,0,157
33901,463149,1,19,6,0,0,157
33902,463149,1,20,1,2,0,159
33903,463149,1,20,2,1,0,160
33904,463149,1,20,3,6,0,166
33905,463149,1,20,4,1,0,167
33906,463149,1,20,5,1,0,168
33907,463149,1,20,6,0,1,168
34028,473918,1,1,1,4,0,4
34029,473918,1,1,2,0,0,4
34030,473918,1,1,3,1,0,5
34031,473918,1,1,4,0,0,5
34032,473918,1,1,5,1,0,6
34033,473918,1,1,6,1,0,7
34034,473918,1,2,1,0,0,7
34035,473918,1,2,2,0,0,7
34036,473918,1,2,3,6,0,13
34037,473918,1,2,4,6,0,19
34038,473918,1,2,5,0,0,19
34039,473918,1,2,6,2,0,21
34040,473918,1,3,1,4,0,25
34041,473918,1,3,2,1,0,26
34042,473918,1,3,3,4,0,30
34043,473918,1,3,4,1,0,31
34044,473918,1,3,5,0,0,31
34045,473918,1,3,6,1,0,32
34046,473918,1,4,1,0,0,32
34047,473918,1,4,2,4,0,36
34048,473918,1,4,3,0,0,36
34049,473918,1,4,4,0,0,36
34050,473918,1,4,5,1,0,37
34051,473918,1,4,6,0,1,37
34052,473918,1,5,1,0,0,37
34053,473918,1,5,2,4,0,41
34054,473918,1,5,3,4,0,45
34055,473918,1,5,4,6,0,51
34056,473918,1,5,5,0,0,51
34057,473918,1,5,6,0,0,51
34058,473918,1,6,1,0,0,51
34059,473918,1,6,2,2,0,53
34060,473918,1,6,3,0,0,53
34061,473918,1,6,4,4,0,57
34062,473918,1,6,5,1,0,58
34063,473918,1,6,6,0,1,58
34064,473918,1,7,1,1,0,59
34065,473918,1,7,2,0,0,59
34066,473918,1,7,3,1,0,60
34067,473918,1,7,4,1,0,61
34068,473918,1,7,5,1,0,62
34069,473918,1,7,6,0,0,62
34070,473918,1,8,1,0,0,62
34071,473918,1,8,2,0,1,62
34072,473918,1,8,3,0,1,62
34073,473918,1,8,4,0,1,62
34074,473918,1,8,5,0,0,62
34075,473918,1,8,6,0,0,62
34076,473918,1,9,1,0,0,62
34077,473918,1,9,2,0,0,62
34078,473918,1,9,3,0,0,62
34079,473918,1,9,4,4,0,66
34080,473918,1,9,5,1,0,67
34081,473918,1,9,6,1,0,68
34082,473918,1,10,1,0,0,68
34083,473918,1,10,2,0,1,68
34084,473918,1,10,3,0,0,68
34085,473918,1,10,4,1,0,69
34086,473918,1,10,5,1,0,70
34087,473918,1,10,6,0,0,70
34088,473918,1,11,1,1,0,71
34089,473918,1,11,2,1,0,72
34090,473918,1,11,3,0,0,72
34091,473918,1,11,4,1,0,73
34092,473918,1,11,5,1,0,74
34093,473918,1,11,6,1,0,75
34094,473918,1,12,1,1,0,76
34095,473918,1,12,2,0,0,76
34096,473918,1,12,3,4,0,80
34097,473918,1,12,4,0,0,80
34098,473918,1,12,5,4,0,84
34099,473918,1,12,6,0,0,84
34100,473918,1,13,1,0,1,84
34101,473918,1,13,2,0,0,84
34102,473918,1,13,3,0,0,84
34103,473918,1,13,4,1,0,85
34104,473918,1,13,5,1,0,86
34105,473918,1,13,6,1,0,87
34106,473918,1,14,1,1,0,88
34107,473918,1,14,2,1,0,89
34108,473918,1,14,3,1,0,90
34109,473918,1,14,4,0,0,90
34110,473918,1,14,5,0,0,90
34111,473918,1,14,6,4,0,94
34112,473918,1,15,1,0,0,94
34113,473918,1,15,2,0,0,94
34114,473918,1,15,3,0,0,94
34115,473918,1,15,4,1,0,95
34116,473918,1,15,5,1,0,96
34117,473918,1,15,6,0,0,96
34118,473918,1,16,1,0,0,96
34119,473918,1,16,2,1,0,97
34120,473918,1,16,3,1,0,98
34121,473918,1,16,4,1,0,99
34122,473918,1,16,5,1,0,100
34123,473918,1,16,6,1,0,101
34124,473918,1,17,1,2,0,103
34125,473918,1,17,2,0,0,103
34126,473918,1,17,3,0,0,103
34127,473918,1,17,4,0,0,103
34128,473918,1,17,5,6,0,109
34129,473918,1,17,6,1,0,110
34130,473918,1,18,1,0,1,110
34131,473918,1,18,2,1,0,111
34132,473918,1,18,3,0,0,111
34133,473918,1,18,4,0,0,111
34134,473918,1,18,5,1,0,112
34135,473918,1,18,6,0,1,112
34136,473918,1,19,1,6,0,118
34137,473918,1,19,2,1,0,119
34138,473918,1,19,3,0,0,119
34139,473918,1,19,4,0,0,119
34140,473918,1,19,5,6,0,125
34141,473918,1,19,6,2,0,127
34142,473918,1,20,1,0,0,127
34143,473918,1,20,2,6,0,133
34144,473918,1,20,3,0,0,133
34145,473918,1,20,4,2,0,135
34146,473918,1,20,5,4,0,139
34147,473918,1,20,6,4,0,143
34251,473919,1,1,1,0,1,0
34252,473919,1,1,2,0,0,0
34253,473919,1,1,3,0,0,0
34254,473919,1,1,4,0,0,0
34255,473919,1,1,5,0,0,0
34256,473919,1,1,6,1,0,1
34257,473919,1,2,1,2,0,3
34258,473919,1,2,2,0,0,3
34259,473919,1,2,3,0,0,3
34260,473919,1,2,4,1,0,4
34261,473919,1,2,5,1,0,5
34262,473919,1,2,6,0,0,5
34263,473919,1,3,1,1,0,6
34264,473919,1,3,2,0,0,6
34265,473919,1,3,3,6,0,12
34266,473919,1,3,4,0,0,12
34267,473919,1,3,5,4,0,16
34268,473919,1,3,6,4,0,20
34269,473919,1,4,1,0,0,20
34270,473919,1,4,2,2,0,22
34271,473919,1,4,3,6,0,28
34272,473919,1,4,4,5,0,33
34273,473919,1,4,5,0,0,33
34274,473919,1,4,6,1,0,34
34275,473919,1,5,1,0,0,34
34276,473919,1,5,2,0,0,34
34277,473919,1,5,3,1,0,35
34278,473919,1,5,4,4,0,39
34279,473919,1,5,5,1,0,40
34280,473919,1,5,6,1,0,41
34281,473919,1,6,1,2,0,43
34282,473919,1,6,2,0,0,43
34283,473919,1,6,3,0,0,43
34284,473919,1,6,4,1,0,44
34285,473919,1,6,5,2,0,46
34286,473919,1,6,6,6,0,52
34287,473919,1,7,1,0,0,52
34288,473919,1,7,2,0,0,52
34289,473919,1,7,3,1,0,53
34290,473919,1,7,4,1,0,54
34291,473919,1,7,5,0,0,54
34292,473919,1,7,6,0,0,54
34293,473919,1,8,1,0,0,54
34294,473919,1,8,2,1,0,55
34295,473919,1,8,3,1,0,56
34296,473919,1,8,4,4,0,60
34297,473919,1,8,5,0,0,60
34298,473919,1,8,6,1,0,61
34299,473919,1,9,1,2,0,63
34300,473919,1,9,2,1,0,64
34301,473919,1,9,3,1,0,65
34302,473919,1,9,4,2,0,67
34303,473919,1,9,5,1,0,68
34304,473919,1,9,6,4,0,72
34305,473919,1,10,1,2,0,74
34306,473919,1,10,2,1,0,75
34307,473919,1,10,3,2,0,77
34308,473919,1,10,4,0,0,77
34309,473919,1,10,5,0,0,77
34310,473919,1,10,6,6,0,83
34311,473919,1,11,1,0,0,83
34312,473919,1,11,2,1,0,84
34313,473919,1,11,3,1,0,85
34314,473919,1,11,4,0,0,85
34315,473919,1,11,5,4,0,89
34316,473919,1,11,6,1,0,90
34317,473919,1,12,1,1,0,91
34318,473919,1,12,2,0,1,91
34319,473919,1,12,3,1,0,92
34320,473919,1,12,4,0,0,92
34321,473919,1,12,5,1,0,93
34322,473919,1,12,6,1,0,94
34323,473919,1,13,1,0,1,94
34324,473919,1,13,2,0,0,94
34325,473919,1,13,3,0,0,94
34326,473919,1,13,4,1,0,95
34327,473919,1,13,5,0,0,95
34328,473919,1,13,6,1,0,96
34329,473919,1,14,1,1,0,97
34330,473919,1,14,2,1,0,98
34331,473919,1,14,3,1,0,99
34332,473919,1,14,4,1,0,100
34333,473919,1,14,5,0,0,100
34334,473919,1,14,6,1,0,101
34335,473919,1,15,1,1,0,102
34336,473919,1,15,2,4,0,106
34337,473919,1,15,3,0,0,106
34338,473919,1,15,4,6,0,112
34339,473919,1,15,5,4,0,116
34340,473919,1,15,6,1,0,117
34341,473919,1,16,1,6,0,123
34342,473919,1,16,2,6,0,129
34343,473919,1,16,3,4,0,133
34344,473919,1,16,4,0,1,133
34345,473919,1,16,5,2,0,135
34346,473919,1,16,6,1,0,136
34347,473919,1,17,1,0,0,136
34348,473919,1,17,2,6,0,142
34349,473919,1,17,3,4,0,146
34350,473919,1,17,4,1,0,147
34351,473919,1,17,5,0,0,147
34352,473919,1,17,6,1,0,148
34353,473919,1,18,1,4,0,152
34354,473919,1,18,2,4,0,156
34355,473919,1,18,3,4,0,160
34356,473919,1,18,4,6,0,166
34357,473919,1,18,5,6,0,172
34358,473919,1,18,6,1,0,173
34359,473919,1,19,1,1,0,174
34360,473919,1,19,2,1,0,175
34361,473919,1,19,3,0,1,175
34362,473919,1,19,4,0,0,175
34363,473919,1,19,5,1,0,176
34364,473919,1,19,6,1,0,177
34365,473919,1,20,1,6,0,183
34366,473919,1,20,2,1,0,184
34367,473919,1,20,3,0,1,184
34368,473919,1,20,4,0,0,184
34369,473919,1,20,5,1,0,185
34370,473919,1,20,6,0,1,185
34491,473920,1,1,1,4,0,4
34492,473920,1,1,2,0,0,4
34493,473920,1,1,3,0,0,4
34494,473920,1,1,4,0,0,4
34495,473920,1,1,5,0,0,4
34496,473920,1,1,6,1,0,5
34497,473920,1,2,1,0,0,5
34498,473920,1,2,2,0,0,5
34499,473920,1,2,3,0,0,5
34500,473920,1,2,4,4,0,9
34501,473920,1,2,5,0,0,9
34502,473920,1,2,6,4,0,13
34503,473920,1,3,1,1,0,14
34504,473920,1,3,2,0,0,14
34505,473920,1,3,3,4,0,18
34506,473920,1,3,4,4,0,22
34507,473920,1,3,5,4,0,26
34508,473920,1,3,6,2,0,28
34509,473920,1,4,1,4,0,32
34510,473920,1,4,2,1,0,33
34511,473920,1,4,3,1,0,34
34512,473920,1,4,4,0,0,34
34513,473920,1,4,5,0,0,34
34514,473920,1,4,6,0,0,34
34515,473920,1,5,1,4,0,38
34516,473920,1,5,2,4,0,42
34517,473920,1,5,3,4,0,46
34518,473920,1,5,4,1,0,47
34519,473920,1,5,5,4,0,51
34520,473920,1,5,6,0,0,51
34521,473920,1,6,1,1,0,52
34522,473920,1,6,2,4,0,56
34523,473920,1,6,3,4,0,60
34524,473920,1,6,4,4,0,64
34525,473920,1,6,5,0,0,64
34526,473920,1,6,6,0,0,64
34527,473920,1,7,1,1,0,65
34528,473920,1,7,2,1,0,66
34529,473920,1,7,3,1,0,67
34530,473920,1,7,4,6,0,73
34531,473920,1,7,5,2,0,75
34532,473920,1,7,6,1,0,76
34533,473920,1,8,1,1,0,77
34534,473920,1,8,2,0,0,77
34535,473920,1,8,3,1,0,78
34536,473920,1,8,4,1,0,79
34537,473920,1,8,5,1,0,80
34538,473920,1,8,6,0,0,80
34539,473920,1,9,1,1,0,81
34540,473920,1,9,2,0,0,81
34541,473920,1,9,3,0,0,81
34542,473920,1,9,4,0,1,81
34543,473920,1,9,5,0,0,81
34544,473920,1,9,6,1,0,82
34545,473920,1,10,1,0,0,82
34546,473920,1,10,2,1,0,83
34547,473920,1,10,3,2,0,85
34548,473920,1,10,4,0,0,85
34549,473920,1,10,5,1,0,86
34550,473920,1,10,6,0,0,86
34551,473920,1,11,1,4,0,90
34552,473920,1,11,2,0,1,90
34553,473920,1,11,3,0,0,90
34554,473920,1,11,4,1,0,91
34555,473920,1,11,5,1,0,92
34556,473920,1,11,6,0,0,92
34557,473920,1,12,1,0,0,92
34558,473920,1,12,2,1,0,93
34559,473920,1,12,3,1,0,94
34560,473920,1,12,4,1,0,95
34561,473920,1,12,5,1,0,96
34562,473920,1,12,6,0,0,96
34563,473920,1,13,1,1,0,97
34564,473920,1,13,2,1,0,98
34565,473920,1,13,3,0,0,98
34566,473920,1,13,4,1,0,99
34567,473920,1,13,5,1,0,100
34568,473920,1,13,6,0,1,100
34569,473920,1,14,1,0,0,100
34570,473920,1,14,2,1,0,101
34571,473920,1,14,3,4,0,105
34572,473920,1,14,4,1,0,106
34573,473920,1,14,5,0,1,106
34574,473920,1,14,6,1,0,107
34575,473920,1,15,1,6,0,113
34576,473920,1,15,2,0,0,113
34577,473920,1,15,3,2,0,115
34578,473920,1,15,4,1,0,116
34579,473920,1,15,5,1,0,117
34580,473920,1,15,6,0,0,117
34581,473920,1,16,1,4,0,121
34582,473920,1,16,2,1,0,122
34583,473920,1,16,3,1,0,123
34584,473920,1,16,4,1,0,124
34585,473920,1,16,5,1,0,125
34586,473920,1,16,6,6,0,131
34587,473920,1,17,1,1,0,132
34588,473920,1,17,2,1,0,133
34589,473920,1,17,3,2,0,135
34590,473920,1,17,4,0,0,135
34591,473920,1,17,5,1,0,136
34592,473920,1,17,6,0,1,136
34593,473920,1,18,1,4,0,140
34594,473920,1,18,2,1,0,141
34595,473920,1,18,3,1,0,142
34596,473920,1,18,4,1,0,143
34597,473920,1,18,5,1,0,144
34598,473920,1,18,6,1,0,145
34599,473920,1,19,1,4,0,149
34600,473920,1,19,2,1,0,150
34601,473920,1,19,3,2,0,152
34602,473920,1,19,4,6,0,158
34603,473920,1,19,5,0,0,158
34604,473920,1,19,6,6,0,164
34605,473920,1,20,1,0,1,164
34606,473920,1,20,2,4,0,168
34607,473920,1,20,3,6,0,174
34608,473920,1,20,4,4,0,178
34609,473920,1,20,5,4,0,182
34610,473920,1,20,6,1,0,183
34706,474466,1,1,1,0,0,0
34707,474466,1,1,2,1,0,1
34708,474466,1,1,3,0,0,1
34709,474466,1,1,4,0,0,1
34710,474466,1,1,5,1,0,2
34711,474466,1,1,6,1,0,3
34712,474466,1,2,1,0,0,3
34713,474466,1,2,2,0,0,3
34714,474466,1,2,3,0,1,3
34715,474466,1,2,4,1,0,4
34716,474466,1,2,5,1,0,5
34717,474466,1,2,6,1,0,6
34718,474466,1,3,1,1,0,7
34719,474466,1,3,2,4,0,11
34720,474466,1,3,3,1,0,12
34721,474466,1,3,4,0,1,12
34722,474466,1,3,5,0,0,12
34723,474466,1,3,6,0,0,12
34724,474466,1,4,1,1,0,13
34725,474466,1,4,2,6,0,19
34726,474466,1,4,3,4,0,23
34727,474466,1,4,4,0,0,23
34728,474466,1,4,5,1,0,24
34729,474466,1,4,6,0,0,24
34730,474466,1,5,1,4,0,28
34731,474466,1,5,2,1,0,29
34732,474466,1,5,3,1,0,30
34733,474466,1,5,4,0,0,30
34734,474466,1,5,5,0,0,30
34735,474466,1,5,6,0,0,30
34736,474466,1,6,1,0,0,30
34737,474466,1,6,2,2,0,32
34738,474466,1,6,3,1,0,33
34739,474466,1,6,4,0,0,33
34740,474466,1,6,5,0,0,33
34741,474466,1,6,6,0,0,33
34742,474466,1,7,1,1,0,34
34743,474466,1,7,2,1,0,35
34744,474466,1,7,3,4,0,39
34745,474466,1,7,4,4,0,43
34746,474466,1,7,5,1,0,44
34747,474466,1,7,6,0,0,44
34748,474466,1,8,1,1,0,45
34749,474466,1,8,2,1,0,46
34750,474466,1,8,3,1,0,47
34751,474466,1,8,4,0,0,47
34752,474466,1,8,5,6,0,53
34753,474466,1,8,6,0,0,53
34754,474466,1,9,1,0,0,53
34755,474466,1,9,2,1,0,54
34756,474466,1,9,3,0,0,54
34757,474466,1,9,4,1,0,55
34758,474466,1,9,5,4,0,59
34759,474466,1,9,6,1,0,60
34760,474466,1,10,1,2,0,62
34761,474466,1,10,2,1,0,63
34762,474466,1,10,3,1,0,64
34763,474466,1,10,4,1,0,65
34764,474466,1,10,5,1,0,66
34765,474466,1,10,6,1,0,67
34766,474466,1,11,1,1,0,68
34767,474466,1,11,2,8,0,76
34768,474466,1,11,3,6,0,82
34769,474466,1,11,4,1,0,83
34770,474466,1,11,5,2,0,85
34771,474466,1,11,6,6,0,91
34772,474466,1,12,1,4,0,95
34773,474466,1,12,2,0,0,95
34774,474466,1,12,3,0,1,95
34775,474466,1,12,4,1,0,96
34776,474466,1,12,5,0,0,96
34777,474466,1,12,6,1,0,97
34778,474466,1,13,1,0,0,97
34779,474466,1,13,2,0,0,97
34780,474466,1,13,3,1,0,98
34781,474466,1,13,4,3,0,101
34782,474466,1,13,5,0,1,101
34783,474466,1,13,6,0,0,101
34784,474466,1,14,1,0,0,101
34785,474466,1,14,2,1,0,102
34786,474466,1,14,3,0,0,102
34787,474466,1,14,4,0,1,102
34788,474466,1,14,5,1,0,103
34789,474466,1,14,6,1,0,104
34790,474466,1,15,1,1,0,105
34791,474466,1,15,2,1,0,106
34792,474466,1,15,3,1,0,107
34793,474466,1,15,4,1,0,108
34794,474466,1,15,5,0,0,108
34795,474466,1,15,6,1,0,109
34796,474466,1,16,1,1,0,110
34797,474466,1,16,2,0,0,110
34798,474466,1,16,3,2,0,112
34799,474466,1,16,4,1,0,113
34800,474466,1,16,5,1,0,114
34801,474466,1,16,6,0,0,114
34802,474466,1,17,1,1,0,115
34803,474466,1,17,2,1,0,116
34804,474466,1,17,3,1,0,117
34805,474466,1,17,4,1,0,118
34806,474466,1,17,5,1,0,119
34807,474466,1,17,6,0,0,119
34808,474466,1,18,1,0,0,119
34809,474466,1,18,2,2,0,121
34810,474466,1,18,3,4,0,125
34811,474466,1,18,4,0,1,125
34812,474466,1,18,5,2,0,127
34813,474466,1,18,6,1,0,128
34814,474466,1,19,1,0,0,128
34815,474466,1,19,2,1,0,129
34816,474466,1,19,3,1,0,130
34817,474466,1,19,4,1,0,131
34818,474466,1,19,5,0,1,131
34819,474466,1,19,6,1,0,132
34820,474466,1,20,1,1,0,133
34821,474466,1,20,2,1,0,134
34822,474466,1,20,3,1,0,135
34823,474466,1,20,4,1,0,136
34824,474466,1,20,5,0,1,136
34825,474466,1,20,6,0,1,136
34930,474476,1,1,1,5,0,5
34931,474476,1,1,2,0,0,5
34932,474476,1,1,3,0,0,5
34933,474476,1,1,4,0,0,5
34934,474476,1,1,5,1,0,6
34935,474476,1,1,6,1,0,7
34936,474476,1,2,1,0,0,7
34937,474476,1,2,2,4,0,11
34938,474476,1,2,3,1,0,12
34939,474476,1,2,4,1,0,13
34940,474476,1,2,5,1,0,14
34941,474476,1,2,6,0,0,14
34942,474476,1,3,1,0,0,14
34943,474476,1,3,2,4,0,18
34944,474476,1,3,3,1,0,19
34945,474476,1,3,4,4,0,23
34946,474476,1,3,5,0,0,23
34947,474476,1,3,6,0,0,23
34948,474476,1,4,1,2,0,25
34949,474476,1,4,2,4,0,29
34950,474476,1,4,3,0,0,29
34951,474476,1,4,4,4,0,33
34952,474476,1,4,5,1,0,34
34953,474476,1,4,6,0,0,34
34954,474476,1,5,1,4,0,38
34955,474476,1,5,2,0,0,38
34956,474476,1,5,3,1,0,39
34957,474476,1,5,4,0,1,39
34958,474476,1,5,5,0,0,39
34959,474476,1,5,6,1,0,40
34960,474476,1,6,1,0,0,40
34961,474476,1,6,2,0,0,40
34962,474476,1,6,3,1,0,41
34963,474476,1,6,4,0,0,41
34964,474476,1,6,5,4,0,45
34965,474476,1,6,6,4,0,49
34966,474476,1,7,1,0,0,49
34967,474476,1,7,2,1,0,50
34968,474476,1,7,3,1,0,51
34969,474476,1,7,4,1,0,52
34970,474476,1,7,5,2,0,54
34971,474476,1,7,6,1,0,55
34972,474476,1,8,1,1,0,56
34973,474476,1,8,2,1,0,57
34974,474476,1,8,3,4,0,61
34975,474476,1,8,4,2,0,63
34976,474476,1,8,5,1,0,64
34977,474476,1,8,6,1,0,65
34978,474476,1,9,1,1,0,66
34979,474476,1,9,2,0,0,66
34980,474476,1,9,3,1,0,67
34981,474476,1,9,4,1,0,68
34982,474476,1,9,5,2,0,70
34983,474476,1,9,6,1,0,71
34984,474476,1,10,1,2,0,73
34985,474476,1,10,2,1,0,74
34986,474476,1,10,3,1,0,75
34987,474476,1,10,4,2,0,77
34988,474476,1,10,5,1,0,78
34989,474476,1,10,6,1,0,79
34990,474476,1,11,1,1,0,80
34991,474476,1,11,2,1,0,81
34992,474476,1,11,3,2,0,83
34993,474476,1,11,4,6,0,89
34994,474476,1,11,5,6,0,95
34995,474476,1,11,6,6,0,101
34996,474476,1,12,1,2,0,103
34997,474476,1,12,2,1,0,104
34998,474476,1,12,3,0,0,104
34999,474476,1,12,4,0,1,104
35000,474476,1,12,5,0,0,104
35001,474476,1,12,6,1,0,105
35002,474476,1,13,1,1,0,106
35003,474476,1,13,2,0,0,106
35004,474476,1,13,3,0,1,106
35005,474476,1,13,4,2,0,108
35006,474476,1,13,5,0,1,108
35007,474476,1,13,6,2,0,110
35008,474476,1,14,1,4,0,114
35009,474476,1,14,2,1,0,115
35010,474476,1,14,3,1,0,116
35011,474476,1,14,4,1,0,117
35012,474476,1,14,5,0,0,117
35013,474476,1,14,6,0,1,117
35014,474476,1,15,1,6,0,123
35015,474476,1,15,2,0,0,123
35016,474476,1,15,3,0,0,123
35017,474476,1,15,4,4,0,127
35018,474476,1,15,5,2,0,129
35019,474476,1,15,6,0,0,129
35020,474476,1,16,1,0,0,129
35021,474476,1,16,2,1,0,130
35022,474476,1,16,3,0,0,130
35023,474476,1,16,4,0,0,130
35024,474476,1,16,5,1,0,131
35025,474476,1,16,6,1,0,132
35026,474476,1,17,1,1,0,133
35027,474476,1,17,2,1,0,134
35028,474476,1,17,3,6,0,140
35029,474476,1,17,4,6,0,146
35030,474476,1,17,5,1,0,147
35031,474476,1,17,6,2,0,149
35032,474476,1,18,1,4,0,153
35033,474476,1,18,2,1,0,154
35034,474476,1,18,3,4,0,158
35035,474476,1,18,4,0,1,158
35036,474476,1,18,5,4,0,162
35037,474476,1,18,6,0,1,162
35038,474476,1,19,1,0,1,162
35039,474476,1,19,2,0,0,162
35040,474476,1,19,3,1,0,163
35041,474476,1,19,4,0,0,163
35042,474476,1,19,5,0,0,163
35043,474476,1,19,6,1,0,164
35044,474476,1,20,1,1,0,165
35045,474476,1,20,2,0,0,165
35046,474476,1,20,3,0,1,165
35047,474476,1,20,4,0,1,165
35165,478279,1,1,1,1,0,1
35166,478279,1,1,2,0,0,1
35167,478279,1,1,3,6,0,7
35168,478279,1,1,4,4,0,11
35169,478279,1,1,5,0,0,11
35170,478279,1,1,6,3,0,14
35171,478279,1,2,1,0,0,14
35172,478279,1,2,2,1,0,15
35173,478279,1,2,3,0,0,15
35174,478279,1,2,4,0,0,15
35175,478279,1,2,5,1,0,16
35176,478279,1,2,6,0,1,16
35177,478279,1,3,1,0,0,16
35178,478279,1,3,2,7,0,23
35179,478279,1,3,3,0,0,23
35180,478279,1,3,4,0,0,23
35181,478279,1,3,5,4,0,27
35182,478279,1,3,6,0,0,27
35183,478279,1,4,1,1,0,28
35184,478279,1,4,2,1,0,29
35185,478279,1,4,3,1,0,30
35186,478279,1,4,4,1,0,31
35187,478279,1,4,5,1,0,32
35188,478279,1,4,6,2,0,34
35189,478279,1,5,1,0,0,34
35190,478279,1,5,2,4,0,38
35191,478279,1,5,3,0,0,38
35192,478279,1,5,4,0,0,38
35193,478279,1,5,5,0,0,38
35194,478279,1,5,6,0,0,38
35195,478279,1,6,1,0,1,38
35196,478279,1,6,2,0,0,38
35197,478279,1,6,3,1,0,39
35198,478279,1,6,4,0,0,39
35199,478279,1,6,5,0,0,39
35200,478279,1,6,6,4,0,43
35201,478279,1,7,1,1,0,44
35202,478279,1,7,2,0,0,44
35203,478279,1,7,3,0,0,44
35204,478279,1,7,4,0,0,44
35205,478279,1,7,5,2,0,46
35206,478279,1,7,6,0,0,46
35207,478279,1,8,1,0,0,46
35208,478279,1,8,2,0,1,46
35209,478279,1,8,3,0,0,46
35210,478279,1,8,4,0,0,46
35211,478279,1,8,5,1,0,47
35212,478279,1,8,6,6,0,53
35213,478279,1,9,1,1,0,54
35214,478279,1,9,2,2,0,56
35215,478279,1,9,3,4,0,60
35216,478279,1,9,4,1,0,61
35217,478279,1,9,5,0,0,61
35218,478279,1,9,6,1,0,62
35219,478279,1,10,1,1,0,63
35220,478279,1,10,2,6,0,69
35221,478279,1,10,3,6,0,75
35222,478279,1,10,4,0,1,75
35223,478279,1,10,5,1,0,76
35224,478279,1,10,6,1,0,77
35225,478279,1,11,1,0,0,77
35226,478279,1,11,2,1,0,78
35227,478279,1,11,3,0,0,78
35228,478279,1,11,4,0,0,78
35229,478279,1,11,5,1,0,79
35230,478279,1,11,6,1,0,80
35231,478279,1,12,1,0,0,80
35232,478279,1,12,2,0,0,80
35233,478279,1,12,3,0,0,80
35234,478279,1,12,4,0,0,80
35235,478279,1,12,5,1,0,81
35236,478279,1,12,6,2,0,83
35237,478279,1,13,1,0,0,83
35238,478279,1,13,2,0,0,83
35239,478279,1,13,3,1,0,84
35240,478279,1,13,4,0,1,84
35241,478279,1,13,5,0,0,84
35242,478279,1,13,6,1,0,85
35243,478279,1,14,1,2,0,87
35244,478279,1,14,2,0,0,87
35245,478279,1,14,3,1,0,88
35246,478279,1,14,4,2,0,90
35247,478279,1,14,5,0,1,90
35248,478279,1,14,6,1,0,91
35249,478279,1,15,1,0,0,91
35250,478279,1,15,2,0,0,91
35251,478279,1,15,3,0,1,91
35252,478279,1,15,4,0,0,91
35253,478279,1,15,5,0,0,91
35254,478279,1,15,6,0,0,91
35255,478279,1,16,1,1,0,92
35256,478279,1,16,2,0,0,92
35257,478279,1,16,3,0,1,92
35258,478279,1,16,4,1,0,93
35259,478279,1,16,5,0,0,93
35260,478279,1,16,6,1,0,94
35261,478279,1,17,1,1,0,95
35262,478279,1,17,2,0,0,95
35263,478279,1,17,3,0,0,95
35264,478279,1,17,4,1,0,96
35265,478279,1,17,5,0,0,96
35266,478279,1,17,6,1,0,97
35267,478279,1,18,1,1,0,98
35268,478279,1,18,2,1,0,99
35269,478279,1,18,3,0,1,99
35270,478279,1,18,4,3,0,102
35271,478279,1,18,5,1,0,103
35272,478279,1,18,6,0,0,103
35273,478279,1,19,1,0,0,103
35274,478279,1,19,2,0,0,103
35275,478279,1,19,3,0,0,103
35276,478279,1,19,4,4,0,107
35277,478279,1,19,5,4,0,111
35278,478279,1,19,6,1,0,112
35279,478279,1,20,1,0,0,112
35280,478279,1,20,2,0,0,112
35281,478279,1,20,3,0,0,112
35282,478279,1,20,4,6,0,118
35283,478279,1,20,5,1,1,119
35394,489212,1,1,1,1,0,1
35395,489212,1,1,2,0,0,1
35396,489212,1,1,3,0,0,1
35397,489212,1,1,4,0,0,1
35398,489212,1,1,5,1,0,2
35399,489212,1,1,6,0,0,2
35400,489212,1,2,1,0,1,2
35401,489212,1,2,2,2,0,4
35402,489212,1,2,3,0,0,4
35403,489212,1,2,4,0,0,4
35404,489212,1,2,5,1,0,5
35405,489212,1,2,6,0,0,5
35406,489212,1,3,1,4,0,9
35407,489212,1,3,2,6,0,15
35408,489212,1,3,3,0,0,15
35409,489212,1,3,4,1,0,16
35410,489212,1,3,5,1,0,17
35411,489212,1,3,6,1,0,18
35412,489212,1,4,1,6,0,24
35413,489212,1,4,2,1,0,25
35414,489212,1,4,3,0,0,25
35415,489212,1,4,4,1,0,26
35416,489212,1,4,5,0,0,26
35417,489212,1,4,6,0,0,26
35418,489212,1,5,1,0,0,26
35419,489212,1,5,2,1,0,27
35420,489212,1,5,3,4,0,31
35421,489212,1,5,4,1,0,32
35422,489212,1,5,5,1,0,33
35423,489212,1,5,6,4,0,37
35424,489212,1,6,1,0,0,37
35425,489212,1,6,2,1,0,38
35426,489212,1,6,3,0,0,38
35427,489212,1,6,4,1,0,39
35428,489212,1,6,5,4,0,43
35429,489212,1,6,6,4,0,47
35430,489212,1,7,1,1,0,48
35431,489212,1,7,2,1,0,49
35432,489212,1,7,3,1,0,50
35433,489212,1,7,4,6,0,56
35434,489212,1,7,5,1,0,57
35435,489212,1,7,6,0,0,57
35436,489212,1,8,1,0,0,57
35437,489212,1,8,2,1,0,58
35438,489212,1,8,3,1,0,59
35439,489212,1,8,4,0,0,59
35440,489212,1,8,5,1,0,60
35441,489212,1,8,6,4,0,64
35442,489212,1,9,1,4,0,68
35443,489212,1,9,2,1,0,69
35444,489212,1,9,3,2,0,71
35445,489212,1,9,4,1,0,72
35446,489212,1,9,5,0,0,72
35447,489212,1,9,6,0,0,72
35448,489212,1,10,1,1,0,73
35449,489212,1,10,2,0,0,73
35450,489212,1,10,3,0,0,73
35451,489212,1,10,4,0,0,73
35452,489212,1,10,5,1,0,74
35453,489212,1,10,6,1,0,75
35454,489212,1,11,1,2,0,77
35455,489212,1,11,2,4,0,81
35456,489212,1,11,3,1,0,82
35457,489212,1,11,4,1,0,83
35458,489212,1,11,5,0,0,83
35459,489212,1,11,6,4,0,87
35460,489212,1,12,1,4,0,91
35461,489212,1,12,2,6,0,97
35462,489212,1,12,3,1,0,98
35463,489212,1,12,4,1,0,99
35464,489212,1,12,5,1,0,100
35465,489212,1,12,6,0,0,100
35466,489212,1,13,1,1,0,101
35467,489212,1,13,2,0,1,101
35468,489212,1,13,3,0,0,101
35469,489212,1,13,4,0,0,101
35470,489212,1,13,5,4,0,105
35471,489212,1,13,6,1,0,106
35472,489212,1,14,1,1,0,107
35473,489212,1,14,2,2,0,109
35474,489212,1,14,3,1,0,110
35475,489212,1,14,4,1,0,111
35476,489212,1,14,5,1,0,112
35477,489212,1,14,6,1,0,113
35478,489212,1,15,1,1,0,114
35479,489212,1,15,2,0,0,114
35480,489212,1,15,3,0,1,114
35481,489212,1,15,4,0,0,114
35482,489212,1,15,5,4,0,118
35483,489212,1,15,6,0,0,118
35484,489212,1,16,1,0,0,118
35485,489212,1,16,2,0,0,118
35486,489212,1,16,3,0,0,118
35487,489212,1,16,4,0,0,118
35488,489212,1,16,5,0,0,118
35489,489212,1,16,6,0,0,118
35490,489212,1,17,1,0,0,118
35491,489212,1,17,2,6,0,124
35492,489212,1,17,3,0,0,124
35493,489212,1,17,4,1,0,125
35494,489212,1,17,5,0,1,125
35495,489212,1,17,6,1,0,126
35496,489212,1,18,1,0,1,126
35497,489212,1,18,2,0,0,126
35498,489212,1,18,3,0,0,126
35499,489212,1,18,4,1,0,127
35500,489212,1,18,5,1,0,128
35501,489212,1,18,6,3,0,131
35502,489212,1,19,1,2,0,133
35503,489212,1,19,2,1,0,134
35504,489212,1,19,3,0,0,134
35505,489212,1,19,4,6,0,140
35506,489212,1,19,5,1,0,141
35507,489212,1,19,6,0,1,141
35508,489212,1,20,1,0,0,141
35509,489212,1,20,2,0,0,141
35510,489212,1,20,3,0,1,141
35511,489212,1,20,4,2,0,143
35512,489212,1,20,5,4,0,147
35513,489212,1,20,6,3,0,150
35634,489220,1,1,1,1,0,1
35635,489220,1,1,2,0,0,1
35636,489220,1,1,3,0,0,1
35637,489220,1,1,4,0,0,1
35638,489220,1,1,5,2,0,3
35639,489220,1,1,6,0,0,3
35640,489220,1,2,1,1,0,4
35641,489220,1,2,2,1,0,5
35642,489220,1,2,3,1,0,6
35643,489220,1,2,4,1,0,7
35644,489220,1,2,5,1,0,8
35645,489220,1,2,6,1,0,9
35646,489220,1,3,1,1,0,10
35647,489220,1,3,2,0,0,10
35648,489220,1,3,3,1,0,11
35649,489220,1,3,4,1,0,12
35650,489220,1,3,5,1,0,13
35651,489220,1,3,6,0,1,13
35652,489220,1,4,1,0,0,13
35653,489220,1,4,2,4,0,17
35654,489220,1,4,3,0,0,17
35655,489220,1,4,4,1,0,18
35656,489220,1,4,5,1,0,19
35657,489220,1,4,6,0,0,19
35658,489220,1,5,1,0,0,19
35659,489220,1,5,2,1,0,20
35660,489220,1,5,3,0,0,20
35661,489220,1,5,4,1,0,21
35662,489220,1,5,5,1,0,22
35663,489220,1,5,6,4,0,26
35664,489220,1,6,1,9,0,35
35665,489220,1,6,2,1,0,36
35666,489220,1,6,3,6,0,42
35667,489220,1,6,4,2,0,44
35668,489220,1,6,5,1,0,45
35669,489220,1,6,6,1,0,46
35670,489220,1,7,1,0,0,46
35671,489220,1,7,2,0,0,46
35672,489220,1,7,3,1,0,47
35673,489220,1,7,4,1,0,48
35674,489220,1,7,5,0,1,48
35675,489220,1,7,6,0,1,48
35676,489220,1,8,1,1,0,49
35677,489220,1,8,2,0,0,49
35678,489220,1,8,3,0,0,49
35679,489220,1,8,4,0,0,49
35680,489220,1,8,5,1,0,50
35681,489220,1,8,6,4,0,54
35682,489220,1,9,1,1,0,55
35683,489220,1,9,2,0,0,55
35684,489220,1,9,3,1,0,56
35685,489220,1,9,4,0,1,56
35686,489220,1,9,5,0,0,56
35687,489220,1,9,6,1,0,57
35688,489220,1,10,1,2,0,59
35689,489220,1,10,2,1,0,60
35690,489220,1,10,3,1,0,61
35691,489220,1,10,4,1,0,62
35692,489220,1,10,5,0,0,62
35693,489220,1,10,6,1,0,63
35694,489220,1,11,1,1,0,64
35695,489220,1,11,2,0,0,64
35696,489220,1,11,3,0,0,64
35697,489220,1,11,4,1,0,65
35698,489220,1,11,5,1,0,66
35699,489220,1,11,6,2,0,68
35700,489220,1,12,1,1,0,69
35701,489220,1,12,2,0,0,69
35702,489220,1,12,3,0,0,69
35703,489220,1,12,4,2,0,71
35704,489220,1,12,5,0,0,71
35705,489220,1,12,6,0,0,71
35706,489220,1,13,1,1,0,72
35707,489220,1,13,2,0,0,72
35708,489220,1,13,3,2,0,74
35709,489220,1,13,4,1,0,75
35710,489220,1,13,5,0,0,75
35711,489220,1,13,6,0,0,75
35712,489220,1,14,1,0,0,75
35713,489220,1,14,2,1,0,76
35714,489220,1,14,3,4,0,80
35715,489220,1,14,4,1,0,81
35716,489220,1,14,5,1,0,82
35717,489220,1,14,6,1,0,83
35718,489220,1,15,1,0,0,83
35719,489220,1,15,2,1,0,84
35720,489220,1,15,3,1,0,85
35721,489220,1,15,4,1,0,86
35722,489220,1,15,5,0,0,86
35723,489220,1,15,6,1,0,87
35724,489220,1,16,1,1,0,88
35725,489220,1,16,2,1,0,89
35726,489220,1,16,3,1,0,90
35727,489220,1,16,4,5,0,95
35728,489220,1,16,5,1,0,96
35729,489220,1,16,6,6,0,102
35730,489220,1,17,1,4,0,106
35731,489220,1,17,2,0,0,106
35732,489220,1,17,3,2,0,108
35733,489220,1,17,4,0,0,108
35734,489220,1,17,5,4,0,112
35735,489220,1,17,6,2,0,114
35736,489220,1,18,1,6,0,120
35737,489220,1,18,2,1,0,121
35738,489220,1,18,3,6,0,127
35739,489220,1,18,4,0,1,127
35740,489220,1,18,5,1,0,128
35741,489220,1,18,6,6,0,134
35742,489220,1,19,1,0,1,134
35743,489220,1,19,2,0,0,134
35744,489220,1,19,3,2,0,136
35745,489220,1,19,4,1,0,137
35746,489220,1,19,5,6,0,143
35747,489220,1,19,6,1,0,144
35748,489220,1,20,1,2,0,146
35749,489220,1,20,2,6,0,152
35750,489220,1,20,3,1,0,153
35751,489220,1,20,4,1,0,154
35752,489220,1,20,5,4,0,158
35753,489220,1,20,6,1,0,159
35874,514023,1,1,1,1,0,1
35875,514023,1,1,2,0,0,1
35876,514023,1,1,3,0,0,1
35877,514023,1,1,4,0,0,1
35878,514023,1,1,5,0,0,1
35879,514023,1,1,6,1,1,2
35880,514023,1,2,1,2,0,4
35881,514023,1,2,2,0,0,4
35882,514023,1,2,3,0,0,4
35883,514023,1,2,4,0,0,4
35884,514023,1,2,5,1,0,5
35885,514023,1,2,6,1,0,6
35886,514023,1,3,1,1,0,7
35887,514023,1,3,2,1,0,8
35888,514023,1,3,3,0,0,8
35889,514023,1,3,4,0,0,8
35890,514023,1,3,5,0,0,8
35891,514023,1,3,6,2,1,10
35892,514023,1,4,1,1,0,11
35893,514023,1,4,2,0,0,11
35894,514023,1,4,3,0,0,11
35895,514023,1,4,4,1,0,12
35896,514023,1,4,5,4,0,16
35897,514023,1,4,6,4,0,20
35898,514023,1,5,1,0,0,20
35899,514023,1,5,2,4,0,24
35900,514023,1,5,3,0,0,24
35901,514023,1,5,4,1,0,25
35902,514023,1,5,5,4,0,29
35903,514023,1,5,6,0,0,29
35904,514023,1,6,1,4,0,33
35905,514023,1,6,2,2,0,35
35906,514023,1,6,3,0,0,35
35907,514023,1,6,4,0,0,35
35908,514023,1,6,5,0,0,35
35909,514023,1,6,6,0,0,35
35910,514023,1,7,1,1,0,36
35911,514023,1,7,2,1,0,37
35912,514023,1,7,3,1,0,38
35913,514023,1,7,4,1,0,39
35914,514023,1,7,5,1,0,40
35915,514023,1,7,6,0,0,40
35916,514023,1,8,1,0,0,40
35917,514023,1,8,2,1,0,41
35918,514023,1,8,3,0,0,41
35919,514023,1,8,4,4,0,45
35920,514023,1,8,5,0,0,45
35921,514023,1,8,6,0,0,45
35922,514023,1,9,1,2,0,47
35923,514023,1,9,2,6,0,53
35924,514023,1,9,3,1,0,54
35925,514023,1,9,4,1,0,55
35926,514023,1,9,5,1,0,56
35927,514023,1,9,6,0,0,56
35928,514023,1,10,1,1,0,57
35929,514023,1,10,2,0,0,57
35930,514023,1,10,3,1,0,58
35931,514023,1,10,4,0,0,58
35932,514023,1,10,5,0,0,58
35933,514023,1,10,6,0,0,58
35934,514023,1,11,1,6,0,64
35935,514023,1,11,2,1,0,65
35936,514023,1,11,3,0,0,65
35937,514023,1,11,4,1,0,66
35938,514023,1,11,5,0,0,66
35939,514023,1,11,6,1,0,67
35940,514023,1,12,1,0,0,67
35941,514023,1,12,2,0,0,67
35942,514023,1,12,3,1,0,68
35943,514023,1,12,4,0,0,68
35944,514023,1,12,5,0,1,68
35945,514023,1,12,6,1,0,69
35946,514023,1,13,1,1,0,70
35947,514023,1,13,2,1,0,71
35948,514023,1,13,3,1,0,72
35949,514023,1,13,4,2,0,74
35950,514023,1,13,5,1,0,75
35951,514023,1,13,6,4,0,79
35952,514023,1,14,1,1,0,80
35953,514023,1,14,2,1,0,81
35954,514023,1,14,3,0,0,81
35955,514023,1,14,4,0,0,81
35956,514023,1,14,5,1,0,82
35957,514023,1,14,6,2,0,84
35958,514023,1,15,1,2,0,86
35959,514023,1,15,2,0,0,86
35960,514023,1,15,3,1,0,87
35961,514023,1,15,4,1,0,88
35962,514023,1,15,5,4,0,92
35963,514023,1,15,6,1,0,93
35964,514023,1,16,1,2,0,95
35965,514023,1,16,2,1,0,96
35966,514023,1,16,3,0,0,96
35967,514023,1,16,4,4,0,100
35968,514023,1,16,5,0,0,100
35969,514023,1,16,6,1,0,101
35970,514023,1,17,1,1,0,102
35971,514023,1,17,2,4,0,106
35972,514023,1,17,3,1,0,107
35973,514023,1,17,4,1,0,108
35974,514023,1,17,5,1,0,109
35975,514023,1,17,6,4,0,113
35976,514023,1,18,1,4,0,117
35977,514023,1,18,2,6,0,123
35978,514023,1,18,3,1,0,124
35979,514023,1,18,4,2,0,126
35980,514023,1,18,5,0,0,126
35981,514023,1,18,6,6,0,132
35982,514023,1,19,1,0,0,132
35983,514023,1,19,2,1,0,133
35984,514023,1,19,3,0,1,133
35985,514023,1,19,4,0,1,133
35986,514023,1,19,5,4,0,137
35987,514023,1,19,6,1,1,138
35988,514023,1,20,1,1,0,139
35989,514023,1,20,2,2,0,141
35990,514023,1,20,3,0,0,141
35991,514023,1,20,4,4,0,145
35992,514023,1,20,5,0,1,145
35993,514023,1,20,6,1,0,146
36111,514024,1,1,1,0,0,0
36112,514024,1,1,2,0,0,0
36113,514024,1,1,3,0,0,0
36114,514024,1,1,4,3,0,3
36115,514024,1,1,5,0,0,3
36116,514024,1,1,6,0,0,3
36117,514024,1,2,1,0,0,3
36118,514024,1,2,2,0,0,3
36119,514024,1,2,3,0,0,3
36120,514024,1,2,4,0,0,3
36121,514024,1,2,5,0,1,3
36122,514024,1,2,6,1,0,4
36123,514024,1,3,1,0,0,4
36124,514024,1,3,2,1,0,5
36125,514024,1,3,3,0,0,5
36126,514024,1,3,4,1,0,6
36127,514024,1,3,5,0,0,6
36128,514024,1,3,6,1,0,7
36129,514024,1,4,1,1,0,8
36130,514024,1,4,2,1,0,9
36131,514024,1,4,3,0,0,9
36132,514024,1,4,4,1,0,10
36133,514024,1,4,5,6,0,16
36134,514024,1,4,6,0,0,16
36135,514024,1,5,1,1,0,17
36136,514024,1,5,2,0,0,17
36137,514024,1,5,3,0,1,17
36138,514024,1,5,4,0,0,17
36139,514024,1,5,5,0,0,17
36140,514024,1,5,6,0,0,17
36141,514024,1,6,1,4,0,21
36142,514024,1,6,2,6,0,27
36143,514024,1,6,3,0,0,27
36144,514024,1,6,4,0,0,27
36145,514024,1,6,5,1,0,28
36146,514024,1,6,6,0,0,28
36147,514024,1,7,1,1,0,29
36148,514024,1,7,2,1,0,30
36149,514024,1,7,3,0,0,30
36150,514024,1,7,4,1,0,31
36151,514024,1,7,5,0,0,31
36152,514024,1,7,6,0,0,31
36153,514024,1,8,1,2,0,33
36154,514024,1,8,2,1,0,34
36155,514024,1,8,3,0,0,34
36156,514024,1,8,4,0,0,34
36157,514024,1,8,5,4,0,38
36158,514024,1,8,6,6,0,44
36159,514024,1,9,1,4,0,48
36160,514024,1,9,2,1,0,49
36161,514024,1,9,3,0,0,49
36162,514024,1,9,4,0,0,49
36163,514024,1,9,5,0,0,49
36164,514024,1,9,6,1,0,50
36165,514024,1,10,1,0,1,50
36166,514024,1,10,2,1,0,51
36167,514024,1,10,3,1,0,52
36168,514024,1,10,4,1,0,53
36169,514024,1,10,5,4,0,57
36170,514024,1,10,6,6,0,63
36171,514024,1,11,1,1,0,64
36172,514024,1,11,2,1,0,65
36173,514024,1,11,3,0,1,65
36174,514024,1,11,4,1,0,66
36175,514024,1,11,5,0,0,66
36176,514024,1,11,6,1,0,67
36177,514024,1,12,1,0,0,67
36178,514024,1,12,2,4,0,71
36179,514024,1,12,3,0,0,71
36180,514024,1,12,4,1,0,72
36181,514024,1,12,5,1,0,73
36182,514024,1,12,6,1,0,74
36183,514024,1,13,1,1,0,75
36184,514024,1,13,2,1,0,76
36185,514024,1,13,3,1,0,77
36186,514024,1,13,4,1,0,78
36187,514024,1,13,5,2,0,80
36188,514024,1,13,6,2,0,82
36189,514024,1,14,1,1,0,83
36190,514024,1,14,2,2,0,85
36191,514024,1,14,3,1,0,86
36192,514024,1,14,4,1,0,87
36193,514024,1,14,5,0,1,87
36194,514024,1,14,6,0,0,87
36195,514024,1,15,1,0,0,87
36196,514024,1,15,2,4,0,91
36197,514024,1,15,3,1,0,92
36198,514024,1,15,4,1,0,93
36199,514024,1,15,5,1,0,94
36200,514024,1,15,6,1,0,95
36201,514024,1,16,1,0,0,95
36202,514024,1,16,2,1,0,96
36203,514024,1,16,3,2,0,98
36204,514024,1,16,4,0,0,98
36205,514024,1,16,5,4,0,102
36206,514024,1,16,6,1,0,103
36207,514024,1,17,1,1,0,104
36208,514024,1,17,2,1,0,105
36209,514024,1,17,3,1,0,106
36210,514024,1,17,4,0,1,106
36211,514024,1,17,5,1,0,107
36212,514024,1,17,6,1,0,108
36213,514024,1,18,1,0,0,108
36214,514024,1,18,2,0,0,108
36215,514024,1,18,3,1,0,109
36216,514024,1,18,4,2,0,111
36217,514024,1,18,5,1,1,112
36218,514024,1,18,6,0,0,112
36219,514024,1,19,1,6,0,118
36220,514024,1,19,2,2,0,120
36221,514024,1,19,3,1,0,121
36222,514024,1,19,4,4,0,125
36223,514024,1,19,5,1,0,126
36224,514024,1,19,6,1,0,127
36225,514024,1,20,1,2,0,129
36226,514024,1,20,2,6,0,135
36227,514024,1,20,3,0,0,135
36228,514024,1,20,4,6,0,141
36229,514024,1,20,5,6,0,147
36230,514024,1,20,6,0,1,147
36346,516204,1,1,1,0,0,0
36347,516204,1,1,2,0,0,0
36348,516204,1,1,3,1,0,1
36349,516204,1,1,4,1,0,2
36350,516204,1,1,5,4,0,6
36351,516204,1,1,6,1,0,7
36352,516204,1,2,1,0,0,7
36353,516204,1,2,2,0,0,7
36354,516204,1,2,3,0,0,7
36355,516204,1,2,4,4,0,11
36356,516204,1,2,5,1,0,12
36357,516204,1,2,6,0,0,12
36358,516204,1,3,1,0,1,12
36359,516204,1,3,2,2,0,14
36360,516204,1,3,3,0,0,14
36361,516204,1,3,4,2,0,16
36362,516204,1,3,5,6,0,22
36363,516204,1,3,6,4,0,26
36364,516204,1,4,1,0,0,26
36365,516204,1,4,2,1,0,27
36366,516204,1,4,3,1,0,28
36367,516204,1,4,4,4,0,32
36368,516204,1,4,5,4,0,36
36369,516204,1,4,6,0,0,36
36370,516204,1,5,1,1,0,37
36371,516204,1,5,2,1,0,38
36372,516204,1,5,3,1,0,39
36373,516204,1,5,4,1,0,40
36374,516204,1,5,5,1,0,41
36375,516204,1,5,6,0,0,41
36376,516204,1,6,1,1,0,42
36377,516204,1,6,2,0,0,42
36378,516204,1,6,3,0,1,42
36379,516204,1,6,4,1,0,43
36380,516204,1,6,5,2,0,45
36381,516204,1,6,6,0,0,45
36382,516204,1,7,1,1,0,46
36383,516204,1,7,2,1,0,47
36384,516204,1,7,3,2,0,49
36385,516204,1,7,4,1,0,50
36386,516204,1,7,5,1,0,51
36387,516204,1,7,6,0,0,51
36388,516204,1,8,1,0,0,51
36389,516204,1,8,2,1,0,52
36390,516204,1,8,3,4,0,56
36391,516204,1,8,4,1,0,57
36392,516204,1,8,5,2,0,59
36393,516204,1,8,6,4,0,63
36394,516204,1,9,1,0,0,63
36395,516204,1,9,2,4,0,67
36396,516204,1,9,3,1,0,68
36397,516204,1,9,4,0,0,68
36398,516204,1,9,5,1,0,69
36399,516204,1,9,6,1,0,70
36400,516204,1,10,1,0,0,70
36401,516204,1,10,2,1,0,71
36402,516204,1,10,3,0,0,71
36403,516204,1,10,4,0,0,71
36404,516204,1,10,5,1,0,72
36405,516204,1,10,6,4,0,76
36406,516204,1,11,1,1,0,77
36407,516204,1,11,2,1,0,78
36408,516204,1,11,3,0,0,78
36409,516204,1,11,4,0,0,78
36410,516204,1,11,5,1,0,79
36411,516204,1,11,6,1,0,80
36412,516204,1,12,1,2,0,82
36413,516204,1,12,2,2,0,84
36414,516204,1,12,3,4,0,88
36415,516204,1,12,4,4,0,92
36416,516204,1,12,5,1,0,93
36417,516204,1,12,6,0,0,93
36418,516204,1,13,1,0,0,93
36419,516204,1,13,2,1,0,94
36420,516204,1,13,3,0,1,94
36421,516204,1,13,4,1,0,95
36422,516204,1,13,5,1,0,96
36423,516204,1,13,6,1,0,97
36424,516204,1,14,1,0,0,97
36425,516204,1,14,2,4,0,101
36426,516204,1,14,3,1,0,102
36427,516204,1,14,4,1,0,103
36428,516204,1,14,5,1,0,104
36429,516204,1,14,6,1,0,105
36430,516204,1,15,1,4,0,109
36431,516204,1,15,2,1,0,110
36432,516204,1,15,3,2,0,112
36433,516204,1,15,4,4,0,116
36434,516204,1,15,5,0,0,116
36435,516204,1,15,6,1,0,117
36436,516204,1,16,1,1,0,118
36437,516204,1,16,2,4,0,122
36438,516204,1,16,3,3,0,125
36439,516204,1,16,4,4,0,129
36440,516204,1,16,5,4,0,133
36441,516204,1,16,6,4,0,137
36442,516204,1,17,1,4,0,141
36443,516204,1,17,2,2,0,143
36444,516204,1,17,3,1,0,144
36445,516204,1,17,4,1,0,145
36446,516204,1,17,5,1,0,146
36447,516204,1,17,6,4,0,150
36448,516204,1,18,1,6,0,156
36449,516204,1,18,2,4,0,160
36450,516204,1,18,3,1,0,161
36451,516204,1,18,4,1,0,162
36452,516204,1,18,5,4,0,166
36453,516204,1,18,6,6,0,172
36454,516204,1,19,1,1,0,173
36455,516204,1,19,2,1,0,174
36456,516204,1,19,3,2,0,176
36457,516204,1,19,4,1,0,177
36458,516204,1,19,5,0,0,177
36459,516204,1,19,6,1,0,178
36460,516204,1,20,1,0,0,178
36461,516204,1,20,2,6,0,184
36462,516204,1,20,3,6,0,190
36463,516204,1,20,4,4,0,194
36464,516204,1,20,5,4,0,198
36465,516204,1,20,6,0,0,198
36586,516205,1,1,1,0,0,0
36587,516205,1,1,2,1,0,1
36588,516205,1,1,3,0,0,1
36589,516205,1,1,4,1,0,2
36590,516205,1,1,5,0,0,2
36591,516205,1,1,6,0,0,2
36592,516205,1,2,1,1,0,3
36593,516205,1,2,2,1,0,4
36594,516205,1,2,3,1,0,5
36595,516205,1,2,4,4,0,9
36596,516205,1,2,5,4,0,13
36597,516205,1,2,6,0,0,13
36598,516205,1,3,1,1,0,14
36599,516205,1,3,2,4,0,18
36600,516205,1,3,3,0,0,18
36601,516205,1,3,4,4,0,22
36602,516205,1,3,5,1,0,23
36603,516205,1,3,6,0,1,23
36604,516205,1,4,1,1,0,24
36605,516205,1,4,2,0,0,24
36606,516205,1,4,3,0,0,24
36607,516205,1,4,4,1,0,25
36608,516205,1,4,5,0,0,25
36609,516205,1,4,6,1,0,26
36610,516205,1,5,1,1,0,27
36611,516205,1,5,2,1,0,28
36612,516205,1,5,3,4,0,32
36613,516205,1,5,4,4,0,36
36614,516205,1,5,5,1,0,37
36615,516205,1,5,6,4,0,41
36616,516205,1,6,1,4,0,45
36617,516205,1,6,2,4,0,49
36618,516205,1,6,3,4,0,53
36619,516205,1,6,4,0,0,53
36620,516205,1,6,5,1,0,54
36621,516205,1,6,6,0,0,54
36622,516205,1,7,1,2,0,56
36623,516205,1,7,2,0,0,56
36624,516205,1,7,3,0,0,56
36625,516205,1,7,4,1,0,57
36626,516205,1,7,5,1,0,58
36627,516205,1,7,6,1,0,59
36628,516205,1,8,1,1,0,60
36629,516205,1,8,2,0,0,60
36630,516205,1,8,3,2,0,62
36631,516205,1,8,4,4,0,66
36632,516205,1,8,5,0,1,66
36633,516205,1,8,6,1,0,67
36634,516205,1,9,1,0,0,67
36635,516205,1,9,2,4,0,71
36636,516205,1,9,3,2,0,73
36637,516205,1,9,4,2,0,75
36638,516205,1,9,5,0,1,75
36639,516205,1,9,6,4,0,79
36640,516205,1,10,1,1,0,80
36641,516205,1,10,2,0,0,80
36642,516205,1,10,3,6,0,86
36643,516205,1,10,4,0,0,86
36644,516205,1,10,5,1,0,87
36645,516205,1,10,6,2,0,89
36646,516205,1,11,1,1,0,90
36647,516205,1,11,2,2,0,92
36648,516205,1,11,3,1,0,93
36649,516205,1,11,4,1,0,94
36650,516205,1,11,5,1,0,95
36651,516205,1,11,6,1,0,96
36652,516205,1,12,1,0,0,96
36653,516205,1,12,2,1,0,97
36654,516205,1,12,3,4,0,101
36655,516205,1,12,4,1,0,102
36656,516205,1,12,5,2,0,104
36657,516205,1,12,6,4,0,108
36658,516205,1,13,1,0,0,108
36659,516205,1,13,2,1,0,109
36660,516205,1,13,3,1,0,110
36661,516205,1,13,4,0,0,110
36662,516205,1,13,5,1,0,111
36663,516205,1,13,6,1,0,112
36664,516205,1,14,1,6,0,118
36665,516205,1,14,2,1,0,119
36666,516205,1,14,3,0,0,119
36667,516205,1,14,4,0,0,119
36668,516205,1,14,5,1,0,120
36669,516205,1,14,6,1,0,121
36670,516205,1,15,1,0,1,121
36671,516205,1,15,2,0,0,121
36672,516205,1,15,3,0,0,121
36673,516205,1,15,4,1,0,122
36674,516205,1,15,5,1,0,123
36675,516205,1,15,6,0,1,123
36676,516205,1,16,1,1,0,124
36677,516205,1,16,2,0,0,124
36678,516205,1,16,3,1,0,125
36679,516205,1,16,4,0,0,125
36680,516205,1,16,5,1,0,126
36681,516205,1,16,6,4,0,130
36682,516205,1,17,1,0,0,130
36683,516205,1,17,2,1,0,131
36684,516205,1,17,3,0,1,131
36685,516205,1,17,4,1,0,132
36686,516205,1,17,5,1,0,133
36687,516205,1,17,6,1,0,134
36688,516205,1,18,1,2,0,136
36689,516205,1,18,2,1,0,137
36690,516205,1,18,3,0,1,137
36691,516205,1,18,4,1,0,138
36692,516205,1,18,5,0,0,138
36693,516205,1,18,6,1,0,139
36694,516205,1,19,1,1,0,140
36695,516205,1,19,2,0,0,140
36696,516205,1,19,3,1,0,141
36697,516205,1,19,4,1,0,142
36698,516205,1,19,5,2,0,144
36699,516205,1,19,6,1,0,145
36700,516205,1,20,1,5,0,150
36701,516205,1,20,2,0,1,150
36702,516205,1,20,3,1,0,151
36703,516205,1,20,4,1,0,152
36704,516205,1,20,5,0,1,152
36705,516205,1,20,6,5,0,157
36826,518954,1,1,1,0,0,0
36827,518954,1,1,2,0,0,0
36828,518954,1,1,3,0,0,0
36829,518954,1,1,4,1,0,1
36830,518954,1,1,5,0,0,1
36831,518954,1,1,6,1,0,2
36832,518954,1,2,1,1,0,3
36833,518954,1,2,2,0,0,3
36834,518954,1,2,3,1,0,4
36835,518954,1,2,4,4,0,8
36836,518954,1,2,5,0,0,8
36837,518954,1,2,6,1,0,9
36838,518954,1,3,1,1,0,10
36839,518954,1,3,2,0,0,10
36840,518954,1,3,3,6,0,16
36841,518954,1,3,4,4,0,20
36842,518954,1,3,5,6,0,26
36843,518954,1,3,6,2,0,28
36844,518954,1,4,1,3,0,31
36845,518954,1,4,2,2,0,33
36846,518954,1,4,3,3,0,36
36847,518954,1,4,4,2,0,38
36848,518954,1,4,5,0,1,38
36849,518954,1,4,6,1,0,39
36850,518954,1,5,1,2,0,41
36851,518954,1,5,2,0,0,41
36852,518954,1,5,3,3,0,44
36853,518954,1,5,4,0,0,44
36854,518954,1,5,5,1,0,45
36855,518954,1,5,6,3,0,48
36856,518954,1,6,1,1,0,49
36857,518954,1,6,2,0,0,49
36858,518954,1,6,3,0,0,49
36859,518954,1,6,4,0,0,49
36860,518954,1,6,5,6,0,55
36861,518954,1,6,6,0,0,55
36862,518954,1,7,1,0,0,55
36863,518954,1,7,2,1,0,56
36864,518954,1,7,3,0,0,56
36865,518954,1,7,4,0,0,56
36866,518954,1,7,5,1,0,57
36867,518954,1,7,6,1,0,58
36868,518954,1,8,1,6,0,64
36869,518954,1,8,2,1,0,65
36870,518954,1,8,3,0,0,65
36871,518954,1,8,4,0,0,65
36872,518954,1,8,5,0,0,65
36873,518954,1,8,6,1,0,66
36874,518954,1,9,1,0,0,66
36875,518954,1,9,2,4,0,70
36876,518954,1,9,3,2,0,72
36877,518954,1,9,4,0,0,72
36878,518954,1,9,5,1,0,73
36879,518954,1,9,6,1,0,74
36880,518954,1,10,1,1,0,75
36881,518954,1,10,2,1,0,76
36882,518954,1,10,3,2,0,78
36883,518954,1,10,4,0,0,78
36884,518954,1,10,5,1,0,79
36885,518954,1,10,6,0,1,79
36886,518954,1,11,1,1,0,80
36887,518954,1,11,2,1,0,81
36888,518954,1,11,3,4,0,85
36889,518954,1,11,4,0,0,85
36890,518954,1,11,5,0,0,85
36891,518954,1,11,6,0,0,85
36892,518954,1,12,1,0,0,85
36893,518954,1,12,2,0,0,85
36894,518954,1,12,3,0,0,85
36895,518954,1,12,4,2,0,87
36896,518954,1,12,5,1,0,88
36897,518954,1,12,6,0,0,88
36898,518954,1,13,1,1,0,89
36899,518954,1,13,2,1,0,90
36900,518954,1,13,3,4,0,94
36901,518954,1,13,4,6,0,100
36902,518954,1,13,5,4,0,104
36903,518954,1,13,6,1,0,105
36904,518954,1,14,1,4,0,109
36905,518954,1,14,2,1,0,110
36906,518954,1,14,3,4,0,114
36907,518954,1,14,4,2,0,116
36908,518954,1,14,5,1,0,117
36909,518954,1,14,6,6,0,123
36910,518954,1,15,1,1,0,124
36911,518954,1,15,2,0,0,124
36912,518954,1,15,3,1,0,125
36913,518954,1,15,4,6,0,131
36914,518954,1,15,5,0,0,131
36915,518954,1,15,6,1,0,132
36916,518954,1,16,1,0,0,132
36917,518954,1,16,2,1,0,133
36918,518954,1,16,3,2,0,135
36919,518954,1,16,4,0,1,135
36920,518954,1,16,5,1,0,136
36921,518954,1,16,6,1,0,137
36922,518954,1,17,1,1,0,138
36923,518954,1,17,2,1,0,139
36924,518954,1,17,3,1,0,140
36925,518954,1,17,4,0,0,140
36926,518954,1,17,5,1,0,141
36927,518954,1,17,6,1,0,142
36928,518954,1,18,1,2,0,144
36929,518954,1,18,2,6,0,150
36930,518954,1,18,3,1,0,151
36931,518954,1,18,4,4,0,155
36932,518954,1,18,5,1,0,156
36933,518954,1,18,6,0,0,156
36934,518954,1,19,1,1,0,157
36935,518954,1,19,2,1,0,158
36936,518954,1,19,3,1,0,159
36937,518954,1,19,4,1,0,160
36938,518954,1,19,5,1,0,161
36939,518954,1,19,6,0,0,161
36940,518954,1,20,1,0,0,161
36941,518954,1,20,2,1,0,162
36942,518954,1,20,3,6,0,168
36943,518954,1,20,4,2,0,170
36944,518954,1,20,5,0,1,170
36945,518954,1,20,6,1,0,171
37066,518955,1,1,1,0,0,0
37067,518955,1,1,2,0,0,0
37068,518955,1,1,3,2,0,2
37069,518955,1,1,4,1,0,3
37070,518955,1,1,5,0,0,3
37071,518955,1,1,6,4,0,7
37072,518955,1,2,1,1,0,8
37073,518955,1,2,2,4,0,12
37074,518955,1,2,3,0,0,12
37075,518955,1,2,4,1,0,13
37076,518955,1,2,5,1,0,14
37077,518955,1,2,6,4,0,18
37078,518955,1,3,1,1,0,19
37079,518955,1,3,2,0,1,19
37080,518955,1,3,3,1,0,20
37081,518955,1,3,4,0,0,20
37082,518955,1,3,5,0,1,20
37083,518955,1,3,6,0,0,20
37084,518955,1,4,1,0,0,20
37085,518955,1,4,2,0,0,20
37086,518955,1,4,3,4,0,24
37087,518955,1,4,4,2,0,26
37088,518955,1,4,5,1,0,27
37089,518955,1,4,6,0,0,27
37090,518955,1,5,1,1,0,28
37091,518955,1,5,2,2,0,30
37092,518955,1,5,3,0,0,30
37093,518955,1,5,4,4,0,34
37094,518955,1,5,5,4,0,38
37095,518955,1,5,6,1,0,39
37096,518955,1,6,1,0,0,39
37097,518955,1,6,2,1,0,40
37098,518955,1,6,3,0,0,40
37099,518955,1,6,4,0,0,40
37100,518955,1,6,5,0,0,40
37101,518955,1,6,6,2,0,42
37102,518955,1,7,1,1,0,43
37103,518955,1,7,2,0,0,43
37104,518955,1,7,3,1,0,44
37105,518955,1,7,4,4,0,48
37106,518955,1,7,5,1,0,49
37107,518955,1,7,6,0,1,49
37108,518955,1,8,1,1,0,50
37109,518955,1,8,2,2,0,52
37110,518955,1,8,3,0,0,52
37111,518955,1,8,4,0,0,52
37112,518955,1,8,5,1,0,53
37113,518955,1,8,6,1,0,54
37114,518955,1,9,1,0,0,54
37115,518955,1,9,2,0,0,54
37116,518955,1,9,3,0,1,54
37117,518955,1,9,4,4,0,58
37118,518955,1,9,5,0,0,58
37119,518955,1,9,6,1,0,59
37120,518955,1,10,1,1,0,60
37121,518955,1,10,2,0,0,60
37122,518955,1,10,3,1,0,61
37123,518955,1,10,4,1,0,62
37124,518955,1,10,5,1,0,63
37125,518955,1,10,6,6,0,69
37126,518955,1,11,1,1,0,70
37127,518955,1,11,2,1,0,71
37128,518955,1,11,3,0,0,71
37129,518955,1,11,4,2,0,73
37130,518955,1,11,5,1,0,74
37131,518955,1,11,6,2,0,76
37132,518955,1,12,1,1,0,77
37133,518955,1,12,2,0,0,77
37134,518955,1,12,3,6,0,83
37135,518955,1,12,4,1,0,84
37136,518955,1,12,5,1,0,85
37137,518955,1,12,6,2,0,87
37138,518955,1,13,1,0,0,87
37139,518955,1,13,2,1,0,88
37140,518955,1,13,3,0,0,88
37141,518955,1,13,4,1,0,89
37142,518955,1,13,5,1,0,90
37143,518955,1,13,6,1,0,91
37144,518955,1,14,1,1,0,92
37145,518955,1,14,2,1,0,93
37146,518955,1,14,3,0,1,93
37147,518955,1,14,4,1,0,94
37148,518955,1,14,5,1,0,95
37149,518955,1,14,6,1,0,96
37150,518955,1,15,1,0,0,96
37151,518955,1,15,2,1,0,97
37152,518955,1,15,3,2,0,99
37153,518955,1,15,4,0,0,99
37154,518955,1,15,5,0,0,99
37155,518955,1,15,6,1,0,100
37156,518955,1,16,1,4,0,104
37157,518955,1,16,2,0,0,104
37158,518955,1,16,3,1,0,105
37159,518955,1,16,4,0,0,105
37160,518955,1,16,5,0,0,105
37161,518955,1,16,6,1,0,106
37162,518955,1,17,1,4,0,110
37163,518955,1,17,2,0,0,110
37164,518955,1,17,3,1,0,111
37165,518955,1,17,4,2,0,113
37166,518955,1,17,5,1,0,114
37167,518955,1,17,6,0,0,114
37168,518955,1,18,1,1,0,115
37169,518955,1,18,2,4,0,119
37170,518955,1,18,3,0,1,119
37171,518955,1,18,4,1,0,120
37172,518955,1,18,5,1,0,121
37173,518955,1,18,6,0,0,121
37174,518955,1,19,1,0,0,121
37175,518955,1,19,2,0,1,121
37176,518955,1,19,3,0,1,121
37177,518955,1,19,4,0,0,121
37178,518955,1,19,5,0,0,121
37179,518955,1,19,6,4,0,125
37180,518955,1,20,1,4,0,129
37181,518955,1,20,2,1,0,130
37182,518955,1,20,3,0,1,130
37183,518955,1,20,4,1,1,131
37302,520595,1,1,1,1,0,1
37303,520595,1,1,2,0,0,1
37304,520595,1,1,3,1,0,2
37305,520595,1,1,4,0,0,2
37306,520595,1,1,5,1,0,3
37307,520595,1,1,6,0,0,3
37308,520595,1,2,1,0,0,3
37309,520595,1,2,2,1,0,4
37310,520595,1,2,3,1,0,5
37311,520595,1,2,4,0,1,5
37312,520595,1,2,5,0,0,5
37313,520595,1,2,6,0,0,5
37314,520595,1,3,1,6,0,11
37315,520595,1,3,2,0,0,11
37316,520595,1,3,3,4,0,15
37317,520595,1,3,4,1,0,16
37318,520595,1,3,5,0,1,16
37319,520595,1,3,6,1,0,17
37320,520595,1,4,1,1,0,18
37321,520595,1,4,2,0,0,18
37322,520595,1,4,3,1,0,19
37323,520595,1,4,4,1,0,20
37324,520595,1,4,5,2,0,22
37325,520595,1,4,6,0,0,22
37326,520595,1,5,1,1,0,23
37327,520595,1,5,2,7,0,30
37328,520595,1,5,3,1,0,31
37329,520595,1,5,4,1,0,32
37330,520595,1,5,5,4,0,36
37331,520595,1,5,6,1,0,37
37332,520595,1,6,1,2,0,39
37333,520595,1,6,2,1,0,40
37334,520595,1,6,3,0,0,40
37335,520595,1,6,4,1,0,41
37336,520595,1,6,5,1,0,42
37337,520595,1,6,6,4,0,46
37338,520595,1,7,1,1,0,47
37339,520595,1,7,2,0,0,47
37340,520595,1,7,3,4,0,51
37341,520595,1,7,4,0,0,51
37342,520595,1,7,5,1,0,52
37343,520595,1,7,6,2,0,54
37344,520595,1,8,1,2,0,56
37345,520595,1,8,2,1,0,57
37346,520595,1,8,3,1,0,58
37347,520595,1,8,4,1,0,59
37348,520595,1,8,5,0,0,59
37349,520595,1,8,6,1,0,60
37350,520595,1,9,1,0,0,60
37351,520595,1,9,2,6,0,66
37352,520595,1,9,3,0,0,66
37353,520595,1,9,4,1,0,67
37354,520595,1,9,5,1,0,68
37355,520595,1,9,6,1,0,69
37356,520595,1,10,1,4,0,73
37357,520595,1,10,2,0,0,73
37358,520595,1,10,3,1,0,74
37359,520595,1,10,4,1,0,75
37360,520595,1,10,5,1,0,76
37361,520595,1,10,6,0,0,76
37362,520595,1,11,1,2,0,78
37363,520595,1,11,2,0,1,78
37364,520595,1,11,3,1,0,79
37365,520595,1,11,4,1,0,80
37366,520595,1,11,5,1,0,81
37367,520595,1,11,6,1,0,82
37368,520595,1,12,1,0,0,82
37369,520595,1,12,2,0,0,82
37370,520595,1,12,3,1,0,83
37371,520595,1,12,4,4,0,87
37372,520595,1,12,5,0,0,87
37373,520595,1,12,6,0,0,87
37374,520595,1,13,1,1,0,88
37375,520595,1,13,2,0,1,88
37376,520595,1,13,3,1,0,89
37377,520595,1,13,4,0,0,89
37378,520595,1,13,5,1,0,90
37379,520595,1,13,6,0,0,90
37380,520595,1,14,1,1,0,91
37381,520595,1,14,2,1,0,92
37382,520595,1,14,3,1,0,93
37383,520595,1,14,4,0,0,93
37384,520595,1,14,5,4,0,97
37385,520595,1,14,6,0,0,97
37386,520595,1,15,1,6,0,103
37387,520595,1,15,2,1,0,104
37388,520595,1,15,3,1,0,105
37389,520595,1,15,4,1,0,106
37390,520595,1,15,5,0,1,106
37391,520595,1,15,6,0,0,106
37392,520595,1,16,1,1,0,107
37393,520595,1,16,2,1,0,108
37394,520595,1,16,3,1,0,109
37395,520595,1,16,4,1,0,110
37396,520595,1,16,5,1,0,111
37397,520595,1,16,6,1,0,112
37398,520595,1,17,1,1,0,113
37399,520595,1,17,2,4,0,117
37400,520595,1,17,3,1,0,118
37401,520595,1,17,4,6,0,124
37402,520595,1,17,5,4,0,128
37403,520595,1,17,6,4,0,132
37404,520595,1,18,1,1,0,133
37405,520595,1,18,2,1,0,134
37406,520595,1,18,3,1,0,135
37407,520595,1,18,4,0,1,135
37408,520595,1,18,5,1,0,136
37409,520595,1,18,6,0,0,136
37410,520595,1,19,1,1,0,137
37411,520595,1,19,2,1,0,138
37412,520595,1,19,3,0,0,138
37413,520595,1,19,4,1,0,139
37414,520595,1,19,5,4,0,143
37415,520595,1,19,6,1,0,144
37416,520595,1,20,1,6,0,150
37417,520595,1,20,2,6,0,156
37418,520595,1,20,3,0,1,156
37419,520595,1,20,4,1,0,157
37420,520595,1,20,5,0,1,157
37421,520595,1,20,6,2,0,159
37523,520596,1,1,1,0,0,0
37524,520596,1,1,2,2,0,2
37525,520596,1,1,3,4,0,6
37526,520596,1,1,4,0,0,6
37527,520596,1,1,5,1,0,7
37528,520596,1,1,6,0,0,7
37529,520596,1,2,1,0,0,7
37530,520596,1,2,2,0,0,7
37531,520596,1,2,3,1,0,8
37532,520596,1,2,4,0,0,8
37533,520596,1,2,5,2,0,10
37534,520596,1,2,6,0,0,10
37535,520596,1,3,1,1,0,11
37536,520596,1,3,2,0,0,11
37537,520596,1,3,3,4,0,15
37538,520596,1,3,4,6,0,21
37539,520596,1,3,5,3,0,24
37540,520596,1,3,6,0,0,24
37541,520596,1,4,1,1,0,25
37542,520596,1,4,2,6,0,31
37543,520596,1,4,3,6,0,37
37544,520596,1,4,4,1,0,38
37545,520596,1,4,5,1,0,39
37546,520596,1,4,6,1,0,40
37547,520596,1,5,1,4,0,44
37548,520596,1,5,2,0,0,44
37549,520596,1,5,3,1,0,45
37550,520596,1,5,4,4,0,49
37551,520596,1,5,5,1,0,50
37552,520596,1,5,6,0,0,50
37553,520596,1,6,1,1,0,51
37554,520596,1,6,2,1,0,52
37555,520596,1,6,3,6,0,58
37556,520596,1,6,4,0,0,58
37557,520596,1,6,5,6,0,64
37558,520596,1,6,6,1,0,65
37559,520596,1,7,1,1,0,66
37560,520596,1,7,2,4,0,70
37561,520596,1,7,3,6,0,76
37562,520596,1,7,4,0,0,76
37563,520596,1,7,5,0,0,76
37564,520596,1,7,6,0,1,76
37565,520596,1,8,1,1,0,77
37566,520596,1,8,2,0,0,77
37567,520596,1,8,3,2,0,79
37568,520596,1,8,4,6,0,85
37569,520596,1,8,5,1,0,86
37570,520596,1,8,6,0,0,86
37571,520596,1,9,1,0,0,86
37572,520596,1,9,2,1,0,87
37573,520596,1,9,3,0,0,87
37574,520596,1,9,4,1,0,88
37575,520596,1,9,5,1,0,89
37576,520596,1,9,6,1,0,90
37577,520596,1,10,1,4,0,94
37578,520596,1,10,2,1,0,95
37579,520596,1,10,3,1,0,96
37580,520596,1,10,4,1,0,97
37581,520596,1,10,5,0,0,97
37582,520596,1,10,6,1,0,98
37583,520596,1,11,1,1,0,99
37584,520596,1,11,2,2,0,101
37585,520596,1,11,3,1,0,102
37586,520596,1,11,4,1,0,103
37587,520596,1,11,5,1,0,104
37588,520596,1,11,6,0,0,104
37589,520596,1,12,1,0,0,104
37590,520596,1,12,2,6,0,110
37591,520596,1,12,3,4,0,114
37592,520596,1,12,4,0,0,114
37593,520596,1,12,5,1,0,115
37594,520596,1,12,6,1,0,116
37595,520596,1,13,1,2,0,118
37596,520596,1,13,2,1,0,119
37597,520596,1,13,3,1,0,120
37598,520596,1,13,4,0,0,120
37599,520596,1,13,5,1,0,121
37600,520596,1,13,6,0,0,121
37601,520596,1,14,1,0,1,121
37602,520596,1,14,2,1,0,122
37603,520596,1,14,3,1,0,123
37604,520596,1,14,4,1,0,124
37605,520596,1,14,5,4,0,128
37606,520596,1,14,6,4,0,132
37607,520596,1,15,1,0,0,132
37608,520596,1,15,2,1,0,133
37609,520596,1,15,3,1,0,134
37610,520596,1,15,4,2,0,136
37611,520596,1,15,5,2,0,138
37612,520596,1,15,6,4,0,142
37613,520596,1,16,1,1,0,143
37614,520596,1,16,2,0,0,143
37615,520596,1,16,3,1,0,144
37616,520596,1,16,4,1,0,145
37617,520596,1,16,5,2,0,147
37618,520596,1,16,6,6,0,153
37619,520596,1,17,1,0,0,153
37620,520596,1,17,2,4,0,157
37621,520596,1,17,3,4,0,161
37622,520596,1,17,4,1,0,162
37623,520596,1,17,5,1,0,163
37624,520596,1,17,6,4,0,167
37625,520596,1,18,1,6,0,173
37626,520596,1,18,2,4,0,177
37627,520596,1,18,3,1,0,178
37628,520596,1,18,4,1,0,179
37629,520596,1,18,5,2,0,181
37630,520596,1,18,6,3,0,184
37631,520596,1,19,1,1,0,185
37632,520596,1,19,2,1,0,186
37633,520596,1,19,3,4,0,190
37634,520596,1,19,4,0,0,190
37635,520596,1,19,5,4,0,194
37636,520596,1,19,6,1,0,195
37637,520596,1,20,1,1,0,196
37638,520596,1,20,2,0,0,196
37639,520596,1,20,3,1,0,197
37640,520596,1,20,4,1,0,198
37641,520596,1,20,5,1,0,199
37642,520596,1,20,6,1,0,200
37761,520597,1,1,1,0,0,0
37762,520597,1,1,2,1,0,1
37763,520597,1,1,3,0,0,1
37764,520597,1,1,4,2,0,3
37765,520597,1,1,5,0,0,3
37766,520597,1,1,6,0,0,3
37767,520597,1,2,1,1,0,4
37768,520597,1,2,2,1,0,5
37769,520597,1,2,3,0,0,5
37770,520597,1,2,4,1,0,6
37771,520597,1,2,5,4,0,10
37772,520597,1,2,6,1,0,11
37773,520597,1,3,1,0,0,11
37774,520597,1,3,2,1,0,12
37775,520597,1,3,3,1,0,13
37776,520597,1,3,4,4,0,17
37777,520597,1,3,5,0,0,17
37778,520597,1,3,6,1,0,18
37779,520597,1,4,1,0,0,18
37780,520597,1,4,2,6,0,24
37781,520597,1,4,3,0,1,24
37782,520597,1,4,4,6,0,30
37783,520597,1,4,5,0,0,30
37784,520597,1,4,6,4,0,34
37785,520597,1,5,1,0,0,34
37786,520597,1,5,2,0,1,34
37787,520597,1,5,3,0,0,34
37788,520597,1,5,4,0,0,34
37789,520597,1,5,5,0,0,34
37790,520597,1,5,6,1,0,35
37791,520597,1,6,1,1,0,36
37792,520597,1,6,2,0,0,36
37793,520597,1,6,3,1,0,37
37794,520597,1,6,4,0,0,37
37795,520597,1,6,5,1,0,38
37796,520597,1,6,6,0,1,38
37797,520597,1,7,1,1,0,39
37798,520597,1,7,2,1,0,40
37799,520597,1,7,3,1,0,41
37800,520597,1,7,4,1,0,42
37801,520597,1,7,5,1,0,43
37802,520597,1,7,6,1,0,44
37803,520597,1,8,1,1,0,45
37804,520597,1,8,2,0,0,45
37805,520597,1,8,3,1,0,46
37806,520597,1,8,4,1,0,47
37807,520597,1,8,5,1,0,48
37808,520597,1,8,6,1,0,49
37809,520597,1,9,1,1,0,50
37810,520597,1,9,2,1,0,51
37811,520597,1,9,3,1,0,52
37812,520597,1,9,4,0,0,52
37813,520597,1,9,5,0,0,52
37814,520597,1,9,6,0,1,52
37815,520597,1,10,1,0,0,52
37816,520597,1,10,2,1,0,53
37817,520597,1,10,3,1,0,54
37818,520597,1,10,4,1,0,55
37819,520597,1,10,5,1,0,56
37820,520597,1,10,6,1,0,57
37821,520597,1,11,1,2,0,59
37822,520597,1,11,2,2,0,61
37823,520597,1,11,3,2,0,63
37824,520597,1,11,4,1,0,64
37825,520597,1,11,5,1,0,65
37826,520597,1,11,6,1,0,66
37827,520597,1,12,1,1,0,67
37828,520597,1,12,2,1,0,68
37829,520597,1,12,3,1,0,69
37830,520597,1,12,4,0,0,69
37831,520597,1,12,5,1,0,70
37832,520597,1,12,6,1,0,71
37833,520597,1,13,1,0,0,71
37834,520597,1,13,2,0,0,71
37835,520597,1,13,3,0,0,71
37836,520597,1,13,4,0,0,71
37837,520597,1,13,5,1,0,72
37838,520597,1,13,6,0,0,72
37839,520597,1,14,1,1,0,73
37840,520597,1,14,2,1,0,74
37841,520597,1,14,3,0,0,74
37842,520597,1,14,4,0,0,74
37843,520597,1,14,5,1,0,75
37844,520597,1,14,6,0,0,75
37845,520597,1,15,1,1,0,76
37846,520597,1,15,2,1,0,77
37847,520597,1,15,3,6,0,83
37848,520597,1,15,4,6,0,89
37849,520597,1,15,5,6,0,95
37850,520597,1,15,6,6,0,101
37851,520597,1,16,1,1,0,102
37852,520597,1,16,2,0,1,102
37853,520597,1,16,3,2,0,104
37854,520597,1,16,4,1,0,105
37855,520597,1,16,5,4,0,109
37856,520597,1,16,6,1,0,110
37857,520597,1,17,1,1,0,111
37858,520597,1,17,2,4,0,115
37859,520597,1,17,3,0,0,115
37860,520597,1,17,4,0,0,115
37861,520597,1,17,5,1,0,116
37862,520597,1,17,6,1,0,117
37863,520597,1,18,1,4,0,121
37864,520597,1,18,2,4,0,125
37865,520597,1,18,3,1,0,126
37866,520597,1,18,4,1,0,127
37867,520597,1,18,5,0,1,127
37868,520597,1,18,6,2,0,129
37869,520597,1,19,1,1,0,130
37870,520597,1,19,2,0,0,130
37871,520597,1,19,3,0,0,130
37872,520597,1,19,4,1,0,131
37873,520597,1,19,5,0,0,131
37874,520597,1,19,6,1,0,132
37875,520597,1,20,1,1,0,133
37876,520597,1,20,2,1,0,134
37877,520597,1,20,3,2,0,136
37878,520597,1,20,4,4,0,140
37879,520597,1,20,5,6,0,146
37880,520597,1,20,6,1,0,147
37997,520598,1,1,1,0,0,0
37998,520598,1,1,2,0,0,0
37999,520598,1,1,3,0,0,0
38000,520598,1,1,4,4,0,4
38001,520598,1,1,5,1,0,5
38002,520598,1,1,6,1,0,6
38003,520598,1,2,1,0,0,6
38004,520598,1,2,2,1,0,7
38005,520598,1,2,3,4,0,11
38006,520598,1,2,4,0,0,11
38007,520598,1,2,5,1,0,12
38008,520598,1,2,6,1,0,13
38009,520598,1,3,1,6,0,19
38010,520598,1,3,2,0,0,19
38011,520598,1,3,3,4,0,23
38012,520598,1,3,4,0,0,23
38013,520598,1,3,5,1,0,24
38014,520598,1,3,6,0,0,24
38015,520598,1,4,1,1,0,25
38016,520598,1,4,2,4,0,29
38017,520598,1,4,3,4,0,33
38018,520598,1,4,4,0,0,33
38019,520598,1,4,5,1,0,34
38020,520598,1,4,6,1,0,35
38021,520598,1,5,1,1,0,36
38022,520598,1,5,2,1,0,37
38023,520598,1,5,3,0,1,37
38024,520598,1,5,4,4,0,41
38025,520598,1,5,5,2,0,43
38026,520598,1,5,6,1,0,44
38027,520598,1,6,1,0,0,44
38028,520598,1,6,2,0,0,44
38029,520598,1,6,3,0,0,44
38030,520598,1,6,4,1,0,45
38031,520598,1,6,5,4,0,49
38032,520598,1,6,6,0,0,49
38033,520598,1,7,1,0,0,49
38034,520598,1,7,2,1,0,50
38035,520598,1,7,3,0,0,50
38036,520598,1,7,4,1,0,51
38037,520598,1,7,5,2,0,53
38038,520598,1,7,6,0,0,53
38039,520598,1,8,1,4,0,57
38040,520598,1,8,2,0,0,57
38041,520598,1,8,3,1,0,58
38042,520598,1,8,4,0,0,58
38043,520598,1,8,5,4,0,62
38044,520598,1,8,6,4,0,66
38045,520598,1,9,1,0,0,66
38046,520598,1,9,2,0,0,66
38047,520598,1,9,3,0,0,66
38048,520598,1,9,4,6,0,72
38049,520598,1,9,5,0,0,72
38050,520598,1,9,6,1,0,73
38051,520598,1,10,1,1,0,74
38052,520598,1,10,2,0,0,74
38053,520598,1,10,3,1,0,75
38054,520598,1,10,4,0,0,75
38055,520598,1,10,5,4,0,79
38056,520598,1,10,6,0,0,79
38057,520598,1,11,1,1,0,80
38058,520598,1,11,2,1,0,81
38059,520598,1,11,3,1,0,82
38060,520598,1,11,4,1,0,83
38061,520598,1,11,5,1,0,84
38062,520598,1,11,6,4,0,88
38063,520598,1,12,1,4,0,92
38064,520598,1,12,2,2,0,94
38065,520598,1,12,3,1,0,95
38066,520598,1,12,4,1,0,96
38067,520598,1,12,5,1,1,97
38068,520598,1,12,6,0,0,97
38069,520598,1,13,1,1,0,98
38070,520598,1,13,2,0,0,98
38071,520598,1,13,3,1,0,99
38072,520598,1,13,4,1,0,100
38073,520598,1,13,5,0,0,100
38074,520598,1,13,6,0,0,100
38075,520598,1,14,1,1,0,101
38076,520598,1,14,2,0,0,101
38077,520598,1,14,3,0,0,101
38078,520598,1,14,4,6,0,107
38079,520598,1,14,5,1,0,108
38080,520598,1,14,6,0,0,108
38081,520598,1,15,1,1,0,109
38082,520598,1,15,2,1,0,110
38083,520598,1,15,3,4,0,114
38084,520598,1,15,4,0,1,114
38085,520598,1,15,5,0,0,114
38086,520598,1,15,6,0,0,114
38087,520598,1,16,1,1,0,115
38088,520598,1,16,2,2,0,117
38089,520598,1,16,3,0,0,117
38090,520598,1,16,4,6,0,123
38091,520598,1,16,5,6,0,129
38092,520598,1,16,6,1,0,130
38093,520598,1,17,1,6,0,136
38094,520598,1,17,2,6,0,142
38095,520598,1,17,3,1,0,143
38096,520598,1,17,4,1,0,144
38097,520598,1,17,5,1,0,145
38098,520598,1,17,6,1,0,146
38099,520598,1,18,1,6,0,152
38100,520598,1,18,2,4,0,156
38101,520598,1,18,3,2,0,158
38102,520598,1,18,4,1,0,159
38103,520598,1,18,5,0,1,159
38104,520598,1,18,6,0,0,159
38105,520598,1,19,1,1,0,160
38106,520598,1,19,2,0,0,160
38107,520598,1,19,3,0,0,160
38108,520598,1,19,4,0,0,160
38109,520598,1,19,5,1,0,161
38110,520598,1,19,6,1,0,162
38111,520598,1,20,1,1,0,163
38112,520598,1,20,2,1,0,164
38113,520598,1,20,3,1,0,165
38114,520598,1,20,4,1,0,166
38115,520598,1,20,5,6,0,172
38116,520598,1,20,6,1,0,173
38213,520599,1,1,1,0,0,0
38214,520599,1,1,2,1,0,1
38215,520599,1,1,3,1,0,2
38216,520599,1,1,4,4,0,6
38217,520599,1,1,5,0,0,6
38218,520599,1,1,6,0,0,6
38219,520599,1,2,1,4,0,10
38220,520599,1,2,2,0,0,10
38221,520599,1,2,3,0,0,10
38222,520599,1,2,4,4,0,14
38223,520599,1,2,5,0,0,14
38224,520599,1,2,6,0,0,14
38225,520599,1,3,1,6,0,20
38226,520599,1,3,2,0,1,20
38227,520599,1,3,3,1,0,21
38228,520599,1,3,4,0,0,21
38229,520599,1,3,5,1,0,22
38230,520599,1,3,6,1,0,23
38231,520599,1,4,1,4,0,27
38232,520599,1,4,2,1,0,28
38233,520599,1,4,3,1,0,29
38234,520599,1,4,4,1,0,30
38235,520599,1,4,5,6,0,36
38236,520599,1,4,6,1,0,37
38237,520599,1,5,1,0,0,37
38238,520599,1,5,2,1,0,38
38239,520599,1,5,3,1,0,39
38240,520599,1,5,4,0,0,39
38241,520599,1,5,5,0,1,39
38242,520599,1,5,6,1,0,40
38243,520599,1,6,1,4,0,44
38244,520599,1,6,2,6,0,50
38245,520599,1,6,3,1,0,51
38246,520599,1,6,4,1,0,52
38247,520599,1,6,5,0,0,52
38248,520599,1,6,6,2,0,54
38249,520599,1,7,1,1,0,55
38250,520599,1,7,2,0,0,55
38251,520599,1,7,3,1,0,56
38252,520599,1,7,4,1,0,57
38253,520599,1,7,5,0,0,57
38254,520599,1,7,6,2,0,59
38255,520599,1,8,1,0,1,59
38256,520599,1,8,2,0,0,59
38257,520599,1,8,3,1,0,60
38258,520599,1,8,4,1,0,61
38259,520599,1,8,5,1,0,62
38260,520599,1,8,6,1,0,63
38261,520599,1,9,1,1,0,64
38262,520599,1,9,2,2,0,66
38263,520599,1,9,3,1,0,67
38264,520599,1,9,4,1,0,68
38265,520599,1,9,5,0,0,68
38266,520599,1,9,6,1,0,69
38267,520599,1,10,1,6,0,75
38268,520599,1,10,2,2,0,77
38269,520599,1,10,3,0,0,77
38270,520599,1,10,4,0,0,77
38271,520599,1,10,5,1,0,78
38272,520599,1,10,6,1,0,79
38273,520599,1,11,1,1,0,80
38274,520599,1,11,2,4,0,84
38275,520599,1,11,3,1,0,85
38276,520599,1,11,4,4,0,89
38277,520599,1,11,5,1,0,90
38278,520599,1,11,6,5,0,95
38279,520599,1,12,1,4,0,99
38280,520599,1,12,2,1,0,100
38281,520599,1,12,3,1,0,101
38282,520599,1,12,4,6,0,107
38283,520599,1,12,5,1,0,108
38284,520599,1,12,6,1,0,109
38285,520599,1,13,1,1,0,110
38286,520599,1,13,2,1,0,111
38287,520599,1,13,3,0,0,111
38288,520599,1,13,4,6,0,117
38289,520599,1,13,5,4,0,121
38290,520599,1,13,6,0,1,121
38291,520599,1,14,1,0,0,121
38292,520599,1,14,2,4,0,125
38293,520599,1,14,3,1,0,126
38294,520599,1,14,4,1,0,127
38295,520599,1,14,5,1,0,128
38296,520599,1,14,6,1,0,129
38297,520599,1,15,1,0,1,129
38298,520599,1,15,2,1,0,130
38299,520599,1,15,3,0,1,130
38300,520599,1,15,4,1,0,131
38301,520599,1,15,5,1,0,132
38302,520599,1,15,6,1,0,133
38303,520599,1,16,1,4,0,137
38304,520599,1,16,2,0,0,137
38305,520599,1,16,3,0,0,137
38306,520599,1,16,4,0,0,137
38307,520599,1,16,5,0,0,137
38308,520599,1,16,6,0,0,137
38309,520599,1,17,1,0,0,137
38310,520599,1,17,2,0,0,137
38311,520599,1,17,3,0,0,137
38312,520599,1,17,4,0,0,137
38313,520599,1,17,5,0,1,137
38314,520599,1,17,6,1,0,138
38315,520599,1,18,1,2,0,140
38316,520599,1,18,2,1,0,141
38317,520599,1,18,3,0,0,141
38318,520599,1,18,4,1,0,142
38319,520599,1,18,5,2,0,144
38320,520599,1,18,6,4,0,148
38321,520599,1,19,1,0,0,148
38322,520599,1,19,2,1,0,149
38323,520599,1,19,3,0,0,149
38324,520599,1,19,4,1,0,150
38325,520599,1,19,5,1,0,151
38326,520599,1,19,6,1,0,152
38327,520599,1,20,1,6,0,158
38328,520599,1,20,2,0,0,158
38329,520599,1,20,3,1,0,159
38330,520599,1,20,4,2,0,161
38331,520599,1,20,5,0,0,161
38332,520599,1,20,6,4,0,165
38453,521217,1,1,1,1,0,1
38454,521217,1,1,2,0,0,1
38455,521217,1,1,3,0,0,1
38456,521217,1,1,4,0,1,1
38457,521217,1,1,5,0,0,1
38458,521217,1,1,6,4,0,5
38459,521217,1,2,1,0,0,5
38460,521217,1,2,2,0,1,5
38461,521217,1,2,3,0,0,5
38462,521217,1,2,4,0,0,5
38463,521217,1,2,5,0,0,5
38464,521217,1,2,6,0,0,5
38465,521217,1,3,1,0,0,5
38466,521217,1,3,2,0,0,5
38467,521217,1,3,3,0,0,5
38468,521217,1,3,4,1,0,6
38469,521217,1,3,5,0,0,6
38470,521217,1,3,6,6,0,12
38471,521217,1,4,1,0,0,12
38472,521217,1,4,2,4,0,16
38473,521217,1,4,3,0,0,16
38474,521217,1,4,4,0,0,16
38475,521217,1,4,5,4,0,20
38476,521217,1,4,6,1,0,21
38477,521217,1,5,1,0,0,21
38478,521217,1,5,2,1,0,22
38479,521217,1,5,3,0,0,22
38480,521217,1,5,4,4,0,26
38481,521217,1,5,5,0,0,26
38482,521217,1,5,6,0,0,26
38483,521217,1,6,1,0,0,26
38484,521217,1,6,2,0,1,26
38485,521217,1,6,3,1,0,27
38486,521217,1,6,4,1,0,28
38487,521217,1,6,5,0,0,28
38488,521217,1,6,6,4,0,32
38489,521217,1,7,1,1,0,33
38490,521217,1,7,2,1,0,34
38491,521217,1,7,3,2,0,36
38492,521217,1,7,4,1,0,37
38493,521217,1,7,5,0,0,37
38494,521217,1,7,6,1,0,38
38495,521217,1,8,1,4,0,42
38496,521217,1,8,2,1,0,43
38497,521217,1,8,3,1,0,44
38498,521217,1,8,4,6,0,50
38499,521217,1,8,5,2,0,52
38500,521217,1,8,6,2,0,54
38501,521217,1,9,1,0,0,54
38502,521217,1,9,2,0,0,54
38503,521217,1,9,3,2,0,56
38504,521217,1,9,4,2,0,58
38505,521217,1,9,5,2,0,60
38506,521217,1,9,6,1,0,61
38507,521217,1,10,1,1,0,62
38508,521217,1,10,2,1,0,63
38509,521217,1,10,3,1,0,64
38510,521217,1,10,4,1,0,65
38511,521217,1,10,5,0,0,65
38512,521217,1,10,6,0,0,65
38513,521217,1,11,1,0,0,65
38514,521217,1,11,2,1,0,66
38515,521217,1,11,3,0,0,66
38516,521217,1,11,4,0,1,66
38517,521217,1,11,5,0,0,66
38518,521217,1,11,6,0,0,66
38519,521217,1,12,1,4,0,70
38520,521217,1,12,2,1,0,71
38521,521217,1,12,3,3,0,74
38522,521217,1,12,4,0,0,74
38523,521217,1,12,5,0,1,74
38524,521217,1,12,6,0,1,74
38525,521217,1,13,1,0,0,74
38526,521217,1,13,2,1,0,75
38527,521217,1,13,3,0,0,75
38528,521217,1,13,4,4,0,79
38529,521217,1,13,5,1,0,80
38530,521217,1,13,6,1,0,81
38531,521217,1,14,1,1,0,82
38532,521217,1,14,2,1,0,83
38533,521217,1,14,3,0,0,83
38534,521217,1,14,4,0,0,83
38535,521217,1,14,5,0,0,83
38536,521217,1,14,6,0,0,83
38537,521217,1,15,1,0,0,83
38538,521217,1,15,2,1,0,84
38539,521217,1,15,3,0,0,84
38540,521217,1,15,4,1,0,85
38541,521217,1,15,5,2,0,87
38542,521217,1,15,6,0,0,87
38543,521217,1,16,1,0,0,87
38544,521217,1,16,2,1,0,88
38545,521217,1,16,3,1,0,89
38546,521217,1,16,4,2,0,91
38547,521217,1,16,5,0,0,91
38548,521217,1,16,6,0,0,91
38549,521217,1,17,1,0,0,91
38550,521217,1,17,2,0,0,91
38551,521217,1,17,3,0,1,91
38552,521217,1,17,4,0,0,91
38553,521217,1,17,5,0,1,91
38554,521217,1,17,6,0,0,91
38555,521217,1,18,1,0,0,91
38556,521217,1,18,2,1,0,92
38557,521217,1,18,3,0,0,92
38558,521217,1,18,4,1,0,93
38559,521217,1,18,5,1,0,94
38560,521217,1,18,6,1,0,95
38561,521217,1,19,1,4,0,99
38562,521217,1,19,2,0,0,99
38563,521217,1,19,3,2,0,101
38564,521217,1,19,4,1,0,102
38565,521217,1,19,5,4,0,106
38566,521217,1,19,6,1,0,107
38567,521217,1,20,1,4,0,111
38568,521217,1,20,2,1,0,112
38569,521217,1,20,3,0,0,112
38570,521217,1,20,4,2,0,114
38571,521217,1,20,5,6,0,120
38572,521217,1,20,6,0,1,120
38685,523735,1,1,1,0,0,0
38686,523735,1,1,2,4,0,4
38687,523735,1,1,3,4,0,8
38688,523735,1,1,4,0,0,8
38689,523735,1,1,5,0,0,8
38690,523735,1,1,6,1,0,9
38691,523735,1,2,1,3,0,12
38692,523735,1,2,2,0,0,12
38693,523735,1,2,3,4,0,16
38694,523735,1,2,4,0,0,16
38695,523735,1,2,5,0,0,16
38696,523735,1,2,6,1,0,17
38697,523735,1,3,1,0,0,17
38698,523735,1,3,2,4,0,21
38699,523735,1,3,3,4,0,25
38700,523735,1,3,4,4,0,29
38701,523735,1,3,5,4,0,33
38702,523735,1,3,6,1,0,34
38703,523735,1,4,1,0,0,34
38704,523735,1,4,2,0,0,34
38705,523735,1,4,3,0,0,34
38706,523735,1,4,4,5,0,39
38707,523735,1,4,5,1,0,40
38708,523735,1,4,6,1,0,41
38709,523735,1,5,1,6,0,47
38710,523735,1,5,2,3,0,50
38711,523735,1,5,3,1,0,51
38712,523735,1,5,4,2,0,53
38713,523735,1,5,5,2,0,55
38714,523735,1,5,6,1,0,56
38715,523735,1,6,1,0,0,56
38716,523735,1,6,2,4,0,60
38717,523735,1,6,3,4,0,64
38718,523735,1,6,4,1,0,65
38719,523735,1,6,5,6,0,71
38720,523735,1,6,6,1,0,72
38721,523735,1,7,1,0,0,72
38722,523735,1,7,2,1,0,73
38723,523735,1,7,3,0,0,73
38724,523735,1,7,4,1,0,74
38725,523735,1,7,5,0,1,74
38726,523735,1,7,6,0,0,74
38727,523735,1,8,1,0,0,74
38728,523735,1,8,2,0,0,74
38729,523735,1,8,3,4,0,78
38730,523735,1,8,4,0,0,78
38731,523735,1,8,5,6,0,84
38732,523735,1,8,6,1,0,85
38733,523735,1,9,1,1,0,86
38734,523735,1,9,2,1,0,87
38735,523735,1,9,3,1,0,88
38736,523735,1,9,4,0,0,88
38737,523735,1,9,5,1,0,89
38738,523735,1,9,6,1,0,90
38739,523735,1,10,1,3,0,93
38740,523735,1,10,2,1,0,94
38741,523735,1,10,3,1,0,95
38742,523735,1,10,4,1,0,96
38743,523735,1,10,5,0,0,96
38744,523735,1,10,6,1,0,97
38745,523735,1,11,1,4,0,101
38746,523735,1,11,2,0,0,101
38747,523735,1,11,3,1,0,102
38748,523735,1,11,4,1,0,103
38749,523735,1,11,5,3,0,106
38750,523735,1,11,6,0,0,106
38751,523735,1,12,1,0,0,106
38752,523735,1,12,2,6,0,112
38753,523735,1,12,3,0,0,112
38754,523735,1,12,4,1,0,113
38755,523735,1,12,5,4,0,117
38756,523735,1,12,6,0,0,117
38757,523735,1,13,1,1,0,118
38758,523735,1,13,2,1,0,119
38759,523735,1,13,3,3,0,122
38760,523735,1,13,4,7,0,129
38761,523735,1,13,5,2,0,131
38762,523735,1,13,6,1,0,132
38763,523735,1,14,1,2,0,134
38764,523735,1,14,2,1,0,135
38765,523735,1,14,3,1,0,136
38766,523735,1,14,4,1,0,137
38767,523735,1,14,5,1,0,138
38768,523735,1,14,6,4,0,142
38769,523735,1,15,1,1,0,143
38770,523735,1,15,2,1,0,144
38771,523735,1,15,3,1,0,145
38772,523735,1,15,4,1,0,146
38773,523735,1,15,5,1,0,147
38774,523735,1,15,6,0,1,147
38775,523735,1,16,1,1,0,148
38776,523735,1,16,2,0,0,148
38777,523735,1,16,3,1,0,149
38778,523735,1,16,4,2,0,151
38779,523735,1,16,5,0,0,151
38780,523735,1,16,6,1,0,152
38781,523735,1,17,1,1,0,153
38782,523735,1,17,2,1,0,154
38783,523735,1,17,3,0,0,154
38784,523735,1,17,4,0,1,154
38785,523735,1,17,5,0,0,154
38786,523735,1,17,6,1,0,155
38787,523735,1,18,1,1,0,156
38788,523735,1,18,2,4,0,160
38789,523735,1,18,3,4,0,164
38790,523735,1,18,4,2,0,166
38791,523735,1,18,5,4,0,170
38792,523735,1,18,6,0,0,170
38793,523735,1,19,1,1,0,171
38794,523735,1,19,2,4,0,175
38795,523735,1,19,3,1,0,176
38796,523735,1,19,4,2,0,178
38797,523735,1,19,5,2,0,180
38798,523735,1,19,6,0,1,180
38799,523735,1,20,1,2,0,182
38800,523735,1,20,2,6,0,188
38801,523735,1,20,3,2,0,190
38802,523735,1,20,4,6,0,196
38803,523735,1,20,5,1,0,197
38804,523735,1,20,6,1,0,198
38897,523736,1,1,1,1,0,1
38898,523736,1,1,2,0,0,1
38899,523736,1,1,3,1,0,2
38900,523736,1,1,4,4,0,6
38901,523736,1,1,5,4,0,10
38902,523736,1,1,6,0,0,10
38903,523736,1,2,1,0,0,10
38904,523736,1,2,2,1,0,11
38905,523736,1,2,3,0,0,11
38906,523736,1,2,4,1,0,12
38907,523736,1,2,5,1,0,13
38908,523736,1,2,6,0,0,13
38909,523736,1,3,1,4,0,17
38910,523736,1,3,2,0,0,17
38911,523736,1,3,3,0,0,17
38912,523736,1,3,4,2,0,19
38913,523736,1,3,5,0,1,19
38914,523736,1,3,6,1,0,20
38915,523736,1,4,1,0,1,20
38916,523736,1,4,2,0,0,20
38917,523736,1,4,3,0,0,20
38918,523736,1,4,4,2,0,22
38919,523736,1,4,5,0,0,22
38920,523736,1,4,6,0,0,22
38921,523736,1,5,1,0,0,22
38922,523736,1,5,2,1,0,23
38923,523736,1,5,3,0,0,23
38924,523736,1,5,4,0,0,23
38925,523736,1,5,5,4,0,27
38926,523736,1,5,6,4,0,31
38927,523736,1,6,1,1,0,32
38928,523736,1,6,2,1,0,33
38929,523736,1,6,3,1,0,34
38930,523736,1,6,4,0,0,34
38931,523736,1,6,5,0,1,34
38932,523736,1,6,6,0,0,34
38933,523736,1,7,1,1,0,35
38934,523736,1,7,2,0,0,35
38935,523736,1,7,3,0,0,35
38936,523736,1,7,4,1,0,36
38937,523736,1,7,5,0,0,36
38938,523736,1,7,6,1,0,37
38939,523736,1,8,1,4,0,41
38940,523736,1,8,2,1,0,42
38941,523736,1,8,3,1,0,43
38942,523736,1,8,4,0,0,43
38943,523736,1,8,5,1,0,44
38944,523736,1,8,6,0,0,44
38945,523736,1,9,1,6,0,50
38946,523736,1,9,2,0,0,50
38947,523736,1,9,3,2,0,52
38948,523736,1,9,4,2,0,54
38949,523736,1,9,5,4,0,58
38950,523736,1,9,6,1,0,59
38951,523736,1,10,1,0,0,59
38952,523736,1,10,2,1,0,60
38953,523736,1,10,3,1,0,61
38954,523736,1,10,4,4,0,65
38955,523736,1,10,5,1,0,66
38956,523736,1,10,6,1,0,67
38957,523736,1,11,1,2,0,69
38958,523736,1,11,2,1,0,70
38959,523736,1,11,3,1,0,71
38960,523736,1,11,4,0,0,71
38961,523736,1,11,5,1,0,72
38962,523736,1,11,6,1,0,73
38963,523736,1,12,1,1,0,74
38964,523736,1,12,2,1,0,75
38965,523736,1,12,3,1,0,76
38966,523736,1,12,4,2,0,78
38967,523736,1,12,5,1,0,79
38968,523736,1,12,6,0,0,79
38969,523736,1,13,1,1,0,80
38970,523736,1,13,2,1,0,81
38971,523736,1,13,3,0,0,81
38972,523736,1,13,4,1,0,82
38973,523736,1,13,5,1,0,83
38974,523736,1,13,6,1,0,84
38975,523736,1,14,1,0,0,84
38976,523736,1,14,2,1,0,85
38977,523736,1,14,3,1,0,86
38978,523736,1,14,4,3,0,89
38979,523736,1,14,5,1,0,90
38980,523736,1,14,6,2,0,92
38981,523736,1,15,1,1,0,93
38982,523736,1,15,2,0,1,93
38983,523736,1,15,3,0,0,93
38984,523736,1,15,4,1,0,94
38985,523736,1,15,5,1,0,95
38986,523736,1,15,6,0,0,95
38987,523736,1,16,1,1,0,96
38988,523736,1,16,2,1,0,97
38989,523736,1,16,3,1,0,98
38990,523736,1,16,4,2,0,100
38991,523736,1,16,5,1,0,101
38992,523736,1,16,6,5,0,106
38993,523736,1,17,1,2,0,108
38994,523736,1,17,2,1,1,109
38995,523736,1,17,3,1,0,110
38996,523736,1,17,4,1,0,111
38997,523736,1,17,5,4,0,115
38998,523736,1,17,6,1,0,116
38999,523736,1,18,1,1,0,117
39000,523736,1,18,2,1,0,118
39001,523736,1,18,3,0,1,118
39002,523736,1,18,4,1,0,119
39003,523736,1,18,5,1,0,120
39004,523736,1,18,6,1,0,121
39005,523736,1,19,1,1,0,122
39006,523736,1,19,2,2,0,124
39007,523736,1,19,3,2,0,126
39008,523736,1,19,4,5,0,131
39009,523736,1,19,5,1,0,132
39010,523736,1,19,6,4,0,136
39011,523736,1,20,1,0,0,136
39012,523736,1,20,2,0,1,136
39013,523736,1,20,3,2,0,138
39014,523736,1,20,4,1,0,139
39015,523736,1,20,5,1,0,140
39016,523736,1,20,6,1,0,141
39137,525816,1,1,1,0,0,0
39138,525816,1,1,2,1,0,1
39139,525816,1,1,3,0,0,1
39140,525816,1,1,4,0,0,1
39141,525816,1,1,5,2,0,3
39142,525816,1,1,6,1,0,4
39143,525816,1,2,1,0,0,4
39144,525816,1,2,2,0,0,4
39145,525816,1,2,3,1,0,5
39146,525816,1,2,4,0,0,5
39147,525816,1,2,5,0,0,5
39148,525816,1,2,6,0,0,5
39149,525816,1,3,1,4,0,9
39150,525816,1,3,2,7,0,16
39151,525816,1,3,3,4,0,20
39152,525816,1,3,4,0,0,20
39153,525816,1,3,5,6,0,26
39154,525816,1,3,6,1,0,27
39155,525816,1,4,1,1,0,28
39156,525816,1,4,2,0,0,28
39157,525816,1,4,3,4,0,32
39158,525816,1,4,4,2,0,34
39159,525816,1,4,5,4,0,38
39160,525816,1,4,6,4,0,42
39161,525816,1,5,1,0,0,42
39162,525816,1,5,2,0,0,42
39163,525816,1,5,3,1,0,43
39164,525816,1,5,4,0,0,43
39165,525816,1,5,5,0,0,43
39166,525816,1,5,6,1,0,44
39167,525816,1,6,1,0,0,44
39168,525816,1,6,2,1,0,45
39169,525816,1,6,3,2,0,47
39170,525816,1,6,4,4,0,51
39171,525816,1,6,5,0,0,51
39172,525816,1,6,6,0,1,51
39173,525816,1,7,1,0,0,51
39174,525816,1,7,2,1,0,52
39175,525816,1,7,3,1,0,53
39176,525816,1,7,4,0,0,53
39177,525816,1,7,5,2,0,55
39178,525816,1,7,6,0,0,55
39179,525816,1,8,1,0,0,55
39180,525816,1,8,2,1,0,56
39181,525816,1,8,3,0,0,56
39182,525816,1,8,4,0,0,56
39183,525816,1,8,5,0,0,56
39184,525816,1,8,6,2,0,58
39185,525816,1,9,1,0,0,58
39186,525816,1,9,2,1,0,59
39187,525816,1,9,3,1,0,60
39188,525816,1,9,4,1,0,61
39189,525816,1,9,5,1,0,62
39190,525816,1,9,6,0,1,62
39191,525816,1,10,1,1,0,63
39192,525816,1,10,2,0,0,63
39193,525816,1,10,3,1,0,64
39194,525816,1,10,4,1,0,65
39195,525816,1,10,5,0,0,65
39196,525816,1,10,6,1,0,66
39197,525816,1,11,1,0,0,66
39198,525816,1,11,2,1,0,67
39199,525816,1,11,3,1,0,68
39200,525816,1,11,4,1,0,69
39201,525816,1,11,5,1,0,70
39202,525816,1,11,6,1,0,71
39203,525816,1,12,1,1,0,72
39204,525816,1,12,2,0,0,72
39205,525816,1,12,3,0,0,72
39206,525816,1,12,4,0,0,72
39207,525816,1,12,5,0,0,72
39208,525816,1,12,6,0,0,72
39209,525816,1,13,1,6,0,78
39210,525816,1,13,2,1,0,79
39211,525816,1,13,3,0,0,79
39212,525816,1,13,4,6,0,85
39213,525816,1,13,5,0,0,85
39214,525816,1,13,6,4,0,89
39215,525816,1,14,1,2,0,91
39216,525816,1,14,2,0,0,91
39217,525816,1,14,3,6,0,97
39218,525816,1,14,4,0,1,97
39219,525816,1,14,5,1,0,98
39220,525816,1,14,6,0,0,98
39221,525816,1,15,1,1,0,99
39222,525816,1,15,2,0,0,99
39223,525816,1,15,3,3,0,102
39224,525816,1,15,4,0,0,102
39225,525816,1,15,5,1,0,103
39226,525816,1,15,6,0,0,103
39227,525816,1,16,1,1,0,104
39228,525816,1,16,2,0,1,104
39229,525816,1,16,3,0,1,104
39230,525816,1,16,4,0,0,104
39231,525816,1,16,5,1,0,105
39232,525816,1,16,6,0,0,105
39233,525816,1,17,1,1,0,106
39234,525816,1,17,2,0,0,106
39235,525816,1,17,3,1,0,107
39236,525816,1,17,4,4,0,111
39237,525816,1,17,5,0,0,111
39238,525816,1,17,6,0,0,111
39239,525816,1,18,1,0,0,111
39240,525816,1,18,2,1,1,112
39241,525816,1,18,3,0,1,112
39242,525816,1,18,4,0,0,112
39243,525816,1,18,5,2,0,114
39244,525816,1,18,6,2,0,116
39245,525816,1,19,1,0,0,116
39246,525816,1,19,2,0,1,116
39247,525816,1,19,3,1,1,117
39248,525816,1,19,4,4,0,121
39249,525816,1,19,5,0,0,121
39250,525816,1,19,6,2,0,123
39251,525816,1,20,1,0,0,123
39252,525816,1,20,2,1,0,124
39253,525816,1,20,3,1,0,125
39254,525816,1,20,4,0,1,125
39347,525817,1,1,1,0,0,0
39348,525817,1,1,2,0,0,0
39349,525817,1,1,3,0,0,0
39350,525817,1,1,4,1,0,1
39351,525817,1,1,5,0,0,1
39352,525817,1,1,6,1,0,2
39353,525817,1,2,1,4,0,6
39354,525817,1,2,2,1,0,7
39355,525817,1,2,3,0,0,7
39356,525817,1,2,4,1,0,8
39357,525817,1,2,5,0,0,8
39358,525817,1,2,6,0,0,8
39359,525817,1,3,1,4,0,12
39360,525817,1,3,2,1,0,13
39361,525817,1,3,3,0,0,13
39362,525817,1,3,4,1,0,14
39363,525817,1,3,5,0,0,14
39364,525817,1,3,6,0,0,14
39365,525817,1,4,1,0,0,14
39366,525817,1,4,2,4,0,18
39367,525817,1,4,3,0,0,18
39368,525817,1,4,4,0,1,18
39369,525817,1,4,5,2,0,20
39370,525817,1,4,6,0,0,20
39371,525817,1,5,1,0,0,20
39372,525817,1,5,2,0,0,20
39373,525817,1,5,3,3,0,23
39374,525817,1,5,4,1,0,24
39375,525817,1,5,5,0,0,24
39376,525817,1,5,6,0,0,24
39377,525817,1,6,1,0,0,24
39378,525817,1,6,2,0,1,24
39379,525817,1,6,3,0,0,24
39380,525817,1,6,4,1,0,25
39381,525817,1,6,5,0,0,25
39382,525817,1,6,6,0,0,25
39383,525817,1,7,1,1,0,26
39384,525817,1,7,2,0,0,26
39385,525817,1,7,3,1,0,27
39386,525817,1,7,4,0,0,27
39387,525817,1,7,5,1,0,28
39388,525817,1,7,6,1,0,29
39389,525817,1,8,1,0,0,29
39390,525817,1,8,2,1,0,30
39391,525817,1,8,3,1,0,31
39392,525817,1,8,4,0,0,31
39393,525817,1,8,5,6,0,37
39394,525817,1,8,6,1,0,38
39395,525817,1,9,1,2,0,40
39396,525817,1,9,2,2,0,42
39397,525817,1,9,3,0,0,42
39398,525817,1,9,4,0,0,42
39399,525817,1,9,5,0,1,42
39400,525817,1,9,6,1,0,43
39401,525817,1,10,1,0,0,43
39402,525817,1,10,2,1,0,44
39403,525817,1,10,3,0,0,44
39404,525817,1,10,4,0,0,44
39405,525817,1,10,5,0,0,44
39406,525817,1,10,6,0,0,44
39407,525817,1,11,1,0,0,44
39408,525817,1,11,2,0,0,44
39409,525817,1,11,3,1,0,45
39410,525817,1,11,4,0,0,45
39411,525817,1,11,5,1,0,46
39412,525817,1,11,6,1,0,47
39413,525817,1,12,1,1,0,48
39414,525817,1,12,2,1,0,49
39415,525817,1,12,3,2,0,51
39416,525817,1,12,4,0,0,51
39417,525817,1,12,5,2,0,53
39418,525817,1,12,6,1,0,54
39419,525817,1,13,1,1,0,55
39420,525817,1,13,2,0,0,55
39421,525817,1,13,3,0,0,55
39422,525817,1,13,4,2,0,57
39423,525817,1,13,5,0,0,57
39424,525817,1,13,6,0,0,57
39425,525817,1,14,1,2,0,59
39426,525817,1,14,2,0,0,59
39427,525817,1,14,3,0,0,59
39428,525817,1,14,4,0,0,59
39429,525817,1,14,5,1,0,60
39430,525817,1,14,6,2,0,62
39431,525817,1,15,1,2,0,64
39432,525817,1,15,2,0,0,64
39433,525817,1,15,3,0,0,64
39434,525817,1,15,4,0,1,64
39435,525817,1,15,5,0,0,64
39436,525817,1,15,6,4,0,68
39437,525817,1,16,1,1,0,69
39438,525817,1,16,2,0,0,69
39439,525817,1,16,3,1,0,70
39440,525817,1,16,4,1,0,71
39441,525817,1,16,5,2,0,73
39442,525817,1,16,6,1,0,74
39443,525817,1,17,1,1,0,75
39444,525817,1,17,2,2,0,77
39445,525817,1,17,3,0,0,77
39446,525817,1,17,4,1,0,78
39447,525817,1,17,5,2,0,80
39448,525817,1,17,6,4,0,84
39449,525817,1,18,1,6,0,90
39450,525817,1,18,2,1,0,91
39451,525817,1,18,3,4,0,95
39452,525817,1,18,4,2,0,97
39453,525817,1,18,5,1,0,98
39454,525817,1,18,6,0,1,98
39455,525817,1,19,1,0,0,98
39456,525817,1,19,2,1,0,99
39457,525817,1,19,3,1,0,100
39458,525817,1,19,4,1,0,101
39459,525817,1,19,5,0,0,101
39460,525817,1,19,6,1,0,102
39461,525817,1,20,1,1,0,103
39462,525817,1,20,2,1,0,104
39463,525817,1,20,3,2,0,106
39464,525817,1,20,4,4,0,110
39465,525817,1,20,5,2,0,112
39466,525817,1,20,6,1,0,113
39567,527012,1,1,1,0,0,0
39568,527012,1,1,2,1,0,1
39569,527012,1,1,3,0,0,1
39570,527012,1,1,4,0,0,1
39571,527012,1,1,5,0,0,1
39572,527012,1,1,6,0,0,1
39573,527012,1,2,1,1,0,2
39574,527012,1,2,2,0,0,2
39575,527012,1,2,3,1,0,3
39576,527012,1,2,4,6,0,9
39577,527012,1,2,5,0,0,9
39578,527012,1,2,6,1,0,10
39579,527012,1,3,1,0,1,10
39580,527012,1,3,2,0,0,10
39581,527012,1,3,3,0,0,10
39582,527012,1,3,4,4,0,14
39583,527012,1,3,5,0,0,14
39584,527012,1,3,6,4,0,18
39585,527012,1,4,1,0,0,18
39586,527012,1,4,2,4,0,22
39587,527012,1,4,3,0,0,22
39588,527012,1,4,4,0,0,22
39589,527012,1,4,5,0,0,22
39590,527012,1,4,6,0,0,22
39591,527012,1,5,1,0,1,22
39592,527012,1,5,2,1,0,23
39593,527012,1,5,3,1,0,24
39594,527012,1,5,4,0,0,24
39595,527012,1,5,5,0,0,24
39596,527012,1,5,6,1,0,25
39597,527012,1,6,1,3,0,28
39598,527012,1,6,2,1,0,29
39599,527012,1,6,3,0,0,29
39600,527012,1,6,4,0,0,29
39601,527012,1,6,5,4,0,33
39602,527012,1,6,6,1,0,34
39603,527012,1,7,1,1,0,35
39604,527012,1,7,2,0,0,35
39605,527012,1,7,3,1,0,36
39606,527012,1,7,4,1,0,37
39607,527012,1,7,5,1,0,38
39608,527012,1,7,6,1,0,39
39609,527012,1,8,1,1,0,40
39610,527012,1,8,2,0,0,40
39611,527012,1,8,3,0,0,40
39612,527012,1,8,4,2,0,42
39613,527012,1,8,5,1,0,43
39614,527012,1,8,6,1,0,44
39615,527012,1,9,1,1,0,45
39616,527012,1,9,2,4,0,49
39617,527012,1,9,3,1,0,50
39618,527012,1,9,4,0,1,50
39619,527012,1,9,5,0,0,50
39620,527012,1,9,6,1,0,51
39621,527012,1,10,1,1,0,52
39622,527012,1,10,2,4,0,56
39623,527012,1,10,3,0,0,56
39624,527012,1,10,4,0,0,56
39625,527012,1,10,5,0,0,56
39626,527012,1,10,6,1,0,57
39627,527012,1,11,1,3,0,60
39628,527012,1,11,2,0,0,60
39629,527012,1,11,3,1,0,61
39630,527012,1,11,4,1,0,62
39631,527012,1,11,5,1,0,63
39632,527012,1,11,6,1,0,64
39633,527012,1,12,1,1,0,65
39634,527012,1,12,2,6,0,71
39635,527012,1,12,3,0,0,71
39636,527012,1,12,4,0,0,71
39637,527012,1,12,5,0,1,71
39638,527012,1,12,6,1,0,72
39639,527012,1,13,1,2,0,74
39640,527012,1,13,2,1,0,75
39641,527012,1,13,3,4,0,79
39642,527012,1,13,4,2,0,81
39643,527012,1,13,5,0,0,81
39644,527012,1,13,6,1,0,82
39645,527012,1,14,1,1,0,83
39646,527012,1,14,2,0,0,83
39647,527012,1,14,3,1,0,84
39648,527012,1,14,4,0,0,84
39649,527012,1,14,5,0,0,84
39650,527012,1,14,6,1,0,85
39651,527012,1,15,1,1,0,86
39652,527012,1,15,2,1,0,87
39653,527012,1,15,3,4,0,91
39654,527012,1,15,4,0,0,91
39655,527012,1,15,5,1,0,92
39656,527012,1,15,6,4,0,96
39657,527012,1,16,1,0,1,96
39658,527012,1,16,2,0,0,96
39659,527012,1,16,3,1,0,97
39660,527012,1,16,4,1,0,98
39661,527012,1,16,5,0,0,98
39662,527012,1,16,6,1,0,99
39663,527012,1,17,1,4,0,103
39664,527012,1,17,2,2,0,105
39665,527012,1,17,3,2,0,107
39666,527012,1,17,4,0,0,107
39667,527012,1,17,5,0,0,107
39668,527012,1,17,6,0,0,107
39669,527012,1,18,1,2,0,109
39670,527012,1,18,2,1,0,110
39671,527012,1,18,3,2,0,112
39672,527012,1,18,4,0,0,112
39673,527012,1,18,5,1,0,113
39674,527012,1,18,6,1,0,114
39675,527012,1,19,1,1,0,115
39676,527012,1,19,2,0,0,115
39677,527012,1,19,3,0,0,115
39678,527012,1,19,4,4,0,119
39679,527012,1,19,5,0,0,119
39680,527012,1,19,6,0,1,119
39681,527012,1,20,1,0,0,119
39682,527012,1,20,2,0,0,119
39683,527012,1,20,3,0,1,119
39684,527012,1,20,4,1,0,120
39685,527012,1,20,5,3,0,123
39686,527012,1,20,6,0,1,123
39768,527013,1,1,1,0,0,0
39769,527013,1,1,2,0,0,0
39770,527013,1,1,3,2,0,2
39771,527013,1,1,4,0,0,2
39772,527013,1,1,5,1,0,3
39773,527013,1,1,6,5,0,8
39774,527013,1,2,1,1,0,9
39775,527013,1,2,2,0,0,9
39776,527013,1,2,3,1,0,10
39777,527013,1,2,4,0,0,10
39778,527013,1,2,5,6,0,16
39779,527013,1,2,6,1,0,17
39780,527013,1,3,1,1,0,18
39781,527013,1,3,2,0,0,18
39782,527013,1,3,3,2,0,20
39783,527013,1,3,4,6,0,26
39784,527013,1,3,5,0,0,26
39785,527013,1,3,6,2,0,28
39786,527013,1,4,1,1,0,29
39787,527013,1,4,2,5,0,34
39788,527013,1,4,3,4,0,38
39789,527013,1,4,4,1,0,39
39790,527013,1,4,5,0,0,39
39791,527013,1,4,6,1,0,40
39792,527013,1,5,1,1,0,41
39793,527013,1,5,2,1,0,42
39794,527013,1,5,3,1,0,43
39795,527013,1,5,4,3,0,46
39796,527013,1,5,5,0,0,46
39797,527013,1,5,6,1,0,47
39798,527013,1,6,1,4,0,51
39799,527013,1,6,2,0,0,51
39800,527013,1,6,3,0,0,51
39801,527013,1,6,4,0,0,51
39802,527013,1,6,5,1,0,52
39803,527013,1,6,6,1,0,53
39804,527013,1,7,1,0,0,53
39805,527013,1,7,2,0,0,53
39806,527013,1,7,3,2,0,55
39807,527013,1,7,4,6,0,61
39808,527013,1,7,5,1,0,62
39809,527013,1,7,6,1,0,63
39810,527013,1,8,1,0,0,63
39811,527013,1,8,2,0,0,63
39812,527013,1,8,3,1,0,64
39813,527013,1,8,4,4,0,68
39814,527013,1,8,5,1,0,69
39815,527013,1,8,6,1,0,70
39816,527013,1,9,1,6,0,76
39817,527013,1,9,2,1,0,77
39818,527013,1,9,3,1,0,78
39819,527013,1,9,4,3,0,81
39820,527013,1,9,5,7,0,88
39821,527013,1,9,6,6,0,94
39822,527013,1,10,1,1,0,95
39823,527013,1,10,2,1,0,96
39824,527013,1,10,3,3,0,99
39825,527013,1,10,4,4,0,103
39826,527013,1,10,5,0,0,103
39827,527013,1,10,6,2,0,105
39828,527013,1,11,1,2,0,107
39829,527013,1,11,2,6,0,113
39830,527013,1,11,3,1,0,114
39831,527013,1,11,4,1,0,115
39832,527013,1,11,5,4,0,119
39833,527013,1,11,6,1,0,120
39834,527013,1,12,1,0,1,120
39835,527013,1,12,2,1,0,121
39836,527013,1,12,3,2,0,123
39837,527013,1,12,4,1,0,124
39838,527013,1,12,5,1,0,125
39839,527013,1,12,6,2,0,127
39840,527013,1,13,1,1,0,128
39841,527013,1,13,2,1,0,129
39842,527013,1,13,3,0,0,129
39843,527013,1,13,4,4,0,133
39844,527013,1,13,5,1,0,134
39845,527013,1,13,6,4,0,138
39846,527013,1,14,1,0,0,138
39847,527013,1,14,2,4,0,142
39848,527013,1,14,3,1,0,143
39849,527013,1,14,4,0,0,143
39850,527013,1,14,5,1,0,144
39851,527013,1,14,6,1,0,145
39852,527013,1,15,1,2,0,147
39853,527013,1,15,2,1,0,148
39854,527013,1,15,3,1,0,149
39855,527013,1,15,4,1,0,150
39856,527013,1,15,5,0,0,150
39857,527013,1,15,6,4,0,154
39858,527013,1,16,1,0,0,154
39859,527013,1,16,2,4,0,158
39860,527013,1,16,3,1,0,159
39861,527013,1,16,4,2,0,161
39862,527013,1,16,5,6,0,167
39863,527013,1,16,6,4,0,171
39864,527013,1,17,1,1,0,172
39865,527013,1,17,2,0,1,172
39866,527013,1,17,3,1,0,173
39867,527013,1,17,4,1,0,174
39868,527013,1,17,5,6,0,180
39869,527013,1,17,6,1,0,181
39870,527013,1,18,1,0,0,181
39871,527013,1,18,2,2,0,183
39872,527013,1,18,3,1,0,184
39873,527013,1,18,4,1,0,185
39874,527013,1,18,5,1,0,186
39875,527013,1,18,6,1,1,187
39977,530432,1,1,1,4,0,4
39978,530432,1,1,2,0,0,4
39979,530432,1,1,3,0,0,4
39980,530432,1,1,4,0,0,4
39981,530432,1,1,5,0,0,4
39982,530432,1,1,6,0,0,4
39983,530432,1,2,1,6,0,10
39984,530432,1,2,2,4,0,14
39985,530432,1,2,3,2,0,16
39986,530432,1,2,4,2,0,18
39987,530432,1,2,5,0,0,18
39988,530432,1,2,6,0,0,18
39989,530432,1,3,1,0,0,18
39990,530432,1,3,2,0,0,18
39991,530432,1,3,3,4,0,22
39992,530432,1,3,4,5,0,27
39993,530432,1,3,5,0,0,27
39994,530432,1,3,6,2,0,29
39995,530432,1,4,1,1,0,30
39996,530432,1,4,2,0,1,30
39997,530432,1,4,3,1,0,31
39998,530432,1,4,4,4,0,35
39999,530432,1,4,5,1,0,36
40000,530432,1,4,6,4,0,40
40001,530432,1,5,1,2,0,42
40002,530432,1,5,2,7,0,49
40003,530432,1,5,3,0,0,49
40004,530432,1,5,4,1,0,50
40005,530432,1,5,5,1,0,51
40006,530432,1,5,6,4,0,55
40007,530432,1,6,1,2,0,57
40008,530432,1,6,2,4,0,61
40009,530432,1,6,3,0,1,61
40010,530432,1,6,4,0,0,61
40011,530432,1,6,5,0,0,61
40012,530432,1,6,6,2,0,63
40013,530432,1,7,1,1,0,64
40014,530432,1,7,2,1,0,65
40015,530432,1,7,3,1,0,66
40016,530432,1,7,4,1,0,67
40017,530432,1,7,5,1,0,68
40018,530432,1,7,6,1,0,69
40019,530432,1,8,1,2,0,71
40020,530432,1,8,2,0,0,71
40021,530432,1,8,3,4,0,75
40022,530432,1,8,4,1,0,76
40023,530432,1,8,5,1,0,77
40024,530432,1,8,6,1,0,78
40025,530432,1,9,1,2,0,80
40026,530432,1,9,2,1,0,81
40027,530432,1,9,3,1,0,82
40028,530432,1,9,4,1,0,83
40029,530432,1,9,5,1,0,84
40030,530432,1,9,6,1,0,85
40031,530432,1,10,1,2,0,87
40032,530432,1,10,2,0,1,87
40033,530432,1,10,3,1,0,88
40034,530432,1,10,4,1,0,89
40035,530432,1,10,5,1,0,90
40036,530432,1,10,6,1,0,91
40037,530432,1,11,1,1,0,92
40038,530432,1,11,2,0,0,92
40039,530432,1,11,3,1,0,93
40040,530432,1,11,4,1,0,94
40041,530432,1,11,5,0,0,94
40042,530432,1,11,6,1,0,95
40043,530432,1,12,1,1,0,96
40044,530432,1,12,2,1,0,97
40045,530432,1,12,3,1,0,98
40046,530432,1,12,4,1,0,99
40047,530432,1,12,5,1,0,100
40048,530432,1,12,6,0,0,100
40049,530432,1,13,1,1,0,101
40050,530432,1,13,2,1,0,102
40051,530432,1,13,3,1,0,103
40052,530432,1,13,4,1,0,104
40053,530432,1,13,5,0,0,104
40054,530432,1,13,6,1,0,105
40055,530432,1,14,1,1,0,106
40056,530432,1,14,2,1,0,107
40057,530432,1,14,3,1,0,108
40058,530432,1,14,4,0,0,108
40059,530432,1,14,5,2,0,110
40060,530432,1,14,6,0,0,110
40061,530432,1,15,1,1,0,111
40062,530432,1,15,2,4,0,115
40063,530432,1,15,3,1,0,116
40064,530432,1,15,4,1,0,117
40065,530432,1,15,5,1,0,118
40066,530432,1,15,6,1,0,119
40067,530432,1,16,1,0,0,119
40068,530432,1,16,2,0,1,119
40069,530432,1,16,3,0,0,119
40070,530432,1,16,4,0,0,119
40071,530432,1,16,5,1,0,120
40072,530432,1,16,6,4,0,124
40073,530432,1,17,1,1,0,125
40074,530432,1,17,2,1,0,126
40075,530432,1,17,3,1,0,127
40076,530432,1,17,4,1,0,128
40077,530432,1,17,5,1,0,129
40078,530432,1,17,6,1,0,130
40079,530432,1,18,1,1,0,131
40080,530432,1,18,2,1,0,132
40081,530432,1,18,3,1,0,133
40082,530432,1,18,4,0,1,133
40083,530432,1,18,5,1,0,134
40084,530432,1,18,6,0,0,134
40085,530432,1,19,1,4,0,138
40086,530432,1,19,2,0,1,138
40087,530432,1,19,3,1,0,139
40088,530432,1,19,4,0,1,139
40089,530432,1,19,5,1,0,140
40090,530432,1,19,6,0,1,140
40091,530432,1,20,1,1,0,141
40092,530432,1,20,2,0,1,141
40093,530432,1,20,3,0,1,141
40211,531635,1,1,1,1,0,1
40212,531635,1,1,2,2,0,3
40213,531635,1,1,3,4,0,7
40214,531635,1,1,4,0,0,7
40215,531635,1,1,5,1,0,8
40216,531635,1,1,6,0,0,8
40217,531635,1,2,1,0,0,8
40218,531635,1,2,2,0,0,8
40219,531635,1,2,3,1,0,9
40220,531635,1,2,4,0,0,9
40221,531635,1,2,5,4,0,13
40222,531635,1,2,6,4,0,17
40223,531635,1,3,1,6,0,23
40224,531635,1,3,2,2,0,25
40225,531635,1,3,3,3,0,28
40226,531635,1,3,4,4,0,32
40227,531635,1,3,5,0,1,32
40228,531635,1,3,6,4,0,36
40229,531635,1,4,1,1,0,37
40230,531635,1,4,2,0,0,37
40231,531635,1,4,3,0,0,37
40232,531635,1,4,4,0,0,37
40233,531635,1,4,5,1,0,38
40234,531635,1,4,6,0,0,38
40235,531635,1,5,1,4,0,42
40236,531635,1,5,2,0,0,42
40237,531635,1,5,3,1,0,43
40238,531635,1,5,4,1,0,44
40239,531635,1,5,5,1,0,45
40240,531635,1,5,6,1,0,46
40241,531635,1,6,1,0,0,46
40242,531635,1,6,2,0,0,46
40243,531635,1,6,3,1,0,47
40244,531635,1,6,4,0,0,47
40245,531635,1,6,5,0,0,47
40246,531635,1,6,6,2,0,49
40247,531635,1,7,1,0,0,49
40248,531635,1,7,2,2,0,51
40249,531635,1,7,3,1,0,52
40250,531635,1,7,4,3,0,55
40251,531635,1,7,5,1,0,56
40252,531635,1,7,6,1,0,57
40253,531635,1,8,1,0,0,57
40254,531635,1,8,2,1,0,58
40255,531635,1,8,3,4,0,62
40256,531635,1,8,4,1,0,63
40257,531635,1,8,5,1,0,64
40258,531635,1,8,6,1,0,65
40259,531635,1,9,1,0,1,65
40260,531635,1,9,2,0,0,65
40261,531635,1,9,3,0,1,65
40262,531635,1,9,4,0,0,65
40263,531635,1,9,5,1,0,66
40264,531635,1,9,6,0,0,66
40265,531635,1,10,1,0,0,66
40266,531635,1,10,2,4,0,70
40267,531635,1,10,3,1,0,71
40268,531635,1,10,4,1,0,72
40269,531635,1,10,5,1,0,73
40270,531635,1,10,6,0,0,73
40271,531635,1,11,1,0,1,73
40272,531635,1,11,2,0,0,73
40273,531635,1,11,3,0,0,73
40274,531635,1,11,4,0,1,73
40275,531635,1,11,5,0,0,73
40276,531635,1,11,6,0,0,73
40277,531635,1,12,1,2,0,75
40278,531635,1,12,2,0,0,75
40279,531635,1,12,3,0,0,75
40280,531635,1,12,4,0,0,75
40281,531635,1,12,5,1,0,76
40282,531635,1,12,6,0,0,76
40283,531635,1,13,1,1,0,77
40284,531635,1,13,2,1,0,78
40285,531635,1,13,3,1,0,79
40286,531635,1,13,4,0,0,79
40287,531635,1,13,5,0,0,79
40288,531635,1,13,6,1,0,80
40289,531635,1,14,1,1,0,81
40290,531635,1,14,2,1,0,82
40291,531635,1,14,3,0,0,82
40292,531635,1,14,4,1,0,83
40293,531635,1,14,5,1,0,84
40294,531635,1,14,6,6,0,90
40295,531635,1,15,1,1,0,91
40296,531635,1,15,2,1,0,92
40297,531635,1,15,3,4,0,96
40298,531635,1,15,4,1,0,97
40299,531635,1,15,5,1,0,98
40300,531635,1,15,6,1,0,99
40301,531635,1,16,1,1,0,100
40302,531635,1,16,2,0,0,100
40303,531635,1,16,3,1,0,101
40304,531635,1,16,4,6,0,107
40305,531635,1,16,5,1,0,108
40306,531635,1,16,6,1,0,109
40307,531635,1,17,1,4,0,113
40308,531635,1,17,2,0,0,113
40309,531635,1,17,3,2,0,115
40310,531635,1,17,4,2,0,117
40311,531635,1,17,5,1,0,118
40312,531635,1,17,6,0,0,118
40313,531635,1,18,1,1,0,119
40314,531635,1,18,2,1,0,120
40315,531635,1,18,3,0,0,120
40316,531635,1,18,4,1,0,121
40317,531635,1,18,5,1,0,122
40318,531635,1,18,6,1,0,123
40319,531635,1,19,1,4,0,127
40320,531635,1,19,2,1,0,128
40321,531635,1,19,3,1,0,129
40322,531635,1,19,4,0,0,129
40323,531635,1,19,5,4,0,133
40324,531635,1,19,6,2,0,135
40325,531635,1,20,1,0,0,135
40326,531635,1,20,2,4,0,139
40327,531635,1,20,3,1,0,140
40328,531635,1,20,4,0,0,140
40329,531635,1,20,5,4,0,144
40330,531635,1,20,6,0,1,144
40451,531636,1,1,1,4,0,4
40452,531636,1,1,2,1,0,5
40453,531636,1,1,3,0,0,5
40454,531636,1,1,4,2,0,7
40455,531636,1,1,5,0,0,7
40456,531636,1,1,6,0,0,7
40457,531636,1,2,1,0,0,7
40458,531636,1,2,2,0,0,7
40459,531636,1,2,3,4,0,11
40460,531636,1,2,4,1,0,12
40461,531636,1,2,5,0,0,12
40462,531636,1,2,6,0,0,12
40463,531636,1,3,1,0,0,12
40464,531636,1,3,2,1,0,13
40465,531636,1,3,3,1,0,14
40466,531636,1,3,4,2,0,16
40467,531636,1,3,5,2,0,18
40468,531636,1,3,6,1,0,19
40469,531636,1,4,1,1,0,20
40470,531636,1,4,2,4,0,24
40471,531636,1,4,3,1,0,25
40472,531636,1,4,4,2,0,27
40473,531636,1,4,5,4,0,31
40474,531636,1,4,6,4,0,35
40475,531636,1,5,1,0,0,35
40476,531636,1,5,2,0,1,35
40477,531636,1,5,3,0,0,35
40478,531636,1,5,4,0,0,35
40479,531636,1,5,5,1,0,36
40480,531636,1,5,6,1,0,37
40481,531636,1,6,1,1,0,38
40482,531636,1,6,2,0,1,38
40483,531636,1,6,3,0,0,38
40484,531636,1,6,4,4,0,42
40485,531636,1,6,5,4,0,46
40486,531636,1,6,6,0,0,46
40487,531636,1,7,1,1,0,47
40488,531636,1,7,2,1,0,48
40489,531636,1,7,3,1,0,49
40490,531636,1,7,4,0,0,49
40491,531636,1,7,5,0,1,49
40492,531636,1,7,6,1,0,50
40493,531636,1,8,1,0,0,50
40494,531636,1,8,2,2,0,52
40495,531636,1,8,3,4,0,56
40496,531636,1,8,4,1,0,57
40497,531636,1,8,5,1,0,58
40498,531636,1,8,6,0,0,58
40499,531636,1,9,1,0,0,58
40500,531636,1,9,2,1,0,59
40501,531636,1,9,3,0,0,59
40502,531636,1,9,4,4,0,63
40503,531636,1,9,5,1,0,64
40504,531636,1,9,6,1,0,65
40505,531636,1,10,1,1,0,66
40506,531636,1,10,2,6,0,72
40507,531636,1,10,3,1,0,73
40508,531636,1,10,4,6,0,79
40509,531636,1,10,5,0,1,79
40510,531636,1,10,6,0,0,79
40511,531636,1,11,1,2,0,81
40512,531636,1,11,2,1,0,82
40513,531636,1,11,3,1,0,83
40514,531636,1,11,4,4,0,87
40515,531636,1,11,5,1,0,88
40516,531636,1,11,6,1,0,89
40517,531636,1,12,1,1,0,90
40518,531636,1,12,2,0,0,90
40519,531636,1,12,3,0,0,90
40520,531636,1,12,4,1,0,91
40521,531636,1,12,5,1,0,92
40522,531636,1,12,6,2,0,94
40523,531636,1,13,1,1,0,95
40524,531636,1,13,2,1,0,96
40525,531636,1,13,3,1,0,97
40526,531636,1,13,4,0,0,97
40527,531636,1,13,5,2,0,99
40528,531636,1,13,6,0,0,99
40529,531636,1,14,1,1,0,100
40530,531636,1,14,2,0,0,100
40531,531636,1,14,3,4,0,104
40532,531636,1,14,4,0,0,104
40533,531636,1,14,5,2,0,106
40534,531636,1,14,6,0,0,106
40535,531636,1,15,1,1,0,107
40536,531636,1,15,2,4,0,111
40537,531636,1,15,3,0,0,111
40538,531636,1,15,4,1,0,112
40539,531636,1,15,5,4,0,116
40540,531636,1,15,6,0,0,116
40541,531636,1,16,1,1,0,117
40542,531636,1,16,2,1,1,118
40543,531636,1,16,3,0,0,118
40544,531636,1,16,4,1,0,119
40545,531636,1,16,5,1,0,120
40546,531636,1,16,6,4,0,124
40547,531636,1,17,1,0,0,124
40548,531636,1,17,2,1,0,125
40549,531636,1,17,3,0,0,125
40550,531636,1,17,4,2,0,127
40551,531636,1,17,5,1,0,128
40552,531636,1,17,6,1,0,129
40553,531636,1,18,1,0,0,129
40554,531636,1,18,2,1,0,130
40555,531636,1,18,3,1,0,131
40556,531636,1,18,4,0,0,131
40557,531636,1,18,5,1,0,132
40558,531636,1,18,6,0,1,132
40559,531636,1,19,1,2,0,134
40560,531636,1,19,2,1,0,135
40561,531636,1,19,3,2,0,137
40562,531636,1,19,4,0,1,137
40563,531636,1,19,5,0,0,137
40564,531636,1,19,6,1,0,138
40565,531636,1,20,1,1,0,139
40566,531636,1,20,2,2,0,141
40567,531636,1,20,3,2,0,143
40568,531636,1,20,4,0,0,143
40569,531636,1,20,5,6,0,149
40570,531636,1,20,6,1,0,150
40681,531637,1,1,1,1,0,1
40682,531637,1,1,2,1,0,2
40683,531637,1,1,3,0,0,2
40684,531637,1,1,4,4,0,6
40685,531637,1,1,5,1,0,7
40686,531637,1,1,6,0,0,7
40687,531637,1,2,1,0,0,7
40688,531637,1,2,2,1,0,8
40689,531637,1,2,3,0,0,8
40690,531637,1,2,4,0,0,8
40691,531637,1,2,5,2,0,10
40692,531637,1,2,6,1,0,11
40693,531637,1,3,1,2,0,13
40694,531637,1,3,2,4,0,17
40695,531637,1,3,3,6,0,23
40696,531637,1,3,4,0,0,23
40697,531637,1,3,5,0,0,23
40698,531637,1,3,6,0,0,23
40699,531637,1,4,1,1,0,24
40700,531637,1,4,2,1,0,25
40701,531637,1,4,3,1,0,26
40702,531637,1,4,4,0,0,26
40703,531637,1,4,5,1,0,27
40704,531637,1,4,6,1,0,28
40705,531637,1,5,1,1,0,29
40706,531637,1,5,2,0,0,29
40707,531637,1,5,3,0,1,29
40708,531637,1,5,4,0,0,29
40709,531637,1,5,5,4,0,33
40710,531637,1,5,6,1,0,34
40711,531637,1,6,1,1,0,35
40712,531637,1,6,2,1,0,36
40713,531637,1,6,3,1,0,37
40714,531637,1,6,4,0,1,37
40715,531637,1,6,5,1,0,38
40716,531637,1,6,6,1,0,39
40717,531637,1,7,1,4,0,43
40718,531637,1,7,2,0,0,43
40719,531637,1,7,3,1,0,44
40720,531637,1,7,4,1,0,45
40721,531637,1,7,5,1,0,46
40722,531637,1,7,6,2,0,48
40723,531637,1,8,1,0,0,48
40724,531637,1,8,2,1,0,49
40725,531637,1,8,3,1,0,50
40726,531637,1,8,4,1,0,51
40727,531637,1,8,5,0,0,51
40728,531637,1,8,6,1,0,52
40729,531637,1,9,1,1,0,53
40730,531637,1,9,2,1,0,54
40731,531637,1,9,3,0,0,54
40732,531637,1,9,4,0,0,54
40733,531637,1,9,5,1,0,55
40734,531637,1,9,6,1,0,56
40735,531637,1,10,1,1,0,57
40736,531637,1,10,2,1,0,58
40737,531637,1,10,3,4,0,62
40738,531637,1,10,4,0,1,62
40739,531637,1,10,5,0,0,62
40740,531637,1,10,6,0,0,62
40741,531637,1,11,1,1,0,63
40742,531637,1,11,2,0,0,63
40743,531637,1,11,3,0,0,63
40744,531637,1,11,4,1,0,64
40745,531637,1,11,5,0,0,64
40746,531637,1,11,6,1,0,65
40747,531637,1,12,1,0,0,65
40748,531637,1,12,2,0,0,65
40749,531637,1,12,3,1,0,66
40750,531637,1,12,4,4,0,70
40751,531637,1,12,5,2,0,72
40752,531637,1,12,6,0,0,72
40753,531637,1,13,1,0,0,72
40754,531637,1,13,2,0,1,72
40755,531637,1,13,3,0,0,72
40756,531637,1,13,4,1,0,73
40757,531637,1,13,5,1,0,74
40758,531637,1,13,6,1,0,75
40759,531637,1,14,1,0,0,75
40760,531637,1,14,2,1,0,76
40761,531637,1,14,3,1,0,77
40762,531637,1,14,4,0,0,77
40763,531637,1,14,5,0,0,77
40764,531637,1,14,6,0,0,77
40765,531637,1,15,1,0,0,77
40766,531637,1,15,2,6,0,83
40767,531637,1,15,3,1,0,84
40768,531637,1,15,4,2,0,86
40769,531637,1,15,5,0,0,86
40770,531637,1,15,6,1,0,87
40771,531637,1,16,1,1,0,88
40772,531637,1,16,2,0,0,88
40773,531637,1,16,3,1,0,89
40774,531637,1,16,4,0,1,89
40775,531637,1,16,5,0,0,89
40776,531637,1,16,6,0,0,89
40777,531637,1,17,1,1,0,90
40778,531637,1,17,2,2,0,92
40779,531637,1,17,3,1,0,93
40780,531637,1,17,4,2,0,95
40781,531637,1,17,5,1,0,96
40782,531637,1,17,6,1,0,97
40783,531637,1,18,1,2,0,99
40784,531637,1,18,2,6,0,105
40785,531637,1,18,3,4,0,109
40786,531637,1,18,4,0,0,109
40787,531637,1,18,5,0,1,109
40788,531637,1,18,6,0,0,109
40789,531637,1,19,1,1,0,110
40790,531637,1,19,2,1,0,111
40791,531637,1,19,3,1,0,112
40792,531637,1,19,4,1,0,113
40793,531637,1,19,5,1,0,114
40794,531637,1,19,6,4,0,118
40795,531637,1,20,1,1,0,119
40796,531637,1,20,2,1,0,120
40797,531637,1,20,3,2,0,122
40798,531637,1,20,4,0,0,122
40799,531637,1,20,5,1,0,123
40800,531637,1,20,6,6,0,129
40921,531982,1,1,1,0,0,0
40922,531982,1,1,2,1,0,1
40923,531982,1,1,3,0,0,1
40924,531982,1,1,4,0,0,1
40925,531982,1,1,5,1,0,2
40926,531982,1,1,6,0,0,2
40927,531982,1,2,1,4,0,6
40928,531982,1,2,2,0,0,6
40929,531982,1,2,3,0,0,6
40930,531982,1,2,4,4,0,10
40931,531982,1,2,5,0,0,10
40932,531982,1,2,6,1,0,11
40933,531982,1,3,1,1,0,12
40934,531982,1,3,2,2,0,14
40935,531982,1,3,3,5,0,19
40936,531982,1,3,4,0,0,19
40937,531982,1,3,5,2,0,21
40938,531982,1,3,6,0,0,21
40939,531982,1,4,1,1,0,22
40940,531982,1,4,2,0,0,22
40941,531982,1,4,3,0,0,22
40942,531982,1,4,4,1,0,23
40943,531982,1,4,5,1,0,24
40944,531982,1,4,6,1,0,25
40945,531982,1,5,1,0,0,25
40946,531982,1,5,2,0,1,25
40947,531982,1,5,3,0,0,25
40948,531982,1,5,4,0,0,25
40949,531982,1,5,5,4,0,29
40950,531982,1,5,6,1,0,30
40951,531982,1,6,1,0,0,30
40952,531982,1,6,2,4,0,34
40953,531982,1,6,3,1,0,35
40954,531982,1,6,4,6,0,41
40955,531982,1,6,5,0,0,41
40956,531982,1,6,6,6,0,47
40957,531982,1,7,1,0,0,47
40958,531982,1,7,2,1,0,48
40959,531982,1,7,3,0,0,48
40960,531982,1,7,4,1,0,49
40961,531982,1,7,5,0,0,49
40962,531982,1,7,6,1,0,50
40963,531982,1,8,1,1,0,51
40964,531982,1,8,2,1,0,52
40965,531982,1,8,3,1,0,53
40966,531982,1,8,4,1,0,54
40967,531982,1,8,5,0,0,54
40968,531982,1,8,6,0,0,54
40969,531982,1,9,1,0,0,54
40970,531982,1,9,2,0,0,54
40971,531982,1,9,3,1,0,55
40972,531982,1,9,4,0,0,55
40973,531982,1,9,5,6,0,61
40974,531982,1,9,6,0,1,61
40975,531982,1,10,1,0,0,61
40976,531982,1,10,2,0,0,61
40977,531982,1,10,3,1,0,62
40978,531982,1,10,4,0,0,62
40979,531982,1,10,5,1,0,63
40980,531982,1,10,6,2,0,65
40981,531982,1,11,1,2,0,67
40982,531982,1,11,2,1,0,68
40983,531982,1,11,3,0,0,68
40984,531982,1,11,4,1,0,69
40985,531982,1,11,5,1,0,70
40986,531982,1,11,6,0,0,70
40987,531982,1,12,1,1,0,71
40988,531982,1,12,2,0,0,71
40989,531982,1,12,3,1,0,72
40990,531982,1,12,4,4,0,76
40991,531982,1,12,5,1,0,77
40992,531982,1,12,6,0,0,77
40993,531982,1,13,1,1,0,78
40994,531982,1,13,2,0,0,78
40995,531982,1,13,3,1,0,79
40996,531982,1,13,4,0,0,79
40997,531982,1,13,5,2,0,81
40998,531982,1,13,6,2,0,83
40999,531982,1,14,1,1,0,84
41000,531982,1,14,2,4,0,88
41001,531982,1,14,3,1,0,89
41002,531982,1,14,4,0,1,89
41003,531982,1,14,5,0,0,89
41004,531982,1,14,6,0,0,89
41005,531982,1,15,1,1,0,90
41006,531982,1,15,2,0,0,90
41007,531982,1,15,3,6,0,96
41008,531982,1,15,4,1,0,97
41009,531982,1,15,5,0,0,97
41010,531982,1,15,6,0,0,97
41011,531982,1,16,1,0,0,97
41012,531982,1,16,2,1,0,98
41013,531982,1,16,3,6,0,104
41014,531982,1,16,4,0,0,104
41015,531982,1,16,5,1,1,105
41016,531982,1,16,6,0,0,105
41017,531982,1,17,1,2,0,107
41018,531982,1,17,2,0,0,107
41019,531982,1,17,3,1,0,108
41020,531982,1,17,4,2,0,110
41021,531982,1,17,5,0,1,110
41022,531982,1,17,6,1,0,111
41023,531982,1,18,1,0,1,111
41024,531982,1,18,2,1,0,112
41025,531982,1,18,3,1,0,113
41026,531982,1,18,4,0,0,113
41027,531982,1,18,5,1,0,114
41028,531982,1,18,6,1,0,115
41029,531982,1,19,1,0,0,115
41030,531982,1,19,2,1,0,116
41031,531982,1,19,3,1,0,117
41032,531982,1,19,4,4,0,121
41033,531982,1,19,5,1,0,122
41034,531982,1,19,6,6,0,128
41035,531982,1,20,1,1,0,129
41036,531982,1,20,2,0,1,129
41037,531982,1,20,3,1,0,130
41038,531982,1,20,4,1,0,131
41039,531982,1,20,5,0,1,131
41040,531982,1,20,6,1,0,132
41160,533272,1,1,1,4,0,4
41161,533272,1,1,2,0,0,4
41162,533272,1,1,3,0,0,4
41163,533272,1,1,4,0,0,4
41164,533272,1,1,5,0,0,4
41165,533272,1,1,6,0,0,4
41166,533272,1,2,1,0,0,4
41167,533272,1,2,2,0,0,4
41168,533272,1,2,3,4,0,8
41169,533272,1,2,4,2,0,10
41170,533272,1,2,5,0,0,10
41171,533272,1,2,6,0,0,10
41172,533272,1,3,1,0,0,10
41173,533272,1,3,2,1,0,11
41174,533272,1,3,3,5,0,16
41175,533272,1,3,4,0,0,16
41176,533272,1,3,5,2,0,18
41177,533272,1,3,6,1,0,19
41178,533272,1,4,1,0,0,19
41179,533272,1,4,2,1,0,20
41180,533272,1,4,3,3,0,23
41181,533272,1,4,4,0,0,23
41182,533272,1,4,5,5,0,28
41183,533272,1,4,6,1,0,29
41184,533272,1,5,1,0,0,29
41185,533272,1,5,2,4,0,33
41186,533272,1,5,3,1,0,34
41187,533272,1,5,4,2,0,36
41188,533272,1,5,5,1,0,37
41189,533272,1,5,6,1,0,38
41190,533272,1,6,1,1,0,39
41191,533272,1,6,2,1,0,40
41192,533272,1,6,3,4,0,44
41193,533272,1,6,4,4,0,48
41194,533272,1,6,5,1,0,49
41195,533272,1,6,6,4,0,53
41196,533272,1,7,1,0,0,53
41197,533272,1,7,2,1,0,54
41198,533272,1,7,3,0,1,54
41199,533272,1,7,4,0,0,54
41200,533272,1,7,5,0,0,54
41201,533272,1,7,6,1,0,55
41202,533272,1,8,1,1,0,56
41203,533272,1,8,2,1,0,57
41204,533272,1,8,3,1,0,58
41205,533272,1,8,4,1,0,59
41206,533272,1,8,5,0,0,59
41207,533272,1,8,6,0,0,59
41208,533272,1,9,1,1,0,60
41209,533272,1,9,2,4,0,64
41210,533272,1,9,3,1,0,65
41211,533272,1,9,4,2,0,67
41212,533272,1,9,5,2,0,69
41213,533272,1,9,6,1,0,70
41214,533272,1,10,1,1,0,71
41215,533272,1,10,2,2,0,73
41216,533272,1,10,3,1,0,74
41217,533272,1,10,4,1,0,75
41218,533272,1,10,5,0,1,75
41219,533272,1,10,6,1,0,76
41220,533272,1,11,1,2,0,78
41221,533272,1,11,2,1,0,79
41222,533272,1,11,3,0,0,79
41223,533272,1,11,4,0,0,79
41224,533272,1,11,5,0,0,79
41225,533272,1,11,6,1,0,80
41226,533272,1,12,1,1,0,81
41227,533272,1,12,2,0,0,81
41228,533272,1,12,3,1,1,82
41229,533272,1,12,4,2,0,84
41230,533272,1,12,5,1,0,85
41231,533272,1,12,6,1,0,86
41232,533272,1,13,1,0,0,86
41233,533272,1,13,2,1,0,87
41234,533272,1,13,3,1,0,88
41235,533272,1,13,4,1,0,89
41236,533272,1,13,5,3,0,92
41237,533272,1,13,6,4,0,96
41238,533272,1,14,1,1,0,97
41239,533272,1,14,2,0,0,97
41240,533272,1,14,3,1,0,98
41241,533272,1,14,4,1,0,99
41242,533272,1,14,5,4,0,103
41243,533272,1,14,6,4,0,107
41244,533272,1,15,1,1,0,108
41245,533272,1,15,2,6,0,114
41246,533272,1,15,3,0,0,114
41247,533272,1,15,4,0,0,114
41248,533272,1,15,5,4,0,118
41249,533272,1,15,6,2,0,120
41250,533272,1,16,1,2,0,122
41251,533272,1,16,2,1,0,123
41252,533272,1,16,3,1,0,124
41253,533272,1,16,4,0,0,124
41254,533272,1,16,5,1,0,125
41255,533272,1,16,6,4,0,129
41256,533272,1,17,1,2,0,131
41257,533272,1,17,2,1,0,132
41258,533272,1,17,3,1,0,133
41259,533272,1,17,4,4,0,137
41260,533272,1,17,5,1,0,138
41261,533272,1,17,6,1,0,139
41262,533272,1,18,1,1,0,140
41263,533272,1,18,2,1,0,141
41264,533272,1,18,3,2,0,143
41265,533272,1,18,4,3,0,146
41266,533272,1,18,5,2,0,148
41267,533272,1,18,6,2,0,150
41268,533272,1,19,1,5,0,155
41269,533272,1,19,2,4,0,159
41270,533272,1,19,3,4,0,163
41271,533272,1,19,4,2,0,165
41272,533272,1,19,5,1,0,166
41273,533272,1,19,6,1,0,167
41274,533272,1,20,1,1,0,168
41275,533272,1,20,2,1,0,169
41276,533272,1,20,3,6,0,175
41277,533272,1,20,4,1,1,176
41278,533272,1,20,5,6,0,182
41279,533272,1,20,6,0,0,182
41385,533273,1,1,1,0,1,0
41386,533273,1,1,2,0,0,0
41387,533273,1,1,3,0,0,0
41388,533273,1,1,4,0,0,0
41389,533273,1,1,5,0,0,0
41390,533273,1,1,6,4,0,4
41391,533273,1,2,1,1,0,5
41392,533273,1,2,2,0,0,5
41393,533273,1,2,3,0,0,5
41394,533273,1,2,4,1,0,6
41395,533273,1,2,5,0,0,6
41396,533273,1,2,6,0,0,6
41397,533273,1,3,1,1,0,7
41398,533273,1,3,2,4,0,11
41399,533273,1,3,3,1,0,12
41400,533273,1,3,4,1,0,13
41401,533273,1,3,5,0,0,13
41402,533273,1,3,6,0,0,13
41403,533273,1,4,1,1,0,14
41404,533273,1,4,2,1,0,15
41405,533273,1,4,3,0,1,15
41406,533273,1,4,4,1,0,16
41407,533273,1,4,5,0,0,16
41408,533273,1,4,6,0,0,16
41409,533273,1,5,1,0,0,16
41410,533273,1,5,2,4,0,20
41411,533273,1,5,3,0,0,20
41412,533273,1,5,4,4,0,24
41413,533273,1,5,5,0,0,24
41414,533273,1,5,6,0,0,24
41415,533273,1,6,1,0,0,24
41416,533273,1,6,2,1,0,25
41417,533273,1,6,3,0,0,25
41418,533273,1,6,4,0,0,25
41419,533273,1,6,5,0,1,25
41420,533273,1,6,6,4,0,29
41421,533273,1,7,1,0,0,29
41422,533273,1,7,2,2,0,31
41423,533273,1,7,3,1,0,32
41424,533273,1,7,4,0,0,32
41425,533273,1,7,5,1,0,33
41426,533273,1,7,6,0,0,33
41427,533273,1,8,1,0,0,33
41428,533273,1,8,2,0,1,33
41429,533273,1,8,3,0,0,33
41430,533273,1,8,4,1,0,34
41431,533273,1,8,5,2,0,36
41432,533273,1,8,6,0,0,36
41433,533273,1,9,1,1,0,37
41434,533273,1,9,2,1,0,38
41435,533273,1,9,3,0,0,38
41436,533273,1,9,4,2,0,40
41437,533273,1,9,5,1,0,41
41438,533273,1,9,6,0,0,41
41439,533273,1,10,1,2,0,43
41440,533273,1,10,2,0,0,43
41441,533273,1,10,3,0,0,43
41442,533273,1,10,4,1,0,44
41443,533273,1,10,5,2,0,46
41444,533273,1,10,6,0,0,46
41445,533273,1,11,1,1,0,47
41446,533273,1,11,2,0,0,47
41447,533273,1,11,3,1,0,48
41448,533273,1,11,4,1,0,49
41449,533273,1,11,5,4,0,53
41450,533273,1,11,6,0,0,53
41451,533273,1,12,1,0,0,53
41452,533273,1,12,2,0,0,53
41453,533273,1,12,3,4,0,57
41454,533273,1,12,4,4,0,61
41455,533273,1,12,5,1,0,62
41456,533273,1,12,6,0,0,62
41457,533273,1,13,1,2,0,64
41458,533273,1,13,2,4,0,68
41459,533273,1,13,3,0,0,68
41460,533273,1,13,4,0,0,68
41461,533273,1,13,5,0,0,68
41462,533273,1,13,6,1,0,69
41463,533273,1,14,1,1,0,70
41464,533273,1,14,2,1,0,71
41465,533273,1,14,3,4,0,75
41466,533273,1,14,4,1,0,76
41467,533273,1,14,5,1,0,77
41468,533273,1,14,6,4,0,81
41469,533273,1,15,1,4,0,85
41470,533273,1,15,2,0,0,85
41471,533273,1,15,3,0,1,85
41472,533273,1,15,4,1,0,86
41473,533273,1,15,5,0,0,86
41474,533273,1,15,6,0,1,86
41475,533273,1,16,1,1,0,87
41476,533273,1,16,2,0,0,87
41477,533273,1,16,3,2,0,89
41478,533273,1,16,4,0,0,89
41479,533273,1,16,5,1,0,90
41480,533273,1,16,6,1,0,91
41481,533273,1,17,1,0,0,91
41482,533273,1,17,2,4,0,95
41483,533273,1,17,3,0,0,95
41484,533273,1,17,4,1,0,96
41485,533273,1,17,5,4,0,100
41486,533273,1,17,6,1,0,101
41487,533273,1,18,1,0,1,101
41488,533273,1,18,2,1,0,102
41489,533273,1,18,3,1,0,103
41490,533273,1,18,4,0,0,103
41491,533273,1,18,5,2,0,105
41492,533273,1,18,6,1,0,106
41493,533273,1,19,1,1,0,107
41494,533273,1,19,2,0,0,107
41495,533273,1,19,3,1,0,108
41496,533273,1,19,4,0,0,108
41497,533273,1,19,5,1,0,109
41498,533273,1,19,6,2,0,111
41499,533273,1,20,1,1,0,112
41500,533273,1,20,2,1,0,113
41501,533273,1,20,3,6,0,119
41502,533273,1,20,4,2,0,121
41503,533273,1,20,5,0,0,121
41504,533273,1,20,6,2,0,123
41596,533274,1,1,1,4,0,4
41597,533274,1,1,2,1,0,5
41598,533274,1,1,3,1,0,6
41599,533274,1,1,4,1,0,7
41600,533274,1,1,5,0,0,7
41601,533274,1,1,6,1,0,8
41602,533274,1,2,1,1,0,9
41603,533274,1,2,2,0,0,9
41604,533274,1,2,3,0,0,9
41605,533274,1,2,4,1,0,10
41606,533274,1,2,5,4,0,14
41607,533274,1,2,6,1,0,15
41608,533274,1,3,1,0,1,15
41609,533274,1,3,2,0,0,15
41610,533274,1,3,3,1,0,16
41611,533274,1,3,4,0,0,16
41612,533274,1,3,5,4,0,20
41613,533274,1,3,6,0,0,20
41614,533274,1,4,1,0,0,20
41615,533274,1,4,2,0,0,20
41616,533274,1,4,3,0,0,20
41617,533274,1,4,4,0,0,20
41618,533274,1,4,5,1,0,21
41619,533274,1,4,6,1,0,22
41620,533274,1,5,1,0,1,22
41621,533274,1,5,2,1,0,23
41622,533274,1,5,3,0,0,23
41623,533274,1,5,4,0,0,23
41624,533274,1,5,5,6,0,29
41625,533274,1,5,6,0,0,29
41626,533274,1,6,1,0,0,29
41627,533274,1,6,2,4,0,33
41628,533274,1,6,3,0,0,33
41629,533274,1,6,4,1,0,34
41630,533274,1,6,5,0,0,34
41631,533274,1,6,6,0,0,34
41632,533274,1,7,1,1,0,35
41633,533274,1,7,2,1,0,36
41634,533274,1,7,3,1,0,37
41635,533274,1,7,4,1,0,38
41636,533274,1,7,5,1,0,39
41637,533274,1,7,6,2,0,41
41638,533274,1,8,1,0,0,41
41639,533274,1,8,2,1,0,42
41640,533274,1,8,3,2,0,44
41641,533274,1,8,4,1,0,45
41642,533274,1,8,5,6,0,51
41643,533274,1,8,6,0,0,51
41644,533274,1,9,1,1,0,52
41645,533274,1,9,2,4,0,56
41646,533274,1,9,3,1,0,57
41647,533274,1,9,4,1,0,58
41648,533274,1,9,5,1,0,59
41649,533274,1,9,6,1,0,60
41650,533274,1,10,1,1,0,61
41651,533274,1,10,2,1,0,62
41652,533274,1,10,3,0,0,62
41653,533274,1,10,4,3,0,65
41654,533274,1,10,5,1,0,66
41655,533274,1,10,6,2,0,68
41656,533274,1,11,1,0,1,68
41657,533274,1,11,2,1,0,69
41658,533274,1,11,3,1,0,70
41659,533274,1,11,4,0,0,70
41660,533274,1,11,5,1,0,71
41661,533274,1,11,6,1,0,72
41662,533274,1,12,1,1,0,73
41663,533274,1,12,2,0,0,73
41664,533274,1,12,3,0,0,73
41665,533274,1,12,4,1,0,74
41666,533274,1,12,5,1,0,75
41667,533274,1,12,6,0,0,75
41668,533274,1,13,1,4,0,79
41669,533274,1,13,2,0,0,79
41670,533274,1,13,3,6,0,85
41671,533274,1,13,4,1,0,86
41672,533274,1,13,5,1,0,87
41673,533274,1,13,6,1,0,88
41674,533274,1,14,1,0,0,88
41675,533274,1,14,2,4,0,92
41676,533274,1,14,3,1,0,93
41677,533274,1,14,4,4,0,97
41678,533274,1,14,5,4,0,101
41679,533274,1,14,6,1,0,102
41680,533274,1,15,1,4,0,106
41681,533274,1,15,2,1,0,107
41682,533274,1,15,3,1,0,108
41683,533274,1,15,4,1,0,109
41684,533274,1,15,5,1,0,110
41685,533274,1,15,6,1,0,111
41686,533274,1,16,1,0,0,111
41687,533274,1,16,2,1,0,112
41688,533274,1,16,3,2,0,114
41689,533274,1,16,4,0,1,114
41690,533274,1,16,5,0,0,114
41691,533274,1,16,6,1,0,115
41692,533274,1,17,1,1,0,116
41693,533274,1,17,2,1,0,117
41694,533274,1,17,3,4,0,121
41695,533274,1,17,4,0,0,121
41696,533274,1,17,5,0,0,121
41697,533274,1,17,6,1,0,122
41698,533274,1,18,1,0,0,122
41699,533274,1,18,2,4,0,126
41700,533274,1,18,3,3,0,129
41701,533274,1,18,4,0,0,129
41702,533274,1,18,5,1,0,130
41703,533274,1,18,6,1,0,131
41704,533274,1,19,1,1,0,132
41705,533274,1,19,2,1,0,133
41706,533274,1,19,3,5,0,138
41707,533274,1,19,4,1,0,139
41708,533274,1,19,5,4,0,143
41709,533274,1,19,6,0,0,143
41710,533274,1,20,1,4,0,147
41711,533274,1,20,2,1,1,148
41712,533274,1,20,3,1,0,149
41713,533274,1,20,4,0,0,149
41714,533274,1,20,5,4,0,153
41715,533274,1,20,6,6,0,159
41833,533275,1,1,1,0,0,0
41834,533275,1,1,2,0,0,0
41835,533275,1,1,3,0,0,0
41836,533275,1,1,4,0,0,0
41837,533275,1,1,5,1,0,1
41838,533275,1,1,6,0,0,1
41839,533275,1,2,1,0,0,1
41840,533275,1,2,2,1,0,2
41841,533275,1,2,3,0,0,2
41842,533275,1,2,4,0,1,2
41843,533275,1,2,5,1,0,3
41844,533275,1,2,6,0,0,3
41845,533275,1,3,1,1,0,4
41846,533275,1,3,2,0,0,4
41847,533275,1,3,3,0,0,4
41848,533275,1,3,4,0,0,4
41849,533275,1,3,5,0,0,4
41850,533275,1,3,6,0,0,4
41851,533275,1,4,1,2,0,6
41852,533275,1,4,2,0,1,6
41853,533275,1,4,3,0,0,6
41854,533275,1,4,4,1,0,7
41855,533275,1,4,5,4,0,11
41856,533275,1,4,6,0,0,11
41857,533275,1,5,1,4,0,15
41858,533275,1,5,2,1,0,16
41859,533275,1,5,3,0,0,16
41860,533275,1,5,4,0,1,16
41861,533275,1,5,5,1,0,17
41862,533275,1,5,6,0,0,17
41863,533275,1,6,1,0,0,17
41864,533275,1,6,2,1,0,18
41865,533275,1,6,3,0,0,18
41866,533275,1,6,4,1,0,19
41867,533275,1,6,5,1,0,20
41868,533275,1,6,6,1,0,21
41869,533275,1,7,1,0,0,21
41870,533275,1,7,2,1,0,22
41871,533275,1,7,3,0,0,22
41872,533275,1,7,4,2,0,24
41873,533275,1,7,5,1,0,25
41874,533275,1,7,6,1,0,26
41875,533275,1,8,1,1,0,27
41876,533275,1,8,2,0,0,27
41877,533275,1,8,3,4,0,31
41878,533275,1,8,4,1,0,32
41879,533275,1,8,5,2,0,34
41880,533275,1,8,6,0,0,34
41881,533275,1,9,1,4,0,38
41882,533275,1,9,2,1,0,39
41883,533275,1,9,3,1,0,40
41884,533275,1,9,4,0,0,40
41885,533275,1,9,5,1,0,41
41886,533275,1,9,6,2,0,43
41887,533275,1,10,1,0,0,43
41888,533275,1,10,2,1,0,44
41889,533275,1,10,3,1,0,45
41890,533275,1,10,4,4,0,49
41891,533275,1,10,5,1,0,50
41892,533275,1,10,6,1,0,51
41893,533275,1,11,1,0,0,51
41894,533275,1,11,2,0,0,51
41895,533275,1,11,3,0,0,51
41896,533275,1,11,4,0,1,51
41897,533275,1,11,5,0,1,51
41898,533275,1,11,6,0,0,51
41899,533275,1,12,1,1,0,52
41900,533275,1,12,2,2,0,54
41901,533275,1,12,3,0,0,54
41902,533275,1,12,4,1,0,55
41903,533275,1,12,5,0,0,55
41904,533275,1,12,6,2,0,57
41905,533275,1,13,1,0,0,57
41906,533275,1,13,2,0,0,57
41907,533275,1,13,3,1,0,58
41908,533275,1,13,4,0,0,58
41909,533275,1,13,5,0,0,58
41910,533275,1,13,6,0,0,58
41911,533275,1,14,1,0,0,58
41912,533275,1,14,2,2,0,60
41913,533275,1,14,3,0,0,60
41914,533275,1,14,4,0,1,60
41915,533275,1,14,5,1,0,61
41916,533275,1,14,6,0,0,61
41917,533275,1,15,1,1,0,62
41918,533275,1,15,2,1,0,63
41919,533275,1,15,3,0,0,63
41920,533275,1,15,4,0,0,63
41921,533275,1,15,5,1,0,64
41922,533275,1,15,6,1,0,65
41923,533275,1,16,1,1,0,66
41924,533275,1,16,2,0,0,66
41925,533275,1,16,3,1,0,67
41926,533275,1,16,4,1,0,68
41927,533275,1,16,5,0,0,68
41928,533275,1,16,6,1,0,69
41929,533275,1,17,1,1,0,70
41930,533275,1,17,2,0,0,70
41931,533275,1,17,3,4,0,74
41932,533275,1,17,4,1,0,75
41933,533275,1,17,5,0,1,75
41934,533275,1,17,6,0,0,75
41935,533275,1,18,1,1,0,76
41936,533275,1,18,2,0,0,76
41937,533275,1,18,3,1,0,77
41938,533275,1,18,4,0,1,77
41939,533275,1,18,5,2,0,79
41940,533275,1,18,6,1,0,80
41941,533275,1,19,1,0,0,80
41942,533275,1,19,2,1,0,81
41943,533275,1,19,3,2,0,83
41944,533275,1,19,4,1,0,84
41945,533275,1,19,5,2,0,86
41946,533275,1,19,6,0,0,86
41947,533275,1,20,1,0,0,86
41948,533275,1,20,2,2,0,88
41949,533275,1,20,3,0,0,88
41950,533275,1,20,4,0,0,88
41951,533275,1,20,5,1,0,89
41952,533275,1,20,6,4,0,93
42029,533276,1,1,1,0,0,0
42030,533276,1,1,2,0,0,0
42031,533276,1,1,3,0,0,0
42032,533276,1,1,4,0,0,0
42033,533276,1,1,5,8,0,8
42034,533276,1,1,6,0,0,8
42035,533276,1,2,1,0,0,8
42036,533276,1,2,2,0,0,8
42037,533276,1,2,3,6,0,14
42038,533276,1,2,4,0,0,14
42039,533276,1,2,5,1,0,15
42040,533276,1,2,6,1,0,16
42041,533276,1,3,1,0,0,16
42042,533276,1,3,2,0,0,16
42043,533276,1,3,3,1,0,17
42044,533276,1,3,4,0,0,17
42045,533276,1,3,5,1,0,18
42046,533276,1,3,6,0,0,18
42047,533276,1,4,1,0,0,18
42048,533276,1,4,2,1,1,19
42049,533276,1,4,3,0,0,19
42050,533276,1,4,4,0,0,19
42051,533276,1,4,5,1,0,20
42052,533276,1,4,6,1,0,21
42053,533276,1,5,1,2,0,23
42054,533276,1,5,2,1,0,24
42055,533276,1,5,3,0,0,24
42056,533276,1,5,4,4,0,28
42057,533276,1,5,5,0,0,28
42058,533276,1,5,6,1,0,29
42059,533276,1,6,1,1,0,30
42060,533276,1,6,2,1,0,31
42061,533276,1,6,3,1,0,32
42062,533276,1,6,4,1,0,33
42063,533276,1,6,5,1,0,34
42064,533276,1,6,6,0,0,34
42065,533276,1,7,1,4,0,38
42066,533276,1,7,2,5,0,43
42067,533276,1,7,3,0,0,43
42068,533276,1,7,4,1,0,44
42069,533276,1,7,5,1,0,45
42070,533276,1,7,6,0,0,45
42071,533276,1,8,1,1,0,46
42072,533276,1,8,2,2,0,48
42073,533276,1,8,3,0,0,48
42074,533276,1,8,4,1,0,49
42075,533276,1,8,5,6,0,55
42076,533276,1,8,6,1,0,56
42077,533276,1,9,1,1,0,57
42078,533276,1,9,2,4,0,61
42079,533276,1,9,3,1,0,62
42080,533276,1,9,4,2,0,64
42081,533276,1,9,5,4,0,68
42082,533276,1,9,6,1,0,69
42083,533276,1,10,1,0,0,69
42084,533276,1,10,2,0,0,69
42085,533276,1,10,3,1,0,70
42086,533276,1,10,4,0,0,70
42087,533276,1,10,5,4,0,74
42088,533276,1,10,6,1,0,75
42089,533276,1,11,1,0,0,75
42090,533276,1,11,2,1,0,76
42091,533276,1,11,3,1,0,77
42092,533276,1,11,4,1,0,78
42093,533276,1,11,5,6,0,84
42094,533276,1,11,6,0,0,84
42095,533276,1,12,1,1,0,85
42096,533276,1,12,2,4,0,89
42097,533276,1,12,3,1,0,90
42098,533276,1,12,4,6,0,96
42099,533276,1,12,5,0,0,96
42100,533276,1,12,6,1,0,97
42101,533276,1,13,1,1,0,98
42102,533276,1,13,2,4,0,102
42103,533276,1,13,3,1,0,103
42104,533276,1,13,4,1,0,104
42105,533276,1,13,5,4,0,108
42106,533276,1,13,6,1,0,109
42107,533276,1,14,1,1,0,110
42108,533276,1,14,2,0,0,110
42109,533276,1,14,3,1,0,111
42110,533276,1,14,4,0,0,111
42111,533276,1,14,5,1,0,112
42112,533276,1,14,6,1,0,113
42113,533276,1,15,1,0,1,113
42114,533276,1,15,2,1,0,114
42115,533276,1,15,3,6,0,120
42116,533276,1,15,4,2,0,122
42117,533276,1,15,5,1,0,123
42118,533276,1,15,6,0,0,123
42119,533276,1,16,1,1,0,124
42120,533276,1,16,2,1,0,125
42121,533276,1,16,3,1,0,126
42122,533276,1,16,4,0,0,126
42123,533276,1,16,5,1,0,127
42124,533276,1,16,6,1,0,128
42125,533276,1,17,1,0,0,128
42126,533276,1,17,2,6,0,134
42127,533276,1,17,3,4,0,138
42128,533276,1,17,4,4,0,142
42129,533276,1,17,5,1,0,143
42130,533276,1,17,6,0,0,143
42131,533276,1,18,1,4,0,147
42132,533276,1,18,2,1,0,148
42133,533276,1,18,3,2,0,150
42134,533276,1,18,4,4,0,154
42135,533276,1,18,5,4,0,158
42136,533276,1,18,6,0,0,158
42137,533276,1,19,1,1,0,159
42138,533276,1,19,2,1,0,160
42139,533276,1,19,3,4,0,164
42140,533276,1,19,4,4,0,168
42141,533276,1,19,5,6,0,174
42142,533276,1,19,6,1,0,175
42143,533276,1,20,1,6,0,181
42144,533276,1,20,2,1,0,182
42145,533276,1,20,3,1,0,183
42146,533276,1,20,4,2,0,185
42147,533276,1,20,5,6,0,191
42148,533276,1,20,6,0,1,191
42269,533277,1,1,1,0,0,0
42270,533277,1,1,2,0,0,0
42271,533277,1,1,3,0,0,0
42272,533277,1,1,4,0,0,0
42273,533277,1,1,5,0,0,0
42274,533277,1,1,6,0,1,0
42275,533277,1,2,1,4,0,4
42276,533277,1,2,2,0,0,4
42277,533277,1,2,3,0,0,4
42278,533277,1,2,4,1,0,5
42279,533277,1,2,5,0,0,5
42280,533277,1,2,6,0,0,5
42281,533277,1,3,1,0,0,5
42282,533277,1,3,2,0,0,5
42283,533277,1,3,3,0,0,5
42284,533277,1,3,4,1,0,6
42285,533277,1,3,5,0,0,6
42286,533277,1,3,6,4,0,10
42287,533277,1,4,1,0,0,10
42288,533277,1,4,2,1,0,11
42289,533277,1,4,3,4,0,15
42290,533277,1,4,4,0,0,15
42291,533277,1,4,5,0,0,15
42292,533277,1,4,6,0,0,15
42293,533277,1,5,1,4,0,19
42294,533277,1,5,2,4,0,23
42295,533277,1,5,3,4,0,27
42296,533277,1,5,4,1,0,28
42297,533277,1,5,5,4,0,32
42298,533277,1,5,6,6,0,38
42299,533277,1,6,1,1,0,39
42300,533277,1,6,2,0,0,39
42301,533277,1,6,3,4,0,43
42302,533277,1,6,4,1,0,44
42303,533277,1,6,5,4,0,48
42304,533277,1,6,6,4,0,52
42305,533277,1,7,1,1,0,53
42306,533277,1,7,2,0,0,53
42307,533277,1,7,3,0,0,53
42308,533277,1,7,4,1,0,54
42309,533277,1,7,5,0,0,54
42310,533277,1,7,6,2,0,56
42311,533277,1,8,1,0,0,56
42312,533277,1,8,2,0,0,56
42313,533277,1,8,3,2,0,58
42314,533277,1,8,4,1,0,59
42315,533277,1,8,5,1,0,60
42316,533277,1,8,6,0,0,60
42317,533277,1,9,1,2,0,62
42318,533277,1,9,2,0,0,62
42319,533277,1,9,3,4,0,66
42320,533277,1,9,4,1,0,67
42321,533277,1,9,5,0,0,67
42322,533277,1,9,6,2,0,69
42323,533277,1,10,1,0,1,69
42324,533277,1,10,2,1,0,70
42325,533277,1,10,3,1,0,71
42326,533277,1,10,4,2,0,73
42327,533277,1,10,5,0,0,73
42328,533277,1,10,6,1,0,74
42329,533277,1,11,1,1,0,75
42330,533277,1,11,2,1,0,76
42331,533277,1,11,3,0,0,76
42332,533277,1,11,4,1,0,77
42333,533277,1,11,5,1,0,78
42334,533277,1,11,6,1,0,79
42335,533277,1,12,1,1,0,80
42336,533277,1,12,2,0,0,80
42337,533277,1,12,3,1,0,81
42338,533277,1,12,4,1,0,82
42339,533277,1,12,5,1,0,83
42340,533277,1,12,6,1,0,84
42341,533277,1,13,1,1,0,85
42342,533277,1,13,2,6,0,91
42343,533277,1,13,3,1,0,92
42344,533277,1,13,4,2,0,94
42345,533277,1,13,5,1,0,95
42346,533277,1,13,6,4,0,99
42347,533277,1,14,1,1,0,100
42348,533277,1,14,2,1,0,101
42349,533277,1,14,3,1,0,102
42350,533277,1,14,4,1,0,103
42351,533277,1,14,5,0,0,103
42352,533277,1,14,6,2,0,105
42353,533277,1,15,1,1,0,106
42354,533277,1,15,2,1,0,107
42355,533277,1,15,3,0,0,107
42356,533277,1,15,4,1,0,108
42357,533277,1,15,5,1,0,109
42358,533277,1,15,6,0,0,109
42359,533277,1,16,1,6,0,115
42360,533277,1,16,2,1,0,116
42361,533277,1,16,3,4,0,120
42362,533277,1,16,4,6,0,126
42363,533277,1,16,5,4,0,130
42364,533277,1,16,6,1,0,131
42365,533277,1,17,1,1,0,132
42366,533277,1,17,2,2,0,134
42367,533277,1,17,3,6,0,140
42368,533277,1,17,4,1,0,141
42369,533277,1,17,5,0,0,141
42370,533277,1,17,6,0,1,141
42371,533277,1,18,1,0,0,141
42372,533277,1,18,2,3,0,144
42373,533277,1,18,3,4,0,148
42374,533277,1,18,4,2,0,150
42375,533277,1,18,5,4,0,154
42376,533277,1,18,6,1,0,155
42377,533277,1,19,1,4,0,159
42378,533277,1,19,2,0,1,159
42379,533277,1,19,3,15,0,174
42380,533277,1,19,4,6,0,180
42381,533277,1,19,5,6,0,186
42382,533277,1,19,6,1,0,187
42383,533277,1,20,1,1,0,188
42384,533277,1,20,2,4,0,192
42385,533277,1,20,3,1,0,193
42386,533277,1,20,4,1,0,194
42387,533277,1,20,5,0,1,194
42388,533277,1,20,6,2,0,196
42493,533278,1,1,1,2,0,2
42494,533278,1,1,2,0,0,2
42495,533278,1,1,3,2,0,4
42496,533278,1,1,4,0,1,4
42497,533278,1,1,5,4,0,8
42498,533278,1,1,6,1,0,9
42499,533278,1,2,1,4,0,13
42500,533278,1,2,2,1,0,14
42501,533278,1,2,3,1,0,15
42502,533278,1,2,4,4,0,19
42503,533278,1,2,5,1,0,20
42504,533278,1,2,6,1,0,21
42505,533278,1,3,1,1,0,22
42506,533278,1,3,2,2,0,24
42507,533278,1,3,3,0,0,24
42508,533278,1,3,4,2,0,26
42509,533278,1,3,5,1,0,27
42510,533278,1,3,6,0,1,27
42511,533278,1,4,1,1,0,28
42512,533278,1,4,2,2,0,30
42513,533278,1,4,3,1,0,31
42514,533278,1,4,4,0,0,31
42515,533278,1,4,5,3,0,34
42516,533278,1,4,6,1,0,35
42517,533278,1,5,1,4,0,39
42518,533278,1,5,2,1,0,40
42519,533278,1,5,3,1,0,41
42520,533278,1,5,4,6,0,47
42521,533278,1,5,5,1,0,48
42522,533278,1,5,6,2,0,50
42523,533278,1,6,1,7,0,57
42524,533278,1,6,2,2,0,59
42525,533278,1,6,3,2,0,61
42526,533278,1,6,4,2,0,63
42527,533278,1,6,5,2,0,65
42528,533278,1,6,6,0,1,65
42529,533278,1,7,1,2,0,67
42530,533278,1,7,2,0,0,67
42531,533278,1,7,3,1,0,68
42532,533278,1,7,4,0,1,68
42533,533278,1,7,5,4,0,72
42534,533278,1,7,6,6,0,78
42577,533279,1,1,1,1,0,1
42578,533279,1,1,2,0,0,1
42579,533279,1,1,3,4,0,5
42580,533279,1,1,4,2,0,7
42581,533279,1,1,5,1,0,8
42582,533279,1,1,6,0,0,8
42583,533279,1,2,1,0,0,8
42584,533279,1,2,2,0,0,8
42585,533279,1,2,3,0,1,8
42586,533279,1,2,4,1,0,9
42587,533279,1,2,5,1,0,10
42588,533279,1,2,6,1,0,11
42589,533279,1,3,1,0,0,11
42590,533279,1,3,2,0,0,11
42591,533279,1,3,3,0,0,11
42592,533279,1,3,4,0,0,11
42593,533279,1,3,5,0,0,11
42594,533279,1,3,6,0,0,11
42595,533279,1,4,1,0,0,11
42596,533279,1,4,2,3,0,14
42597,533279,1,4,3,0,0,14
42598,533279,1,4,4,1,0,15
42599,533279,1,4,5,6,0,21
42600,533279,1,4,6,4,0,25
42601,533279,1,5,1,4,0,29
42602,533279,1,5,2,0,0,29
42603,533279,1,5,3,4,0,33
42604,533279,1,5,4,4,0,37
42605,533279,1,5,5,0,0,37
42606,533279,1,5,6,6,0,43
42607,533279,1,6,1,4,0,47
42608,533279,1,6,2,0,1,47
42609,533279,1,6,3,1,0,48
42610,533279,1,6,4,4,0,52
42611,533279,1,6,5,0,0,52
42612,533279,1,6,6,1,0,53
42613,533279,1,7,1,1,0,54
42614,533279,1,7,2,0,0,54
42615,533279,1,7,3,0,0,54
42616,533279,1,7,4,1,0,55
42617,533279,1,7,5,6,0,61
42618,533279,1,7,6,1,0,62
42619,533279,1,8,1,6,0,68
42620,533279,1,8,2,1,0,69
42621,533279,1,8,3,1,0,70
42622,533279,1,8,4,0,0,70
42623,533279,1,8,5,6,0,76
42624,533279,1,8,6,4,0,80
42625,533279,1,9,1,0,0,80
42626,533279,1,9,2,1,0,81
42627,533279,1,9,3,0,0,81
42628,533279,1,9,4,1,0,82
42629,533279,1,9,5,2,0,84
42630,533279,1,9,6,4,0,88
42631,533279,1,10,1,1,0,89
42632,533279,1,10,2,1,0,90
42633,533279,1,10,3,0,0,90
42634,533279,1,10,4,1,0,91
42635,533279,1,10,5,1,0,92
42636,533279,1,10,6,1,0,93
42637,533279,1,11,1,0,1,93
42638,533279,1,11,2,1,0,94
42639,533279,1,11,3,1,0,95
42640,533279,1,11,4,0,0,95
42641,533279,1,11,5,1,0,96
42642,533279,1,11,6,1,0,97
42643,533279,1,12,1,1,0,98
42644,533279,1,12,2,0,0,98
42645,533279,1,12,3,0,0,98
42646,533279,1,12,4,0,0,98
42647,533279,1,12,5,1,0,99
42648,533279,1,12,6,0,0,99
42649,533279,1,13,1,0,0,99
42650,533279,1,13,2,4,0,103
42651,533279,1,13,3,1,0,104
42652,533279,1,13,4,0,0,104
42653,533279,1,13,5,1,0,105
42654,533279,1,13,6,6,0,111
42655,533279,1,14,1,1,0,112
42656,533279,1,14,2,1,0,113
42657,533279,1,14,3,1,0,114
42658,533279,1,14,4,6,0,120
42659,533279,1,14,5,0,0,120
42660,533279,1,14,6,4,0,124
42661,533279,1,15,1,0,0,124
42662,533279,1,15,2,1,0,125
42663,533279,1,15,3,0,0,125
42664,533279,1,15,4,6,0,131
42665,533279,1,15,5,6,0,137
42666,533279,1,15,6,1,0,138
42667,533279,1,16,1,1,0,139
42668,533279,1,16,2,1,0,140
42669,533279,1,16,3,0,1,140
42670,533279,1,16,4,1,0,141
42671,533279,1,16,5,4,0,145
42672,533279,1,16,6,0,0,145
42673,533279,1,17,1,6,0,151
42674,533279,1,17,2,1,0,152
42675,533279,1,17,3,3,0,155
42676,533279,1,17,4,0,0,155
42677,533279,1,17,5,1,0,156
42678,533279,1,17,6,2,0,158
42679,533279,1,18,1,0,0,158
42680,533279,1,18,2,4,0,162
42681,533279,1,18,3,0,1,162
42682,533279,1,18,4,1,0,163
42683,533279,1,18,5,1,0,164
42684,533279,1,18,6,1,0,165
42685,533279,1,19,1,4,0,169
42686,533279,1,19,2,2,0,171
42687,533279,1,19,3,0,1,171
42688,533279,1,19,4,3,0,174
42689,533279,1,19,5,0,0,174
42690,533279,1,19,6,1,0,175
42691,533279,1,20,1,4,0,179
42692,533279,1,20,2,6,0,185
42693,533279,1,20,3,2,0,187
42694,533279,1,20,4,0,1,187
42695,533279,1,20,5,0,1,187
42696,533279,1,20,6,4,0,191
42752,533280,1,1,1,0,0,0
42753,533280,1,1,2,0,0,0
42754,533280,1,1,3,1,0,1
42755,533280,1,1,4,0,0,1
42756,533280,1,1,5,0,0,1
42757,533280,1,1,6,0,0,1
42758,533280,1,2,1,0,0,1
42759,533280,1,2,2,6,0,7
42760,533280,1,2,3,0,0,7
42761,533280,1,2,4,0,0,7
42762,533280,1,2,5,0,0,7
42763,533280,1,2,6,2,0,9
42764,533280,1,3,1,1,0,10
42765,533280,1,3,2,1,0,11
42766,533280,1,3,3,4,0,15
42767,533280,1,3,4,2,0,17
42768,533280,1,3,5,0,0,17
42769,533280,1,3,6,4,0,21
42770,533280,1,4,1,1,0,22
42771,533280,1,4,2,0,0,22
42772,533280,1,4,3,4,0,26
42773,533280,1,4,4,1,0,27
42774,533280,1,4,5,0,0,27
42775,533280,1,4,6,1,0,28
42776,533280,1,5,1,0,0,28
42777,533280,1,5,2,4,0,32
42778,533280,1,5,3,4,0,36
42779,533280,1,5,4,1,0,37
42780,533280,1,5,5,4,0,41
42781,533280,1,5,6,1,0,42
42782,533280,1,6,1,0,0,42
42783,533280,1,6,2,1,0,43
42784,533280,1,6,3,4,0,47
42785,533280,1,6,4,0,1,47
42786,533280,1,6,5,2,0,49
42787,533280,1,6,6,2,0,51
42788,533280,1,7,1,1,0,52
42789,533280,1,7,2,6,0,58
42790,533280,1,7,3,1,0,59
42791,533280,1,7,4,1,0,60
42792,533280,1,7,5,1,0,61
42793,533280,1,7,6,0,0,61
42794,533280,1,8,1,1,0,62
42795,533280,1,8,2,1,0,63
42796,533280,1,8,3,1,0,64
42797,533280,1,8,4,2,0,66
42798,533280,1,8,5,1,0,67
42799,533280,1,8,6,6,0,73
42800,533280,1,9,1,6,0,79
42801,533280,1,9,2,0,0,79
42802,533280,1,9,3,1,0,80
42803,533280,1,9,4,6,0,86
42804,533280,1,9,5,0,0,86
42805,533280,1,9,6,0,0,86
42806,533280,1,10,1,1,0,87
42807,533280,1,10,2,0,0,87
42808,533280,1,10,3,1,0,88
42809,533280,1,10,4,2,0,90
42810,533280,1,10,5,1,0,91
42811,533280,1,10,6,1,0,92
42812,533280,1,11,1,0,0,92
42813,533280,1,11,2,4,0,96
42814,533280,1,11,3,0,0,96
42815,533280,1,11,4,2,0,98
42816,533280,1,11,5,6,0,104
42817,533280,1,11,6,1,0,105
42818,533280,1,12,1,1,0,106
42819,533280,1,12,2,1,0,107
42820,533280,1,12,3,1,0,108
42821,533280,1,12,4,1,0,109
42822,533280,1,12,5,1,0,110
42823,533280,1,12,6,0,0,110
42824,533280,1,13,1,0,0,110
42825,533280,1,13,2,1,0,111
42826,533280,1,13,3,1,0,112
42827,533280,1,13,4,4,0,116
42828,533280,1,13,5,1,0,117
42829,533280,1,13,6,1,0,118
42830,533280,1,14,1,2,0,120
42831,533280,1,14,2,1,0,121
42832,533280,1,14,3,1,0,122
42833,533280,1,14,4,1,1,123
42834,533280,1,14,5,1,0,124
42835,533280,1,14,6,1,0,125
42836,533280,1,15,1,0,0,125
42837,533280,1,15,2,1,0,126
42838,533280,1,15,3,2,0,128
42839,533280,1,15,4,1,1,129
42840,533280,1,15,5,2,0,131
42841,533280,1,15,6,0,0,131
42842,533280,1,16,1,1,0,132
42843,533280,1,16,2,1,0,133
42844,533280,1,16,3,1,0,134
42845,533280,1,16,4,0,1,134
42846,533280,1,16,5,1,0,135
42847,533280,1,16,6,0,0,135
42848,533280,1,17,1,4,0,139
42849,533280,1,17,2,4,0,143
42850,533280,1,17,3,0,0,143
42851,533280,1,17,4,1,0,144
42852,533280,1,17,5,1,0,145
42853,533280,1,17,6,0,0,145
42854,533280,1,18,1,1,0,146
42855,533280,1,18,2,1,0,147
42856,533280,1,18,3,1,0,148
42857,533280,1,18,4,0,0,148
42858,533280,1,18,5,0,0,148
42859,533280,1,18,6,0,0,148
42860,533280,1,19,1,1,0,149
42861,533280,1,19,2,4,0,153
42862,533280,1,19,3,6,0,159
42863,533280,1,19,4,0,1,159
42864,533280,1,19,5,4,0,163
42865,533280,1,19,6,2,0,165
42866,533280,1,20,1,4,0,169
42867,533280,1,20,2,1,0,170
42868,533280,1,20,3,0,0,170
42869,533280,1,20,4,2,0,172
42870,533280,1,20,5,5,0,177
42871,533280,1,20,6,0,1,177
42992,533281,1,1,1,1,0,1
42993,533281,1,1,2,0,0,1
42994,533281,1,1,3,2,0,3
42995,533281,1,1,4,1,0,4
42996,533281,1,1,5,2,0,6
42997,533281,1,1,6,0,0,6
42998,533281,1,2,1,0,0,6
42999,533281,1,2,2,0,0,6
43000,533281,1,2,3,4,0,10
43001,533281,1,2,4,4,0,14
43002,533281,1,2,5,1,0,15
43003,533281,1,2,6,1,0,16
43004,533281,1,3,1,2,0,18
43005,533281,1,3,2,1,0,19
43006,533281,1,3,3,4,0,23
43007,533281,1,3,4,1,1,24
43008,533281,1,3,5,0,0,24
43009,533281,1,3,6,4,0,28
43010,533281,1,4,1,1,0,29
43011,533281,1,4,2,4,0,33
43012,533281,1,4,3,0,0,33
43013,533281,1,4,4,0,0,33
43014,533281,1,4,5,1,0,34
43015,533281,1,4,6,0,0,34
43016,533281,1,5,1,0,0,34
43017,533281,1,5,2,1,0,35
43018,533281,1,5,3,1,0,36
43019,533281,1,5,4,4,0,40
43020,533281,1,5,5,0,0,40
43021,533281,1,5,6,1,0,41
43022,533281,1,6,1,4,0,45
43023,533281,1,6,2,0,0,45
43024,533281,1,6,3,1,0,46
43025,533281,1,6,4,4,0,50
43026,533281,1,6,5,1,0,51
43027,533281,1,6,6,1,0,52
43028,533281,1,7,1,1,0,53
43029,533281,1,7,2,1,0,54
43030,533281,1,7,3,0,0,54
43031,533281,1,7,4,1,0,55
43032,533281,1,7,5,2,0,57
43033,533281,1,7,6,1,0,58
43034,533281,1,8,1,1,0,59
43035,533281,1,8,2,1,0,60
43036,533281,1,8,3,4,0,64
43037,533281,1,8,4,0,0,64
43038,533281,1,8,5,1,0,65
43039,533281,1,8,6,1,0,66
43040,533281,1,9,1,1,0,67
43041,533281,1,9,2,0,0,67
43042,533281,1,9,3,1,0,68
43043,533281,1,9,4,0,0,68
43044,533281,1,9,5,1,0,69
43045,533281,1,9,6,1,0,70
43046,533281,1,10,1,4,0,74
43047,533281,1,10,2,1,0,75
43048,533281,1,10,3,1,0,76
43049,533281,1,10,4,1,0,77
43050,533281,1,10,5,1,0,78
43051,533281,1,10,6,2,0,80
43052,533281,1,11,1,1,0,81
43053,533281,1,11,2,0,0,81
43054,533281,1,11,3,0,1,81
43055,533281,1,11,4,0,0,81
43056,533281,1,11,5,1,0,82
43057,533281,1,11,6,1,0,83
43058,533281,1,12,1,1,0,84
43059,533281,1,12,2,0,0,84
43060,533281,1,12,3,1,0,85
43061,533281,1,12,4,1,0,86
43062,533281,1,12,5,4,0,90
43063,533281,1,12,6,1,0,91
43064,533281,1,13,1,0,0,91
43065,533281,1,13,2,1,0,92
43066,533281,1,13,3,1,0,93
43067,533281,1,13,4,1,0,94
43068,533281,1,13,5,1,0,95
43069,533281,1,13,6,2,0,97
43070,533281,1,14,1,4,0,101
43071,533281,1,14,2,1,0,102
43072,533281,1,14,3,1,0,103
43073,533281,1,14,4,1,0,104
43074,533281,1,14,5,1,0,105
43075,533281,1,14,6,1,0,106
43076,533281,1,15,1,4,0,110
43077,533281,1,15,2,1,0,111
43078,533281,1,15,3,0,0,111
43079,533281,1,15,4,1,0,112
43080,533281,1,15,5,1,0,113
43081,533281,1,15,6,1,0,114
43082,533281,1,16,1,2,0,116
43083,533281,1,16,2,1,0,117
43084,533281,1,16,3,0,0,117
43085,533281,1,16,4,2,0,119
43086,533281,1,16,5,0,1,119
43087,533281,1,16,6,0,0,119
43088,533281,1,17,1,2,0,121
43089,533281,1,17,2,4,0,125
43090,533281,1,17,3,4,0,129
43091,533281,1,17,4,0,0,129
43092,533281,1,17,5,3,0,132
43093,533281,1,17,6,0,0,132
43094,533281,1,18,1,2,0,134
43095,533281,1,18,2,1,0,135
43096,533281,1,18,3,4,0,139
43097,533281,1,18,4,2,0,141
43098,533281,1,18,5,1,0,142
43099,533281,1,18,6,1,0,143
43100,533281,1,19,1,2,0,145
43101,533281,1,19,2,4,0,149
43102,533281,1,19,3,0,0,149
43103,533281,1,19,4,1,0,150
43104,533281,1,19,5,0,0,150
43105,533281,1,19,6,3,0,153
43106,533281,1,20,1,7,0,160
43107,533281,1,20,2,4,0,164
43108,533281,1,20,3,1,0,165
43109,533281,1,20,4,1,1,166
43110,533281,1,20,5,2,0,168
43111,533281,1,20,6,2,0,170
43200,533283,1,1,1,1,0,1
43201,533283,1,1,2,0,0,1
43202,533283,1,1,3,0,0,1
43203,533283,1,1,4,4,0,5
43204,533283,1,1,5,2,0,7
43205,533283,1,1,6,0,0,7
43206,533283,1,2,1,6,0,13
43207,533283,1,2,2,0,0,13
43208,533283,1,2,3,0,0,13
43209,533283,1,2,4,0,0,13
43210,533283,1,2,5,0,0,13
43211,533283,1,2,6,0,0,13
43212,533283,1,3,1,0,0,13
43213,533283,1,3,2,4,0,17
43214,533283,1,3,3,5,0,22
43215,533283,1,3,4,0,0,22
43216,533283,1,3,5,4,0,26
43217,533283,1,3,6,4,0,30
43218,533283,1,4,1,4,0,34
43219,533283,1,4,2,0,1,34
43220,533283,1,4,3,1,0,35
43221,533283,1,4,4,0,0,35
43222,533283,1,4,5,2,0,37
43223,533283,1,4,6,0,0,37
43224,533283,1,5,1,4,0,41
43225,533283,1,5,2,4,0,45
43226,533283,1,5,3,1,0,46
43227,533283,1,5,4,1,0,47
43228,533283,1,5,5,1,0,48
43229,533283,1,5,6,1,0,49
43230,533283,1,6,1,0,0,49
43231,533283,1,6,2,4,0,53
43232,533283,1,6,3,4,0,57
43233,533283,1,6,4,4,0,61
43234,533283,1,6,5,0,1,61
43235,533283,1,6,6,0,0,61
43236,533283,1,7,1,0,0,61
43237,533283,1,7,2,1,0,62
43238,533283,1,7,3,1,0,63
43239,533283,1,7,4,2,0,65
43240,533283,1,7,5,0,0,65
43241,533283,1,7,6,0,0,65
43242,533283,1,8,1,0,0,65
43243,533283,1,8,2,2,0,67
43244,533283,1,8,3,6,0,73
43245,533283,1,8,4,0,0,73
43246,533283,1,8,5,1,0,74
43247,533283,1,8,6,0,0,74
43248,533283,1,9,1,0,0,74
43249,533283,1,9,2,0,0,74
43250,533283,1,9,3,3,0,77
43251,533283,1,9,4,0,0,77
43252,533283,1,9,5,1,0,78
43253,533283,1,9,6,0,0,78
43254,533283,1,10,1,1,0,79
43255,533283,1,10,2,1,0,80
43256,533283,1,10,3,0,0,80
43257,533283,1,10,4,2,0,82
43258,533283,1,10,5,4,0,86
43259,533283,1,10,6,4,0,90
43260,533283,1,11,1,0,0,90
43261,533283,1,11,2,1,0,91
43262,533283,1,11,3,6,0,97
43263,533283,1,11,4,4,0,101
43264,533283,1,11,5,1,0,102
43265,533283,1,11,6,0,0,102
43266,533283,1,12,1,0,0,102
43267,533283,1,12,2,1,0,103
43268,533283,1,12,3,1,0,104
43269,533283,1,12,4,1,0,105
43270,533283,1,12,5,1,0,106
43271,533283,1,12,6,0,0,106
43272,533283,1,13,1,1,0,107
43273,533283,1,13,2,0,0,107
43274,533283,1,13,3,4,0,111
43275,533283,1,13,4,6,0,117
43276,533283,1,13,5,1,0,118
43277,533283,1,13,6,0,0,118
43278,533283,1,14,1,1,0,119
43279,533283,1,14,2,0,0,119
43280,533283,1,14,3,5,0,124
43281,533283,1,14,4,1,0,125
43282,533283,1,14,5,1,0,126
43283,533283,1,14,6,1,0,127
43284,533283,1,15,1,1,0,128
43285,533283,1,15,2,0,0,128
43286,533283,1,15,3,1,0,129
43287,533283,1,15,4,0,1,129
43288,533283,1,15,5,4,0,133
43289,533283,1,15,6,0,0,133
43290,533283,1,16,1,0,0,133
43291,533283,1,16,2,0,1,133
43292,533283,1,16,3,1,0,134
43293,533283,1,16,4,1,0,135
43294,533283,1,16,5,0,0,135
43295,533283,1,16,6,1,0,136
43296,533283,1,17,1,0,0,136
43297,533283,1,17,2,2,0,138
43298,533283,1,17,3,1,0,139
43299,533283,1,17,4,1,0,140
43300,533283,1,17,5,1,0,141
43301,533283,1,17,6,1,0,142
43302,533283,1,18,1,4,0,146
43303,533283,1,18,2,0,0,146
43304,533283,1,18,3,0,0,146
43305,533283,1,18,4,2,0,148
43306,533283,1,18,5,4,0,152
43307,533283,1,18,6,4,0,156
43308,533283,1,19,1,1,0,157
43309,533283,1,19,2,2,0,159
43310,533283,1,19,3,3,0,162
43311,533283,1,19,4,1,0,163
43312,533283,1,19,5,1,0,164
43313,533283,1,19,6,4,0,168
43314,533283,1,20,1,1,0,169
43315,533283,1,20,2,1,0,170
43316,533283,1,20,3,0,1,170
43317,533283,1,20,4,1,0,171
43318,533283,1,20,5,4,0,175
43319,533283,1,20,6,0,1,175
43432,533285,1,1,1,0,0,0
43433,533285,1,1,2,2,0,2
43434,533285,1,1,3,0,0,2
43435,533285,1,1,4,0,0,2
43436,533285,1,1,5,0,0,2
43437,533285,1,1,6,4,0,6
43438,533285,1,2,1,0,0,6
43439,533285,1,2,2,0,0,6
43440,533285,1,2,3,4,0,10
43441,533285,1,2,4,2,0,12
43442,533285,1,2,5,4,0,16
43443,533285,1,2,6,4,0,20
43444,533285,1,3,1,0,0,20
43445,533285,1,3,2,0,0,20
43446,533285,1,3,3,1,0,21
43447,533285,1,3,4,0,0,21
43448,533285,1,3,5,4,0,25
43449,533285,1,3,6,1,0,26
43450,533285,1,4,1,4,0,30
43451,533285,1,4,2,1,0,31
43452,533285,1,4,3,4,0,35
43453,533285,1,4,4,2,0,37
43454,533285,1,4,5,0,0,37
43455,533285,1,4,6,0,0,37
43456,533285,1,5,1,0,0,37
43457,533285,1,5,2,1,0,38
43458,533285,1,5,3,0,0,38
43459,533285,1,5,4,2,0,40
43460,533285,1,5,5,0,0,40
43461,533285,1,5,6,0,0,40
43462,533285,1,6,1,0,0,40
43463,533285,1,6,2,4,0,44
43464,533285,1,6,3,0,0,44
43465,533285,1,6,4,1,0,45
43466,533285,1,6,5,1,0,46
43467,533285,1,6,6,1,0,47
43468,533285,1,7,1,0,0,47
43469,533285,1,7,2,0,0,47
43470,533285,1,7,3,1,0,48
43471,533285,1,7,4,0,0,48
43472,533285,1,7,5,4,0,52
43473,533285,1,7,6,1,0,53
43474,533285,1,8,1,0,0,53
43475,533285,1,8,2,1,0,54
43476,533285,1,8,3,6,0,60
43477,533285,1,8,4,0,0,60
43478,533285,1,8,5,6,0,66
43479,533285,1,8,6,6,0,72
43480,533285,1,9,1,1,0,73
43481,533285,1,9,2,1,0,74
43482,533285,1,9,3,4,0,78
43483,533285,1,9,4,6,0,84
43484,533285,1,9,5,0,0,84
43485,533285,1,9,6,6,0,90
43486,533285,1,10,1,0,0,90
43487,533285,1,10,2,1,0,91
43488,533285,1,10,3,1,0,92
43489,533285,1,10,4,1,0,93
43490,533285,1,10,5,1,0,94
43491,533285,1,10,6,1,0,95
43492,533285,1,11,1,0,0,95
43493,533285,1,11,2,0,0,95
43494,533285,1,11,3,6,0,101
43495,533285,1,11,4,1,0,102
43496,533285,1,11,5,1,0,103
43497,533285,1,11,6,0,1,103
43498,533285,1,12,1,0,0,103
43499,533285,1,12,2,1,0,104
43500,533285,1,12,3,4,0,108
43501,533285,1,12,4,0,0,108
43502,533285,1,12,5,4,0,112
43503,533285,1,12,6,2,0,114
43504,533285,1,13,1,1,0,115
43505,533285,1,13,2,0,0,115
43506,533285,1,13,3,1,0,116
43507,533285,1,13,4,0,0,116
43508,533285,1,13,5,0,0,116
43509,533285,1,13,6,2,0,118
43510,533285,1,14,1,0,0,118
43511,533285,1,14,2,0,0,118
43512,533285,1,14,3,0,0,118
43513,533285,1,14,4,0,1,118
43514,533285,1,14,5,0,0,118
43515,533285,1,14,6,0,0,118
43516,533285,1,15,1,1,0,119
43517,533285,1,15,2,0,0,119
43518,533285,1,15,3,1,0,120
43519,533285,1,15,4,2,0,122
43520,533285,1,15,5,0,0,122
43521,533285,1,15,6,6,0,128
43522,533285,1,16,1,0,1,128
43523,533285,1,16,2,4,0,132
43524,533285,1,16,3,4,0,136
43525,533285,1,16,4,2,0,138
43526,533285,1,16,5,0,0,138
43527,533285,1,16,6,2,0,140
43528,533285,1,17,1,1,0,141
43529,533285,1,17,2,1,0,142
43530,533285,1,17,3,1,0,143
43531,533285,1,17,4,1,0,144
43532,533285,1,17,5,1,0,145
43533,533285,1,17,6,1,0,146
43534,533285,1,18,1,4,0,150
43535,533285,1,18,2,0,0,150
43536,533285,1,18,3,4,0,154
43537,533285,1,18,4,0,0,154
43538,533285,1,18,5,0,1,154
43539,533285,1,18,6,0,0,154
43540,533285,1,19,1,2,0,156
43541,533285,1,19,2,2,0,158
43542,533285,1,19,3,0,1,158
43543,533285,1,19,4,0,0,158
43544,533285,1,19,5,4,0,162
43545,533285,1,19,6,2,0,164
43546,533285,1,20,1,1,0,165
43547,533285,1,20,2,4,0,169
43548,533285,1,20,3,1,0,170
43549,533285,1,20,4,4,0,174
43550,533285,1,20,5,4,0,178
43551,533285,1,20,6,1,0,179
43672,533286,1,1,1,0,0,0
43673,533286,1,1,2,1,0,1
43674,533286,1,1,3,0,0,1
43675,533286,1,1,4,2,0,3
43676,533286,1,1,5,0,0,3
43677,533286,1,1,6,0,0,3
43678,533286,1,2,1,0,0,3
43679,533286,1,2,2,0,0,3
43680,533286,1,2,3,1,0,4
43681,533286,1,2,4,4,0,8
43682,533286,1,2,5,0,1,8
43683,533286,1,2,6,1,0,9
43684,533286,1,3,1,0,0,9
43685,533286,1,3,2,0,0,9
43686,533286,1,3,3,0,0,9
43687,533286,1,3,4,0,0,9
43688,533286,1,3,5,0,0,9
43689,533286,1,3,6,0,0,9
43690,533286,1,4,1,4,0,13
43691,533286,1,4,2,1,0,14
43692,533286,1,4,3,1,0,15
43693,533286,1,4,4,0,0,15
43694,533286,1,4,5,2,0,17
43695,533286,1,4,6,1,0,18
43696,533286,1,5,1,6,0,24
43697,533286,1,5,2,0,0,24
43698,533286,1,5,3,1,0,25
43699,533286,1,5,4,1,0,26
43700,533286,1,5,5,0,0,26
43701,533286,1,5,6,1,0,27
43702,533286,1,6,1,1,0,28
43703,533286,1,6,2,0,1,28
43704,533286,1,6,3,0,0,28
43705,533286,1,6,4,0,0,28
43706,533286,1,6,5,0,0,28
43707,533286,1,6,6,0,0,28
43708,533286,1,7,1,0,1,28
43709,533286,1,7,2,0,0,28
43710,533286,1,7,3,0,0,28
43711,533286,1,7,4,1,0,29
43712,533286,1,7,5,1,0,30
43713,533286,1,7,6,1,0,31
43714,533286,1,8,1,1,0,32
43715,533286,1,8,2,1,0,33
43716,533286,1,8,3,1,0,34
43717,533286,1,8,4,1,0,35
43718,533286,1,8,5,0,0,35
43719,533286,1,8,6,0,0,35
43720,533286,1,9,1,0,0,35
43721,533286,1,9,2,1,0,36
43722,533286,1,9,3,1,0,37
43723,533286,1,9,4,0,0,37
43724,533286,1,9,5,1,0,38
43725,533286,1,9,6,1,0,39
43726,533286,1,10,1,1,0,40
43727,533286,1,10,2,1,0,41
43728,533286,1,10,3,0,0,41
43729,533286,1,10,4,1,0,42
43730,533286,1,10,5,1,0,43
43731,533286,1,10,6,4,0,47
43732,533286,1,11,1,0,0,47
43733,533286,1,11,2,1,0,48
43734,533286,1,11,3,1,0,49
43735,533286,1,11,4,2,0,51
43736,533286,1,11,5,1,0,52
43737,533286,1,11,6,0,0,52
43738,533286,1,12,1,1,0,53
43739,533286,1,12,2,1,0,54
43740,533286,1,12,3,1,0,55
43741,533286,1,12,4,4,0,59
43742,533286,1,12,5,0,0,59
43743,533286,1,12,6,0,0,59
43744,533286,1,13,1,6,0,65
43745,533286,1,13,2,1,0,66
43746,533286,1,13,3,0,1,66
43747,533286,1,13,4,1,0,67
43748,533286,1,13,5,1,0,68
43749,533286,1,13,6,2,0,70
43750,533286,1,14,1,1,0,71
43751,533286,1,14,2,1,0,72
43752,533286,1,14,3,1,0,73
43753,533286,1,14,4,1,0,74
43754,533286,1,14,5,1,0,75
43755,533286,1,14,6,0,0,75
43756,533286,1,15,1,1,0,76
43757,533286,1,15,2,0,0,76
43758,533286,1,15,3,1,0,77
43759,533286,1,15,4,1,0,78
43760,533286,1,15,5,1,0,79
43761,533286,1,15,6,4,0,83
43762,533286,1,16,1,0,0,83
43763,533286,1,16,2,4,0,87
43764,533286,1,16,3,1,0,88
43765,533286,1,16,4,3,0,91
43766,533286,1,16,5,1,0,92
43767,533286,1,16,6,1,0,93
43768,533286,1,17,1,0,0,93
43769,533286,1,17,2,4,0,97
43770,533286,1,17,3,1,0,98
43771,533286,1,17,4,4,0,102
43772,533286,1,17,5,1,0,103
43773,533286,1,17,6,1,0,104
43774,533286,1,18,1,6,0,110
43775,533286,1,18,2,0,1,110
43776,533286,1,18,3,0,0,110
43777,533286,1,18,4,2,0,112
43778,533286,1,18,5,1,0,113
43779,533286,1,18,6,1,0,114
43780,533286,1,19,1,1,0,115
43781,533286,1,19,2,6,0,121
43782,533286,1,19,3,2,0,123
43783,533286,1,19,4,0,1,123
43784,533286,1,19,5,0,0,123
43785,533286,1,19,6,1,0,124
43786,533286,1,20,1,1,0,125
43787,533286,1,20,2,1,0,126
43788,533286,1,20,3,1,0,127
43789,533286,1,20,4,4,0,131
43790,533286,1,20,5,0,0,131
43791,533286,1,20,6,2,0,133
43910,533287,1,1,1,2,0,2
43911,533287,1,1,2,0,0,2
43912,533287,1,1,3,0,0,2
43913,533287,1,1,4,4,0,6
43914,533287,1,1,5,1,0,7
43915,533287,1,1,6,1,0,8
43916,533287,1,2,1,1,0,9
43917,533287,1,2,2,1,0,10
43918,533287,1,2,3,0,0,10
43919,533287,1,2,4,1,0,11
43920,533287,1,2,5,4,0,15
43921,533287,1,2,6,0,0,15
43922,533287,1,3,1,1,0,16
43923,533287,1,3,2,4,0,20
43924,533287,1,3,3,0,0,20
43925,533287,1,3,4,0,0,20
43926,533287,1,3,5,1,0,21
43927,533287,1,3,6,0,1,21
43928,533287,1,4,1,1,0,22
43929,533287,1,4,2,4,0,26
43930,533287,1,4,3,1,0,27
43931,533287,1,4,4,1,0,28
43932,533287,1,4,5,0,0,28
43933,533287,1,4,6,1,0,29
43934,533287,1,5,1,1,0,30
43935,533287,1,5,2,6,0,36
43936,533287,1,5,3,0,0,36
43937,533287,1,5,4,1,0,37
43938,533287,1,5,5,1,0,38
43939,533287,1,5,6,4,0,42
43940,533287,1,6,1,1,0,43
43941,533287,1,6,2,1,0,44
43942,533287,1,6,3,1,0,45
43943,533287,1,6,4,1,0,46
43944,533287,1,6,5,4,0,50
43945,533287,1,6,6,0,0,50
43946,533287,1,7,1,4,0,54
43947,533287,1,7,2,1,0,55
43948,533287,1,7,3,1,0,56
43949,533287,1,7,4,0,0,56
43950,533287,1,7,5,0,0,56
43951,533287,1,7,6,0,0,56
43952,533287,1,8,1,0,0,56
43953,533287,1,8,2,0,1,56
43954,533287,1,8,3,2,0,58
43955,533287,1,8,4,1,0,59
43956,533287,1,8,5,0,0,59
43957,533287,1,8,6,1,0,60
43958,533287,1,9,1,0,0,60
43959,533287,1,9,2,0,0,60
43960,533287,1,9,3,4,0,64
43961,533287,1,9,4,0,0,64
43962,533287,1,9,5,1,0,65
43963,533287,1,9,6,1,0,66
43964,533287,1,10,1,1,0,67
43965,533287,1,10,2,1,0,68
43966,533287,1,10,3,0,0,68
43967,533287,1,10,4,1,0,69
43968,533287,1,10,5,1,0,70
43969,533287,1,10,6,0,0,70
43970,533287,1,11,1,0,1,70
43971,533287,1,11,2,2,0,72
43972,533287,1,11,3,0,0,72
43973,533287,1,11,4,1,0,73
43974,533287,1,11,5,1,0,74
43975,533287,1,11,6,0,1,74
43976,533287,1,12,1,0,1,74
43977,533287,1,12,2,0,0,74
43978,533287,1,12,3,1,0,75
43979,533287,1,12,4,0,0,75
43980,533287,1,12,5,1,0,76
43981,533287,1,12,6,2,0,78
43982,533287,1,13,1,1,0,79
43983,533287,1,13,2,0,0,79
43984,533287,1,13,3,5,0,84
43985,533287,1,13,4,0,0,84
43986,533287,1,13,5,1,0,85
43987,533287,1,13,6,0,0,85
43988,533287,1,14,1,0,0,85
43989,533287,1,14,2,4,0,89
43990,533287,1,14,3,0,0,89
43991,533287,1,14,4,1,0,90
43992,533287,1,14,5,1,0,91
43993,533287,1,14,6,0,0,91
43994,533287,1,15,1,4,0,95
43995,533287,1,15,2,1,0,96
43996,533287,1,15,3,0,0,96
43997,533287,1,15,4,5,0,101
43998,533287,1,15,5,0,0,101
43999,533287,1,15,6,0,0,101
44000,533287,1,16,1,1,0,102
44001,533287,1,16,2,0,0,102
44002,533287,1,16,3,2,0,104
44003,533287,1,16,4,0,0,104
44004,533287,1,16,5,0,0,104
44005,533287,1,16,6,0,1,104
44006,533287,1,17,1,4,0,108
44007,533287,1,17,2,1,0,109
44008,533287,1,17,3,0,0,109
44009,533287,1,17,4,4,0,113
44010,533287,1,17,5,1,0,114
44011,533287,1,17,6,1,0,115
44012,533287,1,18,1,0,0,115
44013,533287,1,18,2,1,0,116
44014,533287,1,18,3,6,0,122
44015,533287,1,18,4,0,0,122
44016,533287,1,18,5,2,0,124
44017,533287,1,18,6,0,0,124
44018,533287,1,19,1,1,0,125
44019,533287,1,19,2,0,0,125
44020,533287,1,19,3,1,0,126
44021,533287,1,19,4,2,0,128
44022,533287,1,19,5,1,0,129
44023,533287,1,19,6,0,0,129
44024,533287,1,20,1,4,0,133
44025,533287,1,20,2,4,0,137
44026,533287,1,20,3,0,1,137
44027,533287,1,20,4,1,0,138
44028,533287,1,20,5,1,0,139
44029,533287,1,20,6,1,0,140
44119,533288,1,1,1,0,0,0
44120,533288,1,1,2,1,0,1
44121,533288,1,1,3,0,0,1
44122,533288,1,1,4,1,0,2
44123,533288,1,1,5,4,0,6
44124,533288,1,1,6,0,0,6
44125,533288,1,2,1,1,0,7
44126,533288,1,2,2,0,0,7
44127,533288,1,2,3,0,1,7
44128,533288,1,2,4,0,0,7
44129,533288,1,2,5,1,0,8
44130,533288,1,2,6,1,0,9
44131,533288,1,3,1,0,0,9
44132,533288,1,3,2,0,0,9
44133,533288,1,3,3,1,0,10
44134,533288,1,3,4,1,0,11
44135,533288,1,3,5,4,0,15
44136,533288,1,3,6,4,0,19
44137,533288,1,4,1,0,0,19
44138,533288,1,4,2,1,0,20
44139,533288,1,4,3,0,0,20
44140,533288,1,4,4,0,1,20
44141,533288,1,4,5,4,0,24
44142,533288,1,4,6,2,0,26
44143,533288,1,5,1,0,0,26
44144,533288,1,5,2,1,0,27
44145,533288,1,5,3,1,0,28
44146,533288,1,5,4,1,0,29
44147,533288,1,5,5,0,0,29
44148,533288,1,5,6,1,0,30
44149,533288,1,6,1,0,0,30
44150,533288,1,6,2,0,0,30
44151,533288,1,6,3,0,0,30
44152,533288,1,6,4,4,0,34
44153,533288,1,6,5,1,0,35
44154,533288,1,6,6,4,0,39
44155,533288,1,7,1,1,0,40
44156,533288,1,7,2,1,0,41
44157,533288,1,7,3,1,0,42
44158,533288,1,7,4,0,0,42
44159,533288,1,7,5,0,1,42
44160,533288,1,7,6,0,0,42
44161,533288,1,8,1,0,0,42
44162,533288,1,8,2,1,0,43
44163,533288,1,8,3,0,0,43
44164,533288,1,8,4,1,0,44
44165,533288,1,8,5,0,0,44
44166,533288,1,8,6,2,0,46
44167,533288,1,9,1,0,0,46
44168,533288,1,9,2,1,0,47
44169,533288,1,9,3,1,0,48
44170,533288,1,9,4,0,0,48
44171,533288,1,9,5,1,0,49
44172,533288,1,9,6,1,0,50
44173,533288,1,10,1,4,0,54
44174,533288,1,10,2,0,0,54
44175,533288,1,10,3,1,0,55
44176,533288,1,10,4,1,0,56
44177,533288,1,10,5,2,0,58
44178,533288,1,10,6,0,0,58
44179,533288,1,11,1,1,0,59
44180,533288,1,11,2,1,0,60
44181,533288,1,11,3,1,0,61
44182,533288,1,11,4,1,0,62
44183,533288,1,11,5,1,0,63
44184,533288,1,11,6,1,0,64
44185,533288,1,12,1,1,0,65
44186,533288,1,12,2,1,0,66
44187,533288,1,12,3,1,0,67
44188,533288,1,12,4,0,1,67
44189,533288,1,12,5,1,0,68
44190,533288,1,12,6,0,0,68
44191,533288,1,13,1,0,0,68
44192,533288,1,13,2,0,0,68
44193,533288,1,13,3,1,0,69
44194,533288,1,13,4,4,0,73
44195,533288,1,13,5,1,0,74
44196,533288,1,13,6,1,0,75
44197,533288,1,14,1,2,0,77
44198,533288,1,14,2,0,0,77
44199,533288,1,14,3,1,0,78
44200,533288,1,14,4,1,0,79
44201,533288,1,14,5,1,0,80
44202,533288,1,14,6,0,0,80
44203,533288,1,15,1,0,0,80
44204,533288,1,15,2,6,0,86
44205,533288,1,15,3,2,0,88
44206,533288,1,15,4,2,0,90
44207,533288,1,15,5,4,0,94
44208,533288,1,15,6,2,0,96
44209,533288,1,16,1,1,0,97
44210,533288,1,16,2,0,0,97
44211,533288,1,16,3,4,0,101
44212,533288,1,16,4,0,0,101
44213,533288,1,16,5,4,0,105
44214,533288,1,16,6,1,0,106
44215,533288,1,17,1,1,0,107
44216,533288,1,17,2,0,1,107
44217,533288,1,17,3,1,0,108
44218,533288,1,17,4,1,0,109
44219,533288,1,17,5,1,0,110
44220,533288,1,17,6,0,0,110
44221,533288,1,18,1,1,0,111
44222,533288,1,18,2,1,0,112
44223,533288,1,18,3,1,0,113
44224,533288,1,18,4,1,0,114
44225,533288,1,18,5,6,0,120
44226,533288,1,18,6,4,0,124
44227,533288,1,19,1,1,0,125
44228,533288,1,19,2,1,0,126
44229,533288,1,19,3,6,0,132
44230,533288,1,19,4,3,0,135
44231,533288,1,19,5,0,0,135
44232,533288,1,19,6,6,0,141
44233,533288,1,20,1,2,0,143
44234,533288,1,20,2,1,0,144
44235,533288,1,20,3,1,0,145
44236,533288,1,20,4,0,0,145
44237,533288,1,20,5,1,1,146
44238,533288,1,20,6,2,0,148
44352,533289,1,1,1,0,0,0
44353,533289,1,1,2,0,0,0
44354,533289,1,1,3,0,0,0
44355,533289,1,1,4,1,0,1
44356,533289,1,1,5,1,0,2
44357,533289,1,1,6,1,0,3
44358,533289,1,2,1,0,0,3
44359,533289,1,2,2,0,0,3
44360,533289,1,2,3,1,0,4
44361,533289,1,2,4,0,0,4
44362,533289,1,2,5,0,0,4
44363,533289,1,2,6,0,0,4
44364,533289,1,3,1,4,0,8
44365,533289,1,3,2,0,0,8
44366,533289,1,3,3,0,0,8
44367,533289,1,3,4,4,0,12
44368,533289,1,3,5,0,0,12
44369,533289,1,3,6,0,0,12
44370,533289,1,4,1,0,0,12
44371,533289,1,4,2,1,0,13
44372,533289,1,4,3,0,0,13
44373,533289,1,4,4,0,0,13
44374,533289,1,4,5,1,0,14
44375,533289,1,4,6,0,0,14
44376,533289,1,5,1,0,0,14
44377,533289,1,5,2,1,0,15
44378,533289,1,5,3,1,0,16
44379,533289,1,5,4,0,0,16
44380,533289,1,5,5,0,1,16
44381,533289,1,5,6,0,0,16
44382,533289,1,6,1,0,1,16
44383,533289,1,6,2,4,0,20
44384,533289,1,6,3,0,0,20
44385,533289,1,6,4,0,0,20
44386,533289,1,6,5,0,0,20
44387,533289,1,6,6,0,0,20
44388,533289,1,7,1,1,0,21
44389,533289,1,7,2,1,0,22
44390,533289,1,7,3,4,0,26
44391,533289,1,7,4,1,0,27
44392,533289,1,7,5,4,0,31
44393,533289,1,7,6,2,0,33
44394,533289,1,8,1,1,0,34
44395,533289,1,8,2,0,0,34
44396,533289,1,8,3,4,0,38
44397,533289,1,8,4,0,0,38
44398,533289,1,8,5,0,0,38
44399,533289,1,8,6,0,0,38
44400,533289,1,9,1,2,0,40
44401,533289,1,9,2,1,0,41
44402,533289,1,9,3,0,0,41
44403,533289,1,9,4,0,0,41
44404,533289,1,9,5,1,0,42
44405,533289,1,9,6,0,0,42
44406,533289,1,10,1,6,0,48
44407,533289,1,10,2,1,0,49
44408,533289,1,10,3,0,0,49
44409,533289,1,10,4,1,0,50
44410,533289,1,10,5,1,0,51
44411,533289,1,10,6,2,0,53
44412,533289,1,11,1,1,0,54
44413,533289,1,11,2,1,0,55
44414,533289,1,11,3,0,0,55
44415,533289,1,11,4,0,0,55
44416,533289,1,11,5,0,0,55
44417,533289,1,11,6,0,0,55
44418,533289,1,12,1,0,0,55
44419,533289,1,12,2,0,0,55
44420,533289,1,12,3,1,0,56
44421,533289,1,12,4,6,0,62
44422,533289,1,12,5,0,0,62
44423,533289,1,12,6,1,0,63
44424,533289,1,13,1,1,0,64
44425,533289,1,13,2,4,0,68
44426,533289,1,13,3,1,0,69
44427,533289,1,13,4,1,0,70
44428,533289,1,13,5,0,0,70
44429,533289,1,13,6,1,0,71
44430,533289,1,14,1,0,0,71
44431,533289,1,14,2,1,0,72
44432,533289,1,14,3,1,0,73
44433,533289,1,14,4,1,0,74
44434,533289,1,14,5,4,0,78
44435,533289,1,14,6,2,0,80
44436,533289,1,15,1,1,0,81
44437,533289,1,15,2,0,0,81
44438,533289,1,15,3,0,1,81
44439,533289,1,15,4,1,0,82
44440,533289,1,15,5,6,0,88
44441,533289,1,15,6,2,0,90
44442,533289,1,16,1,0,0,90
44443,533289,1,16,2,0,0,90
44444,533289,1,16,3,0,0,90
44445,533289,1,16,4,0,0,90
44446,533289,1,16,5,0,1,90
44447,533289,1,16,6,1,0,91
44448,533289,1,17,1,1,0,92
44449,533289,1,17,2,1,0,93
44450,533289,1,17,3,1,0,94
44451,533289,1,17,4,1,0,95
44452,533289,1,17,5,1,0,96
44453,533289,1,17,6,2,0,98
44454,533289,1,18,1,6,0,104
44455,533289,1,18,2,1,0,105
44456,533289,1,18,3,6,0,111
44457,533289,1,18,4,0,0,111
44458,533289,1,18,5,4,0,115
44459,533289,1,18,6,4,0,119
44460,533289,1,19,1,0,0,119
44461,533289,1,19,2,1,0,120
44462,533289,1,19,3,0,0,120
44463,533289,1,19,4,1,0,121
44464,533289,1,19,5,0,0,121
44465,533289,1,19,6,1,0,122
44466,533289,1,20,1,1,0,123
44467,533289,1,20,2,0,1,123
44468,533289,1,20,3,2,0,125
44469,533289,1,20,4,2,0,127
44470,533289,1,20,5,1,0,128
44471,533289,1,20,6,1,0,129
44564,533290,1,1,1,0,0,0
44565,533290,1,1,2,0,0,0
44566,533290,1,1,3,0,1,0
44567,533290,1,1,4,1,0,1
44568,533290,1,1,5,1,0,2
44569,533290,1,1,6,0,0,2
44570,533290,1,2,1,0,0,2
44571,533290,1,2,2,1,0,3
44572,533290,1,2,3,0,0,3
44573,533290,1,2,4,0,0,3
44574,533290,1,2,5,4,0,7
44575,533290,1,2,6,1,0,8
44576,533290,1,3,1,0,1,8
44577,533290,1,3,2,0,0,8
44578,533290,1,3,3,1,0,9
44579,533290,1,3,4,6,0,15
44580,533290,1,3,5,0,0,15
44581,533290,1,3,6,1,0,16
44582,533290,1,4,1,0,0,16
44583,533290,1,4,2,0,0,16
44584,533290,1,4,3,1,0,17
44585,533290,1,4,4,1,0,18
44586,533290,1,4,5,0,0,18
44587,533290,1,4,6,4,0,22
44588,533290,1,5,1,1,0,23
44589,533290,1,5,2,0,0,23
44590,533290,1,5,3,1,0,24
44591,533290,1,5,4,4,0,28
44592,533290,1,5,5,1,0,29
44593,533290,1,5,6,1,0,30
44594,533290,1,6,1,1,0,31
44595,533290,1,6,2,1,0,32
44596,533290,1,6,3,1,0,33
44597,533290,1,6,4,0,0,33
44598,533290,1,6,5,0,1,33
44599,533290,1,6,6,1,0,34
44600,533290,1,7,1,0,0,34
44601,533290,1,7,2,0,0,34
44602,533290,1,7,3,2,0,36
44603,533290,1,7,4,4,0,40
44604,533290,1,7,5,1,0,41
44605,533290,1,7,6,1,0,42
44606,533290,1,8,1,1,0,43
44607,533290,1,8,2,4,0,47
44608,533290,1,8,3,1,0,48
44609,533290,1,8,4,1,0,49
44610,533290,1,8,5,0,0,49
44611,533290,1,8,6,0,0,49
44612,533290,1,9,1,1,0,50
44613,533290,1,9,2,0,0,50
44614,533290,1,9,3,4,0,54
44615,533290,1,9,4,1,0,55
44616,533290,1,9,5,1,0,56
44617,533290,1,9,6,1,0,57
44618,533290,1,10,1,2,0,59
44619,533290,1,10,2,1,0,60
44620,533290,1,10,3,1,0,61
44621,533290,1,10,4,1,0,62
44622,533290,1,10,5,1,0,63
44623,533290,1,10,6,1,0,64
44624,533290,1,11,1,0,1,64
44625,533290,1,11,2,1,0,65
44626,533290,1,11,3,1,0,66
44627,533290,1,11,4,0,0,66
44628,533290,1,11,5,0,0,66
44629,533290,1,11,6,0,0,66
44630,533290,1,12,1,2,0,68
44631,533290,1,12,2,1,0,69
44632,533290,1,12,3,1,0,70
44633,533290,1,12,4,1,0,71
44634,533290,1,12,5,1,0,72
44635,533290,1,12,6,1,0,73
44636,533290,1,13,1,1,0,74
44637,533290,1,13,2,1,0,75
44638,533290,1,13,3,2,0,77
44639,533290,1,13,4,0,0,77
44640,533290,1,13,5,0,0,77
44641,533290,1,13,6,1,0,78
44642,533290,1,14,1,4,0,82
44643,533290,1,14,2,0,0,82
44644,533290,1,14,3,1,0,83
44645,533290,1,14,4,1,0,84
44646,533290,1,14,5,1,0,85
44647,533290,1,14,6,1,0,86
44648,533290,1,15,1,0,1,86
44649,533290,1,15,2,1,0,87
44650,533290,1,15,3,0,0,87
44651,533290,1,15,4,4,0,91
44652,533290,1,15,5,0,0,91
44653,533290,1,15,6,1,0,92
44654,533290,1,16,1,6,0,98
44655,533290,1,16,2,1,0,99
44656,533290,1,16,3,0,0,99
44657,533290,1,16,4,0,0,99
44658,533290,1,16,5,1,0,100
44659,533290,1,16,6,4,0,104
44660,533290,1,17,1,1,0,105
44661,533290,1,17,2,0,0,105
44662,533290,1,17,3,0,0,105
44663,533290,1,17,4,0,0,105
44664,533290,1,17,5,1,0,106
44665,533290,1,17,6,1,0,107
44666,533290,1,18,1,1,0,108
44667,533290,1,18,2,1,0,109
44668,533290,1,18,3,2,0,111
44669,533290,1,18,4,4,0,115
44670,533290,1,18,5,1,0,116
44671,533290,1,18,6,2,0,118
44672,533290,1,19,1,0,0,118
44673,533290,1,19,2,2,0,120
44674,533290,1,19,3,1,0,121
44675,533290,1,19,4,4,0,125
44676,533290,1,19,5,0,0,125
44677,533290,1,19,6,7,0,132
44678,533290,1,20,1,4,0,136
44679,533290,1,20,2,4,0,140
44680,533290,1,20,3,0,0,140
44681,533290,1,20,4,4,0,144
44682,533290,1,20,5,1,0,145
44683,533290,1,20,6,1,0,146
44790,533291,1,1,1,1,0,1
44791,533291,1,1,2,1,0,2
44792,533291,1,1,3,4,0,6
44793,533291,1,1,4,5,0,11
44794,533291,1,1,5,0,0,11
44795,533291,1,1,6,2,0,13
44796,533291,1,2,1,4,0,17
44797,533291,1,2,2,0,1,17
44798,533291,1,2,3,4,0,21
44799,533291,1,2,4,0,0,21
44800,533291,1,2,5,1,0,22
44801,533291,1,2,6,4,0,26
44802,533291,1,3,1,0,0,26
44803,533291,1,3,2,0,0,26
44804,533291,1,3,3,0,0,26
44805,533291,1,3,4,0,0,26
44806,533291,1,3,5,1,0,27
44807,533291,1,3,6,1,0,28
44808,533291,1,4,1,0,0,28
44809,533291,1,4,2,0,0,28
44810,533291,1,4,3,1,0,29
44811,533291,1,4,4,1,0,30
44812,533291,1,4,5,2,0,32
44813,533291,1,4,6,1,0,33
44814,533291,1,5,1,1,0,34
44815,533291,1,5,2,0,0,34
44816,533291,1,5,3,1,0,35
44817,533291,1,5,4,0,1,35
44818,533291,1,5,5,1,0,36
44819,533291,1,5,6,0,0,36
44820,533291,1,6,1,1,0,37
44821,533291,1,6,2,0,0,37
44822,533291,1,6,3,2,0,39
44823,533291,1,6,4,1,0,40
44824,533291,1,6,5,0,0,40
44825,533291,1,6,6,2,0,42
44826,533291,1,7,1,0,0,42
44827,533291,1,7,2,0,0,42
44828,533291,1,7,3,1,0,43
44829,533291,1,7,4,0,1,43
44830,533291,1,7,5,1,0,44
44831,533291,1,7,6,0,0,44
44832,533291,1,8,1,1,0,45
44833,533291,1,8,2,0,0,45
44834,533291,1,8,3,0,0,45
44835,533291,1,8,4,1,0,46
44836,533291,1,8,5,0,0,46
44837,533291,1,8,6,1,0,47
44838,533291,1,9,1,2,0,49
44839,533291,1,9,2,0,1,49
44840,533291,1,9,3,1,0,50
44841,533291,1,9,4,0,0,50
44842,533291,1,9,5,2,0,52
44843,533291,1,9,6,4,0,56
44844,533291,1,10,1,1,0,57
44845,533291,1,10,2,0,0,57
44846,533291,1,10,3,1,0,58
44847,533291,1,10,4,1,0,59
44848,533291,1,10,5,0,1,59
44849,533291,1,10,6,1,0,60
44850,533291,1,11,1,1,0,61
44851,533291,1,11,2,1,0,62
44852,533291,1,11,3,1,0,63
44853,533291,1,11,4,1,0,64
44854,533291,1,11,5,0,0,64
44855,533291,1,11,6,1,0,65
44856,533291,1,12,1,6,0,71
44857,533291,1,12,2,1,0,72
44858,533291,1,12,3,1,0,73
44859,533291,1,12,4,4,0,77
44860,533291,1,12,5,1,0,78
44861,533291,1,12,6,2,0,80
44862,533291,1,13,1,2,0,82
44863,533291,1,13,2,1,0,83
44864,533291,1,13,3,2,0,85
44865,533291,1,13,4,6,0,91
44866,533291,1,13,5,1,0,92
44867,533291,1,13,6,0,0,92
44868,533291,1,14,1,1,0,93
44869,533291,1,14,2,1,0,94
44870,533291,1,14,3,0,0,94
44871,533291,1,14,4,0,0,94
44872,533291,1,14,5,2,0,96
44873,533291,1,14,6,1,0,97
44874,533291,1,15,1,1,0,98
44875,533291,1,15,2,1,0,99
44876,533291,1,15,3,2,0,101
44877,533291,1,15,4,0,0,101
44878,533291,1,15,5,4,0,105
44879,533291,1,15,6,0,0,105
44880,533291,1,16,1,1,0,106
44881,533291,1,16,2,0,1,106
44882,533291,1,16,3,1,0,107
44883,533291,1,16,4,1,0,108
44884,533291,1,16,5,0,0,108
44885,533291,1,16,6,1,0,109
44886,533291,1,17,1,0,0,109
44887,533291,1,17,2,0,0,109
44888,533291,1,17,3,0,0,109
44889,533291,1,17,4,0,0,109
44890,533291,1,17,5,4,0,113
44891,533291,1,17,6,1,0,114
44892,533291,1,18,1,1,0,115
44893,533291,1,18,2,0,0,115
44894,533291,1,18,3,0,1,115
44895,533291,1,18,4,0,0,115
44896,533291,1,18,5,0,0,115
44897,533291,1,18,6,0,0,115
44898,533291,1,19,1,0,1,115
44899,533291,1,19,2,4,0,119
44900,533291,1,19,3,1,0,120
44901,533291,1,19,4,1,0,121
44902,533291,1,19,5,0,0,121
44903,533291,1,19,6,1,0,122
44904,533291,1,20,1,0,0,122
44905,533291,1,20,2,6,0,128
44906,533291,1,20,3,0,1,128
44907,533291,1,20,4,0,1,128
45010,533293,1,1,1,1,0,1
45011,533293,1,1,2,1,0,2
45012,533293,1,1,3,2,0,4
45013,533293,1,1,4,0,0,4
45014,533293,1,1,5,0,0,4
45015,533293,1,1,6,4,0,8
45016,533293,1,2,1,1,0,9
45017,533293,1,2,2,2,0,11
45018,533293,1,2,3,0,0,11
45019,533293,1,2,4,1,0,12
45020,533293,1,2,5,0,0,12
45021,533293,1,2,6,0,0,12
45022,533293,1,3,1,1,0,13
45023,533293,1,3,2,4,0,17
45024,533293,1,3,3,0,0,17
45025,533293,1,3,4,0,0,17
45026,533293,1,3,5,1,0,18
45027,533293,1,3,6,0,0,18
45028,533293,1,4,1,0,0,18
45029,533293,1,4,2,6,0,24
45030,533293,1,4,3,1,0,25
45031,533293,1,4,4,6,0,31
45032,533293,1,4,5,2,0,33
45033,533293,1,4,6,1,0,34
45034,533293,1,5,1,0,0,34
45035,533293,1,5,2,0,0,34
45036,533293,1,5,3,1,0,35
45037,533293,1,5,4,0,1,35
45038,533293,1,5,5,2,0,37
45039,533293,1,5,6,4,0,41
45040,533293,1,6,1,0,0,41
45041,533293,1,6,2,0,0,41
45042,533293,1,6,3,0,0,41
45043,533293,1,6,4,2,0,43
45044,533293,1,6,5,0,0,43
45045,533293,1,6,6,1,0,44
45046,533293,1,7,1,2,0,46
45047,533293,1,7,2,4,0,50
45048,533293,1,7,3,0,0,50
45049,533293,1,7,4,1,0,51
45050,533293,1,7,5,1,0,52
45051,533293,1,7,6,1,0,53
45052,533293,1,8,1,1,0,54
45053,533293,1,8,2,2,0,56
45054,533293,1,8,3,0,0,56
45055,533293,1,8,4,0,0,56
45056,533293,1,8,5,1,0,57
45057,533293,1,8,6,0,0,57
45058,533293,1,9,1,1,0,58
45059,533293,1,9,2,1,0,59
45060,533293,1,9,3,0,0,59
45061,533293,1,9,4,1,0,60
45062,533293,1,9,5,4,0,64
45063,533293,1,9,6,0,0,64
45064,533293,1,10,1,1,0,65
45065,533293,1,10,2,0,0,65
45066,533293,1,10,3,4,0,69
45067,533293,1,10,4,0,0,69
45068,533293,1,10,5,4,0,73
45069,533293,1,10,6,1,0,74
45070,533293,1,11,1,0,1,74
45071,533293,1,11,2,0,1,74
45072,533293,1,11,3,0,0,74
45073,533293,1,11,4,4,0,78
45074,533293,1,11,5,4,0,82
45075,533293,1,11,6,0,0,82
45076,533293,1,12,1,0,0,82
45077,533293,1,12,2,0,0,82
45078,533293,1,12,3,0,0,82
45079,533293,1,12,4,0,0,82
45080,533293,1,12,5,4,0,86
45081,533293,1,12,6,4,0,90
45082,533293,1,13,1,2,0,92
45083,533293,1,13,2,0,0,92
45084,533293,1,13,3,1,0,93
45085,533293,1,13,4,3,0,96
45086,533293,1,13,5,0,0,96
45087,533293,1,13,6,0,0,96
45088,533293,1,14,1,0,0,96
45089,533293,1,14,2,1,0,97
45090,533293,1,14,3,4,0,101
45091,533293,1,14,4,1,0,102
45092,533293,1,14,5,1,0,103
45093,533293,1,14,6,1,0,104
45094,533293,1,15,1,2,0,106
45095,533293,1,15,2,1,0,107
45096,533293,1,15,3,1,0,108
45097,533293,1,15,4,6,0,114
45098,533293,1,15,5,1,0,115
45099,533293,1,15,6,6,0,121
45100,533293,1,16,1,4,0,125
45101,533293,1,16,2,1,0,126
45102,533293,1,16,3,0,1,126
45103,533293,1,16,4,0,1,126
45104,533293,1,16,5,2,0,128
45105,533293,1,16,6,0,0,128
45106,533293,1,17,1,0,0,128
45107,533293,1,17,2,0,0,128
45108,533293,1,17,3,1,0,129
45109,533293,1,17,4,0,0,129
45110,533293,1,17,5,2,0,131
45111,533293,1,17,6,1,0,132
45112,533293,1,18,1,3,0,135
45113,533293,1,18,2,6,0,141
45114,533293,1,18,3,0,0,141
45115,533293,1,18,4,0,0,141
45116,533293,1,18,5,1,0,142
45117,533293,1,18,6,6,0,148
45118,533293,1,19,1,7,0,155
45119,533293,1,19,2,1,0,156
45120,533293,1,19,3,2,0,158
45121,533293,1,19,4,4,0,162
45122,533293,1,19,5,0,1,162
45123,533293,1,19,6,0,0,162
45124,533293,1,20,1,1,0,163
45125,533293,1,20,2,1,0,164
45126,533293,1,20,3,2,0,166
45127,533293,1,20,4,2,0,168
45128,533293,1,20,5,1,0,169
45129,533293,1,20,6,0,0,169
45250,533294,1,1,1,1,0,1
45251,533294,1,1,2,1,0,2
45252,533294,1,1,3,2,0,4
45253,533294,1,1,4,0,0,4
45254,533294,1,1,5,1,0,5
45255,533294,1,1,6,0,0,5
45256,533294,1,2,1,0,1,5
45257,533294,1,2,2,0,0,5
45258,533294,1,2,3,0,0,5
45259,533294,1,2,4,2,0,7
45260,533294,1,2,5,0,0,7
45261,533294,1,2,6,1,0,8
45262,533294,1,3,1,0,0,8
45263,533294,1,3,2,0,0,8
45264,533294,1,3,3,0,0,8
45265,533294,1,3,4,0,0,8
45266,533294,1,3,5,0,0,8
45267,533294,1,3,6,4,0,12
45268,533294,1,4,1,0,0,12
45269,533294,1,4,2,1,0,13
45270,533294,1,4,3,0,0,13
45271,533294,1,4,4,1,0,14
45272,533294,1,4,5,0,0,14
45273,533294,1,4,6,1,0,15
45274,533294,1,5,1,4,0,19
45275,533294,1,5,2,2,0,21
45276,533294,1,5,3,5,0,26
45277,533294,1,5,4,1,0,27
45278,533294,1,5,5,1,0,28
45279,533294,1,5,6,0,0,28
45280,533294,1,6,1,0,0,28
45281,533294,1,6,2,1,0,29
45282,533294,1,6,3,0,0,29
45283,533294,1,6,4,0,1,29
45284,533294,1,6,5,1,0,30
45285,533294,1,6,6,1,0,31
45286,533294,1,7,1,1,0,32
45287,533294,1,7,2,1,0,33
45288,533294,1,7,3,1,0,34
45289,533294,1,7,4,1,0,35
45290,533294,1,7,5,1,0,36
45291,533294,1,7,6,1,0,37
45292,533294,1,8,1,1,0,38
45293,533294,1,8,2,1,0,39
45294,533294,1,8,3,1,0,40
45295,533294,1,8,4,0,0,40
45296,533294,1,8,5,0,0,40
45297,533294,1,8,6,1,0,41
45298,533294,1,9,1,1,0,42
45299,533294,1,9,2,2,0,44
45300,533294,1,9,3,1,0,45
45301,533294,1,9,4,1,0,46
45302,533294,1,9,5,1,0,47
45303,533294,1,9,6,2,0,49
45304,533294,1,10,1,4,0,53
45305,533294,1,10,2,1,0,54
45306,533294,1,10,3,1,0,55
45307,533294,1,10,4,1,0,56
45308,533294,1,10,5,4,0,60
45309,533294,1,10,6,0,0,60
45310,533294,1,11,1,1,0,61
45311,533294,1,11,2,6,0,67
45312,533294,1,11,3,1,0,68
45313,533294,1,11,4,0,0,68
45314,533294,1,11,5,2,0,70
45315,533294,1,11,6,0,0,70
45316,533294,1,12,1,6,0,76
45317,533294,1,12,2,0,0,76
45318,533294,1,12,3,2,0,78
45319,533294,1,12,4,1,0,79
45320,533294,1,12,5,0,0,79
45321,533294,1,12,6,0,0,79
45322,533294,1,13,1,4,0,83
45323,533294,1,13,2,1,0,84
45324,533294,1,13,3,2,0,86
45325,533294,1,13,4,1,0,87
45326,533294,1,13,5,1,0,88
45327,533294,1,13,6,1,0,89
45328,533294,1,14,1,1,0,90
45329,533294,1,14,2,1,0,91
45330,533294,1,14,3,1,0,92
45331,533294,1,14,4,4,0,96
45332,533294,1,14,5,1,0,97
45333,533294,1,14,6,6,0,103
45334,533294,1,15,1,3,0,106
45335,533294,1,15,2,1,0,107
45336,533294,1,15,3,1,0,108
45337,533294,1,15,4,0,0,108
45338,533294,1,15,5,0,1,108
45339,533294,1,15,6,0,0,108
45340,533294,1,16,1,0,1,108
45341,533294,1,16,2,0,0,108
45342,533294,1,16,3,4,0,112
45343,533294,1,16,4,2,0,114
45344,533294,1,16,5,0,0,114
45345,533294,1,16,6,0,0,114
45346,533294,1,17,1,1,0,115
45347,533294,1,17,2,0,0,115
45348,533294,1,17,3,0,0,115
45349,533294,1,17,4,2,0,117
45350,533294,1,17,5,0,0,117
45351,533294,1,17,6,6,0,123
45352,533294,1,18,1,2,0,125
45353,533294,1,18,2,1,0,126
45354,533294,1,18,3,0,0,126
45355,533294,1,18,4,0,0,126
45356,533294,1,18,5,3,0,129
45357,533294,1,18,6,1,0,130
45358,533294,1,19,1,1,0,131
45359,533294,1,19,2,1,0,132
45360,533294,1,19,3,4,0,136
45361,533294,1,19,4,0,1,136
45362,533294,1,19,5,4,0,140
45363,533294,1,19,6,0,0,140
45364,533294,1,20,1,4,0,144
45365,533294,1,20,2,0,1,144
45366,533294,1,20,3,1,0,145
45367,533294,1,20,4,1,0,146
45368,533294,1,20,5,2,0,148
45369,533294,1,20,6,1,0,149
45490,533295,1,1,1,4,0,4
45491,533295,1,1,2,0,0,4
45492,533295,1,1,3,0,0,4
45493,533295,1,1,4,4,0,8
45494,533295,1,1,5,1,0,9
45495,533295,1,1,6,0,0,9
45496,533295,1,2,1,1,0,10
45497,533295,1,2,2,2,0,12
45498,533295,1,2,3,2,0,14
45499,533295,1,2,4,1,0,15
45500,533295,1,2,5,0,0,15
45501,533295,1,2,6,2,0,17
45502,533295,1,3,1,0,0,17
45503,533295,1,3,2,0,0,17
45504,533295,1,3,3,1,0,18
45505,533295,1,3,4,0,0,18
45506,533295,1,3,5,0,0,18
45507,533295,1,3,6,4,0,22
45508,533295,1,4,1,0,0,22
45509,533295,1,4,2,1,0,23
45510,533295,1,4,3,0,1,23
45511,533295,1,4,4,2,0,25
45512,533295,1,4,5,0,0,25
45513,533295,1,4,6,0,0,25
45514,533295,1,5,1,4,0,29
45515,533295,1,5,2,1,0,30
45516,533295,1,5,3,0,0,30
45517,533295,1,5,4,0,0,30
45518,533295,1,5,5,0,1,30
45519,533295,1,5,6,0,0,30
45520,533295,1,6,1,0,0,30
45521,533295,1,6,2,6,0,36
45522,533295,1,6,3,0,1,36
45523,533295,1,6,4,0,0,36
45524,533295,1,6,5,0,0,36
45525,533295,1,6,6,0,0,36
45526,533295,1,7,1,1,0,37
45527,533295,1,7,2,0,0,37
45528,533295,1,7,3,1,0,38
45529,533295,1,7,4,1,0,39
45530,533295,1,7,5,6,0,45
45531,533295,1,7,6,0,0,45
45532,533295,1,8,1,0,0,45
45533,533295,1,8,2,1,0,46
45534,533295,1,8,3,0,0,46
45535,533295,1,8,4,6,0,52
45536,533295,1,8,5,1,0,53
45537,533295,1,8,6,0,0,53
45538,533295,1,9,1,1,0,54
45539,533295,1,9,2,1,0,55
45540,533295,1,9,3,4,0,59
45541,533295,1,9,4,1,0,60
45542,533295,1,9,5,0,0,60
45543,533295,1,9,6,1,0,61
45544,533295,1,10,1,0,0,61
45545,533295,1,10,2,4,0,65
45546,533295,1,10,3,1,0,66
45547,533295,1,10,4,1,0,67
45548,533295,1,10,5,1,0,68
45549,533295,1,10,6,0,1,68
45550,533295,1,11,1,1,0,69
45551,533295,1,11,2,0,0,69
45552,533295,1,11,3,1,0,70
45553,533295,1,11,4,0,0,70
45554,533295,1,11,5,1,0,71
45555,533295,1,11,6,0,0,71
45556,533295,1,12,1,2,0,73
45557,533295,1,12,2,1,0,74
45558,533295,1,12,3,1,0,75
45559,533295,1,12,4,2,0,77
45560,533295,1,12,5,0,0,77
45561,533295,1,12,6,4,0,81
45562,533295,1,13,1,1,0,82
45563,533295,1,13,2,2,0,84
45564,533295,1,13,3,4,0,88
45565,533295,1,13,4,1,0,89
45566,533295,1,13,5,1,0,90
45567,533295,1,13,6,0,0,90
45568,533295,1,14,1,4,0,94
45569,533295,1,14,2,1,0,95
45570,533295,1,14,3,2,0,97
45571,533295,1,14,4,0,0,97
45572,533295,1,14,5,4,0,101
45573,533295,1,14,6,2,0,103
45574,533295,1,15,1,1,0,104
45575,533295,1,15,2,1,0,105
45576,533295,1,15,3,1,0,106
45577,533295,1,15,4,1,0,107
45578,533295,1,15,5,1,0,108
45579,533295,1,15,6,1,0,109
45580,533295,1,16,1,0,0,109
45581,533295,1,16,2,1,0,110
45582,533295,1,16,3,1,0,111
45583,533295,1,16,4,0,0,111
45584,533295,1,16,5,1,0,112
45585,533295,1,16,6,0,1,112
45586,533295,1,17,1,4,0,116
45587,533295,1,17,2,0,0,116
45588,533295,1,17,3,1,0,117
45589,533295,1,17,4,1,0,118
45590,533295,1,17,5,1,0,119
45591,533295,1,17,6,0,0,119
45592,533295,1,18,1,1,0,120
45593,533295,1,18,2,1,0,121
45594,533295,1,18,3,1,0,122
45595,533295,1,18,4,1,0,123
45596,533295,1,18,5,2,0,125
45597,533295,1,18,6,4,0,129
45598,533295,1,19,1,4,0,133
45599,533295,1,19,2,2,0,135
45600,533295,1,19,3,4,0,139
45601,533295,1,19,4,2,0,141
45602,533295,1,19,5,2,0,143
45603,533295,1,19,6,0,0,143
45604,533295,1,20,1,1,0,144
45605,533295,1,20,2,1,0,145
45606,533295,1,20,3,1,0,146
45607,533295,1,20,4,4,0,150
45608,533295,1,20,5,1,0,151
45609,533295,1,20,6,1,1,152
45729,533296,1,1,1,0,0,0
45730,533296,1,1,2,4,0,4
45731,533296,1,1,3,0,0,4
45732,533296,1,1,4,1,0,5
45733,533296,1,1,5,0,0,5
45734,533296,1,1,6,0,0,5
45735,533296,1,2,1,3,0,8
45736,533296,1,2,2,0,0,8
45737,533296,1,2,3,4,0,12
45738,533296,1,2,4,0,0,12
45739,533296,1,2,5,0,0,12
45740,533296,1,2,6,0,0,12
45741,533296,1,3,1,0,0,12
45742,533296,1,3,2,0,0,12
45743,533296,1,3,3,1,0,13
45744,533296,1,3,4,0,0,13
45745,533296,1,3,5,0,0,13
45746,533296,1,3,6,1,0,14
45747,533296,1,4,1,0,0,14
45748,533296,1,4,2,1,0,15
45749,533296,1,4,3,4,0,19
45750,533296,1,4,4,0,0,19
45751,533296,1,4,5,0,0,19
45752,533296,1,4,6,1,0,20
45753,533296,1,5,1,0,0,20
45754,533296,1,5,2,1,0,21
45755,533296,1,5,3,0,0,21
45756,533296,1,5,4,1,0,22
45757,533296,1,5,5,0,0,22
45758,533296,1,5,6,2,0,24
45759,533296,1,6,1,4,0,28
45760,533296,1,6,2,2,0,30
45761,533296,1,6,3,0,0,30
45762,533296,1,6,4,0,0,30
45763,533296,1,6,5,0,0,30
45764,533296,1,6,6,4,0,34
45765,533296,1,7,1,1,0,35
45766,533296,1,7,2,0,0,35
45767,533296,1,7,3,0,0,35
45768,533296,1,7,4,4,0,39
45769,533296,1,7,5,1,0,40
45770,533296,1,7,6,0,0,40
45771,533296,1,8,1,0,0,40
45772,533296,1,8,2,1,0,41
45773,533296,1,8,3,0,0,41
45774,533296,1,8,4,1,0,42
45775,533296,1,8,5,1,0,43
45776,533296,1,8,6,1,0,44
45777,533296,1,9,1,2,0,46
45778,533296,1,9,2,1,0,47
45779,533296,1,9,3,0,0,47
45780,533296,1,9,4,4,0,51
45781,533296,1,9,5,1,0,52
45782,533296,1,9,6,1,0,53
45783,533296,1,10,1,1,0,54
45784,533296,1,10,2,2,0,56
45785,533296,1,10,3,2,0,58
45786,533296,1,10,4,0,0,58
45787,533296,1,10,5,0,0,58
45788,533296,1,10,6,4,0,62
45789,533296,1,11,1,1,0,63
45790,533296,1,11,2,0,1,63
45791,533296,1,11,3,4,0,67
45792,533296,1,11,4,1,0,68
45793,533296,1,11,5,0,0,68
45794,533296,1,11,6,0,0,68
45795,533296,1,12,1,4,0,72
45796,533296,1,12,2,2,0,74
45797,533296,1,12,3,0,0,74
45798,533296,1,12,4,4,0,78
45799,533296,1,12,5,1,0,79
45800,533296,1,12,6,1,0,80
45801,533296,1,13,1,1,0,81
45802,533296,1,13,2,0,0,81
45803,533296,1,13,3,0,0,81
45804,533296,1,13,4,3,0,84
45805,533296,1,13,5,0,1,84
45806,533296,1,13,6,1,0,85
45807,533296,1,14,1,1,0,86
45808,533296,1,14,2,1,0,87
45809,533296,1,14,3,4,0,91
45810,533296,1,14,4,0,0,91
45811,533296,1,14,5,0,0,91
45812,533296,1,14,6,2,0,93
45813,533296,1,15,1,1,0,94
45814,533296,1,15,2,1,0,95
45815,533296,1,15,3,4,0,99
45816,533296,1,15,4,0,0,99
45817,533296,1,15,5,0,0,99
45818,533296,1,15,6,1,0,100
45819,533296,1,16,1,0,0,100
45820,533296,1,16,2,0,0,100
45821,533296,1,16,3,2,0,102
45822,533296,1,16,4,0,0,102
45823,533296,1,16,5,2,0,104
45824,533296,1,16,6,3,0,107
45825,533296,1,17,1,1,0,108
45826,533296,1,17,2,1,0,109
45827,533296,1,17,3,4,0,113
45828,533296,1,17,4,1,0,114
45829,533296,1,17,5,0,0,114
45830,533296,1,17,6,0,0,114
45831,533296,1,18,1,0,0,114
45832,533296,1,18,2,1,0,115
45833,533296,1,18,3,0,0,115
45834,533296,1,18,4,2,0,117
45835,533296,1,18,5,0,1,117
45836,533296,1,18,6,0,0,117
45837,533296,1,19,1,2,1,119
45838,533296,1,19,2,1,0,120
45839,533296,1,19,3,1,0,121
45840,533296,1,19,4,0,0,121
45841,533296,1,19,5,1,0,122
45842,533296,1,19,6,1,0,123
45843,533296,1,20,1,4,0,127
45844,533296,1,20,2,1,0,128
45845,533296,1,20,3,4,0,132
45846,533296,1,20,4,4,0,136
45847,533296,1,20,5,1,0,137
45848,533296,1,20,6,2,0,139
45969,533297,1,1,1,0,0,0
45970,533297,1,1,2,0,0,0
45971,533297,1,1,3,0,0,0
45972,533297,1,1,4,1,0,1
45973,533297,1,1,5,0,0,1
45974,533297,1,1,6,1,0,2
45975,533297,1,2,1,1,0,3
45976,533297,1,2,2,1,0,4
45977,533297,1,2,3,0,0,4
45978,533297,1,2,4,4,0,8
45979,533297,1,2,5,0,0,8
45980,533297,1,2,6,4,0,12
45981,533297,1,3,1,1,0,13
45982,533297,1,3,2,1,0,14
45983,533297,1,3,3,0,0,14
45984,533297,1,3,4,2,0,16
45985,533297,1,3,5,0,1,16
45986,533297,1,3,6,1,0,17
45987,533297,1,4,1,1,0,18
45988,533297,1,4,2,1,0,19
45989,533297,1,4,3,0,0,19
45990,533297,1,4,4,4,0,23
45991,533297,1,4,5,1,0,24
45992,533297,1,4,6,0,0,24
45993,533297,1,5,1,1,0,25
45994,533297,1,5,2,0,0,25
45995,533297,1,5,3,0,0,25
45996,533297,1,5,4,1,0,26
45997,533297,1,5,5,1,0,27
45998,533297,1,5,6,6,0,33
45999,533297,1,6,1,0,0,33
46000,533297,1,6,2,0,0,33
46001,533297,1,6,3,0,0,33
46002,533297,1,6,4,6,0,39
46003,533297,1,6,5,1,0,40
46004,533297,1,6,6,6,0,46
46005,533297,1,7,1,6,0,52
46006,533297,1,7,2,0,0,52
46007,533297,1,7,3,0,0,52
46008,533297,1,7,4,0,0,52
46009,533297,1,7,5,0,0,52
46010,533297,1,7,6,1,0,53
46011,533297,1,8,1,4,0,57
46012,533297,1,8,2,0,1,57
46013,533297,1,8,3,1,0,58
46014,533297,1,8,4,1,0,59
46015,533297,1,8,5,0,0,59
46016,533297,1,8,6,0,0,59
46017,533297,1,9,1,0,0,59
46018,533297,1,9,2,1,0,60
46019,533297,1,9,3,0,0,60
46020,533297,1,9,4,4,0,64
46021,533297,1,9,5,0,0,64
46022,533297,1,9,6,0,0,64
46023,533297,1,10,1,0,0,64
46024,533297,1,10,2,6,0,70
46025,533297,1,10,3,1,0,71
46026,533297,1,10,4,1,0,72
46027,533297,1,10,5,1,0,73
46028,533297,1,10,6,1,0,74
46029,533297,1,11,1,1,0,75
46030,533297,1,11,2,1,0,76
46031,533297,1,11,3,1,0,77
46032,533297,1,11,4,1,0,78
46033,533297,1,11,5,4,0,82
46034,533297,1,11,6,1,0,83
46035,533297,1,12,1,1,0,84
46036,533297,1,12,2,5,0,89
46037,533297,1,12,3,1,0,90
46038,533297,1,12,4,0,0,90
46039,533297,1,12,5,0,0,90
46040,533297,1,12,6,1,0,91
46041,533297,1,13,1,0,0,91
46042,533297,1,13,2,0,0,91
46043,533297,1,13,3,2,0,93
46044,533297,1,13,4,6,0,99
46045,533297,1,13,5,1,0,100
46046,533297,1,13,6,4,0,104
46047,533297,1,14,1,6,0,110
46048,533297,1,14,2,0,0,110
46049,533297,1,14,3,0,0,110
46050,533297,1,14,4,1,0,111
46051,533297,1,14,5,1,0,112
46052,533297,1,14,6,1,0,113
46053,533297,1,15,1,1,0,114
46054,533297,1,15,2,4,0,118
46055,533297,1,15,3,6,0,124
46056,533297,1,15,4,2,0,126
46057,533297,1,15,5,2,0,128
46058,533297,1,15,6,4,0,132
46059,533297,1,16,1,1,0,133
46060,533297,1,16,2,0,0,133
46061,533297,1,16,3,1,0,134
46062,533297,1,16,4,6,0,140
46063,533297,1,16,5,0,1,140
46064,533297,1,16,6,2,0,142
46065,533297,1,17,1,4,0,146
46066,533297,1,17,2,0,0,146
46067,533297,1,17,3,1,0,147
46068,533297,1,17,4,0,0,147
46069,533297,1,17,5,2,0,149
46070,533297,1,17,6,1,0,150
46071,533297,1,18,1,2,0,152
46072,533297,1,18,2,1,0,153
46073,533297,1,18,3,5,0,158
46074,533297,1,18,4,1,0,159
46075,533297,1,18,5,0,0,159
46076,533297,1,18,6,4,0,163
46077,533297,1,19,1,6,0,169
46078,533297,1,19,2,0,0,169
46079,533297,1,19,3,1,0,170
46080,533297,1,19,4,4,0,174
46081,533297,1,19,5,4,0,178
46082,533297,1,19,6,2,0,180
46083,533297,1,20,1,6,0,186
46084,533297,1,20,2,1,0,187
46085,533297,1,20,3,6,0,193
46086,533297,1,20,4,6,0,199
46087,533297,1,20,5,6,0,205
46088,533297,1,20,6,0,1,205
46189,533298,1,1,1,0,0,0
46190,533298,1,1,2,0,0,0
46191,533298,1,1,3,0,0,0
46192,533298,1,1,4,0,0,0
46193,533298,1,1,5,0,1,0
46194,533298,1,1,6,0,0,0
46195,533298,1,2,1,0,0,0
46196,533298,1,2,2,0,0,0
46197,533298,1,2,3,0,0,0
46198,533298,1,2,4,1,0,1
46199,533298,1,2,5,0,0,1
46200,533298,1,2,6,0,0,1
46201,533298,1,3,1,0,0,1
46202,533298,1,3,2,0,0,1
46203,533298,1,3,3,0,0,1
46204,533298,1,3,4,0,0,1
46205,533298,1,3,5,1,0,2
46206,533298,1,3,6,0,0,2
46207,533298,1,4,1,4,0,6
46208,533298,1,4,2,0,0,6
46209,533298,1,4,3,1,0,7
46210,533298,1,4,4,0,0,7
46211,533298,1,4,5,1,0,8
46212,533298,1,4,6,0,0,8
46213,533298,1,5,1,1,0,9
46214,533298,1,5,2,1,0,10
46215,533298,1,5,3,0,0,10
46216,533298,1,5,4,1,0,11
46217,533298,1,5,5,1,0,12
46218,533298,1,5,6,0,0,12
46219,533298,1,6,1,0,0,12
46220,533298,1,6,2,1,0,13
46221,533298,1,6,3,1,0,14
46222,533298,1,6,4,0,0,14
46223,533298,1,6,5,0,1,14
46224,533298,1,6,6,0,0,14
46225,533298,1,7,1,1,0,15
46226,533298,1,7,2,1,0,16
46227,533298,1,7,3,0,0,16
46228,533298,1,7,4,1,0,17
46229,533298,1,7,5,1,0,18
46230,533298,1,7,6,0,0,18
46231,533298,1,8,1,1,0,19
46232,533298,1,8,2,0,0,19
46233,533298,1,8,3,0,0,19
46234,533298,1,8,4,0,0,19
46235,533298,1,8,5,2,0,21
46236,533298,1,8,6,1,0,22
46237,533298,1,9,1,0,0,22
46238,533298,1,9,2,1,0,23
46239,533298,1,9,3,2,0,25
46240,533298,1,9,4,2,0,27
46241,533298,1,9,5,2,0,29
46242,533298,1,9,6,0,0,29
46243,533298,1,10,1,1,0,30
46244,533298,1,10,2,1,0,31
46245,533298,1,10,3,1,0,32
46246,533298,1,10,4,0,0,32
46247,533298,1,10,5,0,0,32
46248,533298,1,10,6,0,0,32
46249,533298,1,11,1,1,0,33
46250,533298,1,11,2,2,0,35
46251,533298,1,11,3,1,0,36
46252,533298,1,11,4,0,0,36
46253,533298,1,11,5,2,0,38
46254,533298,1,11,6,0,0,38
46255,533298,1,12,1,1,0,39
46256,533298,1,12,2,6,0,45
46257,533298,1,12,3,0,0,45
46258,533298,1,12,4,1,0,46
46259,533298,1,12,5,0,0,46
46260,533298,1,12,6,2,0,48
46261,533298,1,13,1,1,0,49
46262,533298,1,13,2,6,0,55
46263,533298,1,13,3,6,0,61
46264,533298,1,13,4,1,0,62
46265,533298,1,13,5,1,0,63
46266,533298,1,13,6,6,0,69
46267,533298,1,14,1,1,0,70
46268,533298,1,14,2,1,0,71
46269,533298,1,14,3,1,0,72
46270,533298,1,14,4,0,0,72
46271,533298,1,14,5,1,0,73
46272,533298,1,14,6,0,1,73
46273,533298,1,15,1,1,0,74
46274,533298,1,15,2,1,0,75
46275,533298,1,15,3,6,0,81
46276,533298,1,15,4,4,0,85
46277,533298,1,15,5,1,0,86
46278,533298,1,15,6,1,0,87
46279,533298,1,16,1,0,0,87
46280,533298,1,16,2,0,1,87
46281,533298,1,16,3,0,1,87
46282,533298,1,16,4,1,0,88
46283,533298,1,16,5,0,0,88
46284,533298,1,16,6,1,0,89
46285,533298,1,17,1,1,0,90
46286,533298,1,17,2,1,0,91
46287,533298,1,17,3,4,0,95
46288,533298,1,17,4,6,0,101
46289,533298,1,17,5,6,0,107
46290,533298,1,17,6,1,0,108
46291,533298,1,18,1,0,1,108
46292,533298,1,18,2,1,0,109
46293,533298,1,18,3,1,0,110
46294,533298,1,18,4,1,0,111
46295,533298,1,18,5,1,0,112
46296,533298,1,18,6,0,0,112
46297,533298,1,19,1,1,0,113
46298,533298,1,19,2,4,0,117
46299,533298,1,19,3,1,0,118
46300,533298,1,19,4,1,0,119
46301,533298,1,19,5,2,0,121
46302,533298,1,19,6,1,0,122
46303,533298,1,20,1,2,0,124
46304,533298,1,20,2,4,0,128
46305,533298,1,20,3,2,0,130
46306,533298,1,20,4,2,0,132
46307,533298,1,20,5,1,0,133
46308,533298,1,20,6,4,0,137
46421,534208,1,1,1,1,0,1
46422,534208,1,1,2,0,0,1
46423,534208,1,1,3,3,0,4
46424,534208,1,1,4,0,0,4
46425,534208,1,1,5,1,0,5
46426,534208,1,1,6,0,0,5
46427,534208,1,2,1,0,0,5
46428,534208,1,2,2,1,0,6
46429,534208,1,2,3,0,0,6
46430,534208,1,2,4,0,0,6
46431,534208,1,2,5,4,0,10
46432,534208,1,2,6,0,0,10
46433,534208,1,3,1,0,0,10
46434,534208,1,3,2,0,1,10
46435,534208,1,3,3,1,0,11
46436,534208,1,3,4,0,0,11
46437,534208,1,3,5,1,0,12
46438,534208,1,3,6,1,0,13
46439,534208,1,4,1,4,0,17
46440,534208,1,4,2,0,0,17
46441,534208,1,4,3,0,0,17
46442,534208,1,4,4,0,0,17
46443,534208,1,4,5,0,0,17
46444,534208,1,4,6,1,0,18
46445,534208,1,5,1,0,0,18
46446,534208,1,5,2,1,0,19
46447,534208,1,5,3,4,0,23
46448,534208,1,5,4,1,0,24
46449,534208,1,5,5,0,0,24
46450,534208,1,5,6,0,0,24
46451,534208,1,6,1,0,1,24
46452,534208,1,6,2,0,0,24
46453,534208,1,6,3,1,0,25
46454,534208,1,6,4,0,0,25
46455,534208,1,6,5,4,0,29
46456,534208,1,6,6,0,0,29
46457,534208,1,7,1,1,0,30
46458,534208,1,7,2,0,1,30
46459,534208,1,7,3,0,0,30
46460,534208,1,7,4,1,0,31
46461,534208,1,7,5,1,0,32
46462,534208,1,7,6,1,0,33
46463,534208,1,8,1,1,0,34
46464,534208,1,8,2,0,0,34
46465,534208,1,8,3,2,0,36
46466,534208,1,8,4,0,0,36
46467,534208,1,8,5,0,0,36
46468,534208,1,8,6,2,0,38
46469,534208,1,9,1,1,0,39
46470,534208,1,9,2,0,0,39
46471,534208,1,9,3,4,0,43
46472,534208,1,9,4,4,0,47
46473,534208,1,9,5,1,0,48
46474,534208,1,9,6,1,0,49
46475,534208,1,10,1,1,0,50
46476,534208,1,10,2,0,0,50
46477,534208,1,10,3,0,0,50
46478,534208,1,10,4,6,0,56
46479,534208,1,10,5,0,0,56
46480,534208,1,10,6,1,0,57
46481,534208,1,11,1,0,0,57
46482,534208,1,11,2,1,0,58
46483,534208,1,11,3,0,0,58
46484,534208,1,11,4,0,0,58
46485,534208,1,11,5,2,0,60
46486,534208,1,11,6,3,0,63
46487,534208,1,12,1,1,0,64
46488,534208,1,12,2,0,0,64
46489,534208,1,12,3,0,0,64
46490,534208,1,12,4,0,0,64
46491,534208,1,12,5,1,0,65
46492,534208,1,12,6,0,0,65
46493,534208,1,13,1,1,0,66
46494,534208,1,13,2,1,0,67
46495,534208,1,13,3,6,0,73
46496,534208,1,13,4,1,0,74
46497,534208,1,13,5,2,0,76
46498,534208,1,13,6,1,0,77
46499,534208,1,14,1,1,0,78
46500,534208,1,14,2,6,0,84
46501,534208,1,14,3,1,0,85
46502,534208,1,14,4,1,0,86
46503,534208,1,14,5,7,0,93
46504,534208,1,14,6,0,0,93
46505,534208,1,15,1,1,0,94
46506,534208,1,15,2,1,0,95
46507,534208,1,15,3,0,0,95
46508,534208,1,15,4,1,0,96
46509,534208,1,15,5,4,0,100
46510,534208,1,15,6,1,0,101
46511,534208,1,16,1,6,0,107
46512,534208,1,16,2,0,1,107
46513,534208,1,16,3,0,0,107
46514,534208,1,16,4,0,0,107
46515,534208,1,16,5,1,0,108
46516,534208,1,16,6,1,0,109
46517,534208,1,17,1,1,0,110
46518,534208,1,17,2,4,0,114
46519,534208,1,17,3,1,0,115
46520,534208,1,17,4,1,0,116
46521,534208,1,17,5,6,0,122
46522,534208,1,17,6,1,0,123
46523,534208,1,18,1,1,0,124
46524,534208,1,18,2,6,0,130
46525,534208,1,18,3,6,0,136
46526,534208,1,18,4,2,0,138
46527,534208,1,18,5,1,0,139
46528,534208,1,18,6,2,0,141
46529,534208,1,19,1,1,0,142
46530,534208,1,19,2,0,0,142
46531,534208,1,19,3,2,0,144
46532,534208,1,19,4,1,0,145
46533,534208,1,19,5,6,0,151
46534,534208,1,19,6,2,0,153
46535,534208,1,20,1,4,0,157
46536,534208,1,20,2,6,0,163
46537,534208,1,20,3,2,0,165
46538,534208,1,20,4,1,0,166
46539,534208,1,20,5,1,0,167
46540,534208,1,20,6,5,0,172
46659,534233,1,1,1,0,0,0
46660,534233,1,1,2,0,0,0
46661,534233,1,1,3,1,0,1
46662,534233,1,1,4,0,0,1
46663,534233,1,1,5,4,0,5
46664,534233,1,1,6,4,0,9
46665,534233,1,2,1,0,0,9
46666,534233,1,2,2,0,0,9
46667,534233,1,2,3,0,0,9
46668,534233,1,2,4,0,0,9
46669,534233,1,2,5,1,0,10
46670,534233,1,2,6,0,0,10
46671,534233,1,3,1,0,0,10
46672,534233,1,3,2,0,0,10
46673,534233,1,3,3,4,0,14
46674,534233,1,3,4,4,0,18
46675,534233,1,3,5,0,0,18
46676,534233,1,3,6,6,0,24
46677,534233,1,4,1,2,0,26
46678,534233,1,4,2,1,0,27
46679,534233,1,4,3,0,0,27
46680,534233,1,4,4,0,1,27
46681,534233,1,4,5,1,0,28
46682,534233,1,4,6,0,0,28
46683,534233,1,5,1,0,0,28
46684,534233,1,5,2,0,0,28
46685,534233,1,5,3,1,0,29
46686,534233,1,5,4,1,0,30
46687,534233,1,5,5,4,0,34
46688,534233,1,5,6,2,0,36
46689,534233,1,6,1,0,0,36
46690,534233,1,6,2,0,0,36
46691,534233,1,6,3,0,0,36
46692,534233,1,6,4,1,0,37
46693,534233,1,6,5,1,0,38
46694,534233,1,6,6,2,0,40
46695,534233,1,7,1,0,1,40
46696,534233,1,7,2,1,0,41
46697,534233,1,7,3,1,0,42
46698,534233,1,7,4,4,0,46
46699,534233,1,7,5,1,0,47
46700,534233,1,7,6,0,0,47
46701,534233,1,8,1,1,0,48
46702,534233,1,8,2,1,0,49
46703,534233,1,8,3,1,0,50
46704,534233,1,8,4,0,1,50
46705,534233,1,8,5,0,0,50
46706,534233,1,8,6,0,0,50
46707,534233,1,9,1,1,0,51
46708,534233,1,9,2,0,0,51
46709,534233,1,9,3,4,0,55
46710,534233,1,9,4,1,0,56
46711,534233,1,9,5,1,0,57
46712,534233,1,9,6,2,0,59
46713,534233,1,10,1,1,0,60
46714,534233,1,10,2,0,0,60
46715,534233,1,10,3,0,0,60
46716,534233,1,10,4,1,0,61
46717,534233,1,10,5,1,0,62
46718,534233,1,10,6,2,0,64
46719,534233,1,11,1,2,0,66
46720,534233,1,11,2,0,1,66
46721,534233,1,11,3,0,0,66
46722,534233,1,11,4,0,0,66
46723,534233,1,11,5,0,0,66
46724,534233,1,11,6,1,0,67
46725,534233,1,12,1,2,0,69
46726,534233,1,12,2,1,0,70
46727,534233,1,12,3,2,0,72
46728,534233,1,12,4,1,0,73
46729,534233,1,12,5,1,0,74
46730,534233,1,12,6,0,0,74
46731,534233,1,13,1,1,0,75
46732,534233,1,13,2,1,0,76
46733,534233,1,13,3,0,1,76
46734,534233,1,13,4,0,0,76
46735,534233,1,13,5,1,0,77
46736,534233,1,13,6,0,0,77
46737,534233,1,14,1,1,0,78
46738,534233,1,14,2,1,0,79
46739,534233,1,14,3,1,0,80
46740,534233,1,14,4,0,1,80
46741,534233,1,14,5,1,0,81
46742,534233,1,14,6,0,0,81
46743,534233,1,15,1,0,0,81
46744,534233,1,15,2,2,0,83
46745,534233,1,15,3,0,0,83
46746,534233,1,15,4,0,0,83
46747,534233,1,15,5,0,0,83
46748,534233,1,15,6,0,0,83
46749,534233,1,16,1,1,0,84
46750,534233,1,16,2,1,0,85
46751,534233,1,16,3,0,1,85
46752,534233,1,16,4,0,0,85
46753,534233,1,16,5,1,0,86
46754,534233,1,16,6,0,0,86
46755,534233,1,17,1,1,0,87
46756,534233,1,17,2,0,0,87
46757,534233,1,17,3,0,0,87
46758,534233,1,17,4,0,0,87
46759,534233,1,17,5,1,0,88
46760,534233,1,17,6,1,0,89
46761,534233,1,18,1,2,0,91
46762,534233,1,18,2,1,0,92
46763,534233,1,18,3,4,0,96
46764,534233,1,18,4,1,0,97
46765,534233,1,18,5,0,0,97
46766,534233,1,18,6,4,0,101
46767,534233,1,19,1,4,0,105
46768,534233,1,19,2,1,0,106
46769,534233,1,19,3,1,0,107
46770,534233,1,19,4,1,0,108
46771,534233,1,19,5,2,0,110
46772,534233,1,19,6,0,0,110
46773,534233,1,20,1,4,0,114
46774,534233,1,20,2,1,0,115
46775,534233,1,20,3,0,0,115
46776,534233,1,20,4,1,0,116
46777,534233,1,20,5,1,0,117
46778,534233,1,20,6,1,0,118
46893,534235,1,1,1,1,0,1
46894,534235,1,1,2,1,0,2
46895,534235,1,1,3,10,0,12
46896,534235,1,1,4,4,0,16
46897,534235,1,1,5,0,0,16
46898,534235,1,1,6,0,0,16
46899,534235,1,2,1,4,0,20
46900,534235,1,2,2,0,0,20
46901,534235,1,2,3,0,1,20
46902,534235,1,2,4,1,0,21
46903,534235,1,2,5,0,0,21
46904,534235,1,2,6,0,0,21
46905,534235,1,3,1,2,0,23
46906,534235,1,3,2,1,0,24
46907,534235,1,3,3,1,0,25
46908,534235,1,3,4,1,0,26
46909,534235,1,3,5,1,0,27
46910,534235,1,3,6,0,0,27
46911,534235,1,4,1,1,0,28
46912,534235,1,4,2,2,0,30
46913,534235,1,4,3,1,0,31
46914,534235,1,4,4,4,0,35
46915,534235,1,4,5,1,0,36
46916,534235,1,4,6,1,0,37
46917,534235,1,5,1,1,0,38
46918,534235,1,5,2,4,0,42
46919,534235,1,5,3,1,0,43
46920,534235,1,5,4,0,0,43
46921,534235,1,5,5,0,1,43
46922,534235,1,5,6,1,0,44
46923,534235,1,6,1,1,0,45
46924,534235,1,6,2,1,0,46
46925,534235,1,6,3,1,0,47
46926,534235,1,6,4,0,0,47
46927,534235,1,6,5,2,0,49
46928,534235,1,6,6,1,0,50
46929,534235,1,7,1,0,0,50
46930,534235,1,7,2,0,0,50
46931,534235,1,7,3,1,0,51
46932,534235,1,7,4,0,0,51
46933,534235,1,7,5,1,0,52
46934,534235,1,7,6,0,0,52
46935,534235,1,8,1,0,0,52
46936,534235,1,8,2,2,0,54
46937,534235,1,8,3,6,0,60
46938,534235,1,8,4,2,0,62
46939,534235,1,8,5,0,0,62
46940,534235,1,8,6,1,0,63
46941,534235,1,9,1,1,0,64
46942,534235,1,9,2,0,1,64
46943,534235,1,9,3,1,0,65
46944,534235,1,9,4,1,0,66
46945,534235,1,9,5,2,0,68
46946,534235,1,9,6,6,0,74
46947,534235,1,10,1,6,0,80
46948,534235,1,10,2,6,0,86
46949,534235,1,10,3,2,0,88
46950,534235,1,10,4,10,0,98
46951,534235,1,10,5,6,0,104
46952,534235,1,10,6,2,0,106
46953,534235,1,11,1,6,0,112
46954,534235,1,11,2,0,1,112
46955,534235,1,11,3,4,0,116
46956,534235,1,11,4,0,1,116
46957,534235,1,11,5,1,0,117
46958,534235,1,11,6,1,0,118
47025,538068,1,1,1,1,0,1
47026,538068,1,1,2,4,0,5
47027,538068,1,1,3,1,0,6
47028,538068,1,1,4,0,0,6
47029,538068,1,1,5,0,0,6
47030,538068,1,1,6,0,0,6
47031,538068,1,2,1,5,0,11
47032,538068,1,2,2,2,0,13
47033,538068,1,2,3,2,0,15
47034,538068,1,2,4,0,0,15
47035,538068,1,2,5,0,0,15
47036,538068,1,2,6,0,0,15
47037,538068,1,3,1,1,0,16
47038,538068,1,3,2,0,0,16
47039,538068,1,3,3,2,0,18
47040,538068,1,3,4,4,0,22
47041,538068,1,3,5,0,0,22
47042,538068,1,3,6,0,0,22
47043,538068,1,4,1,0,0,22
47044,538068,1,4,2,4,0,26
47045,538068,1,4,3,4,0,30
47046,538068,1,4,4,0,1,30
47047,538068,1,4,5,4,0,34
47048,538068,1,4,6,0,0,34
47049,538068,1,5,1,4,0,38
47050,538068,1,5,2,2,0,40
47051,538068,1,5,3,1,0,41
47052,538068,1,5,4,1,0,42
47053,538068,1,5,5,1,0,43
47054,538068,1,5,6,1,0,44
47055,538068,1,6,1,1,0,45
47056,538068,1,6,2,0,0,45
47057,538068,1,6,3,0,0,45
47058,538068,1,6,4,0,0,45
47059,538068,1,6,5,6,0,51
47060,538068,1,6,6,0,0,51
47061,538068,1,7,1,0,0,51
47062,538068,1,7,2,0,0,51
47063,538068,1,7,3,0,0,51
47064,538068,1,7,4,2,0,53
47065,538068,1,7,5,0,0,53
47066,538068,1,7,6,1,0,54
47067,538068,1,8,1,1,0,55
47068,538068,1,8,2,0,0,55
47069,538068,1,8,3,2,0,57
47070,538068,1,8,4,2,0,59
47071,538068,1,8,5,1,0,60
47072,538068,1,8,6,1,0,61
47073,538068,1,9,1,0,0,61
47074,538068,1,9,2,0,0,61
47075,538068,1,9,3,0,0,61
47076,538068,1,9,4,0,0,61
47077,538068,1,9,5,0,0,61
47078,538068,1,9,6,0,1,61
47079,538068,1,10,1,3,0,64
47080,538068,1,10,2,0,0,64
47081,538068,1,10,3,2,0,66
47082,538068,1,10,4,0,0,66
47083,538068,1,10,5,0,0,66
47084,538068,1,10,6,1,0,67
47085,538068,1,11,1,1,0,68
47086,538068,1,11,2,0,0,68
47087,538068,1,11,3,0,0,68
47088,538068,1,11,4,1,0,69
47089,538068,1,11,5,4,0,73
47090,538068,1,11,6,4,0,77
47091,538068,1,12,1,1,0,78
47092,538068,1,12,2,2,0,80
47093,538068,1,12,3,1,0,81
47094,538068,1,12,4,1,0,82
47095,538068,1,12,5,4,0,86
47096,538068,1,12,6,1,0,87
47097,538068,1,13,1,0,0,87
47098,538068,1,13,2,0,1,87
47099,538068,1,13,3,0,0,87
47100,538068,1,13,4,1,0,88
47101,538068,1,13,5,1,0,89
47102,538068,1,13,6,1,0,90
47103,538068,1,14,1,2,1,92
47104,538068,1,14,2,2,0,94
47105,538068,1,14,3,1,0,95
47106,538068,1,14,4,1,0,96
47107,538068,1,14,5,1,0,97
47108,538068,1,14,6,1,0,98
47109,538068,1,15,1,0,1,98
47110,538068,1,15,2,0,0,98
47111,538068,1,15,3,6,0,104
47112,538068,1,15,4,1,0,105
47113,538068,1,15,5,0,0,105
47114,538068,1,15,6,0,0,105
47115,538068,1,16,1,1,0,106
47116,538068,1,16,2,1,0,107
47117,538068,1,16,3,2,0,109
47118,538068,1,16,4,2,0,111
47119,538068,1,16,5,1,0,112
47120,538068,1,16,6,0,1,112
47121,538068,1,17,1,2,0,114
47122,538068,1,17,2,0,0,114
47123,538068,1,17,3,0,0,114
47124,538068,1,17,4,0,0,114
47125,538068,1,17,5,0,0,114
47126,538068,1,17,6,1,0,115
47127,538068,1,18,1,0,0,115
47128,538068,1,18,2,0,0,115
47129,538068,1,18,3,1,0,116
47130,538068,1,18,4,0,0,116
47131,538068,1,18,5,1,0,117
47132,538068,1,18,6,0,0,117
47133,538068,1,19,1,1,0,118
47134,538068,1,19,2,1,0,119
47135,538068,1,19,3,1,0,120
47136,538068,1,19,4,1,0,121
47137,538068,1,19,5,4,0,125
47138,538068,1,19,6,1,0,126
47139,538068,1,20,1,1,0,127
47140,538068,1,20,2,0,1,127
47141,538068,1,20,3,1,0,128
47142,538068,1,20,4,1,0,129
47143,538068,1,20,5,1,0,130
47144,538068,1,20,6,5,0,135
47265,540173,1,1,1,1,0,1
47266,540173,1,1,2,0,0,1
47267,540173,1,1,3,1,0,2
47268,540173,1,1,4,4,0,6
47269,540173,1,1,5,0,0,6
47270,540173,1,1,6,1,0,7
47271,540173,1,2,1,1,0,8
47272,540173,1,2,2,0,0,8
47273,540173,1,2,3,0,0,8
47274,540173,1,2,4,1,0,9
47275,540173,1,2,5,2,0,11
47276,540173,1,2,6,4,0,15
47277,540173,1,3,1,4,0,19
47278,540173,1,3,2,0,0,19
47279,540173,1,3,3,0,1,19
47280,540173,1,3,4,0,0,19
47281,540173,1,3,5,0,0,19
47282,540173,1,3,6,0,0,19
47283,540173,1,4,1,0,0,19
47284,540173,1,4,2,1,0,20
47285,540173,1,4,3,0,0,20
47286,540173,1,4,4,1,0,21
47287,540173,1,4,5,1,0,22
47288,540173,1,4,6,0,0,22
47289,540173,1,5,1,4,0,26
47290,540173,1,5,2,4,0,30
47291,540173,1,5,3,4,0,34
47292,540173,1,5,4,1,0,35
47293,540173,1,5,5,0,0,35
47294,540173,1,5,6,0,0,35
47295,540173,1,6,1,1,0,36
47296,540173,1,6,2,1,0,37
47297,540173,1,6,3,1,0,38
47298,540173,1,6,4,0,0,38
47299,540173,1,6,5,0,0,38
47300,540173,1,6,6,0,0,38
47301,540173,1,7,1,0,0,38
47302,540173,1,7,2,0,1,38
47303,540173,1,7,3,4,0,42
47304,540173,1,7,4,0,0,42
47305,540173,1,7,5,0,0,42
47306,540173,1,7,6,0,0,42
47307,540173,1,8,1,4,0,46
47308,540173,1,8,2,1,0,47
47309,540173,1,8,3,1,0,48
47310,540173,1,8,4,0,0,48
47311,540173,1,8,5,4,0,52
47312,540173,1,8,6,1,0,53
47313,540173,1,9,1,1,0,54
47314,540173,1,9,2,0,0,54
47315,540173,1,9,3,1,0,55
47316,540173,1,9,4,0,0,55
47317,540173,1,9,5,0,0,55
47318,540173,1,9,6,1,0,56
47319,540173,1,10,1,1,0,57
47320,540173,1,10,2,0,0,57
47321,540173,1,10,3,0,0,57
47322,540173,1,10,4,1,0,58
47323,540173,1,10,5,1,0,59
47324,540173,1,10,6,4,0,63
47325,540173,1,11,1,1,0,64
47326,540173,1,11,2,1,0,65
47327,540173,1,11,3,1,0,66
47328,540173,1,11,4,0,0,66
47329,540173,1,11,5,0,1,66
47330,540173,1,11,6,1,0,67
47331,540173,1,12,1,0,0,67
47332,540173,1,12,2,2,0,69
47333,540173,1,12,3,2,0,71
47334,540173,1,12,4,0,0,71
47335,540173,1,12,5,0,0,71
47336,540173,1,12,6,1,0,72
47337,540173,1,13,1,0,1,72
47338,540173,1,13,2,1,0,73
47339,540173,1,13,3,1,0,74
47340,540173,1,13,4,1,0,75
47341,540173,1,13,5,0,0,75
47342,540173,1,13,6,6,0,81
47343,540173,1,14,1,1,0,82
47344,540173,1,14,2,1,0,83
47345,540173,1,14,3,4,0,87
47346,540173,1,14,4,1,0,88
47347,540173,1,14,5,1,0,89
47348,540173,1,14,6,2,0,91
47349,540173,1,15,1,1,0,92
47350,540173,1,15,2,1,0,93
47351,540173,1,15,3,2,0,95
47352,540173,1,15,4,1,0,96
47353,540173,1,15,5,1,0,97
47354,540173,1,15,6,1,0,98
47355,540173,1,16,1,4,0,102
47356,540173,1,16,2,6,0,108
47357,540173,1,16,3,6,0,114
47358,540173,1,16,4,1,0,115
47359,540173,1,16,5,1,0,116
47360,540173,1,16,6,4,0,120
47361,540173,1,17,1,1,0,121
47362,540173,1,17,2,6,0,127
47363,540173,1,17,3,6,0,133
47364,540173,1,17,4,0,0,133
47365,540173,1,17,5,1,0,134
47366,540173,1,17,6,0,1,134
47367,540173,1,18,1,1,0,135
47368,540173,1,18,2,0,0,135
47369,540173,1,18,3,1,0,136
47370,540173,1,18,4,1,0,137
47371,540173,1,18,5,0,0,137
47372,540173,1,18,6,1,0,138
47373,540173,1,19,1,0,0,138
47374,540173,1,19,2,4,0,142
47375,540173,1,19,3,1,0,143
47376,540173,1,19,4,1,0,144
47377,540173,1,19,5,0,1,144
47378,540173,1,19,6,1,0,145
47379,540173,1,20,1,1,0,146
47380,540173,1,20,2,1,0,147
47381,540173,1,20,3,0,0,147
47382,540173,1,20,4,1,1,148
47383,540173,1,20,5,1,0,149
47384,540173,1,20,6,1,0,150
47494,540174,1,1,1,5,0,5
47495,540174,1,1,2,0,0,5
47496,540174,1,1,3,0,0,5
47497,540174,1,1,4,4,0,9
47498,540174,1,1,5,1,0,10
47499,540174,1,1,6,4,0,14
47500,540174,1,2,1,0,0,14
47501,540174,1,2,2,4,0,18
47502,540174,1,2,3,1,0,19
47503,540174,1,2,4,6,0,25
47504,540174,1,2,5,4,0,29
47505,540174,1,2,6,0,0,29
47506,540174,1,3,1,0,0,29
47507,540174,1,3,2,1,0,30
47508,540174,1,3,3,1,0,31
47509,540174,1,3,4,1,0,32
47510,540174,1,3,5,0,0,32
47511,540174,1,3,6,2,0,34
47512,540174,1,4,1,1,0,35
47513,540174,1,4,2,1,0,36
47514,540174,1,4,3,0,0,36
47515,540174,1,4,4,1,0,37
47516,540174,1,4,5,1,0,38
47517,540174,1,4,6,0,0,38
47518,540174,1,5,1,4,0,42
47519,540174,1,5,2,1,0,43
47520,540174,1,5,3,0,0,43
47521,540174,1,5,4,4,0,47
47522,540174,1,5,5,0,0,47
47523,540174,1,5,6,0,0,47
47524,540174,1,6,1,4,0,51
47525,540174,1,6,2,1,0,52
47526,540174,1,6,3,4,0,56
47527,540174,1,6,4,1,0,57
47528,540174,1,6,5,4,0,61
47529,540174,1,6,6,4,0,65
47530,540174,1,7,1,1,0,66
47531,540174,1,7,2,1,0,67
47532,540174,1,7,3,5,0,72
47533,540174,1,7,4,0,1,72
47534,540174,1,7,5,2,0,74
47535,540174,1,7,6,2,0,76
47536,540174,1,8,1,0,0,76
47537,540174,1,8,2,1,0,77
47538,540174,1,8,3,0,0,77
47539,540174,1,8,4,2,0,79
47540,540174,1,8,5,1,0,80
47541,540174,1,8,6,0,1,80
47542,540174,1,9,1,6,0,86
47543,540174,1,9,2,1,0,87
47544,540174,1,9,3,6,0,93
47545,540174,1,9,4,6,0,99
47546,540174,1,9,5,1,0,100
47547,540174,1,9,6,0,0,100
47548,540174,1,10,1,4,0,104
47549,540174,1,10,2,6,0,110
47550,540174,1,10,3,0,0,110
47551,540174,1,10,4,0,1,110
47552,540174,1,10,5,0,0,110
47553,540174,1,10,6,0,0,110
47554,540174,1,11,1,1,0,111
47555,540174,1,11,2,1,0,112
47556,540174,1,11,3,1,0,113
47557,540174,1,11,4,0,0,113
47558,540174,1,11,5,1,0,114
47559,540174,1,11,6,1,0,115
47560,540174,1,12,1,0,0,115
47561,540174,1,12,2,1,0,116
47562,540174,1,12,3,0,0,116
47563,540174,1,12,4,1,0,117
47564,540174,1,12,5,1,0,118
47565,540174,1,12,6,2,0,120
47566,540174,1,13,1,0,1,120
47567,540174,1,13,2,0,0,120
47568,540174,1,13,3,1,0,121
47569,540174,1,13,4,0,0,121
47570,540174,1,13,5,2,0,123
47571,540174,1,13,6,1,0,124
47572,540174,1,14,1,2,0,126
47573,540174,1,14,2,3,0,129
47574,540174,1,14,3,0,0,129
47575,540174,1,14,4,0,0,129
47576,540174,1,14,5,4,0,133
47577,540174,1,14,6,1,0,134
47578,540174,1,15,1,0,1,134
47579,540174,1,15,2,2,0,136
47580,540174,1,15,3,1,0,137
47581,540174,1,15,4,1,0,138
47582,540174,1,15,5,1,0,139
47583,540174,1,15,6,1,0,140
47584,540174,1,16,1,0,1,140
47585,540174,1,16,2,1,0,141
47586,540174,1,16,3,1,0,142
47587,540174,1,16,4,2,0,144
47588,540174,1,16,5,1,0,145
47589,540174,1,16,6,0,0,145
47590,540174,1,17,1,1,0,146
47591,540174,1,17,2,0,0,146
47592,540174,1,17,3,4,0,150
47593,540174,1,17,4,0,0,150
47594,540174,1,17,5,1,0,151
47595,540174,1,17,6,1,0,152
47596,540174,1,18,1,0,0,152
47597,540174,1,18,2,1,0,153
47598,540174,1,18,3,0,0,153
47599,540174,1,18,4,1,0,154
47600,540174,1,18,5,1,0,155
47601,540174,1,18,6,0,1,155
47602,540174,1,19,1,0,1,155
47603,540174,1,19,2,0,0,155
47604,540174,1,19,3,1,0,156
47605,540174,1,19,4,1,0,157
47606,540174,1,19,5,1,0,158
47607,540174,1,19,6,1,0,159
47608,540174,1,20,1,0,0,159
47609,540174,1,20,2,0,1,159
47610,540174,1,20,3,1,0,160
47611,540174,1,20,4,0,1,160
47732,546418,1,1,1,0,0,0
47733,546418,1,1,2,0,0,0
47734,546418,1,1,3,2,0,2
47735,546418,1,1,4,0,0,2
47736,546418,1,1,5,0,0,2
47737,546418,1,1,6,1,0,3
47738,546418,1,2,1,4,0,7
47739,546418,1,2,2,0,0,7
47740,546418,1,2,3,1,0,8
47741,546418,1,2,4,0,0,8
47742,546418,1,2,5,0,0,8
47743,546418,1,2,6,1,0,9
47744,546418,1,3,1,0,0,9
47745,546418,1,3,2,4,0,13
47746,546418,1,3,3,1,0,14
47747,546418,1,3,4,1,0,15
47748,546418,1,3,5,2,0,17
47749,546418,1,3,6,4,0,21
47750,546418,1,4,1,4,0,25
47751,546418,1,4,2,1,0,26
47752,546418,1,4,3,1,0,27
47753,546418,1,4,4,1,0,28
47754,546418,1,4,5,3,0,31
47755,546418,1,4,6,4,0,35
47756,546418,1,5,1,1,0,36
47757,546418,1,5,2,1,0,37
47758,546418,1,5,3,0,0,37
47759,546418,1,5,4,0,0,37
47760,546418,1,5,5,2,0,39
47761,546418,1,5,6,4,0,43
47762,546418,1,6,1,1,0,44
47763,546418,1,6,2,0,1,44
47764,546418,1,6,3,0,0,44
47765,546418,1,6,4,0,0,44
47766,546418,1,6,5,0,0,44
47767,546418,1,6,6,7,0,51
47768,546418,1,7,1,0,1,51
47769,546418,1,7,2,1,0,52
47770,546418,1,7,3,1,0,53
47771,546418,1,7,4,0,0,53
47772,546418,1,7,5,0,0,53
47773,546418,1,7,6,1,0,54
47774,546418,1,8,1,2,0,56
47775,546418,1,8,2,1,0,57
47776,546418,1,8,3,1,0,58
47777,546418,1,8,4,1,0,59
47778,546418,1,8,5,0,0,59
47779,546418,1,8,6,1,0,60
47780,546418,1,9,1,2,0,62
47781,546418,1,9,2,0,0,62
47782,546418,1,9,3,0,1,62
47783,546418,1,9,4,0,0,62
47784,546418,1,9,5,1,0,63
47785,546418,1,9,6,0,0,63
47786,546418,1,10,1,1,0,64
47787,546418,1,10,2,1,0,65
47788,546418,1,10,3,1,0,66
47789,546418,1,10,4,1,0,67
47790,546418,1,10,5,0,0,67
47791,546418,1,10,6,0,0,67
47792,546418,1,11,1,1,0,68
47793,546418,1,11,2,2,0,70
47794,546418,1,11,3,0,0,70
47795,546418,1,11,4,2,0,72
47796,546418,1,11,5,0,0,72
47797,546418,1,11,6,1,0,73
47798,546418,1,12,1,1,0,74
47799,546418,1,12,2,0,0,74
47800,546418,1,12,3,0,0,74
47801,546418,1,12,4,4,0,78
47802,546418,1,12,5,1,0,79
47803,546418,1,12,6,1,0,80
47804,546418,1,13,1,6,0,86
47805,546418,1,13,2,1,0,87
47806,546418,1,13,3,2,0,89
47807,546418,1,13,4,1,0,90
47808,546418,1,13,5,0,0,90
47809,546418,1,13,6,0,0,90
47810,546418,1,14,1,2,0,92
47811,546418,1,14,2,1,0,93
47812,546418,1,14,3,1,0,94
47813,546418,1,14,4,0,1,94
47814,546418,1,14,5,0,0,94
47815,546418,1,14,6,1,0,95
47816,546418,1,15,1,0,0,95
47817,546418,1,15,2,0,0,95
47818,546418,1,15,3,2,0,97
47819,546418,1,15,4,1,0,98
47820,546418,1,15,5,1,0,99
47821,546418,1,15,6,1,0,100
47822,546418,1,16,1,0,1,100
47823,546418,1,16,2,0,0,100
47824,546418,1,16,3,1,0,101
47825,546418,1,16,4,1,0,102
47826,546418,1,16,5,0,0,102
47827,546418,1,16,6,4,0,106
47828,546418,1,17,1,2,0,108
47829,546418,1,17,2,1,0,109
47830,546418,1,17,3,2,0,111
47831,546418,1,17,4,0,0,111
47832,546418,1,17,5,1,0,112
47833,546418,1,17,6,4,0,116
47834,546418,1,18,1,1,0,117
47835,546418,1,18,2,0,0,117
47836,546418,1,18,3,0,1,117
47837,546418,1,18,4,1,0,118
47838,546418,1,18,5,1,0,119
47839,546418,1,18,6,1,0,120
47840,546418,1,19,1,1,0,121
47841,546418,1,19,2,1,0,122
47842,546418,1,19,3,3,0,125
47843,546418,1,19,4,3,0,128
47844,546418,1,19,5,1,0,129
47845,546418,1,19,6,1,0,130
47846,546418,1,20,1,1,0,131
47847,546418,1,20,2,1,0,132
47848,546418,1,20,3,6,0,138
47849,546418,1,20,4,6,0,144
47850,546418,1,20,5,4,0,148
47851,546418,1,20,6,1,0,149
47970,546470,1,1,1,0,0,0
47971,546470,1,1,2,0,0,0
47972,546470,1,1,3,1,0,1
47973,546470,1,1,4,3,0,4
47974,546470,1,1,5,1,0,5
47975,546470,1,1,6,0,0,5
47976,546470,1,2,1,0,0,5
47977,546470,1,2,2,0,0,5
47978,546470,1,2,3,0,0,5
47979,546470,1,2,4,0,1,5
47980,546470,1,2,5,0,0,5
47981,546470,1,2,6,1,0,6
47982,546470,1,3,1,1,0,7
47983,546470,1,3,2,0,0,7
47984,546470,1,3,3,0,0,7
47985,546470,1,3,4,1,0,8
47986,546470,1,3,5,0,0,8
47987,546470,1,3,6,3,0,11
47988,546470,1,4,1,0,0,11
47989,546470,1,4,2,4,0,15
47990,546470,1,4,3,1,0,16
47991,546470,1,4,4,0,0,16
47992,546470,1,4,5,0,0,16
47993,546470,1,4,6,0,0,16
47994,546470,1,5,1,1,0,17
47995,546470,1,5,2,0,0,17
47996,546470,1,5,3,0,1,17
47997,546470,1,5,4,0,0,17
47998,546470,1,5,5,1,0,18
47999,546470,1,5,6,0,0,18
48000,546470,1,6,1,0,0,18
48001,546470,1,6,2,1,0,19
48002,546470,1,6,3,1,0,20
48003,546470,1,6,4,3,0,23
48004,546470,1,6,5,3,0,26
48005,546470,1,6,6,1,0,27
48006,546470,1,7,1,1,0,28
48007,546470,1,7,2,4,0,32
48008,546470,1,7,3,1,0,33
48009,546470,1,7,4,0,0,33
48010,546470,1,7,5,6,0,39
48011,546470,1,7,6,1,0,40
48012,546470,1,8,1,0,0,40
48013,546470,1,8,2,1,0,41
48014,546470,1,8,3,0,0,41
48015,546470,1,8,4,1,0,42
48016,546470,1,8,5,0,0,42
48017,546470,1,8,6,4,0,46
48018,546470,1,9,1,4,0,50
48019,546470,1,9,2,1,0,51
48020,546470,1,9,3,1,0,52
48021,546470,1,9,4,1,0,53
48022,546470,1,9,5,0,0,53
48023,546470,1,9,6,1,0,54
48024,546470,1,10,1,1,0,55
48025,546470,1,10,2,0,0,55
48026,546470,1,10,3,0,0,55
48027,546470,1,10,4,0,0,55
48028,546470,1,10,5,0,0,55
48029,546470,1,10,6,1,0,56
48030,546470,1,11,1,1,0,57
48031,546470,1,11,2,1,0,58
48032,546470,1,11,3,6,0,64
48033,546470,1,11,4,1,0,65
48034,546470,1,11,5,1,0,66
48035,546470,1,11,6,1,0,67
48036,546470,1,12,1,1,0,68
48037,546470,1,12,2,1,0,69
48038,546470,1,12,3,0,0,69
48039,546470,1,12,4,1,0,70
48040,546470,1,12,5,1,0,71
48041,546470,1,12,6,1,0,72
48042,546470,1,13,1,0,1,72
48043,546470,1,13,2,0,0,72
48044,546470,1,13,3,0,0,72
48045,546470,1,13,4,0,0,72
48046,546470,1,13,5,1,0,73
48047,546470,1,13,6,1,0,74
48048,546470,1,14,1,0,0,74
48049,546470,1,14,2,2,0,76
48050,546470,1,14,3,4,0,80
48051,546470,1,14,4,1,0,81
48052,546470,1,14,5,2,0,83
48053,546470,1,14,6,0,0,83
48054,546470,1,15,1,1,0,84
48055,546470,1,15,2,0,0,84
48056,546470,1,15,3,1,0,85
48057,546470,1,15,4,1,0,86
48058,546470,1,15,5,0,0,86
48059,546470,1,15,6,1,0,87
48060,546470,1,16,1,0,0,87
48061,546470,1,16,2,0,0,87
48062,546470,1,16,3,1,0,88
48063,546470,1,16,4,1,0,89
48064,546470,1,16,5,1,0,90
48065,546470,1,16,6,1,0,91
48066,546470,1,17,1,0,0,91
48067,546470,1,17,2,1,0,92
48068,546470,1,17,3,0,0,92
48069,546470,1,17,4,1,0,93
48070,546470,1,17,5,2,0,95
48071,546470,1,17,6,2,0,97
48072,546470,1,18,1,1,1,98
48073,546470,1,18,2,2,0,100
48074,546470,1,18,3,0,1,100
48075,546470,1,18,4,2,0,102
48076,546470,1,18,5,0,0,102
48077,546470,1,18,6,1,0,103
48078,546470,1,19,1,1,0,104
48079,546470,1,19,2,1,0,105
48080,546470,1,19,3,1,0,106
48081,546470,1,19,4,4,0,110
48082,546470,1,19,5,0,1,110
48083,546470,1,19,6,0,0,110
48084,546470,1,20,1,1,0,111
48085,546470,1,20,2,1,0,112
48086,546470,1,20,3,0,0,112
48087,546470,1,20,4,1,0,113
48088,546470,1,20,5,1,0,114
48089,546470,1,20,6,0,1,114
48190,546477,1,1,1,6,0,6
48191,546477,1,1,2,0,0,6
48192,546477,1,1,3,1,0,7
48193,546477,1,1,4,1,0,8
48194,546477,1,1,5,0,0,8
48195,546477,1,1,6,0,0,8
48196,546477,1,2,1,1,0,9
48197,546477,1,2,2,4,0,13
48198,546477,1,2,3,4,0,17
48199,546477,1,2,4,0,0,17
48200,546477,1,2,5,1,0,18
48201,546477,1,2,6,0,0,18
48202,546477,1,3,1,0,1,18
48203,546477,1,3,2,5,0,23
48204,546477,1,3,3,0,0,23
48205,546477,1,3,4,0,0,23
48206,546477,1,3,5,0,0,23
48207,546477,1,3,6,0,0,23
48208,546477,1,4,1,4,0,27
48209,546477,1,4,2,0,1,27
48210,546477,1,4,3,1,0,28
48211,546477,1,4,4,0,0,28
48212,546477,1,4,5,0,0,28
48213,546477,1,4,6,2,0,30
48214,546477,1,5,1,1,0,31
48215,546477,1,5,2,3,0,34
48216,546477,1,5,3,1,0,35
48217,546477,1,5,4,0,0,35
48218,546477,1,5,5,6,0,41
48219,546477,1,5,6,4,0,45
48220,546477,1,6,1,0,0,45
48221,546477,1,6,2,0,0,45
48222,546477,1,6,3,6,0,51
48223,546477,1,6,4,1,0,52
48224,546477,1,6,5,0,0,52
48225,546477,1,6,6,3,0,55
48226,546477,1,7,1,1,0,56
48227,546477,1,7,2,0,1,56
48228,546477,1,7,3,0,0,56
48229,546477,1,7,4,0,0,56
48230,546477,1,7,5,2,0,58
48231,546477,1,7,6,0,0,58
48232,546477,1,8,1,1,0,59
48233,546477,1,8,2,1,0,60
48234,546477,1,8,3,4,0,64
48235,546477,1,8,4,0,0,64
48236,546477,1,8,5,1,0,65
48237,546477,1,8,6,1,0,66
48238,546477,1,9,1,2,0,68
48239,546477,1,9,2,0,0,68
48240,546477,1,9,3,0,0,68
48241,546477,1,9,4,1,0,69
48242,546477,1,9,5,1,0,70
48243,546477,1,9,6,0,0,70
48244,546477,1,10,1,1,0,71
48245,546477,1,10,2,1,0,72
48246,546477,1,10,3,0,0,72
48247,546477,1,10,4,1,0,73
48248,546477,1,10,5,1,0,74
48249,546477,1,10,6,1,0,75
48250,546477,1,11,1,0,0,75
48251,546477,1,11,2,1,0,76
48252,546477,1,11,3,1,0,77
48253,546477,1,11,4,1,0,78
48254,546477,1,11,5,0,1,78
48255,546477,1,11,6,1,0,79
48256,546477,1,12,1,1,0,80
48257,546477,1,12,2,1,0,81
48258,546477,1,12,3,0,0,81
48259,546477,1,12,4,0,0,81
48260,546477,1,12,5,4,0,85
48261,546477,1,12,6,1,0,86
48262,546477,1,13,1,1,0,87
48263,546477,1,13,2,0,0,87
48264,546477,1,13,3,1,0,88
48265,546477,1,13,4,4,0,92
48266,546477,1,13,5,1,0,93
48267,546477,1,13,6,0,0,93
48268,546477,1,14,1,1,0,94
48269,546477,1,14,2,0,0,94
48270,546477,1,14,3,6,0,100
48271,546477,1,14,4,1,0,101
48272,546477,1,14,5,0,0,101
48273,546477,1,14,6,1,0,102
48274,546477,1,15,1,0,0,102
48275,546477,1,15,2,1,0,103
48276,546477,1,15,3,0,0,103
48277,546477,1,15,4,1,0,104
48278,546477,1,15,5,0,0,104
48279,546477,1,15,6,1,0,105
48280,546477,1,16,1,1,0,106
48281,546477,1,16,2,1,0,107
48282,546477,1,16,3,6,0,113
48283,546477,1,16,4,4,0,117
48284,546477,1,16,5,1,0,118
48285,546477,1,16,6,0,0,118
48286,546477,1,17,1,1,0,119
48287,546477,1,17,2,0,1,119
48288,546477,1,17,3,1,0,120
48289,546477,1,17,4,1,0,121
48290,546477,1,17,5,2,0,123
48291,546477,1,17,6,1,0,124
48292,546477,1,18,1,4,0,128
48293,546477,1,18,2,2,0,130
48294,546477,1,18,3,1,0,131
48295,546477,1,18,4,0,1,131
48296,546477,1,18,5,1,0,132
48297,546477,1,18,6,0,0,132
48298,546477,1,19,1,1,0,133
48299,546477,1,19,2,2,0,135
48300,546477,1,19,3,1,0,136
48301,546477,1,19,4,1,1,137
48302,546477,1,19,5,1,0,138
48303,546477,1,19,6,0,0,138
48304,546477,1,20,1,0,0,138
48305,546477,1,20,2,1,0,139
48306,546477,1,20,3,0,0,139
48307,546477,1,20,4,1,0,140
48308,546477,1,20,5,6,0,146
48309,546477,1,20,6,6,0,152
48423,556252,1,1,1,3,0,3
48424,556252,1,1,2,0,0,3
48425,556252,1,1,3,2,0,5
48426,556252,1,1,4,4,0,9
48427,556252,1,1,5,4,0,13
48428,556252,1,1,6,0,0,13
48429,556252,1,2,1,1,0,14
48430,556252,1,2,2,4,0,18
48431,556252,1,2,3,4,0,22
48432,556252,1,2,4,0,1,22
48433,556252,1,2,5,4,0,26
48434,556252,1,2,6,1,0,27
48435,556252,1,3,1,1,0,28
48436,556252,1,3,2,0,0,28
48437,556252,1,3,3,0,0,28
48438,556252,1,3,4,0,0,28
48439,556252,1,3,5,0,0,28
48440,556252,1,3,6,1,0,29
48441,556252,1,4,1,1,0,30
48442,556252,1,4,2,1,0,31
48443,556252,1,4,3,2,0,33
48444,556252,1,4,4,0,0,33
48445,556252,1,4,5,4,0,37
48446,556252,1,4,6,0,0,37
48447,556252,1,5,1,0,0,37
48448,556252,1,5,2,4,0,41
48449,556252,1,5,3,0,0,41
48450,556252,1,5,4,1,0,42
48451,556252,1,5,5,1,0,43
48452,556252,1,5,6,4,0,47
48453,556252,1,6,1,1,0,48
48454,556252,1,6,2,2,0,50
48455,556252,1,6,3,1,0,51
48456,556252,1,6,4,0,0,51
48457,556252,1,6,5,4,0,55
48458,556252,1,6,6,0,0,55
48459,556252,1,7,1,1,0,56
48460,556252,1,7,2,1,0,57
48461,556252,1,7,3,2,0,59
48462,556252,1,7,4,1,0,60
48463,556252,1,7,5,4,0,64
48464,556252,1,7,6,1,0,65
48465,556252,1,8,1,0,0,65
48466,556252,1,8,2,1,0,66
48467,556252,1,8,3,0,0,66
48468,556252,1,8,4,6,0,72
48469,556252,1,8,5,1,0,73
48470,556252,1,8,6,1,0,74
48471,556252,1,9,1,1,0,75
48472,556252,1,9,2,0,0,75
48473,556252,1,9,3,1,0,76
48474,556252,1,9,4,1,0,77
48475,556252,1,9,5,1,0,78
48476,556252,1,9,6,0,0,78
48477,556252,1,10,1,1,0,79
48478,556252,1,10,2,1,0,80
48479,556252,1,10,3,0,0,80
48480,556252,1,10,4,0,0,80
48481,556252,1,10,5,2,0,82
48482,556252,1,10,6,1,0,83
48483,556252,1,11,1,1,0,84
48484,556252,1,11,2,6,0,90
48485,556252,1,11,3,1,0,91
48486,556252,1,11,4,1,0,92
48487,556252,1,11,5,1,0,93
48488,556252,1,11,6,1,0,94
48489,556252,1,12,1,0,0,94
48490,556252,1,12,2,6,0,100
48491,556252,1,12,3,1,0,101
48492,556252,1,12,4,4,0,105
48493,556252,1,12,5,2,0,107
48494,556252,1,12,6,1,0,108
48495,556252,1,13,1,0,0,108
48496,556252,1,13,2,1,0,109
48497,556252,1,13,3,1,0,110
48498,556252,1,13,4,4,0,114
48499,556252,1,13,5,1,0,115
48500,556252,1,13,6,1,0,116
48501,556252,1,14,1,1,0,117
48502,556252,1,14,2,1,0,118
48503,556252,1,14,3,4,0,122
48504,556252,1,14,4,4,0,126
48505,556252,1,14,5,4,0,130
48506,556252,1,14,6,1,0,131
48507,556252,1,15,1,1,0,132
48508,556252,1,15,2,6,0,138
48509,556252,1,15,3,1,0,139
48510,556252,1,15,4,1,0,140
48511,556252,1,15,5,1,0,141
48512,556252,1,15,6,0,1,141
48513,556252,1,16,1,1,0,142
48514,556252,1,16,2,2,0,144
48515,556252,1,16,3,0,0,144
48516,556252,1,16,4,1,0,145
48517,556252,1,16,5,1,0,146
48518,556252,1,16,6,2,0,148
48519,556252,1,17,1,1,0,149
48520,556252,1,17,2,6,0,155
48521,556252,1,17,3,4,0,159
48522,556252,1,17,4,4,0,163
48523,556252,1,17,5,1,0,164
48524,556252,1,17,6,4,0,168
48525,556252,1,18,1,0,1,168
48526,556252,1,18,2,2,0,170
48527,556252,1,18,3,1,0,171
48528,556252,1,18,4,1,0,172
48529,556252,1,18,5,1,0,173
48530,556252,1,18,6,6,0,179
48531,556252,1,19,1,2,0,181
48532,556252,1,19,2,4,0,185
48533,556252,1,19,3,2,0,187
48534,556252,1,19,4,1,0,188
48535,556252,1,19,5,4,0,192
48536,556252,1,19,6,1,0,193
48537,556252,1,20,1,4,0,197
48538,556252,1,20,2,6,0,203
48539,556252,1,20,3,0,1,203
48540,556252,1,20,4,6,0,209
48541,556252,1,20,5,4,0,213
48542,556252,1,20,6,6,0,219
48590,560921,1,1,1,6,0,6
48591,560921,1,1,2,0,0,6
48592,560921,1,1,3,0,0,6
48593,560921,1,1,4,6,0,12
48594,560921,1,1,5,0,0,12
48595,560921,1,1,6,0,0,12
48596,560921,1,2,1,0,0,12
48597,560921,1,2,2,0,0,12
48598,560921,1,2,3,0,0,12
48599,560921,1,2,4,0,0,12
48600,560921,1,2,5,0,0,12
48601,560921,1,2,6,2,0,14
48602,560921,1,3,1,0,0,14
48603,560921,1,3,2,1,0,15
48604,560921,1,3,3,1,0,16
48605,560921,1,3,4,4,0,20
48606,560921,1,3,5,0,0,20
48607,560921,1,3,6,0,0,20
48608,560921,1,4,1,0,0,20
48609,560921,1,4,2,0,0,20
48610,560921,1,4,3,4,0,24
48611,560921,1,4,4,1,0,25
48612,560921,1,4,5,2,0,27
48613,560921,1,4,6,0,1,27
48614,560921,1,5,1,1,0,28
48615,560921,1,5,2,0,0,28
48616,560921,1,5,3,0,0,28
48617,560921,1,5,4,0,0,28
48618,560921,1,5,5,4,0,32
48619,560921,1,5,6,0,0,32
48620,560921,1,6,1,0,0,32
48621,560921,1,6,2,3,0,35
48622,560921,1,6,3,4,0,39
48623,560921,1,6,4,0,0,39
48624,560921,1,6,5,0,0,39
48625,560921,1,6,6,4,0,43
48626,560921,1,7,1,1,0,44
48627,560921,1,7,2,1,0,45
48628,560921,1,7,3,0,0,45
48629,560921,1,7,4,0,0,45
48630,560921,1,7,5,1,0,46
48631,560921,1,7,6,0,0,46
48632,560921,1,8,1,2,0,48
48633,560921,1,8,2,0,0,48
48634,560921,1,8,3,1,0,49
48635,560921,1,8,4,1,0,50
48636,560921,1,8,5,1,0,51
48637,560921,1,8,6,2,0,53
48638,560921,1,9,1,1,0,54
48639,560921,1,9,2,1,0,55
48640,560921,1,9,3,2,0,57
48641,560921,1,9,4,0,0,57
48642,560921,1,9,5,1,0,58
48643,560921,1,9,6,1,0,59
48644,560921,1,10,1,4,0,63
48645,560921,1,10,2,0,0,63
48646,560921,1,10,3,1,0,64
48647,560921,1,10,4,1,0,65
48648,560921,1,10,5,0,0,65
48649,560921,1,10,6,2,0,67
48650,560921,1,11,1,4,0,71
48651,560921,1,11,2,4,0,75
48652,560921,1,11,3,1,0,76
48653,560921,1,11,4,1,0,77
48654,560921,1,11,5,1,0,78
48655,560921,1,11,6,0,0,78
48656,560921,1,12,1,6,0,84
48657,560921,1,12,2,1,0,85
48658,560921,1,12,3,0,0,85
48659,560921,1,12,4,0,0,85
48660,560921,1,12,5,1,0,86
48661,560921,1,12,6,4,0,90
48662,560921,1,13,1,1,0,91
48663,560921,1,13,2,1,0,92
48664,560921,1,13,3,6,0,98
48665,560921,1,13,4,1,0,99
48666,560921,1,13,5,1,0,100
48667,560921,1,13,6,1,0,101
48668,560921,1,14,1,0,1,101
48669,560921,1,14,2,1,0,102
48670,560921,1,14,3,6,0,108
48671,560921,1,14,4,2,0,110
48672,560921,1,14,5,6,0,116
48673,560921,1,14,6,1,0,117
48674,560921,1,15,1,2,0,119
48675,560921,1,15,2,2,0,121
48676,560921,1,15,3,6,0,127
48677,560921,1,15,4,0,0,127
48678,560921,1,15,5,0,0,127
48679,560921,1,15,6,4,0,131
48680,560921,1,16,1,1,0,132
48681,560921,1,16,2,2,0,134
48682,560921,1,16,3,1,0,135
48683,560921,1,16,4,1,0,136
48684,560921,1,16,5,4,0,140
48685,560921,1,16,6,4,0,144
48686,560921,1,17,1,4,0,148
48687,560921,1,17,2,1,0,149
48688,560921,1,17,3,2,0,151
48689,560921,1,17,4,5,0,156
48690,560921,1,17,5,2,0,158
48691,560921,1,17,6,1,0,159
48692,560921,1,18,1,6,0,165
48693,560921,1,18,2,0,0,165
48694,560921,1,18,3,0,0,165
48695,560921,1,18,4,0,0,165
48696,560921,1,18,5,1,0,166
48697,560921,1,18,6,2,0,168
48698,560921,1,19,1,0,0,168
48699,560921,1,19,2,6,0,174
48700,560921,1,19,3,1,0,175
48701,560921,1,19,4,7,0,182
48702,560921,1,19,5,6,0,188
48703,560921,1,19,6,6,0,194
48704,560921,1,20,1,4,0,198
48705,560921,1,20,2,4,0,202
48706,560921,1,20,3,1,0,203
48707,560921,1,20,4,4,0,207
48708,560921,1,20,5,1,0,208
48709,560921,1,20,6,1,0,209
48821,560922,1,1,1,0,0,0
48822,560922,1,1,2,6,0,6
48823,560922,1,1,3,7,0,13
48824,560922,1,1,4,0,0,13
48825,560922,1,1,5,0,0,13
48826,560922,1,1,6,1,0,14
48827,560922,1,2,1,0,1,14
48828,560922,1,2,2,4,0,18
48829,560922,1,2,3,4,0,22
48830,560922,1,2,4,0,0,22
48831,560922,1,2,5,0,0,22
48832,560922,1,2,6,0,0,22
48833,560922,1,3,1,0,0,22
48834,560922,1,3,2,0,0,22
48835,560922,1,3,3,0,0,22
48836,560922,1,3,4,0,0,22
48837,560922,1,3,5,0,0,22
48838,560922,1,3,6,0,0,22
48839,560922,1,4,1,2,0,24
48840,560922,1,4,2,4,0,28
48841,560922,1,4,3,1,0,29
48842,560922,1,4,4,1,0,30
48843,560922,1,4,5,1,0,31
48844,560922,1,4,6,1,0,32
48845,560922,1,5,1,1,0,33
48846,560922,1,5,2,0,0,33
48847,560922,1,5,3,0,0,33
48848,560922,1,5,4,0,0,33
48849,560922,1,5,5,1,0,34
48850,560922,1,5,6,1,0,35
48851,560922,1,6,1,4,0,39
48852,560922,1,6,2,1,0,40
48853,560922,1,6,3,1,0,41
48854,560922,1,6,4,0,0,41
48855,560922,1,6,5,0,0,41
48856,560922,1,6,6,2,0,43
48857,560922,1,7,1,0,0,43
48858,560922,1,7,2,0,0,43
48859,560922,1,7,3,1,0,44
48860,560922,1,7,4,0,0,44
48861,560922,1,7,5,0,0,44
48862,560922,1,7,6,1,0,45
48863,560922,1,8,1,0,0,45
48864,560922,1,8,2,1,0,46
48865,560922,1,8,3,6,0,52
48866,560922,1,8,4,1,0,53
48867,560922,1,8,5,6,0,59
48868,560922,1,8,6,4,0,63
48869,560922,1,9,1,0,0,63
48870,560922,1,9,2,1,0,64
48871,560922,1,9,3,0,0,64
48872,560922,1,9,4,6,0,70
48873,560922,1,9,5,1,0,71
48874,560922,1,9,6,1,0,72
48875,560922,1,10,1,0,0,72
48876,560922,1,10,2,1,0,73
48877,560922,1,10,3,2,0,75
48878,560922,1,10,4,1,0,76
48879,560922,1,10,5,1,0,77
48880,560922,1,10,6,1,0,78
48881,560922,1,11,1,1,0,79
48882,560922,1,11,2,1,0,80
48883,560922,1,11,3,4,0,84
48884,560922,1,11,4,1,0,85
48885,560922,1,11,5,0,0,85
48886,560922,1,11,6,0,0,85
48887,560922,1,12,1,1,0,86
48888,560922,1,12,2,0,1,86
48889,560922,1,12,3,0,0,86
48890,560922,1,12,4,1,0,87
48891,560922,1,12,5,2,0,89
48892,560922,1,12,6,0,0,89
48893,560922,1,13,1,0,0,89
48894,560922,1,13,2,1,0,90
48895,560922,1,13,3,6,0,96
48896,560922,1,13,4,6,0,102
48897,560922,1,13,5,4,0,106
48898,560922,1,13,6,0,0,106
48899,560922,1,14,1,0,0,106
48900,560922,1,14,2,0,0,106
48901,560922,1,14,3,0,0,106
48902,560922,1,14,4,0,0,106
48903,560922,1,14,5,6,0,112
48904,560922,1,14,6,1,0,113
48905,560922,1,15,1,0,0,113
48906,560922,1,15,2,1,0,114
48907,560922,1,15,3,0,0,114
48908,560922,1,15,4,1,0,115
48909,560922,1,15,5,1,0,116
48910,560922,1,15,6,0,0,116
48911,560922,1,16,1,1,0,117
48912,560922,1,16,2,0,1,117
48913,560922,1,16,3,0,0,117
48914,560922,1,16,4,1,0,118
48915,560922,1,16,5,6,0,124
48916,560922,1,16,6,0,1,124
48917,560922,1,17,1,1,0,125
48918,560922,1,17,2,6,0,131
48919,560922,1,17,3,1,0,132
48920,560922,1,17,4,4,0,136
48921,560922,1,17,5,2,0,138
48922,560922,1,17,6,1,0,139
48923,560922,1,18,1,1,0,140
48924,560922,1,18,2,1,0,141
48925,560922,1,18,3,6,0,147
48926,560922,1,18,4,1,0,148
48927,560922,1,18,5,1,0,149
48928,560922,1,18,6,2,0,151
48929,560922,1,19,1,1,0,152
48930,560922,1,19,2,6,0,158
48931,560922,1,19,3,1,0,159
48932,560922,1,19,4,2,0,161
48933,560922,1,19,5,0,1,161
48934,560922,1,19,6,1,0,162
48935,560922,1,20,1,1,0,163
48936,560922,1,20,2,4,0,167
48937,560922,1,20,3,6,0,173
48938,560922,1,20,4,1,0,174
48939,560922,1,20,5,2,0,176
48940,560922,1,20,6,1,0,177
49053,562437,1,1,1,2,0,2
49054,562437,1,1,2,0,0,2
49055,562437,1,1,3,0,1,2
49056,562437,1,1,4,0,0,2
49057,562437,1,1,5,0,0,2
49058,562437,1,1,6,1,0,3
49059,562437,1,2,1,3,0,6
49060,562437,1,2,2,0,0,6
49061,562437,1,2,3,1,0,7
49062,562437,1,2,4,2,0,9
49063,562437,1,2,5,0,0,9
49064,562437,1,2,6,2,0,11
49065,562437,1,3,1,0,0,11
49066,562437,1,3,2,0,0,11
49067,562437,1,3,3,0,1,11
49068,562437,1,3,4,0,0,11
49069,562437,1,3,5,0,0,11
49070,562437,1,3,6,1,0,12
49071,562437,1,4,1,1,0,13
49072,562437,1,4,2,4,0,17
49073,562437,1,4,3,4,0,21
49074,562437,1,4,4,4,0,25
49075,562437,1,4,5,0,0,25
49076,562437,1,4,6,1,0,26
49077,562437,1,5,1,3,0,29
49078,562437,1,5,2,1,0,30
49079,562437,1,5,3,0,0,30
49080,562437,1,5,4,1,1,31
49081,562437,1,5,5,0,0,31
49082,562437,1,5,6,0,0,31
49083,562437,1,6,1,0,0,31
49084,562437,1,6,2,1,0,32
49085,562437,1,6,3,1,0,33
49086,562437,1,6,4,3,0,36
49087,562437,1,6,5,0,0,36
49088,562437,1,6,6,0,0,36
49089,562437,1,7,1,2,0,38
49090,562437,1,7,2,0,0,38
49091,562437,1,7,3,0,0,38
49092,562437,1,7,4,0,0,38
49093,562437,1,7,5,1,0,39
49094,562437,1,7,6,0,0,39
49095,562437,1,8,1,0,0,39
49096,562437,1,8,2,0,1,39
49097,562437,1,8,3,4,0,43
49098,562437,1,8,4,0,0,43
49099,562437,1,8,5,4,0,47
49100,562437,1,8,6,0,0,47
49101,562437,1,9,1,0,0,47
49102,562437,1,9,2,2,0,49
49103,562437,1,9,3,1,0,50
49104,562437,1,9,4,0,0,50
49105,562437,1,9,5,0,0,50
49106,562437,1,9,6,0,0,50
49107,562437,1,10,1,0,0,50
49108,562437,1,10,2,1,0,51
49109,562437,1,10,3,1,0,52
49110,562437,1,10,4,0,0,52
49111,562437,1,10,5,0,0,52
49112,562437,1,10,6,1,0,53
49113,562437,1,11,1,0,0,53
49114,562437,1,11,2,0,0,53
49115,562437,1,11,3,1,0,54
49116,562437,1,11,4,4,0,58
49117,562437,1,11,5,1,0,59
49118,562437,1,11,6,1,0,60
49119,562437,1,12,1,1,0,61
49120,562437,1,12,2,0,0,61
49121,562437,1,12,3,1,0,62
49122,562437,1,12,4,1,0,63
49123,562437,1,12,5,1,0,64
49124,562437,1,12,6,0,0,64
49125,562437,1,13,1,1,0,65
49126,562437,1,13,2,0,0,65
49127,562437,1,13,3,0,0,65
49128,562437,1,13,4,0,0,65
49129,562437,1,13,5,0,1,65
49130,562437,1,13,6,1,0,66
49131,562437,1,14,1,0,0,66
49132,562437,1,14,2,1,0,67
49133,562437,1,14,3,0,0,67
49134,562437,1,14,4,0,0,67
49135,562437,1,14,5,1,0,68
49136,562437,1,14,6,1,0,69
49137,562437,1,15,1,1,0,70
49138,562437,1,15,2,0,0,70
49139,562437,1,15,3,4,0,74
49140,562437,1,15,4,1,0,75
49141,562437,1,15,5,1,0,76
49142,562437,1,15,6,1,0,77
49143,562437,1,16,1,1,0,78
49144,562437,1,16,2,4,0,82
49145,562437,1,16,3,1,0,83
49146,562437,1,16,4,4,0,87
49147,562437,1,16,5,1,0,88
49148,562437,1,16,6,1,0,89
49149,562437,1,17,1,0,1,89
49150,562437,1,17,2,0,1,89
49151,562437,1,17,3,1,0,90
49152,562437,1,17,4,0,0,90
49153,562437,1,17,5,0,0,90
49154,562437,1,17,6,1,0,91
49155,562437,1,18,1,2,0,93
49156,562437,1,18,2,2,0,95
49157,562437,1,18,3,0,0,95
49158,562437,1,18,4,4,0,99
49159,562437,1,18,5,6,0,105
49160,562437,1,18,6,1,0,106
49161,562437,1,19,1,2,0,108
49162,562437,1,19,2,1,0,109
49163,562437,1,19,3,1,0,110
49164,562437,1,19,4,1,0,111
49165,562437,1,19,5,1,0,112
49166,562437,1,19,6,4,0,116
49167,562437,1,20,1,0,0,116
49168,562437,1,20,2,4,0,120
49169,562437,1,20,3,1,0,121
49170,562437,1,20,4,1,0,122
49171,562437,1,20,5,8,0,130
49172,562437,1,20,6,2,0,132
49279,562438,1,1,1,1,0,1
49280,562438,1,1,2,4,0,5
49281,562438,1,1,3,0,0,5
49282,562438,1,1,4,1,0,6
49283,562438,1,1,5,0,0,6
49284,562438,1,1,6,0,0,6
49285,562438,1,2,1,0,0,6
49286,562438,1,2,2,1,0,7
49287,562438,1,2,3,0,0,7
49288,562438,1,2,4,0,0,7
49289,562438,1,2,5,0,0,7
49290,562438,1,2,6,4,0,11
49291,562438,1,3,1,0,1,11
49292,562438,1,3,2,0,0,11
49293,562438,1,3,3,0,0,11
49294,562438,1,3,4,0,0,11
49295,562438,1,3,5,0,0,11
49296,562438,1,3,6,0,0,11
49297,562438,1,4,1,0,0,11
49298,562438,1,4,2,0,0,11
49299,562438,1,4,3,0,0,11
49300,562438,1,4,4,0,0,11
49301,562438,1,4,5,4,0,15
49302,562438,1,4,6,0,0,15
49303,562438,1,5,1,1,0,16
49304,562438,1,5,2,0,0,16
49305,562438,1,5,3,0,0,16
49306,562438,1,5,4,0,0,16
49307,562438,1,5,5,2,0,18
49308,562438,1,5,6,0,1,18
49309,562438,1,6,1,0,0,18
49310,562438,1,6,2,0,0,18
49311,562438,1,6,3,0,0,18
49312,562438,1,6,4,0,0,18
49313,562438,1,6,5,0,0,18
49314,562438,1,6,6,0,0,18
49315,562438,1,7,1,2,0,20
49316,562438,1,7,2,0,0,20
49317,562438,1,7,3,0,0,20
49318,562438,1,7,4,1,0,21
49319,562438,1,7,5,0,0,21
49320,562438,1,7,6,1,0,22
49321,562438,1,8,1,1,0,23
49322,562438,1,8,2,2,0,25
49323,562438,1,8,3,1,0,26
49324,562438,1,8,4,2,0,28
49325,562438,1,8,5,1,0,29
49326,562438,1,8,6,0,0,29
49327,562438,1,9,1,0,1,29
49328,562438,1,9,2,1,0,30
49329,562438,1,9,3,4,0,34
49330,562438,1,9,4,0,0,34
49331,562438,1,9,5,0,0,34
49332,562438,1,9,6,0,0,34
49333,562438,1,10,1,0,0,34
49334,562438,1,10,2,1,0,35
49335,562438,1,10,3,0,0,35
49336,562438,1,10,4,2,0,37
49337,562438,1,10,5,2,0,39
49338,562438,1,10,6,1,0,40
49339,562438,1,11,1,1,1,41
49340,562438,1,11,2,0,0,41
49341,562438,1,11,3,2,0,43
49342,562438,1,11,4,1,0,44
49343,562438,1,11,5,1,0,45
49344,562438,1,11,6,1,0,46
49345,562438,1,12,1,1,0,47
49346,562438,1,12,2,2,0,49
49347,562438,1,12,3,1,0,50
49348,562438,1,12,4,4,0,54
49349,562438,1,12,5,0,0,54
49350,562438,1,12,6,0,0,54
49351,562438,1,13,1,0,0,54
49352,562438,1,13,2,0,0,54
49353,562438,1,13,3,0,0,54
49354,562438,1,13,4,1,0,55
49355,562438,1,13,5,2,0,57
49356,562438,1,13,6,2,0,59
49357,562438,1,14,1,1,0,60
49358,562438,1,14,2,1,0,61
49359,562438,1,14,3,1,0,62
49360,562438,1,14,4,4,0,66
49361,562438,1,14,5,1,0,67
49362,562438,1,14,6,1,0,68
49363,562438,1,15,1,4,0,72
49364,562438,1,15,2,4,0,76
49365,562438,1,15,3,4,0,80
49366,562438,1,15,4,1,0,81
49367,562438,1,15,5,1,0,82
49368,562438,1,15,6,1,0,83
49369,562438,1,16,1,0,0,83
49370,562438,1,16,2,1,0,84
49371,562438,1,16,3,2,0,86
49372,562438,1,16,4,1,0,87
49373,562438,1,16,5,1,0,88
49374,562438,1,16,6,1,0,89
49375,562438,1,17,1,2,0,91
49376,562438,1,17,2,4,0,95
49377,562438,1,17,3,4,0,99
49378,562438,1,17,4,0,0,99
49379,562438,1,17,5,1,0,100
49380,562438,1,17,6,0,0,100
49381,562438,1,18,1,1,0,101
49382,562438,1,18,2,1,0,102
49383,562438,1,18,3,0,0,102
49384,562438,1,18,4,1,0,103
49385,562438,1,18,5,0,0,103
49386,562438,1,18,6,1,0,104
49387,562438,1,19,1,4,0,108
49388,562438,1,19,2,1,0,109
49389,562438,1,19,3,0,1,109
49390,562438,1,19,4,1,0,110
49391,562438,1,19,5,1,0,111
49392,562438,1,19,6,6,0,117
49393,562438,1,20,1,1,0,118
49394,562438,1,20,2,1,0,119
49395,562438,1,20,3,0,1,119
49396,562438,1,20,4,0,0,119
49397,562438,1,20,5,2,0,121
49398,562438,1,20,6,1,0,122
49515,564786,1,1,1,0,0,0
49516,564786,1,1,2,1,0,1
49517,564786,1,1,3,0,0,1
49518,564786,1,1,4,1,0,2
49519,564786,1,1,5,4,0,6
49520,564786,1,1,6,1,0,7
49521,564786,1,2,1,0,0,7
49522,564786,1,2,2,0,0,7
49523,564786,1,2,3,0,0,7
49524,564786,1,2,4,0,1,7
49525,564786,1,2,5,1,0,8
49526,564786,1,2,6,0,0,8
49527,564786,1,3,1,3,0,11
49528,564786,1,3,2,0,0,11
49529,564786,1,3,3,4,0,15
49530,564786,1,3,4,4,0,19
49531,564786,1,3,5,0,0,19
49532,564786,1,3,6,1,0,20
49533,564786,1,4,1,4,0,24
49534,564786,1,4,2,0,0,24
49535,564786,1,4,3,4,0,28
49536,564786,1,4,4,4,0,32
49537,564786,1,4,5,0,0,32
49538,564786,1,4,6,0,0,32
49539,564786,1,5,1,0,0,32
49540,564786,1,5,2,1,0,33
49541,564786,1,5,3,4,0,37
49542,564786,1,5,4,1,0,38
49543,564786,1,5,5,0,0,38
49544,564786,1,5,6,0,0,38
49545,564786,1,6,1,0,0,38
49546,564786,1,6,2,4,0,42
49547,564786,1,6,3,4,0,46
49548,564786,1,6,4,4,0,50
49549,564786,1,6,5,0,0,50
49550,564786,1,6,6,0,0,50
49551,564786,1,7,1,0,0,50
49552,564786,1,7,2,1,0,51
49553,564786,1,7,3,1,0,52
49554,564786,1,7,4,1,0,53
49555,564786,1,7,5,1,0,54
49556,564786,1,7,6,1,0,55
49557,564786,1,8,1,1,0,56
49558,564786,1,8,2,1,0,57
49559,564786,1,8,3,0,0,57
49560,564786,1,8,4,0,0,57
49561,564786,1,8,5,6,0,63
49562,564786,1,8,6,0,0,63
49563,564786,1,9,1,0,0,63
49564,564786,1,9,2,1,0,64
49565,564786,1,9,3,0,0,64
49566,564786,1,9,4,0,0,64
49567,564786,1,9,5,1,0,65
49568,564786,1,9,6,2,0,67
49569,564786,1,10,1,1,0,68
49570,564786,1,10,2,0,0,68
49571,564786,1,10,3,1,0,69
49572,564786,1,10,4,1,0,70
49573,564786,1,10,5,0,0,70
49574,564786,1,10,6,1,0,71
49575,564786,1,11,1,4,0,75
49576,564786,1,11,2,1,0,76
49577,564786,1,11,3,1,0,77
49578,564786,1,11,4,0,0,77
49579,564786,1,11,5,1,0,78
49580,564786,1,11,6,1,0,79
49581,564786,1,12,1,1,0,80
49582,564786,1,12,2,1,0,81
49583,564786,1,12,3,0,1,81
49584,564786,1,12,4,0,0,81
49585,564786,1,12,5,1,0,82
49586,564786,1,12,6,6,0,88
49587,564786,1,13,1,4,0,92
49588,564786,1,13,2,2,0,94
49589,564786,1,13,3,1,0,95
49590,564786,1,13,4,1,0,96
49591,564786,1,13,5,4,0,100
49592,564786,1,13,6,4,0,104
49593,564786,1,14,1,2,0,106
49594,564786,1,14,2,1,0,107
49595,564786,1,14,3,0,0,107
49596,564786,1,14,4,1,0,108
49597,564786,1,14,5,1,0,109
49598,564786,1,14,6,1,0,110
49599,564786,1,15,1,1,0,111
49600,564786,1,15,2,1,0,112
49601,564786,1,15,3,2,0,114
49602,564786,1,15,4,1,0,115
49603,564786,1,15,5,1,0,116
49604,564786,1,15,6,4,0,120
49605,564786,1,16,1,1,0,121
49606,564786,1,16,2,1,0,122
49607,564786,1,16,3,1,0,123
49608,564786,1,16,4,0,0,123
49609,564786,1,16,5,0,0,123
49610,564786,1,16,6,1,0,124
49611,564786,1,17,1,4,0,128
49612,564786,1,17,2,1,0,129
49613,564786,1,17,3,0,1,129
49614,564786,1,17,4,0,0,129
49615,564786,1,17,5,0,0,129
49616,564786,1,17,6,1,0,130
49617,564786,1,18,1,0,0,130
49618,564786,1,18,2,4,0,134
49619,564786,1,18,3,0,0,134
49620,564786,1,18,4,1,0,135
49621,564786,1,18,5,6,0,141
49622,564786,1,18,6,1,0,142
49623,564786,1,19,1,1,0,143
49624,564786,1,19,2,1,0,144
49625,564786,1,19,3,1,0,145
49626,564786,1,19,4,0,0,145
49627,564786,1,19,5,1,0,146
49628,564786,1,19,6,0,0,146
49629,564786,1,20,1,2,0,148
49630,564786,1,20,2,4,0,152
49631,564786,1,20,3,1,0,153
49632,564786,1,20,4,0,0,153
49633,564786,1,20,5,1,0,154
49634,564786,1,20,6,1,0,155
49743,565810,1,1,1,0,0,0
49744,565810,1,1,2,1,0,1
49745,565810,1,1,3,0,0,1
49746,565810,1,1,4,0,0,1
49747,565810,1,1,5,4,0,5
49748,565810,1,1,6,4,0,9
49749,565810,1,2,1,0,0,9
49750,565810,1,2,2,0,0,9
49751,565810,1,2,3,0,0,9
49752,565810,1,2,4,0,0,9
49753,565810,1,2,5,0,0,9
49754,565810,1,2,6,0,0,9
49755,565810,1,3,1,2,0,11
49756,565810,1,3,2,4,0,15
49757,565810,1,3,3,0,0,15
49758,565810,1,3,4,4,0,19
49759,565810,1,3,5,1,0,20
49760,565810,1,3,6,1,0,21
49761,565810,1,4,1,0,1,21
49762,565810,1,4,2,1,0,22
49763,565810,1,4,3,1,0,23
49764,565810,1,4,4,0,0,23
49765,565810,1,4,5,2,0,25
49766,565810,1,4,6,2,0,27
49767,565810,1,5,1,0,0,27
49768,565810,1,5,2,6,0,33
49769,565810,1,5,3,4,0,37
49770,565810,1,5,4,0,0,37
49771,565810,1,5,5,0,0,37
49772,565810,1,5,6,2,0,39
49773,565810,1,6,1,1,0,40
49774,565810,1,6,2,1,0,41
49775,565810,1,6,3,0,0,41
49776,565810,1,6,4,6,0,47
49777,565810,1,6,5,4,0,51
49778,565810,1,6,6,0,0,51
49779,565810,1,7,1,2,0,53
49780,565810,1,7,2,0,0,53
49781,565810,1,7,3,4,0,57
49782,565810,1,7,4,4,0,61
49783,565810,1,7,5,1,0,62
49784,565810,1,7,6,4,0,66
49785,565810,1,8,1,1,0,67
49786,565810,1,8,2,1,0,68
49787,565810,1,8,3,1,0,69
49788,565810,1,8,4,1,0,70
49789,565810,1,8,5,6,0,76
49790,565810,1,8,6,0,0,76
49791,565810,1,9,1,1,0,77
49792,565810,1,9,2,1,0,78
49793,565810,1,9,3,1,0,79
49794,565810,1,9,4,1,0,80
49795,565810,1,9,5,0,0,80
49796,565810,1,9,6,1,0,81
49797,565810,1,10,1,1,0,82
49798,565810,1,10,2,0,0,82
49799,565810,1,10,3,2,0,84
49800,565810,1,10,4,4,0,88
49801,565810,1,10,5,1,0,89
49802,565810,1,10,6,0,0,89
49803,565810,1,11,1,0,1,89
49804,565810,1,11,2,1,0,90
49805,565810,1,11,3,1,0,91
49806,565810,1,11,4,1,0,92
49807,565810,1,11,5,0,0,92
49808,565810,1,11,6,1,0,93
49809,565810,1,12,1,1,0,94
49810,565810,1,12,2,1,0,95
49811,565810,1,12,3,0,0,95
49812,565810,1,12,4,1,0,96
49813,565810,1,12,5,1,0,97
49814,565810,1,12,6,1,0,98
49815,565810,1,13,1,1,0,99
49816,565810,1,13,2,0,1,99
49817,565810,1,13,3,1,0,100
49818,565810,1,13,4,0,1,100
49819,565810,1,13,5,0,0,100
49820,565810,1,13,6,1,0,101
49821,565810,1,14,1,1,0,102
49822,565810,1,14,2,1,0,103
49823,565810,1,14,3,1,0,104
49824,565810,1,14,4,0,0,104
49825,565810,1,14,5,1,0,105
49826,565810,1,14,6,1,0,106
49827,565810,1,15,1,4,0,110
49828,565810,1,15,2,1,0,111
49829,565810,1,15,3,1,0,112
49830,565810,1,15,4,0,0,112
49831,565810,1,15,5,0,0,112
49832,565810,1,15,6,1,0,113
49833,565810,1,16,1,1,0,114
49834,565810,1,16,2,1,0,115
49835,565810,1,16,3,0,0,115
49836,565810,1,16,4,0,0,115
49837,565810,1,16,5,1,0,116
49838,565810,1,16,6,1,0,117
49839,565810,1,17,1,1,0,118
49840,565810,1,17,2,1,0,119
49841,565810,1,17,3,1,0,120
49842,565810,1,17,4,1,0,121
49843,565810,1,17,5,1,0,122
49844,565810,1,17,6,1,0,123
49845,565810,1,18,1,1,0,124
49846,565810,1,18,2,6,0,130
49847,565810,1,18,3,1,0,131
49848,565810,1,18,4,6,0,137
49849,565810,1,18,5,1,0,138
49850,565810,1,18,6,0,0,138
49851,565810,1,19,1,0,1,138
49852,565810,1,19,2,0,0,138
49853,565810,1,19,3,1,0,139
49854,565810,1,19,4,0,1,139
49855,565810,1,19,5,0,0,139
49856,565810,1,19,6,1,0,140
49857,565810,1,20,1,1,0,141
49858,565810,1,20,2,1,0,142
49859,565810,1,20,3,6,0,148
49860,565810,1,20,4,6,0,154
49861,565810,1,20,5,2,0,156
49862,565810,1,20,6,1,0,157
49970,565811,1,1,1,0,0,0
49971,565811,1,1,2,2,0,2
49972,565811,1,1,3,0,0,2
49973,565811,1,1,4,1,0,3
49974,565811,1,1,5,1,0,4
49975,565811,1,1,6,1,0,5
49976,565811,1,2,1,1,0,6
49977,565811,1,2,2,0,0,6
49978,565811,1,2,3,0,0,6
49979,565811,1,2,4,1,0,7
49980,565811,1,2,5,0,1,7
49981,565811,1,2,6,0,0,7
49982,565811,1,3,1,1,0,8
49983,565811,1,3,2,2,0,10
49984,565811,1,3,3,1,0,11
49985,565811,1,3,4,1,0,12
49986,565811,1,3,5,0,0,12
49987,565811,1,3,6,1,0,13
49988,565811,1,4,1,4,0,17
49989,565811,1,4,2,4,0,21
49990,565811,1,4,3,0,0,21
49991,565811,1,4,4,2,0,23
49992,565811,1,4,5,0,0,23
49993,565811,1,4,6,1,0,24
49994,565811,1,5,1,0,0,24
49995,565811,1,5,2,1,0,25
49996,565811,1,5,3,9,0,34
49997,565811,1,5,4,1,0,35
49998,565811,1,5,5,0,0,35
49999,565811,1,5,6,4,0,39
50000,565811,1,6,1,4,0,43
50001,565811,1,6,2,0,0,43
50002,565811,1,6,3,7,0,50
50003,565811,1,6,4,4,0,54
50004,565811,1,6,5,4,0,58
50005,565811,1,6,6,1,0,59
50006,565811,1,7,1,1,0,60
50007,565811,1,7,2,2,0,62
50008,565811,1,7,3,0,0,62
50009,565811,1,7,4,2,0,64
50010,565811,1,7,5,0,1,64
50011,565811,1,7,6,1,0,65
50012,565811,1,8,1,1,0,66
50013,565811,1,8,2,1,0,67
50014,565811,1,8,3,1,0,68
50015,565811,1,8,4,2,0,70
50016,565811,1,8,5,1,0,71
50017,565811,1,8,6,0,0,71
50018,565811,1,9,1,0,1,71
50019,565811,1,9,2,1,0,72
50020,565811,1,9,3,1,0,73
50021,565811,1,9,4,1,0,74
50022,565811,1,9,5,1,0,75
50023,565811,1,9,6,2,0,77
50024,565811,1,10,1,1,0,78
50025,565811,1,10,2,0,0,78
50026,565811,1,10,3,6,0,84
50027,565811,1,10,4,0,0,84
50028,565811,1,10,5,1,0,85
50029,565811,1,10,6,1,0,86
50030,565811,1,11,1,1,0,87
50031,565811,1,11,2,0,0,87
50032,565811,1,11,3,1,0,88
50033,565811,1,11,4,0,0,88
50034,565811,1,11,5,0,1,88
50035,565811,1,11,6,1,0,89
50036,565811,1,12,1,1,0,90
50037,565811,1,12,2,0,0,90
50038,565811,1,12,3,0,0,90
50039,565811,1,12,4,1,0,91
50040,565811,1,12,5,1,0,92
50041,565811,1,12,6,1,0,93
50042,565811,1,13,1,0,0,93
50043,565811,1,13,2,1,0,94
50044,565811,1,13,3,1,0,95
50045,565811,1,13,4,2,0,97
50046,565811,1,13,5,1,0,98
50047,565811,1,13,6,1,0,99
50048,565811,1,14,1,4,0,103
50049,565811,1,14,2,0,0,103
50050,565811,1,14,3,2,0,105
50051,565811,1,14,4,1,0,106
50052,565811,1,14,5,2,0,108
50053,565811,1,14,6,0,0,108
50054,565811,1,15,1,0,1,108
50055,565811,1,15,2,1,0,109
50056,565811,1,15,3,0,0,109
50057,565811,1,15,4,1,0,110
50058,565811,1,15,5,0,0,110
50059,565811,1,15,6,4,0,114
50060,565811,1,16,1,1,0,115
50061,565811,1,16,2,4,0,119
50062,565811,1,16,3,0,0,119
50063,565811,1,16,4,2,0,121
50064,565811,1,16,5,0,0,121
50065,565811,1,16,6,2,0,123
50066,565811,1,17,1,4,0,127
50067,565811,1,17,2,1,0,128
50068,565811,1,17,3,1,0,129
50069,565811,1,17,4,4,0,133
50070,565811,1,17,5,6,0,139
50071,565811,1,17,6,4,0,143
50072,565811,1,18,1,6,0,149
50073,565811,1,18,2,2,0,151
50074,565811,1,18,3,2,0,153
50075,565811,1,18,4,0,0,153
50076,565811,1,18,5,2,0,155
50077,565811,1,18,6,6,0,161
50078,565811,1,19,1,1,0,162
50079,565811,1,19,2,4,0,166
50080,565811,1,19,3,2,0,168
50081,565811,1,19,4,0,1,168
50082,565811,1,19,5,1,0,169
50083,565811,1,19,6,0,0,169
50084,565811,1,20,1,1,0,170
50085,565811,1,20,2,1,0,171
50086,565811,1,20,3,0,1,171
50087,565811,1,20,4,4,0,175
50088,565811,1,20,5,1,0,176
50089,565811,1,20,6,1,1,177
50210,565820,1,1,1,0,0,0
50211,565820,1,1,2,0,0,0
50212,565820,1,1,3,1,0,1
50213,565820,1,1,4,0,0,1
50214,565820,1,1,5,1,0,2
50215,565820,1,1,6,0,1,2
50216,565820,1,2,1,0,0,2
50217,565820,1,2,2,0,0,2
50218,565820,1,2,3,0,1,2
50219,565820,1,2,4,4,0,6
50220,565820,1,2,5,0,0,6
50221,565820,1,2,6,0,0,6
50222,565820,1,3,1,0,0,6
50223,565820,1,3,2,1,0,7
50224,565820,1,3,3,1,0,8
50225,565820,1,3,4,0,0,8
50226,565820,1,3,5,1,0,9
50227,565820,1,3,6,0,0,9
50228,565820,1,4,1,4,0,13
50229,565820,1,4,2,1,0,14
50230,565820,1,4,3,1,0,15
50231,565820,1,4,4,0,0,15
50232,565820,1,4,5,0,0,15
50233,565820,1,4,6,0,0,15
50234,565820,1,5,1,4,0,19
50235,565820,1,5,2,1,0,20
50236,565820,1,5,3,1,0,21
50237,565820,1,5,4,2,0,23
50238,565820,1,5,5,4,0,27
50239,565820,1,5,6,1,0,28
50240,565820,1,6,1,0,0,28
50241,565820,1,6,2,0,0,28
50242,565820,1,6,3,0,0,28
50243,565820,1,6,4,4,0,32
50244,565820,1,6,5,0,0,32
50245,565820,1,6,6,4,0,36
50246,565820,1,7,1,1,0,37
50247,565820,1,7,2,0,0,37
50248,565820,1,7,3,0,0,37
50249,565820,1,7,4,1,0,38
50250,565820,1,7,5,1,0,39
50251,565820,1,7,6,1,0,40
50252,565820,1,8,1,0,0,40
50253,565820,1,8,2,1,0,41
50254,565820,1,8,3,0,0,41
50255,565820,1,8,4,2,0,43
50256,565820,1,8,5,1,0,44
50257,565820,1,8,6,4,0,48
50258,565820,1,9,1,1,0,49
50259,565820,1,9,2,6,0,55
50260,565820,1,9,3,1,0,56
50261,565820,1,9,4,1,0,57
50262,565820,1,9,5,0,0,57
50263,565820,1,9,6,1,0,58
50264,565820,1,10,1,1,0,59
50265,565820,1,10,2,1,0,60
50266,565820,1,10,3,1,0,61
50267,565820,1,10,4,1,0,62
50268,565820,1,10,5,6,0,68
50269,565820,1,10,6,1,0,69
50270,565820,1,11,1,4,0,73
50271,565820,1,11,2,0,0,73
50272,565820,1,11,3,2,0,75
50273,565820,1,11,4,1,0,76
50274,565820,1,11,5,1,0,77
50275,565820,1,11,6,1,0,78
50276,565820,1,12,1,1,0,79
50277,565820,1,12,2,0,0,79
50278,565820,1,12,3,4,0,83
50279,565820,1,12,4,1,0,84
50280,565820,1,12,5,1,0,85
50281,565820,1,12,6,2,0,87
50282,565820,1,13,1,4,0,91
50283,565820,1,13,2,1,0,92
50284,565820,1,13,3,0,1,92
50285,565820,1,13,4,1,0,93
50286,565820,1,13,5,1,0,94
50287,565820,1,13,6,1,0,95
50288,565820,1,14,1,0,0,95
50289,565820,1,14,2,1,0,96
50290,565820,1,14,3,1,0,97
50291,565820,1,14,4,1,0,98
50292,565820,1,14,5,1,0,99
50293,565820,1,14,6,1,0,100
50294,565820,1,15,1,1,0,101
50295,565820,1,15,2,1,0,102
50296,565820,1,15,3,4,0,106
50297,565820,1,15,4,1,0,107
50298,565820,1,15,5,2,0,109
50299,565820,1,15,6,6,0,115
50300,565820,1,16,1,1,0,116
50301,565820,1,16,2,1,0,117
50302,565820,1,16,3,2,0,119
50303,565820,1,16,4,1,0,120
50304,565820,1,16,5,4,0,124
50305,565820,1,16,6,4,0,128
50306,565820,1,17,1,6,0,134
50307,565820,1,17,2,1,0,135
50308,565820,1,17,3,4,0,139
50309,565820,1,17,4,0,1,139
50310,565820,1,17,5,1,0,140
50311,565820,1,17,6,1,0,141
50312,565820,1,18,1,1,0,142
50313,565820,1,18,2,0,1,142
50314,565820,1,18,3,1,0,143
50315,565820,1,18,4,1,0,144
50316,565820,1,18,5,1,0,145
50317,565820,1,18,6,1,0,146
50318,565820,1,19,1,4,0,150
50319,565820,1,19,2,0,0,150
50320,565820,1,19,3,4,0,154
50321,565820,1,19,4,1,0,155
50322,565820,1,19,5,0,0,155
50323,565820,1,19,6,1,0,156
50324,565820,1,20,1,1,0,157
50325,565820,1,20,2,2,0,159
50326,565820,1,20,3,4,0,163
50327,565820,1,20,4,1,0,164
50328,565820,1,20,5,2,0,166
50329,565820,1,20,6,1,0,167
50450,566926,1,1,1,0,0,0
50451,566926,1,1,2,0,0,0
50452,566926,1,1,3,1,0,1
50453,566926,1,1,4,0,1,1
50454,566926,1,1,5,1,0,2
50455,566926,1,1,6,4,0,6
50456,566926,1,2,1,4,0,10
50457,566926,1,2,2,0,0,10
50458,566926,1,2,3,6,0,16
50459,566926,1,2,4,4,0,20
50460,566926,1,2,5,1,0,21
50461,566926,1,2,6,4,0,25
50462,566926,1,3,1,0,0,25
50463,566926,1,3,2,4,0,29
50464,566926,1,3,3,0,0,29
50465,566926,1,3,4,4,0,33
50466,566926,1,3,5,1,0,34
50467,566926,1,3,6,0,0,34
50468,566926,1,4,1,1,0,35
50469,566926,1,4,2,2,0,37
50470,566926,1,4,3,0,0,37
50471,566926,1,4,4,0,0,37
50472,566926,1,4,5,1,0,38
50473,566926,1,4,6,4,0,42
50474,566926,1,5,1,0,0,42
50475,566926,1,5,2,6,0,48
50476,566926,1,5,3,0,0,48
50477,566926,1,5,4,1,0,49
50478,566926,1,5,5,0,0,49
50479,566926,1,5,6,0,0,49
50480,566926,1,6,1,0,0,49
50481,566926,1,6,2,4,0,53
50482,566926,1,6,3,0,0,53
50483,566926,1,6,4,0,0,53
50484,566926,1,6,5,0,0,53
50485,566926,1,6,6,1,0,54
50486,566926,1,7,1,1,0,55
50487,566926,1,7,2,1,0,56
50488,566926,1,7,3,2,0,58
50489,566926,1,7,4,0,0,58
50490,566926,1,7,5,3,0,61
50491,566926,1,7,6,1,0,62
50492,566926,1,8,1,1,0,63
50493,566926,1,8,2,1,0,64
50494,566926,1,8,3,6,0,70
50495,566926,1,8,4,6,0,76
50496,566926,1,8,5,0,0,76
50497,566926,1,8,6,1,0,77
50498,566926,1,9,1,1,0,78
50499,566926,1,9,2,2,0,80
50500,566926,1,9,3,1,0,81
50501,566926,1,9,4,1,0,82
50502,566926,1,9,5,4,0,86
50503,566926,1,9,6,1,0,87
50504,566926,1,10,1,2,0,89
50505,566926,1,10,2,2,0,91
50506,566926,1,10,3,1,0,92
50507,566926,1,10,4,4,0,96
50508,566926,1,10,5,2,0,98
50509,566926,1,10,6,6,0,104
50510,566926,1,11,1,4,0,108
50511,566926,1,11,2,0,0,108
50512,566926,1,11,3,3,0,111
50513,566926,1,11,4,0,0,111
50514,566926,1,11,5,0,0,111
50515,566926,1,11,6,2,0,113
50516,566926,1,12,1,2,0,115
50517,566926,1,12,2,0,0,115
50518,566926,1,12,3,0,0,115
50519,566926,1,12,4,0,0,115
50520,566926,1,12,5,0,1,115
50521,566926,1,12,6,1,0,116
50522,566926,1,13,1,4,0,120
50523,566926,1,13,2,1,0,121
50524,566926,1,13,3,0,0,121
50525,566926,1,13,4,0,0,121
50526,566926,1,13,5,1,0,122
50527,566926,1,13,6,1,0,123
50528,566926,1,14,1,1,0,124
50529,566926,1,14,2,2,0,126
50530,566926,1,14,3,2,0,128
50531,566926,1,14,4,1,0,129
50532,566926,1,14,5,1,0,130
50533,566926,1,14,6,4,0,134
50534,566926,1,15,1,0,0,134
50535,566926,1,15,2,11,0,145
50536,566926,1,15,3,4,0,149
50537,566926,1,15,4,1,0,150
50538,566926,1,15,5,2,0,152
50539,566926,1,15,6,4,0,156
50540,566926,1,16,1,2,0,158
50541,566926,1,16,2,1,0,159
50542,566926,1,16,3,1,0,160
50543,566926,1,16,4,1,0,161
50544,566926,1,16,5,0,1,161
50545,566926,1,16,6,1,0,162
50546,566926,1,17,1,0,0,162
50547,566926,1,17,2,2,0,164
50548,566926,1,17,3,1,0,165
50549,566926,1,17,4,0,0,165
50550,566926,1,17,5,2,0,167
50551,566926,1,17,6,6,0,173
50552,566926,1,18,1,1,0,174
50553,566926,1,18,2,1,0,175
50554,566926,1,18,3,6,0,181
50555,566926,1,18,4,2,0,183
50556,566926,1,18,5,1,0,184
50557,566926,1,18,6,1,0,185
50558,566926,1,19,1,1,0,186
50559,566926,1,19,2,4,0,190
50560,566926,1,19,3,1,0,191
50561,566926,1,19,4,0,0,191
50562,566926,1,19,5,2,0,193
50563,566926,1,19,6,1,0,194
50564,566926,1,20,1,0,0,194
50565,566926,1,20,2,4,0,198
50566,566926,1,20,3,0,0,198
50567,566926,1,20,4,2,0,200
50568,566926,1,20,5,0,1,200
50569,566926,1,20,6,1,0,201
50690,566937,1,1,1,0,0,0
50691,566937,1,1,2,2,0,2
50692,566937,1,1,3,0,0,2
50693,566937,1,1,4,1,0,3
50694,566937,1,1,5,6,0,9
50695,566937,1,1,6,1,0,10
50696,566937,1,2,1,1,0,11
50697,566937,1,2,2,0,1,11
50698,566937,1,2,3,4,0,15
50699,566937,1,2,4,0,0,15
50700,566937,1,2,5,1,0,16
50701,566937,1,2,6,0,0,16
50702,566937,1,3,1,5,0,21
50703,566937,1,3,2,4,0,25
50704,566937,1,3,3,0,0,25
50705,566937,1,3,4,4,0,29
50706,566937,1,3,5,0,0,29
50707,566937,1,3,6,0,0,29
50708,566937,1,4,1,0,0,29
50709,566937,1,4,2,1,0,30
50710,566937,1,4,3,3,0,33
50711,566937,1,4,4,0,0,33
50712,566937,1,4,5,2,0,35
50713,566937,1,4,6,4,0,39
50714,566937,1,5,1,1,0,40
50715,566937,1,5,2,1,0,41
50716,566937,1,5,3,2,0,43
50717,566937,1,5,4,0,0,43
50718,566937,1,5,5,0,0,43
50719,566937,1,5,6,6,0,49
50720,566937,1,6,1,0,0,49
50721,566937,1,6,2,1,0,50
50722,566937,1,6,3,1,0,51
50723,566937,1,6,4,1,0,52
50724,566937,1,6,5,0,0,52
50725,566937,1,6,6,6,0,58
50726,566937,1,7,1,1,0,59
50727,566937,1,7,2,4,0,63
50728,566937,1,7,3,0,0,63
50729,566937,1,7,4,1,0,64
50730,566937,1,7,5,6,0,70
50731,566937,1,7,6,1,0,71
50732,566937,1,8,1,4,0,75
50733,566937,1,8,2,1,0,76
50734,566937,1,8,3,0,0,76
50735,566937,1,8,4,6,0,82
50736,566937,1,8,5,4,0,86
50737,566937,1,8,6,0,0,86
50738,566937,1,9,1,1,0,87
50739,566937,1,9,2,1,0,88
50740,566937,1,9,3,1,0,89
50741,566937,1,9,4,1,0,90
50742,566937,1,9,5,1,0,91
50743,566937,1,9,6,4,0,95
50744,566937,1,10,1,1,0,96
50745,566937,1,10,2,6,0,102
50746,566937,1,10,3,6,0,108
50747,566937,1,10,4,6,0,114
50748,566937,1,10,5,4,0,118
50749,566937,1,10,6,4,0,122
50750,566937,1,11,1,1,0,123
50751,566937,1,11,2,2,0,125
50752,566937,1,11,3,0,1,125
50753,566937,1,11,4,0,0,125
50754,566937,1,11,5,2,0,127
50755,566937,1,11,6,1,0,128
50756,566937,1,12,1,1,0,129
50757,566937,1,12,2,2,0,131
50758,566937,1,12,3,1,0,132
50759,566937,1,12,4,1,0,133
50760,566937,1,12,5,4,0,137
50761,566937,1,12,6,4,0,141
50762,566937,1,13,1,1,0,142
50763,566937,1,13,2,0,0,142
50764,566937,1,13,3,1,0,143
50765,566937,1,13,4,1,0,144
50766,566937,1,13,5,1,0,145
50767,566937,1,13,6,0,0,145
50768,566937,1,14,1,1,0,146
50769,566937,1,14,2,0,0,146
50770,566937,1,14,3,6,0,152
50771,566937,1,14,4,1,0,153
50772,566937,1,14,5,4,0,157
50773,566937,1,14,6,0,0,157
50774,566937,1,15,1,2,0,159
50775,566937,1,15,2,6,0,165
50776,566937,1,15,3,6,0,171
50777,566937,1,15,4,1,0,172
50778,566937,1,15,5,6,0,178
50779,566937,1,15,6,2,0,180
50780,566937,1,16,1,6,0,186
50781,566937,1,16,2,1,0,187
50782,566937,1,16,3,6,0,193
50783,566937,1,16,4,4,0,197
50784,566937,1,16,5,1,0,198
50785,566937,1,16,6,1,0,199
50786,566937,1,17,1,4,0,203
50787,566937,1,17,2,6,0,209
50788,566937,1,17,3,6,0,215
50789,566937,1,17,4,0,0,215
50790,566937,1,17,5,6,0,221
50791,566937,1,17,6,1,0,222
50792,566937,1,18,1,4,0,226
50793,566937,1,18,2,0,1,226
50794,566937,1,18,3,1,0,227
50795,566937,1,18,4,0,1,227
50796,566937,1,18,5,1,0,228
50797,566937,1,18,6,0,0,228
50798,566937,1,19,1,0,1,228
50799,566937,1,19,2,0,0,228
50800,566937,1,19,3,0,0,228
50801,566937,1,19,4,4,0,232
50802,566937,1,19,5,6,0,238
50803,566937,1,19,6,4,0,242
50804,566937,1,20,1,0,1,242
50805,566937,1,20,2,1,0,243
50806,566937,1,20,3,0,0,243
50807,566937,1,20,4,1,0,244
50808,566937,1,20,5,2,0,246
50809,566937,1,20,6,2,0,248
50930,566938,1,1,1,0,0,0
50931,566938,1,1,2,0,0,0
50932,566938,1,1,3,0,0,0
50933,566938,1,1,4,1,0,1
50934,566938,1,1,5,0,0,1
50935,566938,1,1,6,0,0,1
50936,566938,1,2,1,4,0,5
50937,566938,1,2,2,1,0,6
50938,566938,1,2,3,1,0,7
50939,566938,1,2,4,4,0,11
50940,566938,1,2,5,2,0,13
50941,566938,1,2,6,0,0,13
50942,566938,1,3,1,0,0,13
50943,566938,1,3,2,4,0,17
50944,566938,1,3,3,4,0,21
50945,566938,1,3,4,0,0,21
50946,566938,1,3,5,0,0,21
50947,566938,1,3,6,1,0,22
50948,566938,1,4,1,0,0,22
50949,566938,1,4,2,0,0,22
50950,566938,1,4,3,1,0,23
50951,566938,1,4,4,4,0,27
50952,566938,1,4,5,0,0,27
50953,566938,1,4,6,0,0,27
50954,566938,1,5,1,4,0,31
50955,566938,1,5,2,4,0,35
50956,566938,1,5,3,0,0,35
50957,566938,1,5,4,6,0,41
50958,566938,1,5,5,4,0,45
50959,566938,1,5,6,1,0,46
50960,566938,1,6,1,4,0,50
50961,566938,1,6,2,0,0,50
50962,566938,1,6,3,1,0,51
50963,566938,1,6,4,4,0,55
50964,566938,1,6,5,4,0,59
50965,566938,1,6,6,2,0,61
50966,566938,1,7,1,2,0,63
50967,566938,1,7,2,1,0,64
50968,566938,1,7,3,6,0,70
50969,566938,1,7,4,1,0,71
50970,566938,1,7,5,1,0,72
50971,566938,1,7,6,2,0,74
50972,566938,1,8,1,0,0,74
50973,566938,1,8,2,4,0,78
50974,566938,1,8,3,1,0,79
50975,566938,1,8,4,0,0,79
50976,566938,1,8,5,1,0,80
50977,566938,1,8,6,1,0,81
50978,566938,1,9,1,1,0,82
50979,566938,1,9,2,1,0,83
50980,566938,1,9,3,0,0,83
50981,566938,1,9,4,0,0,83
50982,566938,1,9,5,4,0,87
50983,566938,1,9,6,1,0,88
50984,566938,1,10,1,2,0,90
50985,566938,1,10,2,1,0,91
50986,566938,1,10,3,1,0,92
50987,566938,1,10,4,1,0,93
50988,566938,1,10,5,0,0,93
50989,566938,1,10,6,1,0,94
50990,566938,1,11,1,1,0,95
50991,566938,1,11,2,0,0,95
50992,566938,1,11,3,6,0,101
50993,566938,1,11,4,4,0,105
50994,566938,1,11,5,1,0,106
50995,566938,1,11,6,4,0,110
50996,566938,1,12,1,1,0,111
50997,566938,1,12,2,0,1,111
50998,566938,1,12,3,2,0,113
50999,566938,1,12,4,1,0,114
51000,566938,1,12,5,1,0,115
51001,566938,1,12,6,1,0,116
51002,566938,1,13,1,1,0,117
51003,566938,1,13,2,1,0,118
51004,566938,1,13,3,0,0,118
51005,566938,1,13,4,4,0,122
51006,566938,1,13,5,0,0,122
51007,566938,1,13,6,2,0,124
51008,566938,1,14,1,0,0,124
51009,566938,1,14,2,2,0,126
51010,566938,1,14,3,2,0,128
51011,566938,1,14,4,1,0,129
51012,566938,1,14,5,1,0,130
51013,566938,1,14,6,1,0,131
51014,566938,1,15,1,0,0,131
51015,566938,1,15,2,0,0,131
51016,566938,1,15,3,0,0,131
51017,566938,1,15,4,1,0,132
51018,566938,1,15,5,1,0,133
51019,566938,1,15,6,4,0,137
51020,566938,1,16,1,1,0,138
51021,566938,1,16,2,6,0,144
51022,566938,1,16,3,4,0,148
51023,566938,1,16,4,4,0,152
51024,566938,1,16,5,1,0,153
51025,566938,1,16,6,2,0,155
51026,566938,1,17,1,2,0,157
51027,566938,1,17,2,0,1,157
51028,566938,1,17,3,2,0,159
51029,566938,1,17,4,1,0,160
51030,566938,1,17,5,1,0,161
51031,566938,1,17,6,1,0,162
51032,566938,1,18,1,6,0,168
51033,566938,1,18,2,1,0,169
51034,566938,1,18,3,5,0,174
51035,566938,1,18,4,4,0,178
51036,566938,1,18,5,1,0,179
51037,566938,1,18,6,2,0,181
51038,566938,1,19,1,1,0,182
51039,566938,1,19,2,2,0,184
51040,566938,1,19,3,0,0,184
51041,566938,1,19,4,1,0,185
51042,566938,1,19,5,2,0,187
51043,566938,1,19,6,0,1,187
51044,566938,1,20,1,0,1,187
51045,566938,1,20,2,1,0,188
51046,566938,1,20,3,6,0,194
51047,566938,1,20,4,0,1,194
51048,566938,1,20,5,1,0,195
51049,566938,1,20,6,0,0,195
51170,567071,1,1,1,0,0,0
51171,567071,1,1,2,0,0,0
51172,567071,1,1,3,2,0,2
51173,567071,1,1,4,4,0,6
51174,567071,1,1,5,0,0,6
51175,567071,1,1,6,1,0,7
51176,567071,1,2,1,1,0,8
51177,567071,1,2,2,0,0,8
51178,567071,1,2,3,0,0,8
51179,567071,1,2,4,0,0,8
51180,567071,1,2,5,0,0,8
51181,567071,1,2,6,0,0,8
51182,567071,1,3,1,2,0,10
51183,567071,1,3,2,1,0,11
51184,567071,1,3,3,0,0,11
51185,567071,1,3,4,3,0,14
51186,567071,1,3,5,1,0,15
51187,567071,1,3,6,4,0,19
51188,567071,1,4,1,0,0,19
51189,567071,1,4,2,1,0,20
51190,567071,1,4,3,2,0,22
51191,567071,1,4,4,1,0,23
51192,567071,1,4,5,0,0,23
51193,567071,1,4,6,4,0,27
51194,567071,1,5,1,1,0,28
51195,567071,1,5,2,0,0,28
51196,567071,1,5,3,2,0,30
51197,567071,1,5,4,1,0,31
51198,567071,1,5,5,4,0,35
51199,567071,1,5,6,0,1,35
51200,567071,1,6,1,0,0,35
51201,567071,1,6,2,1,0,36
51202,567071,1,6,3,0,0,36
51203,567071,1,6,4,4,0,40
51204,567071,1,6,5,0,0,40
51205,567071,1,6,6,2,0,42
51206,567071,1,7,1,1,0,43
51207,567071,1,7,2,0,0,43
51208,567071,1,7,3,1,0,44
51209,567071,1,7,4,4,0,48
51210,567071,1,7,5,0,0,48
51211,567071,1,7,6,1,0,49
51212,567071,1,8,1,1,0,50
51213,567071,1,8,2,2,0,52
51214,567071,1,8,3,1,0,53
51215,567071,1,8,4,0,0,53
51216,567071,1,8,5,1,0,54
51217,567071,1,8,6,4,0,58
51218,567071,1,9,1,1,0,59
51219,567071,1,9,2,4,0,63
51220,567071,1,9,3,0,0,63
51221,567071,1,9,4,4,0,67
51222,567071,1,9,5,4,0,71
51223,567071,1,9,6,1,0,72
51224,567071,1,10,1,1,0,73
51225,567071,1,10,2,1,0,74
51226,567071,1,10,3,1,0,75
51227,567071,1,10,4,4,0,79
51228,567071,1,10,5,2,0,81
51229,567071,1,10,6,1,0,82
51230,567071,1,11,1,0,0,82
51231,567071,1,11,2,0,0,82
51232,567071,1,11,3,4,0,86
51233,567071,1,11,4,2,0,88
51234,567071,1,11,5,4,0,92
51235,567071,1,11,6,1,0,93
51236,567071,1,12,1,1,0,94
51237,567071,1,12,2,0,1,94
51238,567071,1,12,3,0,0,94
51239,567071,1,12,4,4,0,98
51240,567071,1,12,5,1,0,99
51241,567071,1,12,6,0,0,99
51242,567071,1,13,1,2,0,101
51243,567071,1,13,2,2,0,103
51244,567071,1,13,3,2,0,105
51245,567071,1,13,4,4,0,109
51246,567071,1,13,5,1,0,110
51247,567071,1,13,6,4,0,114
51248,567071,1,14,1,0,1,114
51249,567071,1,14,2,1,0,115
51250,567071,1,14,3,1,0,116
51251,567071,1,14,4,1,0,117
51252,567071,1,14,5,1,0,118
51253,567071,1,14,6,1,0,119
51254,567071,1,15,1,0,0,119
51255,567071,1,15,2,0,0,119
51256,567071,1,15,3,0,0,119
51257,567071,1,15,4,1,0,120
51258,567071,1,15,5,0,1,120
51259,567071,1,15,6,1,0,121
51260,567071,1,16,1,4,0,125
51261,567071,1,16,2,0,0,125
51262,567071,1,16,3,1,0,126
51263,567071,1,16,4,0,0,126
51264,567071,1,16,5,6,0,132
51265,567071,1,16,6,6,0,138
51266,567071,1,17,1,6,0,144
51267,567071,1,17,2,6,0,150
51268,567071,1,17,3,1,0,151
51269,567071,1,17,4,2,0,153
51270,567071,1,17,5,1,0,154
51271,567071,1,17,6,0,1,154
51272,567071,1,18,1,1,0,155
51273,567071,1,18,2,1,0,156
51274,567071,1,18,3,1,0,157
51275,567071,1,18,4,2,0,159
51276,567071,1,18,5,6,0,165
51277,567071,1,18,6,1,0,166
51278,567071,1,19,1,1,0,167
51279,567071,1,19,2,1,0,168
51280,567071,1,19,3,6,0,174
51281,567071,1,19,4,1,0,175
51282,567071,1,19,5,2,0,177
51283,567071,1,19,6,2,0,179
51284,567071,1,20,1,0,0,179
51285,567071,1,20,2,2,0,181
51286,567071,1,20,3,1,0,182
51287,567071,1,20,4,1,0,183
51288,567071,1,20,5,6,0,189
51289,567071,1,20,6,1,0,190
51409,567205,1,1,1,0,0,0
51410,567205,1,1,2,0,0,0
51411,567205,1,1,3,1,0,1
51412,567205,1,1,4,0,0,1
51413,567205,1,1,5,0,1,1
51414,567205,1,1,6,0,0,1
51415,567205,1,2,1,2,0,3
51416,567205,1,2,2,4,0,7
51417,567205,1,2,3,1,0,8
51418,567205,1,2,4,1,0,9
51419,567205,1,2,5,0,0,9
51420,567205,1,2,6,1,0,10
51421,567205,1,3,1,2,0,12
51422,567205,1,3,2,0,1,12
51423,567205,1,3,3,0,0,12
51424,567205,1,3,4,1,0,13
51425,567205,1,3,5,0,0,13
51426,567205,1,3,6,1,0,14
51427,567205,1,4,1,0,0,14
51428,567205,1,4,2,0,1,14
51429,567205,1,4,3,0,0,14
51430,567205,1,4,4,0,0,14
51431,567205,1,4,5,4,0,18
51432,567205,1,4,6,1,0,19
51433,567205,1,5,1,1,0,20
51434,567205,1,5,2,0,0,20
51435,567205,1,5,3,1,0,21
51436,567205,1,5,4,0,0,21
51437,567205,1,5,5,0,0,21
51438,567205,1,5,6,1,0,22
51439,567205,1,6,1,1,0,23
51440,567205,1,6,2,4,0,27
51441,567205,1,6,3,6,0,33
51442,567205,1,6,4,1,0,34
51443,567205,1,6,5,0,0,34
51444,567205,1,6,6,0,0,34
51445,567205,1,7,1,2,0,36
51446,567205,1,7,2,2,0,38
51447,567205,1,7,3,4,0,42
51448,567205,1,7,4,1,0,43
51449,567205,1,7,5,4,0,47
51450,567205,1,7,6,1,0,48
51451,567205,1,8,1,1,0,49
51452,567205,1,8,2,1,0,50
51453,567205,1,8,3,1,0,51
51454,567205,1,8,4,1,0,52
51455,567205,1,8,5,0,1,52
51456,567205,1,8,6,1,0,53
51457,567205,1,9,1,0,0,53
51458,567205,1,9,2,0,0,53
51459,567205,1,9,3,1,0,54
51460,567205,1,9,4,0,0,54
51461,567205,1,9,5,2,0,56
51462,567205,1,9,6,0,0,56
51463,567205,1,10,1,1,0,57
51464,567205,1,10,2,0,0,57
51465,567205,1,10,3,2,0,59
51466,567205,1,10,4,1,0,60
51467,567205,1,10,5,1,0,61
51468,567205,1,10,6,0,0,61
51469,567205,1,11,1,1,0,62
51470,567205,1,11,2,4,0,66
51471,567205,1,11,3,1,0,67
51472,567205,1,11,4,0,0,67
51473,567205,1,11,5,1,0,68
51474,567205,1,11,6,2,0,70
51475,567205,1,12,1,4,0,74
51476,567205,1,12,2,1,0,75
51477,567205,1,12,3,6,0,81
51478,567205,1,12,4,1,0,82
51479,567205,1,12,5,2,0,84
51480,567205,1,12,6,1,0,85
51481,567205,1,13,1,1,0,86
51482,567205,1,13,2,0,0,86
51483,567205,1,13,3,1,0,87
51484,567205,1,13,4,2,0,89
51485,567205,1,13,5,4,0,93
51486,567205,1,13,6,1,0,94
51487,567205,1,14,1,0,1,94
51488,567205,1,14,2,1,0,95
51489,567205,1,14,3,1,0,96
51490,567205,1,14,4,1,0,97
51491,567205,1,14,5,1,0,98
51492,567205,1,14,6,2,0,100
51493,567205,1,15,1,1,0,101
51494,567205,1,15,2,0,0,101
51495,567205,1,15,3,1,0,102
51496,567205,1,15,4,0,1,102
51497,567205,1,15,5,0,0,102
51498,567205,1,15,6,1,0,103
51499,567205,1,16,1,1,0,104
51500,567205,1,16,2,0,0,104
51501,567205,1,16,3,0,0,104
51502,567205,1,16,4,1,0,105
51503,567205,1,16,5,1,0,106
51504,567205,1,16,6,0,0,106
51505,567205,1,17,1,1,0,107
51506,567205,1,17,2,1,0,108
51507,567205,1,17,3,1,0,109
51508,567205,1,17,4,1,0,110
51509,567205,1,17,5,1,0,111
51510,567205,1,17,6,1,0,112
51511,567205,1,18,1,1,0,113
51512,567205,1,18,2,1,0,114
51513,567205,1,18,3,1,0,115
51514,567205,1,18,4,4,0,119
51515,567205,1,18,5,1,0,120
51516,567205,1,18,6,1,0,121
51517,567205,1,19,1,1,0,122
51518,567205,1,19,2,0,1,122
51519,567205,1,19,3,1,0,123
51520,567205,1,19,4,1,0,124
51521,567205,1,19,5,1,0,125
51522,567205,1,19,6,2,0,127
51523,567205,1,20,1,0,0,127
51524,567205,1,20,2,6,0,133
51525,567205,1,20,3,1,0,134
51526,567205,1,20,4,4,0,138
51527,567205,1,20,5,2,0,140
51528,567205,1,20,6,4,0,144
51637,567353,1,1,1,0,0,0
51638,567353,1,1,2,1,0,1
51639,567353,1,1,3,0,0,1
51640,567353,1,1,4,0,0,1
51641,567353,1,1,5,4,0,5
51642,567353,1,1,6,0,0,5
51643,567353,1,2,1,2,0,7
51644,567353,1,2,2,1,0,8
51645,567353,1,2,3,1,0,9
51646,567353,1,2,4,0,0,9
51647,567353,1,2,5,0,0,9
51648,567353,1,2,6,0,0,9
51649,567353,1,3,1,0,1,9
51650,567353,1,3,2,0,0,9
51651,567353,1,3,3,0,0,9
51652,567353,1,3,4,4,0,13
51653,567353,1,3,5,1,0,14
51654,567353,1,3,6,0,0,14
51655,567353,1,4,1,0,0,14
51656,567353,1,4,2,1,0,15
51657,567353,1,4,3,4,0,19
51658,567353,1,4,4,0,0,19
51659,567353,1,4,5,0,0,19
51660,567353,1,4,6,0,1,19
51661,567353,1,5,1,0,0,19
51662,567353,1,5,2,0,0,19
51663,567353,1,5,3,0,0,19
51664,567353,1,5,4,0,0,19
51665,567353,1,5,5,0,1,19
51666,567353,1,5,6,0,0,19
51667,567353,1,6,1,0,0,19
51668,567353,1,6,2,0,0,19
51669,567353,1,6,3,4,0,23
51670,567353,1,6,4,0,0,23
51671,567353,1,6,5,0,0,23
51672,567353,1,6,6,4,0,27
51673,567353,1,7,1,0,0,27
51674,567353,1,7,2,0,1,27
51675,567353,1,7,3,1,0,28
51676,567353,1,7,4,1,0,29
51677,567353,1,7,5,0,0,29
51678,567353,1,7,6,4,0,33
51679,567353,1,8,1,1,0,34
51680,567353,1,8,2,0,0,34
51681,567353,1,8,3,0,1,34
51682,567353,1,8,4,1,0,35
51683,567353,1,8,5,1,0,36
51684,567353,1,8,6,0,0,36
51685,567353,1,9,1,0,0,36
51686,567353,1,9,2,0,0,36
51687,567353,1,9,3,0,0,36
51688,567353,1,9,4,0,0,36
51689,567353,1,9,5,0,1,36
51690,567353,1,9,6,1,0,37
51691,567353,1,10,1,4,0,41
51692,567353,1,10,2,0,0,41
51693,567353,1,10,3,4,0,45
51694,567353,1,10,4,1,0,46
51695,567353,1,10,5,4,0,50
51696,567353,1,10,6,1,0,51
51697,567353,1,11,1,2,0,53
51698,567353,1,11,2,1,0,54
51699,567353,1,11,3,0,0,54
51700,567353,1,11,4,0,1,54
51701,567353,1,11,5,0,0,54
51702,567353,1,11,6,0,0,54
51703,567353,1,12,1,0,0,54
51704,567353,1,12,2,0,0,54
51705,567353,1,12,3,4,0,58
51706,567353,1,12,4,1,0,59
51707,567353,1,12,5,1,0,60
51708,567353,1,12,6,0,1,60
51709,567353,1,13,1,1,0,61
51710,567353,1,13,2,0,0,61
51711,567353,1,13,3,1,0,62
51712,567353,1,13,4,0,0,62
51713,567353,1,13,5,0,0,62
51714,567353,1,13,6,0,0,62
51715,567353,1,14,1,0,0,62
51716,567353,1,14,2,0,0,62
51717,567353,1,14,3,1,0,63
51718,567353,1,14,4,1,0,64
51719,567353,1,14,5,0,0,64
51720,567353,1,14,6,0,0,64
51721,567353,1,15,1,0,0,64
51722,567353,1,15,2,0,0,64
51723,567353,1,15,3,2,0,66
51724,567353,1,15,4,0,0,66
51725,567353,1,15,5,0,0,66
51726,567353,1,15,6,0,0,66
51727,567353,1,16,1,0,0,66
51728,567353,1,16,2,4,0,70
51729,567353,1,16,3,4,0,74
51730,567353,1,16,4,4,0,78
51731,567353,1,16,5,0,0,78
51732,567353,1,16,6,1,0,79
51733,567353,1,17,1,0,0,79
51734,567353,1,17,2,0,0,79
51735,567353,1,17,3,0,0,79
51736,567353,1,17,4,0,0,79
51737,567353,1,17,5,1,0,80
51738,567353,1,17,6,1,0,81
51739,567353,1,18,1,0,1,81
51740,567353,1,18,2,1,0,82
51741,567353,1,18,3,2,0,84
51742,567353,1,18,4,2,0,86
51743,567353,1,18,5,0,0,86
51744,567353,1,18,6,0,0,86
51745,567353,1,19,1,0,0,86
51746,567353,1,19,2,0,1,86
51820,567354,1,1,1,0,0,0
51821,567354,1,1,2,0,0,0
51822,567354,1,1,3,0,0,0
51823,567354,1,1,4,0,0,0
51824,567354,1,1,5,0,0,0
51825,567354,1,1,6,1,0,1
51826,567354,1,2,1,0,0,1
51827,567354,1,2,2,0,0,1
51828,567354,1,2,3,1,0,2
51829,567354,1,2,4,1,0,3
51830,567354,1,2,5,1,0,4
51831,567354,1,2,6,0,0,4
51832,567354,1,3,1,1,0,5
51833,567354,1,3,2,1,0,6
51834,567354,1,3,3,1,0,7
51835,567354,1,3,4,4,0,11
51836,567354,1,3,5,2,0,13
51837,567354,1,3,6,0,0,13
51838,567354,1,4,1,0,1,13
51839,567354,1,4,2,0,0,13
51840,567354,1,4,3,0,0,13
51841,567354,1,4,4,1,0,14
51842,567354,1,4,5,1,0,15
51843,567354,1,4,6,0,0,15
51844,567354,1,5,1,4,0,19
51845,567354,1,5,2,1,0,20
51846,567354,1,5,3,3,0,23
51847,567354,1,5,4,1,0,24
51848,567354,1,5,5,0,0,24
51849,567354,1,5,6,4,0,28
51850,567354,1,6,1,4,0,32
51851,567354,1,6,2,4,0,36
51852,567354,1,6,3,0,0,36
51853,567354,1,6,4,0,0,36
51854,567354,1,6,5,0,0,36
51855,567354,1,6,6,1,0,37
51856,567354,1,7,1,2,0,39
51857,567354,1,7,2,0,0,39
51858,567354,1,7,3,0,0,39
51859,567354,1,7,4,0,0,39
51860,567354,1,7,5,1,0,40
51861,567354,1,7,6,0,0,40
51862,567354,1,8,1,4,0,44
51863,567354,1,8,2,1,0,45
51864,567354,1,8,3,1,0,46
51865,567354,1,8,4,4,0,50
51866,567354,1,8,5,0,0,50
51867,567354,1,8,6,0,0,50
51868,567354,1,9,1,0,0,50
51869,567354,1,9,2,0,0,50
51870,567354,1,9,3,0,0,50
51871,567354,1,9,4,1,0,51
51872,567354,1,9,5,1,0,52
51873,567354,1,9,6,2,0,54
51874,567354,1,10,1,6,0,60
51875,567354,1,10,2,2,0,62
51876,567354,1,10,3,1,0,63
51877,567354,1,10,4,1,0,64
51878,567354,1,10,5,1,0,65
51879,567354,1,10,6,4,0,69
51880,567354,1,11,1,1,0,70
51881,567354,1,11,2,1,0,71
51882,567354,1,11,3,4,0,75
51883,567354,1,11,4,1,0,76
51884,567354,1,11,5,1,0,77
51885,567354,1,11,6,0,0,77
51886,567354,1,12,1,4,0,81
51887,567354,1,12,2,0,0,81
51888,567354,1,12,3,0,1,81
51889,567354,1,12,4,0,0,81
51890,567354,1,12,5,1,0,82
51891,567354,1,12,6,0,0,82
51892,567354,1,13,1,4,0,86
51893,567354,1,13,2,1,0,87
51894,567354,1,13,3,1,0,88
51895,567354,1,13,4,0,0,88
51896,567354,1,13,5,0,0,88
51897,567354,1,13,6,1,0,89
51898,567354,1,14,1,4,0,93
51899,567354,1,14,2,0,0,93
51900,567354,1,14,3,1,0,94
51901,567354,1,14,4,1,0,95
51902,567354,1,14,5,3,0,98
51903,567354,1,14,6,1,0,99
51904,567354,1,15,1,2,0,101
51905,567354,1,15,2,2,0,103
51906,567354,1,15,3,2,0,105
51907,567354,1,15,4,1,0,106
51908,567354,1,15,5,1,0,107
51909,567354,1,15,6,1,0,108
51910,567354,1,16,1,0,0,108
51911,567354,1,16,2,6,0,114
51912,567354,1,16,3,1,0,115
51913,567354,1,16,4,6,0,121
51914,567354,1,16,5,4,0,125
51915,567354,1,16,6,1,0,126
51916,567354,1,17,1,2,0,128
51917,567354,1,17,2,0,0,128
51918,567354,1,17,3,4,0,132
51919,567354,1,17,4,4,0,136
51920,567354,1,17,5,0,0,136
51921,567354,1,17,6,2,0,138
51922,567354,1,18,1,6,0,144
51923,567354,1,18,2,1,0,145
51924,567354,1,18,3,1,0,146
51925,567354,1,18,4,4,0,150
51926,567354,1,18,5,1,0,151
51927,567354,1,18,6,4,0,155
51928,567354,1,19,1,4,0,159
51929,567354,1,19,2,1,1,160
51930,567354,1,19,3,0,1,160
51931,567354,1,19,4,1,0,161
51932,567354,1,19,5,0,1,161
51933,567354,1,19,6,4,0,165
52048,567355,1,1,1,1,0,1
52049,567355,1,1,2,0,0,1
52050,567355,1,1,3,0,0,1
52051,567355,1,1,4,0,0,1
52052,567355,1,1,5,1,0,2
52053,567355,1,1,6,0,0,2
52054,567355,1,2,1,0,0,2
52055,567355,1,2,2,0,0,2
52056,567355,1,2,3,0,0,2
52057,567355,1,2,4,0,0,2
52058,567355,1,2,5,0,1,2
52059,567355,1,2,6,0,0,2
52060,567355,1,3,1,4,0,6
52061,567355,1,3,2,0,0,6
52062,567355,1,3,3,0,0,6
52063,567355,1,3,4,1,0,7
52064,567355,1,3,5,0,0,7
52065,567355,1,3,6,1,0,8
52066,567355,1,4,1,0,0,8
52067,567355,1,4,2,4,0,12
52068,567355,1,4,3,6,0,18
52069,567355,1,4,4,1,0,19
52070,567355,1,4,5,1,0,20
52071,567355,1,4,6,0,0,20
52072,567355,1,5,1,1,0,21
52073,567355,1,5,2,4,0,25
52074,567355,1,5,3,1,0,26
52075,567355,1,5,4,0,1,26
52076,567355,1,5,5,0,0,26
52077,567355,1,5,6,4,0,30
52078,567355,1,6,1,0,0,30
52079,567355,1,6,2,1,0,31
52080,567355,1,6,3,1,0,32
52081,567355,1,6,4,2,0,34
52082,567355,1,6,5,1,0,35
52083,567355,1,6,6,1,0,36
52084,567355,1,7,1,2,0,38
52085,567355,1,7,2,1,0,39
52086,567355,1,7,3,0,0,39
52087,567355,1,7,4,1,0,40
52088,567355,1,7,5,0,0,40
52089,567355,1,7,6,1,0,41
52090,567355,1,8,1,0,0,41
52091,567355,1,8,2,1,0,42
52092,567355,1,8,3,4,0,46
52093,567355,1,8,4,1,0,47
52094,567355,1,8,5,2,0,49
52095,567355,1,8,6,0,0,49
52096,567355,1,9,1,1,0,50
52097,567355,1,9,2,1,0,51
52098,567355,1,9,3,1,0,52
52099,567355,1,9,4,1,0,53
52100,567355,1,9,5,1,0,54
52101,567355,1,9,6,4,0,58
52102,567355,1,10,1,1,0,59
52103,567355,1,10,2,0,0,59
52104,567355,1,10,3,1,0,60
52105,567355,1,10,4,1,0,61
52106,567355,1,10,5,1,0,62
52107,567355,1,10,6,1,0,63
52108,567355,1,11,1,1,0,64
52109,567355,1,11,2,0,0,64
52110,567355,1,11,3,4,0,68
52111,567355,1,11,4,1,0,69
52112,567355,1,11,5,1,0,70
52113,567355,1,11,6,1,0,71
52114,567355,1,12,1,1,0,72
52115,567355,1,12,2,1,0,73
52116,567355,1,12,3,1,0,74
52117,567355,1,12,4,6,0,80
52118,567355,1,12,5,2,0,82
52119,567355,1,12,6,2,0,84
52120,567355,1,13,1,1,0,85
52121,567355,1,13,2,1,0,86
52122,567355,1,13,3,1,0,87
52123,567355,1,13,4,1,0,88
52124,567355,1,13,5,4,0,92
52125,567355,1,13,6,1,0,93
52126,567355,1,14,1,2,0,95
52127,567355,1,14,2,1,0,96
52128,567355,1,14,3,1,0,97
52129,567355,1,14,4,1,0,98
52130,567355,1,14,5,0,0,98
52131,567355,1,14,6,1,0,99
52132,567355,1,15,1,6,0,105
52133,567355,1,15,2,6,0,111
52134,567355,1,15,3,2,0,113
52135,567355,1,15,4,2,0,115
52136,567355,1,15,5,0,1,115
52137,567355,1,15,6,1,0,116
52138,567355,1,16,1,6,0,122
52139,567355,1,16,2,2,0,124
52140,567355,1,16,3,4,0,128
52141,567355,1,16,4,1,0,129
52142,567355,1,16,5,1,0,130
52143,567355,1,16,6,1,0,131
52144,567355,1,17,1,3,0,134
52145,567355,1,17,2,1,0,135
52146,567355,1,17,3,0,1,135
52147,567355,1,17,4,1,0,136
52148,567355,1,17,5,1,0,137
52149,567355,1,17,6,1,0,138
52150,567355,1,18,1,1,0,139
52151,567355,1,18,2,2,0,141
52152,567355,1,18,3,4,0,145
52153,567355,1,18,4,1,0,146
52154,567355,1,18,5,1,0,147
52155,567355,1,18,6,0,0,147
52156,567355,1,19,1,1,0,148
52157,567355,1,19,2,6,0,154
52158,567355,1,19,3,6,0,160
52159,567355,1,19,4,2,0,162
52160,567355,1,19,5,0,0,162
52161,567355,1,19,6,3,0,165
52162,567355,1,20,1,4,0,169
52163,567355,1,20,2,4,0,173
52164,567355,1,20,3,2,0,175
52165,567355,1,20,4,4,0,179
52166,567355,1,20,5,0,1,179
52167,567355,1,20,6,0,1,179
52288,567367,1,1,1,0,0,0
52289,567367,1,1,2,0,0,0
52290,567367,1,1,3,4,0,4
52291,567367,1,1,4,0,0,4
52292,567367,1,1,5,0,0,4
52293,567367,1,1,6,0,0,4
52294,567367,1,2,1,0,0,4
52295,567367,1,2,2,4,0,8
52296,567367,1,2,3,0,0,8
52297,567367,1,2,4,0,0,8
52298,567367,1,2,5,1,0,9
52299,567367,1,2,6,1,0,10
52300,567367,1,3,1,2,0,12
52301,567367,1,3,2,4,0,16
52302,567367,1,3,3,1,0,17
52303,567367,1,3,4,0,0,17
52304,567367,1,3,5,4,0,21
52305,567367,1,3,6,6,0,27
52306,567367,1,4,1,2,0,29
52307,567367,1,4,2,0,0,29
52308,567367,1,4,3,0,1,29
52309,567367,1,4,4,0,0,29
52310,567367,1,4,5,0,0,29
52311,567367,1,4,6,0,0,29
52312,567367,1,5,1,0,0,29
52313,567367,1,5,2,2,0,31
52314,567367,1,5,3,4,0,35
52315,567367,1,5,4,0,0,35
52316,567367,1,5,5,0,0,35
52317,567367,1,5,6,1,0,36
52318,567367,1,6,1,0,0,36
52319,567367,1,6,2,5,0,41
52320,567367,1,6,3,0,0,41
52321,567367,1,6,4,1,0,42
52322,567367,1,6,5,6,0,48
52323,567367,1,6,6,4,0,52
52324,567367,1,7,1,0,0,52
52325,567367,1,7,2,4,0,56
52326,567367,1,7,3,6,0,62
52327,567367,1,7,4,0,0,62
52328,567367,1,7,5,0,0,62
52329,567367,1,7,6,2,0,64
52330,567367,1,8,1,1,0,65
52331,567367,1,8,2,4,0,69
52332,567367,1,8,3,0,0,69
52333,567367,1,8,4,1,0,70
52334,567367,1,8,5,4,0,74
52335,567367,1,8,6,1,0,75
52336,567367,1,9,1,0,0,75
52337,567367,1,9,2,4,0,79
52338,567367,1,9,3,1,0,80
52339,567367,1,9,4,2,0,82
52340,567367,1,9,5,1,0,83
52341,567367,1,9,6,2,0,85
52342,567367,1,10,1,4,0,89
52343,567367,1,10,2,1,0,90
52344,567367,1,10,3,1,0,91
52345,567367,1,10,4,6,0,97
52346,567367,1,10,5,1,0,98
52347,567367,1,10,6,1,0,99
52348,567367,1,11,1,4,0,103
52349,567367,1,11,2,1,0,104
52350,567367,1,11,3,1,0,105
52351,567367,1,11,4,1,0,106
52352,567367,1,11,5,4,0,110
52353,567367,1,11,6,2,0,112
52354,567367,1,12,1,0,1,112
52355,567367,1,12,2,1,0,113
52356,567367,1,12,3,4,0,117
52357,567367,1,12,4,3,0,120
52358,567367,1,12,5,4,0,124
52359,567367,1,12,6,1,0,125
52360,567367,1,13,1,4,0,129
52361,567367,1,13,2,0,0,129
52362,567367,1,13,3,1,0,130
52363,567367,1,13,4,2,0,132
52364,567367,1,13,5,2,0,134
52365,567367,1,13,6,1,0,135
52366,567367,1,14,1,6,0,141
52367,567367,1,14,2,6,0,147
52368,567367,1,14,3,1,0,148
52369,567367,1,14,4,1,0,149
52370,567367,1,14,5,4,0,153
52371,567367,1,14,6,1,0,154
52372,567367,1,15,1,0,0,154
52373,567367,1,15,2,0,0,154
52374,567367,1,15,3,1,0,155
52375,567367,1,15,4,0,1,155
52376,567367,1,15,5,1,0,156
52377,567367,1,15,6,1,0,157
52378,567367,1,16,1,1,0,158
52379,567367,1,16,2,2,0,160
52380,567367,1,16,3,1,0,161
52381,567367,1,16,4,4,0,165
52382,567367,1,16,5,1,0,166
52383,567367,1,16,6,2,0,168
52384,567367,1,17,1,0,0,168
52385,567367,1,17,2,2,0,170
52386,567367,1,17,3,0,1,170
52387,567367,1,17,4,1,0,171
52388,567367,1,17,5,0,1,171
52389,567367,1,17,6,0,0,171
52390,567367,1,18,1,1,0,172
52391,567367,1,18,2,1,0,173
52392,567367,1,18,3,0,0,173
52393,567367,1,18,4,0,0,173
52394,567367,1,18,5,1,0,174
52395,567367,1,18,6,0,1,174
52396,567367,1,19,1,1,0,175
52397,567367,1,19,2,0,0,175
52398,567367,1,19,3,1,0,176
52399,567367,1,19,4,4,0,180
52400,567367,1,19,5,1,0,181
52401,567367,1,19,6,0,0,181
52402,567367,1,20,1,4,0,185
52403,567367,1,20,2,4,0,189
52404,567367,1,20,3,1,0,190
52405,567367,1,20,4,0,1,190
52406,567367,1,20,5,4,0,194
52407,567367,1,20,6,1,0,195
52482,569237,1,1,1,1,0,1
52483,569237,1,1,2,3,0,4
52484,569237,1,1,3,1,0,5
52485,569237,1,1,4,0,0,5
52486,569237,1,1,5,0,0,5
52487,569237,1,1,6,1,0,6
52488,569237,1,2,1,5,0,11
52489,569237,1,2,2,2,0,13
52490,569237,1,2,3,6,0,19
52491,569237,1,2,4,0,0,19
52492,569237,1,2,5,0,0,19
52493,569237,1,2,6,0,0,19
52494,569237,1,3,1,0,0,19
52495,569237,1,3,2,1,0,20
52496,569237,1,3,3,4,0,24
52497,569237,1,3,4,1,0,25
52498,569237,1,3,5,0,0,25
52499,569237,1,3,6,0,0,25
52500,569237,1,4,1,0,0,25
52501,569237,1,4,2,0,0,25
52502,569237,1,4,3,4,0,29
52503,569237,1,4,4,0,1,29
52504,569237,1,4,5,0,0,29
52505,569237,1,4,6,1,0,30
52506,569237,1,5,1,0,0,30
52507,569237,1,5,2,0,0,30
52508,569237,1,5,3,4,0,34
52509,569237,1,5,4,0,0,34
52510,569237,1,5,5,6,0,40
52511,569237,1,5,6,1,0,41
52512,569237,1,6,1,0,0,41
52513,569237,1,6,2,6,0,47
52514,569237,1,6,3,4,0,51
52515,569237,1,6,4,1,0,52
52516,569237,1,6,5,4,0,56
52517,569237,1,6,6,6,0,62
52518,569237,1,7,1,1,0,63
52519,569237,1,7,2,0,0,63
52520,569237,1,7,3,1,0,64
52521,569237,1,7,4,0,0,64
52522,569237,1,7,5,6,0,70
52523,569237,1,7,6,1,0,71
52524,569237,1,8,1,1,0,72
52525,569237,1,8,2,6,0,78
52526,569237,1,8,3,1,0,79
52527,569237,1,8,4,4,0,83
52528,569237,1,8,5,6,0,89
52529,569237,1,8,6,0,1,89
52530,569237,1,9,1,1,0,90
52531,569237,1,9,2,1,0,91
52532,569237,1,9,3,0,0,91
52533,569237,1,9,4,0,1,91
52534,569237,1,9,5,0,0,91
52535,569237,1,9,6,4,0,95
52536,569237,1,10,1,4,0,99
52537,569237,1,10,2,4,0,103
52538,569237,1,10,3,0,0,103
52539,569237,1,10,4,0,0,103
52540,569237,1,10,5,0,0,103
52541,569237,1,10,6,6,0,109
52542,569237,1,11,1,1,0,110
52543,569237,1,11,2,0,0,110
52544,569237,1,11,3,1,0,111
52545,569237,1,11,4,0,0,111
52546,569237,1,11,5,6,0,117
52547,569237,1,11,6,1,0,118
52548,569237,1,12,1,6,0,124
52549,569237,1,12,2,4,0,128
52550,569237,1,12,3,1,0,129
52551,569237,1,12,4,1,0,130
52552,569237,1,12,5,2,0,132
52553,569237,1,12,6,1,0,133
52554,569237,1,13,1,1,0,134
52555,569237,1,13,2,0,0,134
52556,569237,1,13,3,2,0,136
52557,569237,1,13,4,1,0,137
52558,569237,1,13,5,6,0,143
52559,569237,1,13,6,1,0,144
52560,569237,1,14,1,1,0,145
52561,569237,1,14,2,1,0,146
52562,569237,1,14,3,4,0,150
52563,569237,1,14,4,1,0,151
52564,569237,1,14,5,1,0,152
52565,569237,1,14,6,1,0,153
52566,569237,1,15,1,4,0,157
52567,569237,1,15,2,6,0,163
52568,569237,1,15,3,1,0,164
52569,569237,1,15,4,1,0,165
52570,569237,1,15,5,0,0,165
52571,569237,1,15,6,1,0,166
52572,569237,1,16,1,1,0,167
52573,569237,1,16,2,4,0,171
52574,569237,1,16,3,1,0,172
52575,569237,1,16,4,0,0,172
52576,569237,1,16,5,0,1,172
52577,569237,1,16,6,1,0,173
52578,569237,1,17,1,1,0,174
52579,569237,1,17,2,0,0,174
52580,569237,1,17,3,6,0,180
52581,569237,1,17,4,6,0,186
52582,569237,1,17,5,4,0,190
52583,569237,1,17,6,1,0,191
52584,569237,1,18,1,0,0,191
52585,569237,1,18,2,1,0,192
52586,569237,1,18,3,1,0,193
52587,569237,1,18,4,1,0,194
52588,569237,1,18,5,0,1,194
52589,569237,1,18,6,1,0,195
52590,569237,1,19,1,1,0,196
52591,569237,1,19,2,1,0,197
52592,569237,1,19,3,0,1,197
52593,569237,1,19,4,1,0,198
52594,569237,1,19,5,0,0,198
52595,569237,1,19,6,4,0,202
52596,569237,1,20,1,1,0,203
52597,569237,1,20,2,0,1,203
52598,569237,1,20,3,0,0,203
52599,569237,1,20,4,0,0,203
52600,569237,1,20,5,6,0,209
52601,569237,1,20,6,5,0,214
52722,569238,1,1,1,0,0,0
52723,569238,1,1,2,1,0,1
52724,569238,1,1,3,1,0,2
52725,569238,1,1,4,6,0,8
52726,569238,1,1,5,1,0,9
52727,569238,1,1,6,1,0,10
52728,569238,1,2,1,0,0,10
52729,569238,1,2,2,1,0,11
52730,569238,1,2,3,0,0,11
52731,569238,1,2,4,1,0,12
52732,569238,1,2,5,2,0,14
52733,569238,1,2,6,6,0,20
52734,569238,1,3,1,0,0,20
52735,569238,1,3,2,1,0,21
52736,569238,1,3,3,0,0,21
52737,569238,1,3,4,1,0,22
52738,569238,1,3,5,0,0,22
52739,569238,1,3,6,4,0,26
52740,569238,1,4,1,1,0,27
52741,569238,1,4,2,1,0,28
52742,569238,1,4,3,2,0,30
52743,569238,1,4,4,2,0,32
52744,569238,1,4,5,1,0,33
52745,569238,1,4,6,1,0,34
52746,569238,1,5,1,0,0,34
52747,569238,1,5,2,1,0,35
52748,569238,1,5,3,6,0,41
52749,569238,1,5,4,1,0,42
52750,569238,1,5,5,4,0,46
52751,569238,1,5,6,1,0,47
52752,569238,1,6,1,4,0,51
52753,569238,1,6,2,1,0,52
52754,569238,1,6,3,1,0,53
52755,569238,1,6,4,1,0,54
52756,569238,1,6,5,0,0,54
52757,569238,1,6,6,0,0,54
52758,569238,1,7,1,4,0,58
52759,569238,1,7,2,1,0,59
52760,569238,1,7,3,0,0,59
52761,569238,1,7,4,1,0,60
52762,569238,1,7,5,1,0,61
52763,569238,1,7,6,1,0,62
52764,569238,1,8,1,0,0,62
52765,569238,1,8,2,0,0,62
52766,569238,1,8,3,6,0,68
52767,569238,1,8,4,1,0,69
52768,569238,1,8,5,1,0,70
52769,569238,1,8,6,1,0,71
52770,569238,1,9,1,4,0,75
52771,569238,1,9,2,0,1,75
52772,569238,1,9,3,0,0,75
52773,569238,1,9,4,0,0,75
52774,569238,1,9,5,0,0,75
52775,569238,1,9,6,1,0,76
52776,569238,1,10,1,1,0,77
52777,569238,1,10,2,6,0,83
52778,569238,1,10,3,0,0,83
52779,569238,1,10,4,1,0,84
52780,569238,1,10,5,0,0,84
52781,569238,1,10,6,0,0,84
52782,569238,1,11,1,2,0,86
52783,569238,1,11,2,1,0,87
52784,569238,1,11,3,6,0,93
52785,569238,1,11,4,1,0,94
52786,569238,1,11,5,1,0,95
52787,569238,1,11,6,0,0,95
52788,569238,1,12,1,1,0,96
52789,569238,1,12,2,0,0,96
52790,569238,1,12,3,6,0,102
52791,569238,1,12,4,3,0,105
52792,569238,1,12,5,0,1,105
52793,569238,1,12,6,0,0,105
52794,569238,1,13,1,1,0,106
52795,569238,1,13,2,1,0,107
52796,569238,1,13,3,1,0,108
52797,569238,1,13,4,1,0,109
52798,569238,1,13,5,1,0,110
52799,569238,1,13,6,1,0,111
52800,569238,1,14,1,1,0,112
52801,569238,1,14,2,0,0,112
52802,569238,1,14,3,0,0,112
52803,569238,1,14,4,4,0,116
52804,569238,1,14,5,4,0,120
52805,569238,1,14,6,4,0,124
52806,569238,1,15,1,0,1,124
52807,569238,1,15,2,1,0,125
52808,569238,1,15,3,0,0,125
52809,569238,1,15,4,0,0,125
52810,569238,1,15,5,1,0,126
52811,569238,1,15,6,4,0,130
52812,569238,1,16,1,1,0,131
52813,569238,1,16,2,1,0,132
52814,569238,1,16,3,1,0,133
52815,569238,1,16,4,2,0,135
52816,569238,1,16,5,4,0,139
52817,569238,1,16,6,0,1,139
52818,569238,1,17,1,2,0,141
52819,569238,1,17,2,1,0,142
52820,569238,1,17,3,1,0,143
52821,569238,1,17,4,1,0,144
52822,569238,1,17,5,2,0,146
52823,569238,1,17,6,0,0,146
52824,569238,1,18,1,1,0,147
52825,569238,1,18,2,2,0,149
52826,569238,1,18,3,4,0,153
52827,569238,1,18,4,1,0,154
52828,569238,1,18,5,0,0,154
52829,569238,1,18,6,0,1,154
52830,569238,1,19,1,1,0,155
52831,569238,1,19,2,1,0,156
52832,569238,1,19,3,6,0,162
52833,569238,1,19,4,6,0,168
52834,569238,1,19,5,2,0,170
52835,569238,1,19,6,6,0,176
52836,569238,1,20,1,1,0,177
52837,569238,1,20,2,1,0,178
52838,569238,1,20,3,1,0,179
52839,569238,1,20,4,4,0,183
52840,569238,1,20,5,5,1,188
52841,569238,1,20,6,4,0,192
52959,569239,1,1,1,0,0,0
52960,569239,1,1,2,1,0,1
52961,569239,1,1,3,0,0,1
52962,569239,1,1,4,1,0,2
52963,569239,1,1,5,1,0,3
52964,569239,1,1,6,0,0,3
52965,569239,1,2,1,0,0,3
52966,569239,1,2,2,4,0,7
52967,569239,1,2,3,0,0,7
52968,569239,1,2,4,1,0,8
52969,569239,1,2,5,0,0,8
52970,569239,1,2,6,1,0,9
52971,569239,1,3,1,0,0,9
52972,569239,1,3,2,0,0,9
52973,569239,1,3,3,2,0,11
52974,569239,1,3,4,1,0,12
52975,569239,1,3,5,0,0,12
52976,569239,1,3,6,4,0,16
52977,569239,1,4,1,0,0,16
52978,569239,1,4,2,1,0,17
52979,569239,1,4,3,0,1,17
52980,569239,1,4,4,0,0,17
52981,569239,1,4,5,1,0,18
52982,569239,1,4,6,0,0,18
52983,569239,1,5,1,0,0,18
52984,569239,1,5,2,1,0,19
52985,569239,1,5,3,0,0,19
52986,569239,1,5,4,0,0,19
52987,569239,1,5,5,0,0,19
52988,569239,1,5,6,1,0,20
52989,569239,1,6,1,4,0,24
52990,569239,1,6,2,1,0,25
52991,569239,1,6,3,1,0,26
52992,569239,1,6,4,2,0,28
52993,569239,1,6,5,1,0,29
52994,569239,1,6,6,1,0,30
52995,569239,1,7,1,1,0,31
52996,569239,1,7,2,4,0,35
52997,569239,1,7,3,1,0,36
52998,569239,1,7,4,1,0,37
52999,569239,1,7,5,1,0,38
53000,569239,1,7,6,1,0,39
53001,569239,1,8,1,2,0,41
53002,569239,1,8,2,1,0,42
53003,569239,1,8,3,1,0,43
53004,569239,1,8,4,4,0,47
53005,569239,1,8,5,2,0,49
53006,569239,1,8,6,1,0,50
53007,569239,1,9,1,1,0,51
53008,569239,1,9,2,0,0,51
53009,569239,1,9,3,4,0,55
53010,569239,1,9,4,2,0,57
53011,569239,1,9,5,2,0,59
53012,569239,1,9,6,1,0,60
53013,569239,1,10,1,1,0,61
53014,569239,1,10,2,1,0,62
53015,569239,1,10,3,0,1,62
53016,569239,1,10,4,0,0,62
53017,569239,1,10,5,0,0,62
53018,569239,1,10,6,1,0,63
53019,569239,1,11,1,1,0,64
53020,569239,1,11,2,0,0,64
53021,569239,1,11,3,0,0,64
53022,569239,1,11,4,6,0,70
53023,569239,1,11,5,0,1,70
53024,569239,1,11,6,3,0,73
53025,569239,1,12,1,1,0,74
53026,569239,1,12,2,0,0,74
53027,569239,1,12,3,2,0,76
53028,569239,1,12,4,1,0,77
53029,569239,1,12,5,1,0,78
53030,569239,1,12,6,6,0,84
53031,569239,1,13,1,1,0,85
53032,569239,1,13,2,1,0,86
53033,569239,1,13,3,0,0,86
53034,569239,1,13,4,1,0,87
53035,569239,1,13,5,1,0,88
53036,569239,1,13,6,1,0,89
53037,569239,1,14,1,1,0,90
53038,569239,1,14,2,1,0,91
53039,569239,1,14,3,1,0,92
53040,569239,1,14,4,0,0,92
53041,569239,1,14,5,2,0,94
53042,569239,1,14,6,1,0,95
53043,569239,1,15,1,0,0,95
53044,569239,1,15,2,0,1,95
53045,569239,1,15,3,1,0,96
53046,569239,1,15,4,1,0,97
53047,569239,1,15,5,1,0,98
53048,569239,1,15,6,0,0,98
53049,569239,1,16,1,1,0,99
53050,569239,1,16,2,0,1,99
53051,569239,1,16,3,0,0,99
53052,569239,1,16,4,1,0,100
53053,569239,1,16,5,2,0,102
53054,569239,1,16,6,0,0,102
53055,569239,1,17,1,1,0,103
53056,569239,1,17,2,0,0,103
53057,569239,1,17,3,4,0,107
53058,569239,1,17,4,0,0,107
53059,569239,1,17,5,1,0,108
53060,569239,1,17,6,1,0,109
53061,569239,1,18,1,4,0,113
53062,569239,1,18,2,2,0,115
53063,569239,1,18,3,1,0,116
53064,569239,1,18,4,1,0,117
53065,569239,1,18,5,6,0,123
53066,569239,1,18,6,1,0,124
53067,569239,1,19,1,1,0,125
53068,569239,1,19,2,1,0,126
53069,569239,1,19,3,1,0,127
53070,569239,1,19,4,1,0,128
53071,569239,1,19,5,0,1,128
53072,569239,1,19,6,1,0,129
53073,569239,1,20,1,1,0,130
53074,569239,1,20,2,0,1,130
53075,569239,1,20,3,1,0,131
53076,569239,1,20,4,4,0,135
53077,569239,1,20,5,4,0,139
53078,569239,1,20,6,0,1,139
53155,571148,1,1,1,1,0,1
53156,571148,1,1,2,1,0,2
53157,571148,1,1,3,4,0,6
53158,571148,1,1,4,2,0,8
53159,571148,1,1,5,0,0,8
53160,571148,1,1,6,0,0,8
53161,571148,1,2,1,1,0,9
53162,571148,1,2,2,1,0,10
53163,571148,1,2,3,0,0,10
53164,571148,1,2,4,0,0,10
53165,571148,1,2,5,1,0,11
53166,571148,1,2,6,0,0,11
53167,571148,1,3,1,1,0,12
53168,571148,1,3,2,0,0,12
53169,571148,1,3,3,0,0,12
53170,571148,1,3,4,0,0,12
53171,571148,1,3,5,0,1,12
53172,571148,1,3,6,1,0,13
53173,571148,1,4,1,0,0,13
53174,571148,1,4,2,0,1,13
53175,571148,1,4,3,2,0,15
53176,571148,1,4,4,4,0,19
53177,571148,1,4,5,0,0,19
53178,571148,1,4,6,4,0,23
53179,571148,1,5,1,0,0,23
53180,571148,1,5,2,0,0,23
53181,571148,1,5,3,3,0,26
53182,571148,1,5,4,2,0,28
53183,571148,1,5,5,0,0,28
53184,571148,1,5,6,2,0,30
53185,571148,1,6,1,1,0,31
53186,571148,1,6,2,0,0,31
53187,571148,1,6,3,0,0,31
53188,571148,1,6,4,0,0,31
53189,571148,1,6,5,0,0,31
53190,571148,1,6,6,1,0,32
53191,571148,1,7,1,0,0,32
53192,571148,1,7,2,1,0,33
53193,571148,1,7,3,1,0,34
53194,571148,1,7,4,1,0,35
53195,571148,1,7,5,3,0,38
53196,571148,1,7,6,0,0,38
53197,571148,1,8,1,0,0,38
53198,571148,1,8,2,1,0,39
53199,571148,1,8,3,1,0,40
53200,571148,1,8,4,0,0,40
53201,571148,1,8,5,1,0,41
53202,571148,1,8,6,1,0,42
53203,571148,1,9,1,3,0,45
53204,571148,1,9,2,1,0,46
53205,571148,1,9,3,0,1,46
53206,571148,1,9,4,1,0,47
53207,571148,1,9,5,1,0,48
53208,571148,1,9,6,1,0,49
53209,571148,1,10,1,1,0,50
53210,571148,1,10,2,1,0,51
53211,571148,1,10,3,0,1,51
53212,571148,1,10,4,0,0,51
53213,571148,1,10,5,0,0,51
53214,571148,1,10,6,0,0,51
53215,571148,1,11,1,1,0,52
53216,571148,1,11,2,0,0,52
53217,571148,1,11,3,0,1,52
53218,571148,1,11,4,1,0,53
53219,571148,1,11,5,0,0,53
53220,571148,1,11,6,1,0,54
53221,571148,1,12,1,0,0,54
53222,571148,1,12,2,0,0,54
53223,571148,1,12,3,0,0,54
53224,571148,1,12,4,1,0,55
53225,571148,1,12,5,1,0,56
53226,571148,1,12,6,0,0,56
53227,571148,1,13,1,0,0,56
53228,571148,1,13,2,0,0,56
53229,571148,1,13,3,0,0,56
53230,571148,1,13,4,2,0,58
53231,571148,1,13,5,0,0,58
53232,571148,1,13,6,2,0,60
53233,571148,1,14,1,1,0,61
53234,571148,1,14,2,1,0,62
53235,571148,1,14,3,1,0,63
53236,571148,1,14,4,1,0,64
53237,571148,1,14,5,1,0,65
53238,571148,1,14,6,2,0,67
53239,571148,1,15,1,1,0,68
53240,571148,1,15,2,0,0,68
53241,571148,1,15,3,0,0,68
53242,571148,1,15,4,1,0,69
53243,571148,1,15,5,1,0,70
53244,571148,1,15,6,1,0,71
53245,571148,1,16,1,0,0,71
53246,571148,1,16,2,1,0,72
53247,571148,1,16,3,0,1,72
53248,571148,1,16,4,1,0,73
53249,571148,1,16,5,0,0,73
53250,571148,1,16,6,1,0,74
53251,571148,1,17,1,1,0,75
53252,571148,1,17,2,1,0,76
53253,571148,1,17,3,2,0,78
53254,571148,1,17,4,1,0,79
53255,571148,1,17,5,1,0,80
53256,571148,1,17,6,1,0,81
53257,571148,1,18,1,0,1,81
53258,571148,1,18,2,0,1,81
53259,571148,1,18,3,0,0,81
53260,571148,1,18,4,2,0,83
53261,571148,1,18,5,0,0,83
53262,571148,1,18,6,1,0,84
53263,571148,1,19,1,1,0,85
53264,571148,1,19,2,1,0,86
53265,571148,1,19,3,0,0,86
53266,571148,1,19,4,1,0,87
53267,571148,1,19,5,0,0,87
53268,571148,1,19,6,1,0,88
53269,571148,1,20,1,0,1,88
53270,571148,1,20,2,1,0,89
53271,571148,1,20,3,0,1,89
53361,571150,1,1,1,0,0,0
53362,571150,1,1,2,0,0,0
53363,571150,1,1,3,4,0,4
53364,571150,1,1,4,0,0,4
53365,571150,1,1,5,0,0,4
53366,571150,1,1,6,2,0,6
53367,571150,1,2,1,0,0,6
53368,571150,1,2,2,0,0,6
53369,571150,1,2,3,1,0,7
53370,571150,1,2,4,1,0,8
53371,571150,1,2,5,1,0,9
53372,571150,1,2,6,1,0,10
53373,571150,1,3,1,1,0,11
53374,571150,1,3,2,0,0,11
53375,571150,1,3,3,4,0,15
53376,571150,1,3,4,0,0,15
53377,571150,1,3,5,0,0,15
53378,571150,1,3,6,1,0,16
53379,571150,1,4,1,1,0,17
53380,571150,1,4,2,6,0,23
53381,571150,1,4,3,1,0,24
53382,571150,1,4,4,1,0,25
53383,571150,1,4,5,1,0,26
53384,571150,1,4,6,1,0,27
53385,571150,1,5,1,2,0,29
53386,571150,1,5,2,2,0,31
53387,571150,1,5,3,6,0,37
53388,571150,1,5,4,0,0,37
53389,571150,1,5,5,1,0,38
53390,571150,1,5,6,3,0,41
53391,571150,1,6,1,0,0,41
53392,571150,1,6,2,1,0,42
53393,571150,1,6,3,0,0,42
53394,571150,1,6,4,0,0,42
53395,571150,1,6,5,0,0,42
53396,571150,1,6,6,0,0,42
53397,571150,1,7,1,0,0,42
53398,571150,1,7,2,2,0,44
53399,571150,1,7,3,3,0,47
53400,571150,1,7,4,0,0,47
53401,571150,1,7,5,2,0,49
53402,571150,1,7,6,1,0,50
53403,571150,1,8,1,6,0,56
53404,571150,1,8,2,1,0,57
53405,571150,1,8,3,1,0,58
53406,571150,1,8,4,6,0,64
53407,571150,1,8,5,0,0,64
53408,571150,1,8,6,6,0,70
53409,571150,1,9,1,6,0,76
53410,571150,1,9,2,0,0,76
53411,571150,1,9,3,0,0,76
53412,571150,1,9,4,6,0,82
53413,571150,1,9,5,6,0,88
53414,571150,1,9,6,1,0,89
53415,571150,1,10,1,6,0,95
53416,571150,1,10,2,1,0,96
53417,571150,1,10,3,6,0,102
53418,571150,1,10,4,0,0,102
53419,571150,1,10,5,1,0,103
53420,571150,1,10,6,1,0,104
53421,571150,1,11,1,6,0,110
53422,571150,1,11,2,1,0,111
53423,571150,1,11,3,0,0,111
53424,571150,1,11,4,0,1,111
53425,571150,1,11,5,1,0,112
53426,571150,1,11,6,0,0,112
53427,571150,1,12,1,0,0,112
53428,571150,1,12,2,0,0,112
53429,571150,1,12,3,0,0,112
53430,571150,1,12,4,0,0,112
53431,571150,1,12,5,0,0,112
53432,571150,1,12,6,2,0,114
53433,571150,1,13,1,0,1,114
53434,571150,1,13,2,0,0,114
53435,571150,1,13,3,4,0,118
53436,571150,1,13,4,4,0,122
53437,571150,1,13,5,0,0,122
53438,571150,1,13,6,1,0,123
53439,571150,1,14,1,1,0,124
53440,571150,1,14,2,1,0,125
53441,571150,1,14,3,6,0,131
53442,571150,1,14,4,1,0,132
53443,571150,1,14,5,1,0,133
53444,571150,1,14,6,1,0,134
53445,571150,1,15,1,2,0,136
53446,571150,1,15,2,4,0,140
53447,571150,1,15,3,0,0,140
53448,571150,1,15,4,0,1,140
53449,571150,1,15,5,1,0,141
53450,571150,1,15,6,0,0,141
53451,571150,1,16,1,1,0,142
53452,571150,1,16,2,2,0,144
53453,571150,1,16,3,0,0,144
53454,571150,1,16,4,0,0,144
53455,571150,1,16,5,1,0,145
53456,571150,1,16,6,0,0,145
53457,571150,1,17,1,0,1,145
53458,571150,1,17,2,1,0,146
53459,571150,1,17,3,4,0,150
53460,571150,1,17,4,0,0,150
53461,571150,1,17,5,1,0,151
53462,571150,1,17,6,0,0,151
53463,571150,1,18,1,1,0,152
53464,571150,1,18,2,0,0,152
53465,571150,1,18,3,0,1,152
53466,571150,1,18,4,0,0,152
53467,571150,1,18,5,4,0,156
53468,571150,1,18,6,2,0,158
53469,571150,1,19,1,1,0,159
53470,571150,1,19,2,0,0,159
53471,571150,1,19,3,0,1,159
53472,571150,1,19,4,0,0,159
53473,571150,1,19,5,0,0,159
53474,571150,1,19,6,1,0,160
53475,571150,1,20,1,2,0,162
53476,571150,1,20,2,2,0,164
53477,571150,1,20,3,1,0,165
53478,571150,1,20,4,2,0,167
53479,571150,1,20,5,0,1,167
53480,571150,1,20,6,1,0,168
53596,573019,1,1,1,0,0,0
53597,573019,1,1,2,2,0,2
53598,573019,1,1,3,1,0,3
53599,573019,1,1,4,1,0,4
53600,573019,1,1,5,3,0,7
53601,573019,1,1,6,0,0,7
53602,573019,1,2,1,0,0,7
53603,573019,1,2,2,0,0,7
53604,573019,1,2,3,0,0,7
53605,573019,1,2,4,1,0,8
53606,573019,1,2,5,0,1,8
53607,573019,1,2,6,0,0,8
53608,573019,1,3,1,3,0,11
53609,573019,1,3,2,1,0,12
53610,573019,1,3,3,4,0,16
53611,573019,1,3,4,0,0,16
53612,573019,1,3,5,4,0,20
53613,573019,1,3,6,0,0,20
53614,573019,1,4,1,1,0,21
53615,573019,1,4,2,2,0,23
53616,573019,1,4,3,1,0,24
53617,573019,1,4,4,0,0,24
53618,573019,1,4,5,1,0,25
53619,573019,1,4,6,0,0,25
53620,573019,1,5,1,1,0,26
53621,573019,1,5,2,1,0,27
53622,573019,1,5,3,0,0,27
53623,573019,1,5,4,0,0,27
53624,573019,1,5,5,0,0,27
53625,573019,1,5,6,1,0,28
53626,573019,1,6,1,1,0,29
53627,573019,1,6,2,1,0,30
53628,573019,1,6,3,0,0,30
53629,573019,1,6,4,0,0,30
53630,573019,1,6,5,1,0,31
53631,573019,1,6,6,0,0,31
53632,573019,1,7,1,0,0,31
53633,573019,1,7,2,0,0,31
53634,573019,1,7,3,0,1,31
53635,573019,1,7,4,1,0,32
53636,573019,1,7,5,2,0,34
53637,573019,1,7,6,1,0,35
53638,573019,1,8,1,0,0,35
53639,573019,1,8,2,6,0,41
53640,573019,1,8,3,1,0,42
53641,573019,1,8,4,1,0,43
53642,573019,1,8,5,1,0,44
53643,573019,1,8,6,1,0,45
53644,573019,1,9,1,2,0,47
53645,573019,1,9,2,0,0,47
53646,573019,1,9,3,0,0,47
53647,573019,1,9,4,6,0,53
53648,573019,1,9,5,0,0,53
53649,573019,1,9,6,0,1,53
53650,573019,1,10,1,1,0,54
53651,573019,1,10,2,1,0,55
53652,573019,1,10,3,2,0,57
53653,573019,1,10,4,1,0,58
53654,573019,1,10,5,0,0,58
53655,573019,1,10,6,0,0,58
53656,573019,1,11,1,1,0,59
53657,573019,1,11,2,0,0,59
53658,573019,1,11,3,1,0,60
53659,573019,1,11,4,0,0,60
53660,573019,1,11,5,0,0,60
53661,573019,1,11,6,4,0,64
53662,573019,1,12,1,0,0,64
53663,573019,1,12,2,1,0,65
53664,573019,1,12,3,1,0,66
53665,573019,1,12,4,1,0,67
53666,573019,1,12,5,2,0,69
53667,573019,1,12,6,1,0,70
53668,573019,1,13,1,1,0,71
53669,573019,1,13,2,1,0,72
53670,573019,1,13,3,4,0,76
53671,573019,1,13,4,1,0,77
53672,573019,1,13,5,1,0,78
53673,573019,1,13,6,1,0,79
53674,573019,1,14,1,1,0,80
53675,573019,1,14,2,1,0,81
53676,573019,1,14,3,1,0,82
53677,573019,1,14,4,1,0,83
53678,573019,1,14,5,1,0,84
53679,573019,1,14,6,2,0,86
53680,573019,1,15,1,4,0,90
53681,573019,1,15,2,6,0,96
53682,573019,1,15,3,3,0,99
53683,573019,1,15,4,1,0,100
53684,573019,1,15,5,1,0,101
53685,573019,1,15,6,0,0,101
53686,573019,1,16,1,1,0,102
53687,573019,1,16,2,0,0,102
53688,573019,1,16,3,1,0,103
53689,573019,1,16,4,1,0,104
53690,573019,1,16,5,1,0,105
53691,573019,1,16,6,1,0,106
53692,573019,1,17,1,2,0,108
53693,573019,1,17,2,1,0,109
53694,573019,1,17,3,1,0,110
53695,573019,1,17,4,1,0,111
53696,573019,1,17,5,1,0,112
53697,573019,1,17,6,0,0,112
53698,573019,1,18,1,6,0,118
53699,573019,1,18,2,2,0,120
53700,573019,1,18,3,1,0,121
53701,573019,1,18,4,0,0,121
53702,573019,1,18,5,1,0,122
53703,573019,1,18,6,1,0,123
53704,573019,1,19,1,1,0,124
53705,573019,1,19,2,1,0,125
53706,573019,1,19,3,1,0,126
53707,573019,1,19,4,1,0,127
53708,573019,1,19,5,1,0,128
53709,573019,1,19,6,1,0,129
53710,573019,1,20,1,1,0,130
53711,573019,1,20,2,1,0,131
53712,573019,1,20,3,2,0,133
53713,573019,1,20,4,1,0,134
53714,573019,1,20,5,2,0,136
53715,573019,1,20,6,1,0,137
53829,573020,1,1,1,0,0,0
53830,573020,1,1,2,3,0,3
53831,573020,1,1,3,0,0,3
53832,573020,1,1,4,1,0,4
53833,573020,1,1,5,1,0,5
53834,573020,1,1,6,0,0,5
53835,573020,1,2,1,1,0,6
53836,573020,1,2,2,0,0,6
53837,573020,1,2,3,1,0,7
53838,573020,1,2,4,0,0,7
53839,573020,1,2,5,2,0,9
53840,573020,1,2,6,0,0,9
53841,573020,1,3,1,1,0,10
53842,573020,1,3,2,1,0,11
53843,573020,1,3,3,0,0,11
53844,573020,1,3,4,4,0,15
53845,573020,1,3,5,0,1,15
53846,573020,1,3,6,0,0,15
53847,573020,1,4,1,0,0,15
53848,573020,1,4,2,0,0,15
53849,573020,1,4,3,4,0,19
53850,573020,1,4,4,0,0,19
53851,573020,1,4,5,5,0,24
53852,573020,1,4,6,4,0,28
53853,573020,1,5,1,0,0,28
53854,573020,1,5,2,0,0,28
53855,573020,1,5,3,0,0,28
53856,573020,1,5,4,0,0,28
53857,573020,1,5,5,1,0,29
53858,573020,1,5,6,0,0,29
53859,573020,1,6,1,4,0,33
53860,573020,1,6,2,0,0,33
53861,573020,1,6,3,0,1,33
53862,573020,1,6,4,1,0,34
53863,573020,1,6,5,1,0,35
53864,573020,1,6,6,1,0,36
53865,573020,1,7,1,1,0,37
53866,573020,1,7,2,1,0,38
53867,573020,1,7,3,1,0,39
53868,573020,1,7,4,0,1,39
53869,573020,1,7,5,0,0,39
53870,573020,1,7,6,0,0,39
53871,573020,1,8,1,0,0,39
53872,573020,1,8,2,1,0,40
53873,573020,1,8,3,1,0,41
53874,573020,1,8,4,1,0,42
53875,573020,1,8,5,4,0,46
53876,573020,1,8,6,1,0,47
53877,573020,1,9,1,1,0,48
53878,573020,1,9,2,1,0,49
53879,573020,1,9,3,2,0,51
53880,573020,1,9,4,0,0,51
53881,573020,1,9,5,2,0,53
53882,573020,1,9,6,1,0,54
53883,573020,1,10,1,1,0,55
53884,573020,1,10,2,1,0,56
53885,573020,1,10,3,0,0,56
53886,573020,1,10,4,0,0,56
53887,573020,1,10,5,0,0,56
53888,573020,1,10,6,0,0,56
53889,573020,1,11,1,1,0,57
53890,573020,1,11,2,4,0,61
53891,573020,1,11,3,1,0,62
53892,573020,1,11,4,1,0,63
53893,573020,1,11,5,1,0,64
53894,573020,1,11,6,0,0,64
53895,573020,1,12,1,1,0,65
53896,573020,1,12,2,6,0,71
53897,573020,1,12,3,2,0,73
53898,573020,1,12,4,1,0,74
53899,573020,1,12,5,0,0,74
53900,573020,1,12,6,1,0,75
53901,573020,1,13,1,1,0,76
53902,573020,1,13,2,0,0,76
53903,573020,1,13,3,0,0,76
53904,573020,1,13,4,4,0,80
53905,573020,1,13,5,0,0,80
53906,573020,1,13,6,1,0,81
53907,573020,1,14,1,1,0,82
53908,573020,1,14,2,4,0,86
53909,573020,1,14,3,4,0,90
53910,573020,1,14,4,0,0,90
53911,573020,1,14,5,2,0,92
53912,573020,1,14,6,0,0,92
53913,573020,1,15,1,0,0,92
53914,573020,1,15,2,6,0,98
53915,573020,1,15,3,1,0,99
53916,573020,1,15,4,1,0,100
53917,573020,1,15,5,0,0,100
53918,573020,1,15,6,1,0,101
53919,573020,1,16,1,1,0,102
53920,573020,1,16,2,0,1,102
53921,573020,1,16,3,2,0,104
53922,573020,1,16,4,4,0,108
53923,573020,1,16,5,1,0,109
53924,573020,1,16,6,1,0,110
53925,573020,1,17,1,1,0,111
53926,573020,1,17,2,6,0,117
53927,573020,1,17,3,1,0,118
53928,573020,1,17,4,1,0,119
53929,573020,1,17,5,1,0,120
53930,573020,1,17,6,0,0,120
53931,573020,1,18,1,2,0,122
53932,573020,1,18,2,1,0,123
53933,573020,1,18,3,2,0,125
53934,573020,1,18,4,1,0,126
53935,573020,1,18,5,4,0,130
53936,573020,1,18,6,0,0,130
53937,573020,1,19,1,2,0,132
53938,573020,1,19,2,1,0,133
53939,573020,1,19,3,1,0,134
53940,573020,1,19,4,1,0,135
53941,573020,1,19,5,2,0,137
53942,573020,1,19,6,4,0,141
53943,573020,1,20,1,4,0,145
53944,573020,1,20,2,4,0,149
53945,573020,1,20,3,4,0,153
53946,573020,1,20,4,1,0,154
53947,573020,1,20,5,6,0,160
53948,573020,1,20,6,1,0,161
54039,573027,1,1,1,0,0,0
54040,573027,1,1,2,1,0,1
54041,573027,1,1,3,0,0,1
54042,573027,1,1,4,3,0,4
54043,573027,1,1,5,0,0,4
54044,573027,1,1,6,1,0,5
54045,573027,1,2,1,0,0,5
54046,573027,1,2,2,6,0,11
54047,573027,1,2,3,0,1,11
54048,573027,1,2,4,1,0,12
54049,573027,1,2,5,1,0,13
54050,573027,1,2,6,4,0,17
54051,573027,1,3,1,0,0,17
54052,573027,1,3,2,0,0,17
54053,573027,1,3,3,4,0,21
54054,573027,1,3,4,0,0,21
54055,573027,1,3,5,0,0,21
54056,573027,1,3,6,1,0,22
54057,573027,1,4,1,1,0,23
54058,573027,1,4,2,1,0,24
54059,573027,1,4,3,3,0,27
54060,573027,1,4,4,2,0,29
54061,573027,1,4,5,0,0,29
54062,573027,1,4,6,1,0,30
54063,573027,1,5,1,0,0,30
54064,573027,1,5,2,0,0,30
54065,573027,1,5,3,0,0,30
54066,573027,1,5,4,4,0,34
54067,573027,1,5,5,4,0,38
54068,573027,1,5,6,3,0,41
54069,573027,1,6,1,0,0,41
54070,573027,1,6,2,0,0,41
54071,573027,1,6,3,0,0,41
54072,573027,1,6,4,1,0,42
54073,573027,1,6,5,0,0,42
54074,573027,1,6,6,1,0,43
54075,573027,1,7,1,1,0,44
54076,573027,1,7,2,1,0,45
54077,573027,1,7,3,1,0,46
54078,573027,1,7,4,0,0,46
54079,573027,1,7,5,6,0,52
54080,573027,1,7,6,1,0,53
54081,573027,1,8,1,1,0,54
54082,573027,1,8,2,2,0,56
54083,573027,1,8,3,4,0,60
54084,573027,1,8,4,1,0,61
54085,573027,1,8,5,1,0,62
54086,573027,1,8,6,1,0,63
54087,573027,1,9,1,1,0,64
54088,573027,1,9,2,2,0,66
54089,573027,1,9,3,4,0,70
54090,573027,1,9,4,1,0,71
54091,573027,1,9,5,1,0,72
54092,573027,1,9,6,4,0,76
54093,573027,1,10,1,1,0,77
54094,573027,1,10,2,4,0,81
54095,573027,1,10,3,1,0,82
54096,573027,1,10,4,1,0,83
54097,573027,1,10,5,2,0,85
54098,573027,1,10,6,2,0,87
54099,573027,1,11,1,4,0,91
54100,573027,1,11,2,2,0,93
54101,573027,1,11,3,2,0,95
54102,573027,1,11,4,4,0,99
54103,573027,1,11,5,0,0,99
54104,573027,1,11,6,0,1,99
54105,573027,1,12,1,1,0,100
54106,573027,1,12,2,0,0,100
54107,573027,1,12,3,1,0,101
54108,573027,1,12,4,0,0,101
54109,573027,1,12,5,1,0,102
54110,573027,1,12,6,1,0,103
54111,573027,1,13,1,2,0,105
54112,573027,1,13,2,1,1,106
54113,573027,1,13,3,0,0,106
54114,573027,1,13,4,1,0,107
54115,573027,1,13,5,2,0,109
54116,573027,1,13,6,4,0,113
54117,573027,1,14,1,0,0,113
54118,573027,1,14,2,0,0,113
54119,573027,1,14,3,3,0,116
54120,573027,1,14,4,0,0,116
54121,573027,1,14,5,2,0,118
54122,573027,1,14,6,4,0,122
54123,573027,1,15,1,0,0,122
54124,573027,1,15,2,0,0,122
54125,573027,1,15,3,1,0,123
54126,573027,1,15,4,1,0,124
54127,573027,1,15,5,1,0,125
54128,573027,1,15,6,1,0,126
54129,573027,1,16,1,6,0,132
54130,573027,1,16,2,0,0,132
54131,573027,1,16,3,1,0,133
54132,573027,1,16,4,3,0,136
54133,573027,1,16,5,1,0,137
54134,573027,1,16,6,2,0,139
54135,573027,1,17,1,0,1,139
54136,573027,1,17,2,2,0,141
54137,573027,1,17,3,0,1,141
54138,573027,1,17,4,1,0,142
54139,573027,1,17,5,0,0,142
54140,573027,1,17,6,1,0,143
54141,573027,1,18,1,2,0,145
54142,573027,1,18,2,2,0,147
54143,573027,1,18,3,1,0,148
54144,573027,1,18,4,4,0,152
54145,573027,1,18,5,1,0,153
54146,573027,1,18,6,4,0,157
54147,573027,1,19,1,6,0,163
54148,573027,1,19,2,2,0,165
54149,573027,1,19,3,7,0,172
54150,573027,1,19,4,0,1,172
54151,573027,1,19,5,1,0,173
54152,573027,1,19,6,1,0,174
54153,573027,1,20,1,4,0,178
54154,573027,1,20,2,1,0,179
54155,573027,1,20,3,4,0,183
54156,573027,1,20,4,2,0,185
54157,573027,1,20,5,4,0,189
54158,573027,1,20,6,2,0,191
54279,573672,1,1,1,1,0,1
54280,573672,1,1,2,0,0,1
54281,573672,1,1,3,0,0,1
54282,573672,1,1,4,0,0,1
54283,573672,1,1,5,0,1,1
54284,573672,1,1,6,0,0,1
54285,573672,1,2,1,0,0,1
54286,573672,1,2,2,3,0,4
54287,573672,1,2,3,0,0,4
54288,573672,1,2,4,0,1,4
54289,573672,1,2,5,0,0,4
54290,573672,1,2,6,0,0,4
54291,573672,1,3,1,1,0,5
54292,573672,1,3,2,0,0,5
54293,573672,1,3,3,1,0,6
54294,573672,1,3,4,0,0,6
54295,573672,1,3,5,1,0,7
54296,573672,1,3,6,1,0,8
54297,573672,1,4,1,0,1,8
54298,573672,1,4,2,0,0,8
54299,573672,1,4,3,0,0,8
54300,573672,1,4,4,0,0,8
54301,573672,1,4,5,0,0,8
54302,573672,1,4,6,0,0,8
54303,573672,1,5,1,4,0,12
54304,573672,1,5,2,1,0,13
54305,573672,1,5,3,1,0,14
54306,573672,1,5,4,0,0,14
54307,573672,1,5,5,0,0,14
54308,573672,1,5,6,1,0,15
54309,573672,1,6,1,1,0,16
54310,573672,1,6,2,4,0,20
54311,573672,1,6,3,4,0,24
54312,573672,1,6,4,4,0,28
54313,573672,1,6,5,0,0,28
54314,573672,1,6,6,2,0,30
54315,573672,1,7,1,1,0,31
54316,573672,1,7,2,1,0,32
54317,573672,1,7,3,0,0,32
54318,573672,1,7,4,1,0,33
54319,573672,1,7,5,1,0,34
54320,573672,1,7,6,1,0,35
54321,573672,1,8,1,1,0,36
54322,573672,1,8,2,1,0,37
54323,573672,1,8,3,1,0,38
54324,573672,1,8,4,2,0,40
54325,573672,1,8,5,1,0,41
54326,573672,1,8,6,0,0,41
54327,573672,1,9,1,4,0,45
54328,573672,1,9,2,1,0,46
54329,573672,1,9,3,0,0,46
54330,573672,1,9,4,1,0,47
54331,573672,1,9,5,4,0,51
54332,573672,1,9,6,1,0,52
54333,573672,1,10,1,1,0,53
54334,573672,1,10,2,2,0,55
54335,573672,1,10,3,1,0,56
54336,573672,1,10,4,0,0,56
54337,573672,1,10,5,1,0,57
54338,573672,1,10,6,0,0,57
54339,573672,1,11,1,0,0,57
54340,573672,1,11,2,0,0,57
54341,573672,1,11,3,0,0,57
54342,573672,1,11,4,2,0,59
54343,573672,1,11,5,1,0,60
54344,573672,1,11,6,4,0,64
54345,573672,1,12,1,4,0,68
54346,573672,1,12,2,1,0,69
54347,573672,1,12,3,1,0,70
54348,573672,1,12,4,0,1,70
54349,573672,1,12,5,1,0,71
54350,573672,1,12,6,1,0,72
54351,573672,1,13,1,1,0,73
54352,573672,1,13,2,1,0,74
54353,573672,1,13,3,0,0,74
54354,573672,1,13,4,1,0,75
54355,573672,1,13,5,0,0,75
54356,573672,1,13,6,1,0,76
54357,573672,1,14,1,0,0,76
54358,573672,1,14,2,1,0,77
54359,573672,1,14,3,0,0,77
54360,573672,1,14,4,2,0,79
54361,573672,1,14,5,6,0,85
54362,573672,1,14,6,1,0,86
54363,573672,1,15,1,0,0,86
54364,573672,1,15,2,4,0,90
54365,573672,1,15,3,0,0,90
54366,573672,1,15,4,1,0,91
54367,573672,1,15,5,1,0,92
54368,573672,1,15,6,4,0,96
54369,573672,1,16,1,2,0,98
54370,573672,1,16,2,1,0,99
54371,573672,1,16,3,1,0,100
54372,573672,1,16,4,1,0,101
54373,573672,1,16,5,1,0,102
54374,573672,1,16,6,2,0,104
54375,573672,1,17,1,1,0,105
54376,573672,1,17,2,0,0,105
54377,573672,1,17,3,1,0,106
54378,573672,1,17,4,0,1,106
54379,573672,1,17,5,0,0,106
54380,573672,1,17,6,0,0,106
54381,573672,1,18,1,0,0,106
54382,573672,1,18,2,0,0,106
54383,573672,1,18,3,2,0,108
54384,573672,1,18,4,1,0,109
54385,573672,1,18,5,6,0,115
54386,573672,1,18,6,1,0,116
54387,573672,1,19,1,2,0,118
54388,573672,1,19,2,2,0,120
54389,573672,1,19,3,0,1,120
54390,573672,1,19,4,1,0,121
54391,573672,1,19,5,2,0,123
54392,573672,1,19,6,0,1,123
54393,573672,1,20,1,3,0,126
54394,573672,1,20,2,0,1,126
54395,573672,1,20,3,0,0,126
54396,573672,1,20,4,0,1,126
54397,573672,1,20,5,1,0,127
54398,573672,1,20,6,1,1,128
54519,587476,1,1,1,1,0,1
54520,587476,1,1,2,1,0,2
54521,587476,1,1,3,0,0,2
54522,587476,1,1,4,0,0,2
54523,587476,1,1,5,6,0,8
54524,587476,1,1,6,2,0,10
54525,587476,1,2,1,1,0,11
54526,587476,1,2,2,4,0,15
54527,587476,1,2,3,1,0,16
54528,587476,1,2,4,0,0,16
54529,587476,1,2,5,0,0,16
54530,587476,1,2,6,0,0,16
54531,587476,1,3,1,0,0,16
54532,587476,1,3,2,4,0,20
54533,587476,1,3,3,0,0,20
54534,587476,1,3,4,1,0,21
54535,587476,1,3,5,4,0,25
54536,587476,1,3,6,0,1,25
54537,587476,1,4,1,0,0,25
54538,587476,1,4,2,0,0,25
54539,587476,1,4,3,0,0,25
54540,587476,1,4,4,0,0,25
54541,587476,1,4,5,1,0,26
54542,587476,1,4,6,0,0,26
54543,587476,1,5,1,4,0,30
54544,587476,1,5,2,0,0,30
54545,587476,1,5,3,0,0,30
54546,587476,1,5,4,0,0,30
54547,587476,1,5,5,0,1,30
54548,587476,1,5,6,4,0,34
54549,587476,1,6,1,1,0,35
54550,587476,1,6,2,0,0,35
54551,587476,1,6,3,4,0,39
54552,587476,1,6,4,4,0,43
54553,587476,1,6,5,0,0,43
54554,587476,1,6,6,0,0,43
54555,587476,1,7,1,1,0,44
54556,587476,1,7,2,2,0,46
54557,587476,1,7,3,1,0,47
54558,587476,1,7,4,1,0,48
54559,587476,1,7,5,1,0,49
54560,587476,1,7,6,0,0,49
54561,587476,1,8,1,0,0,49
54562,587476,1,8,2,5,0,54
54563,587476,1,8,3,0,0,54
54564,587476,1,8,4,0,0,54
54565,587476,1,8,5,0,0,54
54566,587476,1,8,6,1,0,55
54567,587476,1,9,1,6,0,61
54568,587476,1,9,2,1,0,62
54569,587476,1,9,3,6,0,68
54570,587476,1,9,4,1,0,69
54571,587476,1,9,5,0,0,69
54572,587476,1,9,6,1,0,70
54573,587476,1,10,1,6,0,76
54574,587476,1,10,2,0,0,76
54575,587476,1,10,3,0,0,76
54576,587476,1,10,4,4,0,80
54577,587476,1,10,5,1,0,81
54578,587476,1,10,6,0,0,81
54579,587476,1,11,1,0,0,81
54580,587476,1,11,2,1,0,82
54581,587476,1,11,3,0,0,82
54582,587476,1,11,4,4,0,86
54583,587476,1,11,5,0,0,86
54584,587476,1,11,6,1,0,87
54585,587476,1,12,1,1,0,88
54586,587476,1,12,2,1,0,89
54587,587476,1,12,3,6,0,95
54588,587476,1,12,4,1,0,96
54589,587476,1,12,5,0,1,96
54590,587476,1,12,6,0,0,96
54591,587476,1,13,1,0,0,96
54592,587476,1,13,2,0,0,96
54593,587476,1,13,3,1,0,97
54594,587476,1,13,4,1,0,98
54595,587476,1,13,5,1,0,99
54596,587476,1,13,6,1,0,100
54597,587476,1,14,1,1,0,101
54598,587476,1,14,2,6,0,107
54599,587476,1,14,3,1,0,108
54600,587476,1,14,4,0,0,108
54601,587476,1,14,5,6,0,114
54602,587476,1,14,6,6,0,120
54603,587476,1,15,1,0,0,120
54604,587476,1,15,2,1,0,121
54605,587476,1,15,3,0,0,121
54606,587476,1,15,4,0,1,121
54607,587476,1,15,5,1,0,122
54608,587476,1,15,6,0,0,122
54609,587476,1,16,1,1,0,123
54610,587476,1,16,2,6,0,129
54611,587476,1,16,3,0,0,129
54612,587476,1,16,4,6,0,135
54613,587476,1,16,5,1,0,136
54614,587476,1,16,6,1,0,137
54615,587476,1,17,1,1,0,138
54616,587476,1,17,2,0,0,138
54617,587476,1,17,3,1,0,139
54618,587476,1,17,4,1,0,140
54619,587476,1,17,5,1,0,141
54620,587476,1,17,6,0,0,141
54621,587476,1,18,1,0,0,141
54622,587476,1,18,2,6,0,147
54623,587476,1,18,3,1,0,148
54624,587476,1,18,4,4,0,152
54625,587476,1,18,5,2,0,154
54626,587476,1,18,6,4,0,158
54627,587476,1,19,1,2,0,160
54628,587476,1,19,2,1,0,161
54629,587476,1,19,3,1,0,162
54630,587476,1,19,4,1,0,163
54631,587476,1,19,5,1,0,164
54632,587476,1,19,6,4,0,168
54633,587476,1,20,1,1,0,169
54634,587476,1,20,2,6,0,175
54635,587476,1,20,3,6,0,181
54636,587476,1,20,4,6,0,187
54637,587476,1,20,5,4,0,191
54638,587476,1,20,6,6,0,197
54759,589306,1,1,1,0,0,0
54760,589306,1,1,2,1,0,1
54761,589306,1,1,3,1,0,2
54762,589306,1,1,4,0,0,2
54763,589306,1,1,5,3,0,5
54764,589306,1,1,6,1,0,6
54765,589306,1,2,1,0,0,6
54766,589306,1,2,2,2,0,8
54767,589306,1,2,3,1,0,9
54768,589306,1,2,4,0,0,9
54769,589306,1,2,5,0,0,9
54770,589306,1,2,6,1,0,10
54771,589306,1,3,1,0,0,10
54772,589306,1,3,2,1,0,11
54773,589306,1,3,3,0,0,11
54774,589306,1,3,4,1,0,12
54775,589306,1,3,5,1,0,13
54776,589306,1,3,6,4,0,17
54777,589306,1,4,1,1,0,18
54778,589306,1,4,2,4,0,22
54779,589306,1,4,3,1,0,23
54780,589306,1,4,4,0,0,23
54781,589306,1,4,5,2,0,25
54782,589306,1,4,6,1,0,26
54783,589306,1,5,1,0,0,26
54784,589306,1,5,2,1,0,27
54785,589306,1,5,3,4,0,31
54786,589306,1,5,4,1,0,32
54787,589306,1,5,5,2,0,34
54788,589306,1,5,6,0,0,34
54789,589306,1,6,1,1,0,35
54790,589306,1,6,2,0,0,35
54791,589306,1,6,3,1,0,36
54792,589306,1,6,4,0,0,36
54793,589306,1,6,5,1,0,37
54794,589306,1,6,6,0,0,37
54795,589306,1,7,1,4,0,41
54796,589306,1,7,2,1,0,42
54797,589306,1,7,3,1,0,43
54798,589306,1,7,4,1,0,44
54799,589306,1,7,5,6,0,50
54800,589306,1,7,6,0,0,50
54801,589306,1,8,1,0,0,50
54802,589306,1,8,2,1,0,51
54803,589306,1,8,3,0,0,51
54804,589306,1,8,4,1,0,52
54805,589306,1,8,5,6,0,58
54806,589306,1,8,6,0,0,58
54807,589306,1,9,1,0,0,58
54808,589306,1,9,2,1,0,59
54809,589306,1,9,3,1,0,60
54810,589306,1,9,4,4,0,64
54811,589306,1,9,5,2,0,66
54812,589306,1,9,6,2,0,68
54813,589306,1,10,1,4,0,72
54814,589306,1,10,2,1,0,73
54815,589306,1,10,3,0,0,73
54816,589306,1,10,4,1,0,74
54817,589306,1,10,5,0,0,74
54818,589306,1,10,6,1,0,75
54819,589306,1,11,1,0,0,75
54820,589306,1,11,2,1,0,76
54821,589306,1,11,3,1,0,77
54822,589306,1,11,4,0,0,77
54823,589306,1,11,5,0,1,77
54824,589306,1,11,6,1,0,78
54825,589306,1,12,1,1,0,79
54826,589306,1,12,2,1,0,80
54827,589306,1,12,3,1,0,81
54828,589306,1,12,4,1,0,82
54829,589306,1,12,5,1,0,83
54830,589306,1,12,6,0,0,83
54831,589306,1,13,1,4,0,87
54832,589306,1,13,2,1,0,88
54833,589306,1,13,3,1,0,89
54834,589306,1,13,4,1,1,90
54835,589306,1,13,5,6,0,96
54836,589306,1,13,6,0,0,96
54837,589306,1,14,1,1,0,97
54838,589306,1,14,2,1,0,98
54839,589306,1,14,3,4,0,102
54840,589306,1,14,4,0,0,102
54841,589306,1,14,5,1,0,103
54842,589306,1,14,6,0,0,103
54843,589306,1,15,1,0,0,103
54844,589306,1,15,2,0,0,103
54845,589306,1,15,3,0,1,103
54846,589306,1,15,4,1,0,104
54847,589306,1,15,5,2,0,106
54848,589306,1,15,6,2,0,108
54849,589306,1,16,1,0,1,108
54850,589306,1,16,2,0,0,108
54851,589306,1,16,3,0,0,108
54852,589306,1,16,4,1,0,109
54853,589306,1,16,5,2,0,111
54854,589306,1,16,6,4,0,115
54855,589306,1,17,1,0,0,115
54856,589306,1,17,2,0,1,115
54857,589306,1,17,3,2,0,117
54858,589306,1,17,4,1,0,118
54859,589306,1,17,5,1,0,119
54860,589306,1,17,6,2,0,121
54861,589306,1,18,1,1,0,122
54862,589306,1,18,2,0,0,122
54863,589306,1,18,3,0,1,122
54864,589306,1,18,4,1,1,123
54865,589306,1,18,5,0,0,123
54866,589306,1,18,6,1,0,124
54867,589306,1,19,1,0,1,124
54868,589306,1,19,2,0,1,124
54869,589306,1,19,3,0,0,124
54870,589306,1,19,4,1,0,125
54871,589306,1,19,5,0,0,125
54872,589306,1,19,6,1,0,126
54873,589306,1,20,1,1,0,127
54874,589306,1,20,2,1,0,128
54875,589306,1,20,3,1,0,129
54876,589306,1,20,4,1,0,130
54877,589306,1,20,5,2,0,132
54878,589306,1,20,6,1,0,133
54997,589307,1,1,1,1,0,1
54998,589307,1,1,2,0,0,1
54999,589307,1,1,3,4,0,5
55000,589307,1,1,4,0,0,5
55001,589307,1,1,5,1,0,6
55002,589307,1,1,6,1,0,7
55003,589307,1,2,1,4,0,11
55004,589307,1,2,2,1,0,12
55005,589307,1,2,3,4,0,16
55006,589307,1,2,4,0,0,16
55007,589307,1,2,5,0,0,16
55008,589307,1,2,6,1,0,17
55009,589307,1,3,1,0,0,17
55010,589307,1,3,2,0,0,17
55011,589307,1,3,3,1,0,18
55012,589307,1,3,4,1,0,19
55013,589307,1,3,5,1,0,20
55014,589307,1,3,6,0,0,20
55015,589307,1,4,1,1,0,21
55016,589307,1,4,2,1,0,22
55017,589307,1,4,3,4,0,26
55018,589307,1,4,4,4,0,30
55019,589307,1,4,5,0,0,30
55020,589307,1,4,6,1,0,31
55021,589307,1,5,1,1,0,32
55022,589307,1,5,2,4,0,36
55023,589307,1,5,3,4,0,40
55024,589307,1,5,4,4,0,44
55025,589307,1,5,5,0,1,44
55026,589307,1,5,6,0,0,44
55027,589307,1,6,1,0,0,44
55028,589307,1,6,2,0,0,44
55029,589307,1,6,3,1,0,45
55030,589307,1,6,4,1,0,46
55031,589307,1,6,5,1,0,47
55032,589307,1,6,6,1,0,48
55033,589307,1,7,1,1,0,49
55034,589307,1,7,2,2,0,51
55035,589307,1,7,3,0,0,51
55036,589307,1,7,4,1,0,52
55037,589307,1,7,5,1,0,53
55038,589307,1,7,6,0,1,53
55039,589307,1,8,1,0,0,53
55040,589307,1,8,2,1,0,54
55041,589307,1,8,3,0,0,54
55042,589307,1,8,4,0,0,54
55043,589307,1,8,5,1,0,55
55044,589307,1,8,6,4,0,59
55045,589307,1,9,1,1,0,60
55046,589307,1,9,2,0,0,60
55047,589307,1,9,3,1,0,61
55048,589307,1,9,4,1,0,62
55049,589307,1,9,5,1,0,63
55050,589307,1,9,6,1,0,64
55051,589307,1,10,1,1,0,65
55052,589307,1,10,2,4,0,69
55053,589307,1,10,3,1,0,70
55054,589307,1,10,4,1,0,71
55055,589307,1,10,5,1,0,72
55056,589307,1,10,6,0,0,72
55057,589307,1,11,1,4,0,76
55058,589307,1,11,2,1,0,77
55059,589307,1,11,3,1,0,78
55060,589307,1,11,4,0,0,78
55061,589307,1,11,5,1,0,79
55062,589307,1,11,6,4,0,83
55063,589307,1,12,1,2,0,85
55064,589307,1,12,2,1,0,86
55065,589307,1,12,3,1,0,87
55066,589307,1,12,4,0,0,87
55067,589307,1,12,5,1,0,88
55068,589307,1,12,6,0,1,88
55069,589307,1,13,1,1,0,89
55070,589307,1,13,2,4,0,93
55071,589307,1,13,3,1,0,94
55072,589307,1,13,4,6,0,100
55073,589307,1,13,5,4,0,104
55074,589307,1,13,6,1,0,105
55075,589307,1,14,1,1,0,106
55076,589307,1,14,2,2,0,108
55077,589307,1,14,3,0,0,108
55078,589307,1,14,4,2,0,110
55079,589307,1,14,5,0,0,110
55080,589307,1,14,6,0,0,110
55081,589307,1,15,1,6,0,116
55082,589307,1,15,2,0,0,116
55083,589307,1,15,3,1,0,117
55084,589307,1,15,4,0,0,117
55085,589307,1,15,5,1,0,118
55086,589307,1,15,6,0,0,118
55087,589307,1,16,1,4,0,122
55088,589307,1,16,2,2,0,124
55089,589307,1,16,3,4,0,128
55090,589307,1,16,4,4,0,132
55091,589307,1,16,5,1,0,133
55092,589307,1,16,6,0,0,133
55093,589307,1,17,1,1,0,134
55094,589307,1,17,2,0,0,134
55095,589307,1,17,3,4,0,138
55096,589307,1,17,4,1,0,139
55097,589307,1,17,5,1,0,140
55098,589307,1,17,6,4,0,144
55099,589307,1,18,1,1,0,145
55100,589307,1,18,2,6,0,151
55101,589307,1,18,3,6,0,157
55102,589307,1,18,4,0,0,157
55103,589307,1,18,5,1,0,158
55104,589307,1,18,6,4,0,162
55105,589307,1,19,1,1,0,163
55106,589307,1,19,2,2,0,165
55107,589307,1,19,3,1,0,166
55108,589307,1,19,4,6,0,172
55109,589307,1,19,5,6,0,178
55110,589307,1,19,6,6,0,184
55111,589307,1,20,1,1,0,185
55112,589307,1,20,2,0,1,185
55113,589307,1,20,3,1,0,186
55114,589307,1,20,4,1,0,187
55115,589307,1,20,5,0,1,187
55116,589307,1,20,6,5,0,192
55237,593986,1,1,1,1,0,1
55238,593986,1,1,2,0,0,1
55239,593986,1,1,3,1,0,2
55240,593986,1,1,4,0,0,2
55241,593986,1,1,5,0,0,2
55242,593986,1,1,6,1,0,3
55243,593986,1,2,1,4,0,7
55244,593986,1,2,2,0,0,7
55245,593986,1,2,3,0,0,7
55246,593986,1,2,4,0,0,7
55247,593986,1,2,5,4,0,11
55248,593986,1,2,6,0,0,11
55249,593986,1,3,1,0,0,11
55250,593986,1,3,2,0,0,11
55251,593986,1,3,3,0,0,11
55252,593986,1,3,4,1,0,12
55253,593986,1,3,5,4,0,16
55254,593986,1,3,6,0,1,16
55255,593986,1,4,1,1,0,17
55256,593986,1,4,2,0,0,17
55257,593986,1,4,3,0,0,17
55258,593986,1,4,4,0,1,17
55259,593986,1,4,5,4,0,21
55260,593986,1,4,6,0,0,21
55261,593986,1,5,1,1,0,22
55262,593986,1,5,2,0,0,22
55263,593986,1,5,3,6,0,28
55264,593986,1,5,4,0,0,28
55265,593986,1,5,5,0,1,28
55266,593986,1,5,6,0,0,28
55267,593986,1,6,1,0,0,28
55268,593986,1,6,2,1,0,29
55269,593986,1,6,3,1,0,30
55270,593986,1,6,4,0,0,30
55271,593986,1,6,5,0,0,30
55272,593986,1,6,6,4,0,34
55273,593986,1,7,1,4,0,38
55274,593986,1,7,2,1,0,39
55275,593986,1,7,3,0,0,39
55276,593986,1,7,4,0,0,39
55277,593986,1,7,5,0,0,39
55278,593986,1,7,6,0,0,39
55279,593986,1,8,1,1,0,40
55280,593986,1,8,2,1,0,41
55281,593986,1,8,3,1,0,42
55282,593986,1,8,4,0,0,42
55283,593986,1,8,5,1,0,43
55284,593986,1,8,6,4,0,47
55285,593986,1,9,1,1,0,48
55286,593986,1,9,2,0,0,48
55287,593986,1,9,3,1,0,49
55288,593986,1,9,4,4,0,53
55289,593986,1,9,5,0,0,53
55290,593986,1,9,6,1,0,54
55291,593986,1,10,1,0,0,54
55292,593986,1,10,2,0,0,54
55293,593986,1,10,3,0,0,54
55294,593986,1,10,4,2,0,56
55295,593986,1,10,5,0,0,56
55296,593986,1,10,6,0,0,56
55297,593986,1,11,1,1,0,57
55298,593986,1,11,2,1,0,58
55299,593986,1,11,3,1,0,59
55300,593986,1,11,4,0,0,59
55301,593986,1,11,5,1,0,60
55302,593986,1,11,6,1,0,61
55303,593986,1,12,1,0,0,61
55304,593986,1,12,2,1,0,62
55305,593986,1,12,3,1,0,63
55306,593986,1,12,4,1,0,64
55307,593986,1,12,5,0,0,64
55308,593986,1,12,6,0,0,64
55309,593986,1,13,1,0,0,64
55310,593986,1,13,2,1,0,65
55311,593986,1,13,3,4,0,69
55312,593986,1,13,4,4,0,73
55313,593986,1,13,5,0,0,73
55314,593986,1,13,6,1,0,74
55315,593986,1,14,1,1,0,75
55316,593986,1,14,2,1,0,76
55317,593986,1,14,3,1,0,77
55318,593986,1,14,4,1,0,78
55319,593986,1,14,5,1,0,79
55320,593986,1,14,6,1,0,80
55321,593986,1,15,1,0,0,80
55322,593986,1,15,2,4,0,84
55323,593986,1,15,3,0,0,84
55324,593986,1,15,4,1,0,85
55325,593986,1,15,5,1,0,86
55326,593986,1,15,6,2,0,88
55327,593986,1,16,1,0,1,88
55328,593986,1,16,2,0,0,88
55329,593986,1,16,3,0,0,88
55330,593986,1,16,4,1,0,89
55331,593986,1,16,5,1,0,90
55332,593986,1,16,6,1,0,91
55333,593986,1,17,1,1,0,92
55334,593986,1,17,2,6,0,98
55335,593986,1,17,3,7,0,105
55336,593986,1,17,4,1,0,106
55337,593986,1,17,5,1,0,107
55338,593986,1,17,6,2,0,109
55339,593986,1,18,1,4,0,113
55340,593986,1,18,2,0,0,113
55341,593986,1,18,3,1,0,114
55342,593986,1,18,4,4,0,118
55343,593986,1,18,5,1,0,119
55344,593986,1,18,6,0,1,119
55345,593986,1,19,1,0,1,119
55346,593986,1,19,2,2,0,121
55347,593986,1,19,3,1,0,122
55348,593986,1,19,4,0,0,122
55349,593986,1,19,5,1,0,123
55350,593986,1,19,6,1,0,124
55351,593986,1,20,1,0,1,124
55352,593986,1,20,2,1,0,125
55353,593986,1,20,3,1,0,126
55354,593986,1,20,4,0,1,126
55355,593986,1,20,5,0,0,126
55356,593986,1,20,6,4,0,130
55454,593987,1,1,1,0,0,0
55455,593987,1,1,2,0,0,0
55456,593987,1,1,3,2,0,2
55457,593987,1,1,4,1,0,3
55458,593987,1,1,5,1,0,4
55459,593987,1,1,6,1,0,5
55460,593987,1,2,1,0,0,5
55461,593987,1,2,2,0,0,5
55462,593987,1,2,3,0,0,5
55463,593987,1,2,4,2,0,7
55464,593987,1,2,5,0,0,7
55465,593987,1,2,6,0,0,7
55466,593987,1,3,1,1,0,8
55467,593987,1,3,2,0,0,8
55468,593987,1,3,3,1,0,9
55469,593987,1,3,4,1,0,10
55470,593987,1,3,5,4,0,14
55471,593987,1,3,6,1,0,15
55472,593987,1,4,1,4,0,19
55473,593987,1,4,2,0,1,19
55474,593987,1,4,3,0,0,19
55475,593987,1,4,4,0,0,19
55476,593987,1,4,5,1,0,20
55477,593987,1,4,6,1,0,21
55478,593987,1,5,1,0,0,21
55479,593987,1,5,2,0,0,21
55480,593987,1,5,3,0,0,21
55481,593987,1,5,4,0,0,21
55482,593987,1,5,5,1,0,22
55483,593987,1,5,6,1,0,23
55484,593987,1,6,1,6,0,29
55485,593987,1,6,2,1,0,30
55486,593987,1,6,3,2,0,32
55487,593987,1,6,4,1,0,33
55488,593987,1,6,5,1,0,34
55489,593987,1,6,6,5,0,39
55490,593987,1,7,1,1,0,40
55491,593987,1,7,2,1,0,41
55492,593987,1,7,3,1,0,42
55493,593987,1,7,4,1,0,43
55494,593987,1,7,5,1,0,44
55495,593987,1,7,6,1,0,45
55496,593987,1,8,1,0,0,45
55497,593987,1,8,2,1,0,46
55498,593987,1,8,3,1,0,47
55499,593987,1,8,4,1,0,48
55500,593987,1,8,5,0,0,48
55501,593987,1,8,6,1,0,49
55502,593987,1,9,1,1,0,50
55503,593987,1,9,2,2,0,52
55504,593987,1,9,3,0,0,52
55505,593987,1,9,4,1,0,53
55506,593987,1,9,5,1,0,54
55507,593987,1,9,6,1,0,55
55508,593987,1,10,1,6,0,61
55509,593987,1,10,2,0,1,61
55510,593987,1,10,3,2,0,63
55511,593987,1,10,4,0,0,63
55512,593987,1,10,5,1,0,64
55513,593987,1,10,6,0,0,64
55514,593987,1,11,1,0,0,64
55515,593987,1,11,2,0,0,64
55516,593987,1,11,3,1,0,65
55517,593987,1,11,4,0,0,65
55518,593987,1,11,5,1,0,66
55519,593987,1,11,6,2,0,68
55520,593987,1,12,1,1,0,69
55521,593987,1,12,2,2,0,71
55522,593987,1,12,3,4,0,75
55523,593987,1,12,4,1,0,76
55524,593987,1,12,5,1,0,77
55525,593987,1,12,6,1,0,78
55526,593987,1,13,1,1,0,79
55527,593987,1,13,2,0,1,79
55528,593987,1,13,3,1,0,80
55529,593987,1,13,4,1,0,81
55530,593987,1,13,5,0,0,81
55531,593987,1,13,6,1,0,82
55532,593987,1,14,1,1,0,83
55533,593987,1,14,2,1,0,84
55534,593987,1,14,3,1,0,85
55535,593987,1,14,4,1,0,86
55536,593987,1,14,5,6,0,92
55537,593987,1,14,6,0,1,92
55538,593987,1,15,1,1,0,93
55539,593987,1,15,2,1,0,94
55540,593987,1,15,3,4,0,98
55541,593987,1,15,4,1,0,99
55542,593987,1,15,5,0,0,99
55543,593987,1,15,6,0,0,99
55544,593987,1,16,1,1,0,100
55545,593987,1,16,2,1,0,101
55546,593987,1,16,3,1,0,102
55547,593987,1,16,4,7,0,109
55548,593987,1,16,5,1,0,110
55549,593987,1,16,6,1,0,111
55550,593987,1,17,1,1,0,112
55551,593987,1,17,2,4,0,116
55552,593987,1,17,3,1,0,117
55553,593987,1,17,4,1,0,118
55554,593987,1,17,5,3,0,121
55555,593987,1,17,6,0,0,121
55556,593987,1,18,1,6,0,127
55557,593987,1,18,2,7,0,134
55558,593987,1,18,3,4,0,138
55559,593987,1,18,4,1,0,139
55560,593987,1,18,5,1,0,140
55561,593987,1,18,6,4,0,144
55562,593987,1,19,1,4,0,148
55563,593987,1,19,2,0,1,148
55564,593987,1,19,3,1,0,149
55565,593987,1,19,4,0,1,149
55566,593987,1,19,5,0,0,149
55567,593987,1,19,6,6,0,155
55568,593987,1,20,1,0,1,155
55569,593987,1,20,2,1,0,156
55570,593987,1,20,3,0,0,156
55571,593987,1,20,4,2,0,158
55572,593987,1,20,5,0,0,158
55573,593987,1,20,6,0,0,158
55694,602477,1,1,1,0,0,0
55695,602477,1,1,2,4,0,4
55696,602477,1,1,3,0,0,4
55697,602477,1,1,4,0,0,4
55698,602477,1,1,5,6,0,10
55699,602477,1,1,6,4,0,14
55700,602477,1,2,1,0,0,14
55701,602477,1,2,2,0,0,14
55702,602477,1,2,3,6,0,20
55703,602477,1,2,4,0,0,20
55704,602477,1,2,5,1,0,21
55705,602477,1,2,6,4,0,25
55706,602477,1,3,1,6,0,31
55707,602477,1,3,2,0,0,31
55708,602477,1,3,3,1,0,32
55709,602477,1,3,4,0,1,32
55710,602477,1,3,5,1,0,33
55711,602477,1,3,6,2,0,35
55712,602477,1,4,1,0,0,35
55713,602477,1,4,2,3,0,38
55714,602477,1,4,3,1,0,39
55715,602477,1,4,4,1,0,40
55716,602477,1,4,5,1,0,41
55717,602477,1,4,6,4,0,45
55718,602477,1,5,1,1,0,46
55719,602477,1,5,2,1,0,47
55720,602477,1,5,3,0,0,47
55721,602477,1,5,4,1,0,48
55722,602477,1,5,5,4,0,52
55723,602477,1,5,6,0,0,52
55724,602477,1,6,1,1,0,53
55725,602477,1,6,2,0,0,53
55726,602477,1,6,3,6,0,59
55727,602477,1,6,4,0,0,59
55728,602477,1,6,5,2,0,61
55729,602477,1,6,6,1,0,62
55730,602477,1,7,1,0,0,62
55731,602477,1,7,2,4,0,66
55732,602477,1,7,3,2,0,68
55733,602477,1,7,4,0,0,68
55734,602477,1,7,5,1,0,69
55735,602477,1,7,6,2,0,71
55736,602477,1,8,1,0,0,71
55737,602477,1,8,2,1,0,72
55738,602477,1,8,3,1,0,73
55739,602477,1,8,4,2,0,75
55740,602477,1,8,5,1,0,76
55741,602477,1,8,6,1,0,77
55742,602477,1,9,1,0,1,77
55743,602477,1,9,2,1,0,78
55744,602477,1,9,3,1,0,79
55745,602477,1,9,4,0,0,79
55746,602477,1,9,5,1,0,80
55747,602477,1,9,6,0,0,80
55748,602477,1,10,1,1,0,81
55749,602477,1,10,2,2,0,83
55750,602477,1,10,3,1,0,84
55751,602477,1,10,4,2,0,86
55752,602477,1,10,5,0,0,86
55753,602477,1,10,6,0,1,86
55754,602477,1,11,1,1,0,87
55755,602477,1,11,2,1,0,88
55756,602477,1,11,3,1,0,89
55757,602477,1,11,4,1,0,90
55758,602477,1,11,5,0,0,90
55759,602477,1,11,6,0,0,90
55760,602477,1,12,1,1,0,91
55761,602477,1,12,2,7,0,98
55762,602477,1,12,3,2,0,100
55763,602477,1,12,4,0,0,100
55764,602477,1,12,5,0,0,100
55765,602477,1,12,6,0,1,100
55766,602477,1,13,1,0,0,100
55767,602477,1,13,2,0,0,100
55768,602477,1,13,3,1,0,101
55769,602477,1,13,4,4,0,105
55770,602477,1,13,5,1,0,106
55771,602477,1,13,6,1,0,107
55772,602477,1,14,1,1,0,108
55773,602477,1,14,2,0,0,108
55774,602477,1,14,3,1,0,109
55775,602477,1,14,4,2,0,111
55776,602477,1,14,5,2,0,113
55777,602477,1,14,6,2,0,115
55778,602477,1,15,1,1,0,116
55779,602477,1,15,2,1,0,117
55780,602477,1,15,3,1,0,118
55781,602477,1,15,4,2,0,120
55782,602477,1,15,5,2,0,122
55783,602477,1,15,6,1,0,123
55784,602477,1,16,1,1,0,124
55785,602477,1,16,2,6,0,130
55786,602477,1,16,3,2,0,132
55787,602477,1,16,4,0,0,132
55788,602477,1,16,5,1,0,133
55789,602477,1,16,6,1,0,134
55790,602477,1,17,1,6,0,140
55791,602477,1,17,2,6,0,146
55792,602477,1,17,3,1,0,147
55793,602477,1,17,4,1,0,148
55794,602477,1,17,5,6,0,154
55795,602477,1,17,6,0,0,154
55796,602477,1,18,1,6,0,160
55797,602477,1,18,2,4,0,164
55798,602477,1,18,3,1,0,165
55799,602477,1,18,4,1,0,166
55800,602477,1,18,5,0,1,166
55801,602477,1,18,6,0,0,166
55802,602477,1,19,1,2,0,168
55803,602477,1,19,2,1,0,169
55804,602477,1,19,3,4,0,173
55805,602477,1,19,4,6,0,179
55806,602477,1,19,5,4,0,183
55807,602477,1,19,6,7,0,190
55808,602477,1,20,1,1,0,191
55809,602477,1,20,2,1,0,192
55810,602477,1,20,3,1,0,193
55811,602477,1,20,4,1,0,194
55812,602477,1,20,5,2,0,196
55813,602477,1,20,6,2,0,198
55934,623571,1,1,1,1,0,1
55935,623571,1,1,2,0,0,1
55936,623571,1,1,3,0,1,1
55937,623571,1,1,4,0,0,1
55938,623571,1,1,5,4,0,5
55939,623571,1,1,6,0,0,5
55940,623571,1,2,1,1,0,6
55941,623571,1,2,2,4,0,10
55942,623571,1,2,3,4,0,14
55943,623571,1,2,4,0,0,14
55944,623571,1,2,5,1,0,15
55945,623571,1,2,6,4,0,19
55946,623571,1,3,1,2,0,21
55947,623571,1,3,2,1,0,22
55948,623571,1,3,3,1,0,23
55949,623571,1,3,4,2,0,25
55950,623571,1,3,5,0,0,25
55951,623571,1,3,6,0,0,25
55952,623571,1,4,1,1,0,26
55953,623571,1,4,2,0,0,26
55954,623571,1,4,3,1,0,27
55955,623571,1,4,4,1,0,28
55956,623571,1,4,5,0,0,28
55957,623571,1,4,6,4,0,32
55958,623571,1,5,1,1,0,33
55959,623571,1,5,2,1,0,34
55960,623571,1,5,3,1,0,35
55961,623571,1,5,4,4,0,39
55962,623571,1,5,5,0,0,39
55963,623571,1,5,6,0,0,39
55964,623571,1,6,1,0,0,39
55965,623571,1,6,2,0,0,39
55966,623571,1,6,3,4,0,43
55967,623571,1,6,4,4,0,47
55968,623571,1,6,5,0,0,47
55969,623571,1,6,6,1,0,48
55970,623571,1,7,1,4,0,52
55971,623571,1,7,2,1,0,53
55972,623571,1,7,3,0,0,53
55973,623571,1,7,4,1,0,54
55974,623571,1,7,5,4,0,58
55975,623571,1,7,6,0,0,58
55976,623571,1,8,1,1,0,59
55977,623571,1,8,2,6,0,65
55978,623571,1,8,3,1,0,66
55979,623571,1,8,4,1,0,67
55980,623571,1,8,5,4,0,71
55981,623571,1,8,6,2,0,73
55982,623571,1,9,1,1,0,74
55983,623571,1,9,2,1,0,75
55984,623571,1,9,3,0,1,75
55985,623571,1,9,4,0,0,75
55986,623571,1,9,5,0,0,75
55987,623571,1,9,6,1,0,76
55988,623571,1,10,1,2,0,78
55989,623571,1,10,2,1,0,79
55990,623571,1,10,3,1,0,80
55991,623571,1,10,4,1,0,81
55992,623571,1,10,5,3,0,84
55993,623571,1,10,6,0,0,84
55994,623571,1,11,1,2,0,86
55995,623571,1,11,2,1,0,87
55996,623571,1,11,3,2,0,89
55997,623571,1,11,4,1,0,90
55998,623571,1,11,5,1,0,91
55999,623571,1,11,6,1,0,92
56000,623571,1,12,1,0,0,92
56001,623571,1,12,2,0,1,92
56002,623571,1,12,3,4,0,96
56003,623571,1,12,4,1,0,97
56004,623571,1,12,5,1,0,98
56005,623571,1,12,6,0,0,98
56006,623571,1,13,1,6,0,104
56007,623571,1,13,2,1,0,105
56008,623571,1,13,3,1,0,106
56009,623571,1,13,4,1,0,107
56010,623571,1,13,5,0,0,107
56011,623571,1,13,6,1,0,108
56012,623571,1,14,1,2,0,110
56013,623571,1,14,2,1,0,111
56014,623571,1,14,3,1,0,112
56015,623571,1,14,4,1,0,113
56016,623571,1,14,5,2,0,115
56017,623571,1,14,6,1,0,116
56018,623571,1,15,1,1,0,117
56019,623571,1,15,2,2,0,119
56020,623571,1,15,3,1,0,120
56021,623571,1,15,4,0,0,120
56022,623571,1,15,5,0,0,120
56023,623571,1,15,6,0,1,120
56024,623571,1,16,1,1,0,121
56025,623571,1,16,2,2,0,123
56026,623571,1,16,3,3,0,126
56027,623571,1,16,4,4,0,130
56028,623571,1,16,5,1,0,131
56029,623571,1,16,6,2,0,133
56030,623571,1,17,1,1,0,134
56031,623571,1,17,2,0,0,134
56032,623571,1,17,3,2,0,136
56033,623571,1,17,4,4,0,140
56034,623571,1,17,5,1,0,141
56035,623571,1,17,6,0,0,141
56036,623571,1,18,1,1,0,142
56037,623571,1,18,2,0,0,142
56038,623571,1,18,3,0,1,142
56039,623571,1,18,4,2,0,144
56040,623571,1,18,5,1,0,145
56041,623571,1,18,6,1,0,146
56042,623571,1,19,1,0,0,146
56043,623571,1,19,2,4,0,150
56044,623571,1,19,3,2,0,152
56045,623571,1,19,4,2,0,154
56046,623571,1,19,5,2,0,156
56047,623571,1,19,6,1,0,157
56048,623571,1,20,1,0,0,157
56049,623571,1,20,2,1,0,158
56050,623571,1,20,3,0,0,158
56051,623571,1,20,4,4,0,162
56052,623571,1,20,5,0,0,162
56053,623571,1,20,6,6,0,168
56174,623572,1,1,1,2,0,2
56175,623572,1,1,2,2,0,4
56176,623572,1,1,3,0,0,4
56177,623572,1,1,4,0,1,4
56178,623572,1,1,5,0,0,4
56179,623572,1,1,6,0,0,4
56180,623572,1,2,1,1,0,5
56181,623572,1,2,2,0,0,5
56182,623572,1,2,3,0,0,5
56183,623572,1,2,4,0,0,5
56184,623572,1,2,5,4,0,9
56185,623572,1,2,6,1,0,10
56186,623572,1,3,1,5,0,15
56187,623572,1,3,2,4,0,19
56188,623572,1,3,3,4,0,23
56189,623572,1,3,4,1,0,24
56190,623572,1,3,5,4,0,28
56191,623572,1,3,6,0,0,28
56192,623572,1,4,1,4,0,32
56193,623572,1,4,2,1,0,33
56194,623572,1,4,3,0,0,33
56195,623572,1,4,4,4,0,37
56196,623572,1,4,5,0,0,37
56197,623572,1,4,6,0,0,37
56198,623572,1,5,1,4,0,41
56199,623572,1,5,2,1,0,42
56200,623572,1,5,3,0,0,42
56201,623572,1,5,4,4,0,46
56202,623572,1,5,5,4,0,50
56203,623572,1,5,6,1,0,51
56204,623572,1,6,1,1,0,52
56205,623572,1,6,2,1,0,53
56206,623572,1,6,3,1,0,54
56207,623572,1,6,4,2,0,56
56208,623572,1,6,5,0,0,56
56209,623572,1,6,6,1,0,57
56210,623572,1,7,1,1,0,58
56211,623572,1,7,2,0,0,58
56212,623572,1,7,3,1,0,59
56213,623572,1,7,4,0,0,59
56214,623572,1,7,5,0,0,59
56215,623572,1,7,6,0,0,59
56216,623572,1,8,1,4,0,63
56217,623572,1,8,2,1,0,64
56218,623572,1,8,3,6,0,70
56219,623572,1,8,4,1,0,71
56220,623572,1,8,5,1,0,72
56221,623572,1,8,6,1,0,73
56222,623572,1,9,1,2,0,75
56223,623572,1,9,2,4,0,79
56224,623572,1,9,3,6,0,85
56225,623572,1,9,4,1,0,86
56226,623572,1,9,5,0,1,86
56227,623572,1,9,6,4,0,90
56228,623572,1,10,1,2,0,92
56229,623572,1,10,2,1,0,93
56230,623572,1,10,3,0,0,93
56231,623572,1,10,4,1,0,94
56232,623572,1,10,5,1,0,95
56233,623572,1,10,6,4,0,99
56234,623572,1,11,1,1,0,100
56235,623572,1,11,2,1,0,101
56236,623572,1,11,3,0,0,101
56237,623572,1,11,4,0,0,101
56238,623572,1,11,5,0,1,101
56239,623572,1,11,6,1,0,102
56240,623572,1,12,1,2,0,104
56241,623572,1,12,2,1,0,105
56242,623572,1,12,3,1,0,106
56243,623572,1,12,4,1,0,107
56244,623572,1,12,5,1,0,108
56245,623572,1,12,6,1,0,109
56246,623572,1,13,1,1,0,110
56247,623572,1,13,2,1,0,111
56248,623572,1,13,3,0,1,111
56249,623572,1,13,4,0,0,111
56250,623572,1,13,5,1,0,112
56251,623572,1,13,6,2,0,114
56252,623572,1,14,1,1,0,115
56253,623572,1,14,2,1,0,116
56254,623572,1,14,3,0,0,116
56255,623572,1,14,4,0,0,116
56256,623572,1,14,5,0,0,116
56257,623572,1,15,0,0,1,116
56258,623572,1,15,1,0,0,116
56259,623572,1,15,2,1,0,117
56260,623572,1,15,3,4,0,121
56261,623572,1,15,4,4,0,125
56262,623572,1,15,5,1,0,126
56263,623572,1,16,0,0,0,126
56264,623572,1,16,1,4,0,130
56265,623572,1,16,2,1,0,131
56266,623572,1,16,3,1,0,132
56267,623572,1,16,4,3,0,135
56268,623572,1,16,5,1,0,136
56269,623572,1,17,0,2,0,138
56270,623572,1,17,1,1,0,139
56271,623572,1,17,2,1,0,140
56272,623572,1,17,3,0,0,140
56273,623572,1,17,4,1,0,141
56274,623572,1,17,5,5,0,146
56275,623572,1,18,0,0,0,146
56276,623572,1,18,1,3,0,149
56277,623572,1,18,2,2,0,151
56278,623572,1,18,3,1,0,152
56279,623572,1,18,4,0,1,152
56280,623572,1,18,5,0,1,152
56281,623572,1,19,0,1,0,153
56282,623572,1,19,1,0,0,153
56283,623572,1,19,2,1,0,154
56284,623572,1,19,3,0,0,154
56285,623572,1,19,4,2,0,156
56286,623572,1,19,5,4,0,160
56287,623572,1,20,0,1,0,161
56288,623572,1,20,1,2,0,163
56289,623572,1,20,2,0,0,163
56290,623572,1,20,3,1,0,164
56291,623572,1,20,4,2,0,166
56292,623572,1,20,5,2,0,168
56413,635658,1,1,1,1,0,1
56414,635658,1,1,2,0,0,1
56415,635658,1,1,3,0,0,1
56416,635658,1,1,4,0,0,1
56417,635658,1,1,5,4,0,5
56418,635658,1,1,6,1,0,6
56419,635658,1,2,1,0,0,6
56420,635658,1,2,2,0,1,6
56421,635658,1,2,3,1,0,7
56422,635658,1,2,4,0,0,7
56423,635658,1,2,5,0,0,7
56424,635658,1,2,6,0,0,7
56425,635658,1,3,1,0,0,7
56426,635658,1,3,2,1,0,8
56427,635658,1,3,3,1,0,9
56428,635658,1,3,4,0,0,9
56429,635658,1,3,5,1,0,10
56430,635658,1,3,6,0,0,10
56431,635658,1,4,1,0,0,10
56432,635658,1,4,2,2,0,12
56433,635658,1,4,3,0,0,12
56434,635658,1,4,4,0,1,12
56435,635658,1,4,5,1,0,13
56436,635658,1,4,6,0,0,13
56437,635658,1,5,1,0,0,13
56438,635658,1,5,2,0,0,13
56439,635658,1,5,3,0,0,13
56440,635658,1,5,4,4,0,17
56441,635658,1,5,5,2,0,19
56442,635658,1,5,6,0,0,19
56443,635658,1,6,1,4,0,23
56444,635658,1,6,2,0,0,23
56445,635658,1,6,3,0,1,23
56446,635658,1,6,4,0,0,23
56447,635658,1,6,5,0,0,23
56448,635658,1,6,6,0,0,23
56449,635658,1,7,1,0,0,23
56450,635658,1,7,2,1,0,24
56451,635658,1,7,3,1,0,25
56452,635658,1,7,4,1,0,26
56453,635658,1,7,5,1,0,27
56454,635658,1,7,6,0,0,27
56455,635658,1,8,1,4,0,31
56456,635658,1,8,2,1,0,32
56457,635658,1,8,3,1,0,33
56458,635658,1,8,4,4,0,37
56459,635658,1,8,5,0,0,37
56460,635658,1,8,6,1,0,38
56461,635658,1,9,1,1,0,39
56462,635658,1,9,2,1,0,40
56463,635658,1,9,3,0,0,40
56464,635658,1,9,4,1,0,41
56465,635658,1,9,5,2,0,43
56466,635658,1,9,6,1,0,44
56467,635658,1,10,1,0,0,44
56468,635658,1,10,2,1,0,45
56469,635658,1,10,3,1,0,46
56470,635658,1,10,4,0,0,46
56471,635658,1,10,5,0,0,46
56472,635658,1,10,6,4,0,50
56473,635658,1,11,1,0,0,50
56474,635658,1,11,2,0,1,50
56475,635658,1,11,3,0,0,50
56476,635658,1,11,4,0,0,50
56477,635658,1,11,5,1,0,51
56478,635658,1,11,6,0,0,51
56479,635658,1,12,1,0,0,51
56480,635658,1,12,2,1,0,52
56481,635658,1,12,3,1,0,53
56482,635658,1,12,4,1,0,54
56483,635658,1,12,5,1,0,55
56484,635658,1,12,6,1,0,56
56485,635658,1,13,1,1,0,57
56486,635658,1,13,2,0,0,57
56487,635658,1,13,3,1,0,58
56488,635658,1,13,4,0,0,58
56489,635658,1,13,5,0,0,58
56490,635658,1,13,6,1,0,59
56491,635658,1,14,1,1,0,60
56492,635658,1,14,2,0,0,60
56493,635658,1,14,3,1,0,61
56494,635658,1,14,4,1,0,62
56495,635658,1,14,5,1,0,63
56496,635658,1,14,6,2,0,65
56497,635658,1,15,1,0,0,65
56498,635658,1,15,2,1,0,66
56499,635658,1,15,3,1,0,67
56500,635658,1,15,4,1,0,68
56501,635658,1,15,5,6,0,74
56502,635658,1,15,6,1,0,75
56503,635658,1,16,1,0,0,75
56504,635658,1,16,2,1,0,76
56505,635658,1,16,3,1,0,77
56506,635658,1,16,4,1,0,78
56507,635658,1,16,5,2,0,80
56508,635658,1,16,6,1,0,81
56509,635658,1,17,1,1,0,82
56510,635658,1,17,2,1,0,83
56511,635658,1,17,3,2,0,85
56512,635658,1,17,4,4,0,89
56513,635658,1,17,5,1,0,90
56514,635658,1,17,6,0,0,90
56515,635658,1,18,1,1,0,91
56516,635658,1,18,2,6,0,97
56517,635658,1,18,3,2,0,99
56518,635658,1,18,4,1,0,100
56519,635658,1,18,5,1,0,101
56520,635658,1,18,6,1,0,102
56521,635658,1,19,1,1,0,103
56522,635658,1,19,2,1,0,104
56523,635658,1,19,3,1,0,105
56524,635658,1,19,4,1,0,106
56525,635658,1,19,5,0,1,106
56526,635658,1,19,6,1,0,107
56527,635658,1,20,1,4,0,111
56528,635658,1,20,2,1,0,112
56529,635658,1,20,3,1,0,113
56530,635658,1,20,4,0,0,113
56531,635658,1,20,5,0,1,113
56532,635658,1,20,6,2,0,115
56653,635659,1,1,1,0,0,0
56654,635659,1,1,2,0,0,0
56655,635659,1,1,3,2,0,2
56656,635659,1,1,4,2,0,4
56657,635659,1,1,5,1,0,5
56658,635659,1,1,6,1,0,6
56659,635659,1,2,1,1,0,7
56660,635659,1,2,2,0,0,7
56661,635659,1,2,3,0,0,7
56662,635659,1,2,4,3,0,10
56663,635659,1,2,5,0,0,10
56664,635659,1,2,6,1,0,11
56665,635659,1,3,1,0,1,11
56666,635659,1,3,2,0,0,11
56667,635659,1,3,3,1,0,12
56668,635659,1,3,4,0,0,12
56669,635659,1,3,5,2,0,14
56670,635659,1,3,6,0,0,14
56671,635659,1,4,1,0,0,14
56672,635659,1,4,2,1,0,15
56673,635659,1,4,3,0,0,15
56674,635659,1,4,4,0,0,15
56675,635659,1,4,5,4,0,19
56676,635659,1,4,6,0,0,19
56677,635659,1,5,1,1,0,20
56678,635659,1,5,2,4,0,24
56679,635659,1,5,3,4,0,28
56680,635659,1,5,4,0,0,28
56681,635659,1,5,5,0,0,28
56682,635659,1,5,6,0,0,28
56683,635659,1,6,1,0,0,28
56684,635659,1,6,2,0,0,28
56685,635659,1,6,3,0,0,28
56686,635659,1,6,4,0,0,28
56687,635659,1,6,5,1,0,29
56688,635659,1,6,6,1,0,30
56689,635659,1,7,1,0,0,30
56690,635659,1,7,2,2,0,32
56691,635659,1,7,3,1,0,33
56692,635659,1,7,4,0,0,33
56693,635659,1,7,5,0,0,33
56694,635659,1,7,6,6,0,39
56695,635659,1,8,1,0,0,39
56696,635659,1,8,2,0,0,39
56697,635659,1,8,3,5,0,44
56698,635659,1,8,4,0,1,44
56699,635659,1,8,5,0,0,44
56700,635659,1,8,6,2,0,46
56701,635659,1,9,1,2,0,48
56702,635659,1,9,2,0,1,48
56703,635659,1,9,3,1,0,49
56704,635659,1,9,4,2,0,51
56705,635659,1,9,5,1,0,52
56706,635659,1,9,6,1,0,53
56707,635659,1,10,1,2,0,55
56708,635659,1,10,2,1,0,56
56709,635659,1,10,3,1,0,57
56710,635659,1,10,4,0,0,57
56711,635659,1,10,5,1,0,58
56712,635659,1,10,6,1,0,59
56713,635659,1,11,1,0,0,59
56714,635659,1,11,2,1,0,60
56715,635659,1,11,3,0,0,60
56716,635659,1,11,4,0,0,60
56717,635659,1,11,5,1,0,61
56718,635659,1,11,6,1,0,62
56719,635659,1,12,1,4,0,66
56720,635659,1,12,2,2,0,68
56721,635659,1,12,3,4,0,72
56722,635659,1,12,4,3,0,75
56723,635659,1,12,5,1,0,76
56724,635659,1,12,6,1,0,77
56725,635659,1,13,1,1,0,78
56726,635659,1,13,2,1,0,79
56727,635659,1,13,3,1,0,80
56728,635659,1,13,4,2,0,82
56729,635659,1,13,5,4,0,86
56730,635659,1,13,6,0,1,86
56731,635659,1,14,1,1,0,87
56732,635659,1,14,2,0,0,87
56733,635659,1,14,3,0,0,87
56734,635659,1,14,4,0,0,87
56735,635659,1,14,5,0,0,87
56736,635659,1,14,6,4,0,91
56737,635659,1,15,1,2,0,93
56738,635659,1,15,2,0,0,93
56739,635659,1,15,3,6,0,99
56740,635659,1,15,4,1,0,100
56741,635659,1,15,5,1,0,101
56742,635659,1,15,6,1,0,102
56743,635659,1,16,1,2,0,104
56744,635659,1,16,2,1,0,105
56745,635659,1,16,3,0,1,105
56746,635659,1,16,4,1,0,106
56747,635659,1,16,5,0,0,106
56748,635659,1,16,6,0,0,106
56749,635659,1,17,1,2,0,108
56750,635659,1,17,2,2,0,110
56751,635659,1,17,3,0,0,110
56752,635659,1,17,4,6,0,116
56753,635659,1,17,5,2,0,118
56754,635659,1,17,6,1,0,119
56755,635659,1,18,1,4,0,123
56756,635659,1,18,2,1,0,124
56757,635659,1,18,3,1,0,125
56758,635659,1,18,4,1,0,126
56759,635659,1,18,5,1,0,127
56760,635659,1,18,6,1,0,128
56761,635659,1,19,1,1,0,129
56762,635659,1,19,2,2,0,131
56763,635659,1,19,3,1,0,132
56764,635659,1,19,4,0,1,132
56765,635659,1,19,5,1,0,133
56766,635659,1,19,6,1,0,134
56767,635659,1,20,1,2,0,136
56768,635659,1,20,2,1,0,137
56769,635659,1,20,3,0,0,137
56770,635659,1,20,4,2,0,139
56771,635659,1,20,5,4,0,143
56772,635659,1,20,6,2,0,145
56893,635660,1,1,1,0,1,0
56894,635660,1,1,2,0,0,0
56895,635660,1,1,3,4,0,4
56896,635660,1,1,4,0,0,4
56897,635660,1,1,5,3,0,7
56898,635660,1,1,6,0,0,7
56899,635660,1,2,1,0,0,7
56900,635660,1,2,2,0,0,7
56901,635660,1,2,3,0,0,7
56902,635660,1,2,4,0,0,7
56903,635660,1,2,5,0,0,7
56904,635660,1,2,6,2,0,9
56905,635660,1,3,1,1,0,10
56906,635660,1,3,2,0,0,10
56907,635660,1,3,3,0,0,10
56908,635660,1,3,4,1,0,11
56909,635660,1,3,5,0,0,11
56910,635660,1,3,6,4,0,15
56911,635660,1,4,1,0,0,15
56912,635660,1,4,2,0,0,15
56913,635660,1,4,3,4,0,19
56914,635660,1,4,4,0,0,19
56915,635660,1,4,5,0,0,19
56916,635660,1,4,6,1,0,20
56917,635660,1,5,1,1,0,21
56918,635660,1,5,2,0,0,21
56919,635660,1,5,3,0,0,21
56920,635660,1,5,4,1,0,22
56921,635660,1,5,5,4,0,26
56922,635660,1,5,6,4,0,30
56923,635660,1,6,1,2,0,32
56924,635660,1,6,2,0,0,32
56925,635660,1,6,3,1,0,33
56926,635660,1,6,4,0,0,33
56927,635660,1,6,5,1,0,34
56928,635660,1,6,6,1,0,35
56929,635660,1,7,1,0,0,35
56930,635660,1,7,2,1,0,36
56931,635660,1,7,3,0,0,36
56932,635660,1,7,4,1,0,37
56933,635660,1,7,5,4,0,41
56934,635660,1,7,6,4,0,45
56935,635660,1,8,1,0,0,45
56936,635660,1,8,2,0,1,45
56937,635660,1,8,3,1,0,46
56938,635660,1,8,4,1,0,47
56939,635660,1,8,5,0,0,47
56940,635660,1,8,6,2,0,49
56941,635660,1,9,1,6,0,55
56942,635660,1,9,2,0,0,55
56943,635660,1,9,3,1,0,56
56944,635660,1,9,4,1,0,57
56945,635660,1,9,5,6,0,63
56946,635660,1,9,6,1,0,64
56947,635660,1,10,1,1,0,65
56948,635660,1,10,2,0,0,65
56949,635660,1,10,3,2,0,67
56950,635660,1,10,4,4,0,71
56951,635660,1,10,5,0,0,71
56952,635660,1,10,6,1,0,72
56953,635660,1,11,1,1,0,73
56954,635660,1,11,2,1,0,74
56955,635660,1,11,3,1,0,75
56956,635660,1,11,4,0,0,75
56957,635660,1,11,5,4,0,79
56958,635660,1,11,6,0,0,79
56959,635660,1,12,1,1,0,80
56960,635660,1,12,2,4,0,84
56961,635660,1,12,3,1,0,85
56962,635660,1,12,4,1,0,86
56963,635660,1,12,5,0,0,86
56964,635660,1,12,6,6,0,92
56965,635660,1,13,1,1,0,93
56966,635660,1,13,2,1,0,94
56967,635660,1,13,3,1,0,95
56968,635660,1,13,4,0,0,95
56969,635660,1,13,5,1,0,96
56970,635660,1,13,6,4,0,100
56971,635660,1,14,1,1,0,101
56972,635660,1,14,2,0,0,101
56973,635660,1,14,3,1,0,102
56974,635660,1,14,4,0,0,102
56975,635660,1,14,5,1,0,103
56976,635660,1,14,6,0,0,103
56977,635660,1,15,1,1,0,104
56978,635660,1,15,2,1,0,105
56979,635660,1,15,3,0,0,105
56980,635660,1,15,4,6,0,111
56981,635660,1,15,5,1,0,112
56982,635660,1,15,6,0,0,112
56983,635660,1,16,1,1,0,113
56984,635660,1,16,2,0,0,113
56985,635660,1,16,3,1,0,114
56986,635660,1,16,4,2,0,116
56987,635660,1,16,5,1,0,117
56988,635660,1,16,6,2,0,119
56989,635660,1,17,1,1,0,120
56990,635660,1,17,2,1,0,121
56991,635660,1,17,3,1,0,122
56992,635660,1,17,4,4,0,126
56993,635660,1,17,5,1,0,127
56994,635660,1,17,6,6,0,133
56995,635660,1,18,1,0,0,133
56996,635660,1,18,2,1,0,134
56997,635660,1,18,3,4,0,138
56998,635660,1,18,4,2,0,140
56999,635660,1,18,5,1,0,141
57000,635660,1,18,6,4,0,145
57001,635660,1,19,1,1,0,146
57002,635660,1,19,2,0,0,146
57003,635660,1,19,3,0,0,146
57004,635660,1,19,4,4,0,150
57005,635660,1,19,5,4,0,154
57006,635660,1,19,6,1,0,155
57007,635660,1,20,1,1,0,156
57008,635660,1,20,2,1,0,157
57009,635660,1,20,3,0,1,157
57010,635660,1,20,4,1,0,158
57011,635660,1,20,5,4,0,162
57012,635660,1,20,6,1,0,163
57122,636164,1,1,1,3,0,3
57123,636164,1,1,2,0,0,3
57124,636164,1,1,3,1,0,4
57125,636164,1,1,4,0,0,4
57126,636164,1,1,5,0,0,4
57127,636164,1,1,6,0,0,4
57128,636164,1,2,1,1,0,5
57129,636164,1,2,2,2,0,7
57130,636164,1,2,3,0,0,7
57131,636164,1,2,4,0,0,7
57132,636164,1,2,5,6,0,13
57133,636164,1,2,6,0,0,13
57134,636164,1,3,1,6,0,19
57135,636164,1,3,2,0,0,19
57136,636164,1,3,3,1,0,20
57137,636164,1,3,4,0,0,20
57138,636164,1,3,5,2,0,22
57139,636164,1,3,6,1,0,23
57140,636164,1,4,1,2,0,25
57141,636164,1,4,2,0,0,25
57142,636164,1,4,3,0,0,25
57143,636164,1,4,4,6,0,31
57144,636164,1,4,5,1,0,32
57145,636164,1,4,6,0,0,32
57146,636164,1,5,1,4,0,36
57147,636164,1,5,2,4,0,40
57148,636164,1,5,3,6,0,46
57149,636164,1,5,4,1,0,47
57150,636164,1,5,5,0,0,47
57151,636164,1,5,6,1,0,48
57152,636164,1,6,1,1,0,49
57153,636164,1,6,2,1,0,50
57154,636164,1,6,3,1,0,51
57155,636164,1,6,4,0,0,51
57156,636164,1,6,5,1,0,52
57157,636164,1,6,6,0,0,52
57158,636164,1,7,1,4,0,56
57159,636164,1,7,2,1,0,57
57160,636164,1,7,3,6,0,63
57161,636164,1,7,4,0,0,63
57162,636164,1,7,5,1,0,64
57163,636164,1,7,6,0,0,64
57164,636164,1,8,1,0,0,64
57165,636164,1,8,2,1,0,65
57166,636164,1,8,3,4,0,69
57167,636164,1,8,4,4,0,73
57168,636164,1,8,5,1,0,74
57169,636164,1,8,6,4,0,78
57170,636164,1,9,1,2,0,80
57171,636164,1,9,2,6,0,86
57172,636164,1,9,3,1,0,87
57173,636164,1,9,4,0,0,87
57174,636164,1,9,5,2,0,89
57175,636164,1,9,6,0,0,89
57176,636164,1,10,1,4,0,93
57177,636164,1,10,2,2,0,95
57178,636164,1,10,3,1,0,96
57179,636164,1,10,4,2,0,98
57180,636164,1,10,5,4,0,102
57181,636164,1,10,6,2,0,104
57182,636164,1,11,1,0,0,104
57183,636164,1,11,2,1,0,105
57184,636164,1,11,3,1,0,106
57185,636164,1,11,4,0,1,106
57186,636164,1,11,5,4,0,110
57187,636164,1,11,6,1,0,111
57188,636164,1,12,1,1,0,112
57189,636164,1,12,2,1,0,113
57190,636164,1,12,3,2,0,115
57191,636164,1,12,4,1,0,116
57192,636164,1,12,5,0,0,116
57193,636164,1,12,6,1,0,117
57194,636164,1,13,1,6,0,123
57195,636164,1,13,2,4,0,127
57196,636164,1,13,3,4,0,131
57197,636164,1,13,4,3,0,134
57198,636164,1,13,5,0,1,134
57199,636164,1,13,6,1,0,135
57200,636164,1,14,1,0,0,135
57201,636164,1,14,2,1,0,136
57202,636164,1,14,3,4,0,140
57203,636164,1,14,4,6,0,146
57204,636164,1,14,5,3,0,149
57205,636164,1,14,6,4,0,153
57206,636164,1,15,1,1,0,154
57207,636164,1,15,2,0,0,154
57208,636164,1,15,3,1,0,155
57209,636164,1,15,4,1,0,156
57210,636164,1,15,5,0,0,156
57211,636164,1,15,6,1,0,157
57212,636164,1,16,1,0,1,157
57213,636164,1,16,2,1,0,158
57214,636164,1,16,3,0,0,158
57215,636164,1,16,4,1,0,159
57216,636164,1,16,5,0,0,159
57217,636164,1,16,6,1,0,160
57218,636164,1,17,1,6,0,166
57219,636164,1,17,2,1,0,167
57220,636164,1,17,3,1,0,168
57221,636164,1,17,4,2,0,170
57222,636164,1,17,5,2,0,172
57223,636164,1,17,6,1,0,173
57224,636164,1,18,1,1,0,174
57225,636164,1,18,2,0,0,174
57226,636164,1,18,3,0,0,174
57227,636164,1,18,4,6,0,180
57228,636164,1,18,5,5,0,185
57229,636164,1,18,6,1,0,186
57230,636164,1,19,1,2,0,188
57231,636164,1,19,2,0,0,188
57232,636164,1,19,3,6,0,194
57233,636164,1,19,4,1,0,195
57234,636164,1,19,5,4,0,199
57235,636164,1,19,6,1,0,200
57236,636164,1,20,1,0,1,200
57237,636164,1,20,2,2,0,202
57238,636164,1,20,3,4,0,206
57239,636164,1,20,4,1,0,207
57240,636164,1,20,5,4,0,211
57241,636164,1,20,6,2,0,213
57362,636165,1,1,1,1,0,1
57363,636165,1,1,2,0,0,1
57364,636165,1,1,3,0,0,1
57365,636165,1,1,4,4,0,5
57366,636165,1,1,5,4,0,9
57367,636165,1,1,6,1,0,10
57368,636165,1,2,1,0,0,10
57369,636165,1,2,2,0,0,10
57370,636165,1,2,3,0,0,10
57371,636165,1,2,4,4,0,14
57372,636165,1,2,5,4,0,18
57373,636165,1,2,6,0,0,18
57374,636165,1,3,1,1,0,19
57375,636165,1,3,2,0,0,19
57376,636165,1,3,3,1,0,20
57377,636165,1,3,4,0,0,20
57378,636165,1,3,5,0,0,20
57379,636165,1,3,6,4,0,24
57380,636165,1,4,1,0,0,24
57381,636165,1,4,2,0,1,24
57382,636165,1,4,3,4,0,28
57383,636165,1,4,4,2,0,30
57384,636165,1,4,5,0,0,30
57385,636165,1,4,6,0,0,30
57386,636165,1,5,1,0,0,30
57387,636165,1,5,2,0,1,30
57388,636165,1,5,3,4,0,34
57389,636165,1,5,4,4,0,38
57390,636165,1,5,5,0,0,38
57391,636165,1,5,6,0,0,38
57392,636165,1,6,1,4,0,42
57393,636165,1,6,2,0,0,42
57394,636165,1,6,3,0,0,42
57395,636165,1,6,4,0,1,42
57396,636165,1,6,5,2,0,44
57397,636165,1,6,6,4,0,48
57398,636165,1,7,1,4,0,52
57399,636165,1,7,2,1,0,53
57400,636165,1,7,3,1,0,54
57401,636165,1,7,4,1,0,55
57402,636165,1,7,5,0,0,55
57403,636165,1,7,6,0,1,55
57404,636165,1,8,1,0,0,55
57405,636165,1,8,2,2,0,57
57406,636165,1,8,3,1,0,58
57407,636165,1,8,4,0,0,58
57408,636165,1,8,5,1,0,59
57409,636165,1,8,6,1,0,60
57410,636165,1,9,1,1,0,61
57411,636165,1,9,2,1,0,62
57412,636165,1,9,3,1,1,63
57413,636165,1,9,4,1,0,64
57414,636165,1,9,5,1,0,65
57415,636165,1,9,6,1,0,66
57416,636165,1,10,1,1,0,67
57417,636165,1,10,2,0,0,67
57418,636165,1,10,3,0,0,67
57419,636165,1,10,4,1,0,68
57420,636165,1,10,5,1,0,69
57421,636165,1,10,6,1,0,70
57422,636165,1,11,1,1,0,71
57423,636165,1,11,2,1,0,72
57424,636165,1,11,3,1,0,73
57425,636165,1,11,4,4,0,77
57426,636165,1,11,5,1,0,78
57427,636165,1,11,6,0,0,78
57428,636165,1,12,1,2,0,80
57429,636165,1,12,2,0,0,80
57430,636165,1,12,3,4,0,84
57431,636165,1,12,4,1,0,85
57432,636165,1,12,5,1,0,86
57433,636165,1,12,6,0,0,86
57434,636165,1,13,1,0,0,86
57435,636165,1,13,2,1,1,87
57436,636165,1,13,3,2,0,89
57437,636165,1,13,4,0,0,89
57438,636165,1,13,5,3,0,92
57439,636165,1,13,6,0,0,92
57440,636165,1,14,1,1,0,93
57441,636165,1,14,2,0,0,93
57442,636165,1,14,3,0,0,93
57443,636165,1,14,4,1,0,94
57444,636165,1,14,5,0,0,94
57445,636165,1,14,6,0,0,94
57446,636165,1,15,1,1,0,95
57447,636165,1,15,2,0,0,95
57448,636165,1,15,3,0,0,95
57449,636165,1,15,4,0,0,95
57450,636165,1,15,5,1,0,96
57451,636165,1,15,6,0,0,96
57452,636165,1,16,1,0,1,96
57453,636165,1,16,2,0,0,96
57454,636165,1,16,3,1,0,97
57455,636165,1,16,4,1,0,98
57456,636165,1,16,5,1,0,99
57457,636165,1,16,6,0,0,99
57458,636165,1,17,1,4,0,103
57459,636165,1,17,2,1,0,104
57460,636165,1,17,3,0,0,104
57461,636165,1,17,4,0,0,104
57462,636165,1,17,5,0,0,104
57463,636165,1,17,6,1,0,105
57464,636165,1,18,1,0,0,105
57465,636165,1,18,2,1,0,106
57466,636165,1,18,3,4,0,110
57467,636165,1,18,4,2,0,112
57468,636165,1,18,5,1,0,113
57469,636165,1,18,6,2,0,115
57470,636165,1,19,1,0,0,115
57471,636165,1,19,2,0,0,115
57472,636165,1,19,3,0,0,115
57473,636165,1,19,4,1,0,116
57474,636165,1,19,5,1,0,117
57475,636165,1,19,6,1,0,118
57476,636165,1,20,1,4,0,122
57477,636165,1,20,2,4,0,126
57478,636165,1,20,3,1,0,127
57479,636165,1,20,4,3,0,130
57480,636165,1,20,5,0,1,130
57481,636165,1,20,6,0,1,130
57571,636166,1,1,1,0,0,0
57572,636166,1,1,2,0,0,0
57573,636166,1,1,3,1,0,1
57574,636166,1,1,4,1,0,2
57575,636166,1,1,5,1,0,3
57576,636166,1,1,6,0,0,3
57577,636166,1,2,1,1,0,4
57578,636166,1,2,2,0,0,4
57579,636166,1,2,3,2,0,6
57580,636166,1,2,4,1,0,7
57581,636166,1,2,5,0,0,7
57582,636166,1,2,6,0,0,7
57583,636166,1,3,1,0,0,7
57584,636166,1,3,2,4,0,11
57585,636166,1,3,3,4,0,15
57586,636166,1,3,4,1,0,16
57587,636166,1,3,5,1,0,17
57588,636166,1,3,6,0,0,17
57589,636166,1,4,1,4,0,21
57590,636166,1,4,2,0,0,21
57591,636166,1,4,3,1,0,22
57592,636166,1,4,4,0,0,22
57593,636166,1,4,5,1,0,23
57594,636166,1,4,6,1,0,24
57595,636166,1,5,1,0,0,24
57596,636166,1,5,2,1,0,25
57597,636166,1,5,3,0,0,25
57598,636166,1,5,4,0,0,25
57599,636166,1,5,5,1,0,26
57600,636166,1,5,6,1,0,27
57601,636166,1,6,1,0,0,27
57602,636166,1,6,2,6,0,33
57603,636166,1,6,3,2,0,35
57604,636166,1,6,4,0,0,35
57605,636166,1,6,5,6,0,41
57606,636166,1,6,6,0,0,41
57607,636166,1,7,1,1,0,42
57608,636166,1,7,2,6,0,48
57609,636166,1,7,3,0,0,48
57610,636166,1,7,4,0,1,48
57611,636166,1,7,5,1,0,49
57612,636166,1,7,6,1,0,50
57613,636166,1,8,1,0,0,50
57614,636166,1,8,2,1,0,51
57615,636166,1,8,3,0,0,51
57616,636166,1,8,4,7,0,58
57617,636166,1,8,5,0,0,58
57618,636166,1,8,6,1,0,59
57619,636166,1,9,1,6,0,65
57620,636166,1,9,2,0,1,65
57621,636166,1,9,3,1,0,66
57622,636166,1,9,4,2,0,68
57623,636166,1,9,5,0,0,68
57624,636166,1,9,6,6,0,74
57625,636166,1,10,1,0,0,74
57626,636166,1,10,2,2,0,76
57627,636166,1,10,3,0,0,76
57628,636166,1,10,4,1,0,77
57629,636166,1,10,5,1,0,78
57630,636166,1,10,6,1,0,79
57631,636166,1,11,1,4,0,83
57632,636166,1,11,2,4,0,87
57633,636166,1,11,3,1,0,88
57634,636166,1,11,4,6,0,94
57635,636166,1,11,5,2,0,96
57636,636166,1,11,6,1,0,97
57637,636166,1,12,1,1,0,98
57638,636166,1,12,2,1,0,99
57639,636166,1,12,3,1,0,100
57640,636166,1,12,4,4,0,104
57641,636166,1,12,5,0,0,104
57642,636166,1,12,6,0,0,104
57643,636166,1,13,1,6,0,110
57644,636166,1,13,2,0,0,110
57645,636166,1,13,3,1,0,111
57646,636166,1,13,4,0,0,111
57647,636166,1,13,5,6,0,117
57648,636166,1,13,6,0,0,117
57649,636166,1,14,1,1,0,118
57650,636166,1,14,2,0,1,118
57651,636166,1,14,3,0,0,118
57652,636166,1,14,4,4,0,122
57653,636166,1,14,5,2,0,124
57654,636166,1,14,6,6,0,130
57655,636166,1,15,1,0,1,130
57656,636166,1,15,2,1,0,131
57657,636166,1,15,3,1,0,132
57658,636166,1,15,4,4,0,136
57659,636166,1,15,5,1,0,137
57660,636166,1,15,6,0,0,137
57661,636166,1,16,1,0,0,137
57662,636166,1,16,2,0,0,137
57663,636166,1,16,3,2,0,139
57664,636166,1,16,4,0,1,139
57665,636166,1,16,5,0,0,139
57666,636166,1,16,6,0,1,139
57667,636166,1,17,1,1,0,140
57668,636166,1,17,2,1,0,141
57669,636166,1,17,3,2,0,143
57670,636166,1,17,4,1,0,144
57671,636166,1,17,5,1,0,145
57672,636166,1,17,6,1,0,146
57673,636166,1,18,1,1,0,147
57674,636166,1,18,2,1,0,148
57675,636166,1,18,3,1,0,149
57676,636166,1,18,4,3,0,152
57677,636166,1,18,5,4,0,156
57678,636166,1,18,6,1,0,157
57679,636166,1,19,1,6,0,163
57680,636166,1,19,2,1,0,164
57681,636166,1,19,3,2,0,166
57682,636166,1,19,4,1,0,167
57683,636166,1,19,5,0,0,167
57684,636166,1,19,6,2,0,169
57685,636166,1,20,1,4,0,173
57686,636166,1,20,2,6,0,179
57687,636166,1,20,3,6,0,185
57688,636166,1,20,4,4,0,189
57689,636166,1,20,5,4,0,193
57690,636166,1,20,6,2,0,195
57795,636536,1,1,1,6,0,6
57796,636536,1,1,2,0,0,6
57797,636536,1,1,3,4,0,10
57798,636536,1,1,4,4,0,14
57799,636536,1,1,5,4,0,18
57800,636536,1,1,6,1,0,19
57801,636536,1,2,1,0,0,19
57802,636536,1,2,2,0,0,19
57803,636536,1,2,3,1,0,20
57804,636536,1,2,4,0,0,20
57805,636536,1,2,5,4,0,24
57806,636536,1,2,6,0,0,24
57807,636536,1,3,1,0,0,24
57808,636536,1,3,2,0,0,24
57809,636536,1,3,3,0,0,24
57810,636536,1,3,4,0,0,24
57811,636536,1,3,5,0,0,24
57812,636536,1,3,6,1,0,25
57813,636536,1,4,1,1,0,26
57814,636536,1,4,2,4,0,30
57815,636536,1,4,3,0,0,30
57816,636536,1,4,4,1,0,31
57817,636536,1,4,5,1,0,32
57818,636536,1,4,6,0,0,32
57819,636536,1,5,1,4,0,36
57820,636536,1,5,2,4,0,40
57821,636536,1,5,3,0,0,40
57822,636536,1,5,4,4,0,44
57823,636536,1,5,5,1,0,45
57824,636536,1,5,6,0,0,45
57825,636536,1,6,1,0,0,45
57826,636536,1,6,2,6,0,51
57827,636536,1,6,3,4,0,55
57828,636536,1,6,4,1,0,56
57829,636536,1,6,5,0,0,56
57830,636536,1,6,6,0,0,56
57831,636536,1,7,1,1,0,57
57832,636536,1,7,2,0,1,57
57833,636536,1,7,3,4,0,61
57834,636536,1,7,4,1,0,62
57835,636536,1,7,5,1,0,63
57836,636536,1,7,6,0,0,63
57837,636536,1,8,1,0,0,63
57838,636536,1,8,2,0,0,63
57839,636536,1,8,3,0,0,63
57840,636536,1,8,4,1,0,64
57841,636536,1,8,5,0,0,64
57842,636536,1,8,6,1,0,65
57843,636536,1,9,1,1,0,66
57844,636536,1,9,2,1,0,67
57845,636536,1,9,3,1,0,68
57846,636536,1,9,4,1,0,69
57847,636536,1,9,5,0,0,69
57848,636536,1,9,6,0,0,69
57849,636536,1,10,1,0,0,69
57850,636536,1,10,2,6,0,75
57851,636536,1,10,3,1,0,76
57852,636536,1,10,4,0,0,76
57853,636536,1,10,5,0,0,76
57854,636536,1,10,6,2,0,78
57855,636536,1,11,1,4,0,82
57856,636536,1,11,2,1,0,83
57857,636536,1,11,3,2,0,85
57858,636536,1,11,4,0,0,85
57859,636536,1,11,5,0,0,85
57860,636536,1,11,6,1,0,86
57861,636536,1,12,1,1,0,87
57862,636536,1,12,2,0,0,87
57863,636536,1,12,3,0,1,87
57864,636536,1,12,4,1,0,88
57865,636536,1,12,5,2,0,90
57866,636536,1,12,6,0,0,90
57867,636536,1,13,1,1,0,91
57868,636536,1,13,2,2,0,93
57869,636536,1,13,3,4,0,97
57870,636536,1,13,4,6,0,103
57871,636536,1,13,5,4,0,107
57872,636536,1,13,6,2,0,109
57873,636536,1,14,1,1,0,110
57874,636536,1,14,2,0,0,110
57875,636536,1,14,3,1,0,111
57876,636536,1,14,4,0,0,111
57877,636536,1,14,5,0,0,111
57878,636536,1,14,6,0,0,111
57879,636536,1,15,1,1,0,112
57880,636536,1,15,2,0,1,112
57881,636536,1,15,3,1,0,113
57882,636536,1,15,4,1,0,114
57883,636536,1,15,5,1,0,115
57884,636536,1,15,6,0,0,115
57885,636536,1,16,1,1,0,116
57886,636536,1,16,2,4,0,120
57887,636536,1,16,3,0,0,120
57888,636536,1,16,4,1,0,121
57889,636536,1,16,5,0,0,121
57890,636536,1,16,6,1,0,122
57891,636536,1,17,1,4,0,126
57892,636536,1,17,2,0,0,126
57893,636536,1,17,3,4,0,130
57894,636536,1,17,4,1,0,131
57895,636536,1,17,5,0,0,131
57896,636536,1,17,6,1,0,132
57897,636536,1,18,1,0,0,132
57898,636536,1,18,2,4,0,136
57899,636536,1,18,3,4,0,140
57900,636536,1,18,4,4,0,144
57901,636536,1,18,5,4,0,148
57902,636536,1,18,6,4,0,152
57903,636536,1,19,1,1,0,153
57904,636536,1,19,2,0,0,153
57905,636536,1,19,3,1,0,154
57906,636536,1,19,4,6,0,160
57907,636536,1,19,5,1,0,161
57908,636536,1,19,6,4,0,165
57909,636536,1,20,1,1,0,166
57910,636536,1,20,2,1,0,167
57911,636536,1,20,3,1,0,168
57912,636536,1,20,4,0,0,168
57913,636536,1,20,5,1,0,169
57914,636536,1,20,6,1,0,170
58035,636537,1,1,1,1,0,1
58036,636537,1,1,2,0,0,1
58037,636537,1,1,3,4,0,5
58038,636537,1,1,4,0,0,5
58039,636537,1,1,5,1,0,6
58040,636537,1,1,6,2,0,8
58041,636537,1,2,1,0,0,8
58042,636537,1,2,2,2,0,10
58043,636537,1,2,3,1,0,11
58044,636537,1,2,4,1,0,12
58045,636537,1,2,5,1,0,13
58046,636537,1,2,6,0,1,13
58047,636537,1,3,1,0,0,13
58048,636537,1,3,2,1,0,14
58049,636537,1,3,3,0,0,14
58050,636537,1,3,4,0,0,14
58051,636537,1,3,5,0,0,14
58052,636537,1,3,6,1,0,15
58053,636537,1,4,1,2,0,17
58054,636537,1,4,2,4,0,21
58055,636537,1,4,3,0,1,21
58056,636537,1,4,4,0,0,21
58057,636537,1,4,5,0,0,21
58058,636537,1,4,6,2,0,23
58059,636537,1,5,1,1,0,24
58060,636537,1,5,2,1,0,25
58061,636537,1,5,3,1,0,26
58062,636537,1,5,4,0,0,26
58063,636537,1,5,5,0,0,26
58064,636537,1,5,6,0,1,26
58065,636537,1,6,1,1,0,27
58066,636537,1,6,2,0,0,27
58067,636537,1,6,3,0,0,27
58068,636537,1,6,4,1,0,28
58069,636537,1,6,5,1,0,29
58070,636537,1,6,6,1,0,30
58071,636537,1,7,1,1,0,31
58072,636537,1,7,2,1,0,32
58073,636537,1,7,3,0,0,32
58074,636537,1,7,4,0,0,32
58075,636537,1,7,5,1,0,33
58076,636537,1,7,6,1,0,34
58077,636537,1,8,1,4,0,38
58078,636537,1,8,2,0,0,38
58079,636537,1,8,3,0,0,38
58080,636537,1,8,4,0,0,38
58081,636537,1,8,5,0,0,38
58082,636537,1,8,6,1,0,39
58083,636537,1,9,1,4,0,43
58084,636537,1,9,2,0,0,43
58085,636537,1,9,3,1,0,44
58086,636537,1,9,4,1,0,45
58087,636537,1,9,5,3,0,48
58088,636537,1,9,6,1,0,49
58089,636537,1,10,1,1,0,50
58090,636537,1,10,2,0,0,50
58091,636537,1,10,3,2,0,52
58092,636537,1,10,4,2,0,54
58093,636537,1,10,5,6,0,60
58094,636537,1,10,6,1,0,61
58095,636537,1,11,1,0,0,61
58096,636537,1,11,2,1,0,62
58097,636537,1,11,3,1,0,63
58098,636537,1,11,4,1,0,64
58099,636537,1,11,5,0,0,64
58100,636537,1,11,6,1,0,65
58101,636537,1,12,1,4,0,69
58102,636537,1,12,2,1,0,70
58103,636537,1,12,3,1,0,71
58104,636537,1,12,4,4,0,75
58105,636537,1,12,5,6,0,81
58106,636537,1,12,6,1,0,82
58107,636537,1,13,1,1,0,83
58108,636537,1,13,2,6,0,89
58109,636537,1,13,3,1,0,90
58110,636537,1,13,4,1,0,91
58111,636537,1,13,5,1,0,92
58112,636537,1,13,6,6,0,98
58113,636537,1,14,1,1,0,99
58114,636537,1,14,2,1,0,100
58115,636537,1,14,3,1,0,101
58116,636537,1,14,4,1,0,102
58117,636537,1,14,5,0,1,102
58118,636537,1,14,6,2,0,104
58119,636537,1,15,1,1,0,105
58120,636537,1,15,2,1,0,106
58121,636537,1,15,3,1,0,107
58122,636537,1,15,4,0,0,107
58123,636537,1,15,5,1,0,108
58124,636537,1,15,6,1,0,109
58125,636537,1,16,1,4,0,113
58126,636537,1,16,2,1,0,114
58127,636537,1,16,3,1,0,115
58128,636537,1,16,4,1,0,116
58129,636537,1,16,5,1,0,117
58130,636537,1,16,6,0,0,117
58131,636537,1,17,1,1,0,118
58132,636537,1,17,2,1,0,119
58133,636537,1,17,3,1,0,120
58134,636537,1,17,4,1,0,121
58135,636537,1,17,5,0,0,121
58136,636537,1,17,6,4,0,125
58137,636537,1,18,1,1,0,126
58138,636537,1,18,2,1,0,127
58139,636537,1,18,3,0,0,127
58140,636537,1,18,4,1,0,128
58141,636537,1,18,5,2,0,130
58142,636537,1,18,6,6,0,136
58143,636537,1,19,1,1,0,137
58144,636537,1,19,2,0,1,137
58145,636537,1,19,3,1,0,138
58146,636537,1,19,4,4,0,142
58147,636537,1,19,5,1,0,143
58148,636537,1,19,6,0,1,143
58149,636537,1,20,1,1,0,144
58150,636537,1,20,2,6,0,150
58151,636537,1,20,3,1,0,151
58152,636537,1,20,4,0,0,151
58153,636537,1,20,5,1,0,152
58154,636537,1,20,6,0,1,152
58268,636538,1,1,1,0,0,0
58269,636538,1,1,2,0,0,0
58270,636538,1,1,3,0,0,0
58271,636538,1,1,4,4,0,4
58272,636538,1,1,5,1,0,5
58273,636538,1,1,6,0,0,5
58274,636538,1,2,1,4,0,9
58275,636538,1,2,2,0,0,9
58276,636538,1,2,3,0,0,9
58277,636538,1,2,4,5,0,14
58278,636538,1,2,5,4,0,18
58279,636538,1,2,6,4,0,22
58280,636538,1,3,1,4,0,26
58281,636538,1,3,2,4,0,30
58282,636538,1,3,3,1,0,31
58283,636538,1,3,4,0,0,31
58284,636538,1,3,5,6,0,37
58285,636538,1,3,6,1,0,38
58286,636538,1,4,1,0,0,38
58287,636538,1,4,2,0,0,38
58288,636538,1,4,3,4,0,42
58289,636538,1,4,4,6,0,48
58290,636538,1,4,5,4,0,52
58291,636538,1,4,6,0,0,52
58292,636538,1,5,1,0,0,52
58293,636538,1,5,2,0,0,52
58294,636538,1,5,3,4,0,56
58295,636538,1,5,4,0,0,56
58296,636538,1,5,5,0,0,56
58297,636538,1,5,6,2,0,58
58298,636538,1,6,1,0,0,58
58299,636538,1,6,2,1,0,59
58300,636538,1,6,3,1,0,60
58301,636538,1,6,4,0,0,60
58302,636538,1,6,5,0,0,60
58303,636538,1,6,6,4,0,64
58304,636538,1,7,1,1,0,65
58305,636538,1,7,2,1,0,66
58306,636538,1,7,3,6,0,72
58307,636538,1,7,4,0,0,72
58308,636538,1,7,5,1,0,73
58309,636538,1,7,6,2,0,75
58310,636538,1,8,1,1,0,76
58311,636538,1,8,2,1,0,77
58312,636538,1,8,3,0,0,77
58313,636538,1,8,4,0,0,77
58314,636538,1,8,5,0,0,77
58315,636538,1,8,6,1,0,78
58316,636538,1,9,1,1,0,79
58317,636538,1,9,2,0,0,79
58318,636538,1,9,3,1,0,80
58319,636538,1,9,4,2,0,82
58320,636538,1,9,5,2,0,84
58321,636538,1,9,6,1,0,85
58322,636538,1,10,1,4,0,89
58323,636538,1,10,2,2,0,91
58324,636538,1,10,3,0,0,91
58325,636538,1,10,4,1,0,92
58326,636538,1,10,5,4,0,96
58327,636538,1,10,6,0,0,96
58328,636538,1,11,1,1,0,97
58329,636538,1,11,2,1,0,98
58330,636538,1,11,3,0,0,98
58331,636538,1,11,4,0,0,98
58332,636538,1,11,5,0,1,98
58333,636538,1,11,6,1,0,99
58334,636538,1,12,1,1,0,100
58335,636538,1,12,2,1,0,101
58336,636538,1,12,3,1,0,102
58337,636538,1,12,4,0,0,102
58338,636538,1,12,5,0,0,102
58339,636538,1,12,6,0,0,102
58340,636538,1,13,1,1,0,103
58341,636538,1,13,2,1,0,104
58342,636538,1,13,3,1,0,105
58343,636538,1,13,4,6,0,111
58344,636538,1,13,5,1,0,112
58345,636538,1,13,6,0,1,112
58346,636538,1,14,1,1,0,113
58347,636538,1,14,2,2,0,115
58348,636538,1,14,3,1,0,116
58349,636538,1,14,4,0,0,116
58350,636538,1,14,5,0,0,116
58351,636538,1,14,6,0,0,116
58352,636538,1,15,1,0,0,116
58353,636538,1,15,2,1,0,117
58354,636538,1,15,3,0,0,117
58355,636538,1,15,4,1,0,118
58356,636538,1,15,5,0,0,118
58357,636538,1,15,6,1,0,119
58358,636538,1,16,1,4,0,123
58359,636538,1,16,2,0,0,123
58360,636538,1,16,3,0,0,123
58361,636538,1,16,4,0,1,123
58362,636538,1,16,5,1,0,124
58363,636538,1,16,6,1,0,125
58364,636538,1,17,1,2,0,127
58365,636538,1,17,2,1,0,128
58366,636538,1,17,3,0,1,128
58367,636538,1,17,4,1,0,129
58368,636538,1,17,5,0,1,129
58369,636538,1,17,6,1,0,130
58370,636538,1,18,1,1,0,131
58371,636538,1,18,2,1,0,132
58372,636538,1,18,3,0,0,132
58373,636538,1,18,4,6,0,138
58374,636538,1,18,5,0,0,138
58375,636538,1,18,6,0,0,138
58376,636538,1,19,1,0,1,138
58377,636538,1,19,2,0,0,138
58378,636538,1,19,3,0,0,138
58379,636538,1,19,4,1,0,139
58380,636538,1,19,5,0,0,139
58381,636538,1,19,6,0,0,139
58382,636538,1,20,1,2,0,141
58383,636538,1,20,2,6,0,147
58384,636538,1,20,3,6,0,153
58385,636538,1,20,4,6,0,159
58386,636538,1,20,5,0,0,159
58387,636538,1,20,6,6,0,165
58508,645645,1,1,1,1,0,1
58509,645645,1,1,2,1,0,2
58510,645645,1,1,3,0,1,2
58511,645645,1,1,4,0,0,2
58512,645645,1,1,5,1,0,3
58513,645645,1,1,6,0,0,3
58514,645645,1,2,1,0,0,3
58515,645645,1,2,2,4,0,7
58516,645645,1,2,3,1,0,8
58517,645645,1,2,4,4,0,12
58518,645645,1,2,5,0,0,12
58519,645645,1,2,6,0,0,12
58520,645645,1,3,1,0,0,12
58521,645645,1,3,2,0,0,12
58522,645645,1,3,3,0,0,12
58523,645645,1,3,4,1,0,13
58524,645645,1,3,5,0,1,13
58525,645645,1,3,6,0,0,13
58526,645645,1,4,1,0,0,13
58527,645645,1,4,2,4,0,17
58528,645645,1,4,3,4,0,21
58529,645645,1,4,4,0,0,21
58530,645645,1,4,5,0,0,21
58531,645645,1,4,6,6,0,27
58532,645645,1,5,1,0,0,27
58533,645645,1,5,2,6,0,33
58534,645645,1,5,3,0,0,33
58535,645645,1,5,4,0,1,33
58536,645645,1,5,5,4,0,37
58537,645645,1,5,6,0,0,37
58538,645645,1,6,1,0,0,37
58539,645645,1,6,2,0,0,37
58540,645645,1,6,3,0,0,37
58541,645645,1,6,4,4,0,41
58542,645645,1,6,5,0,0,41
58543,645645,1,6,6,0,0,41
58544,645645,1,7,1,1,0,42
58545,645645,1,7,2,0,1,42
58546,645645,1,7,3,4,0,46
58547,645645,1,7,4,1,0,47
58548,645645,1,7,5,0,0,47
58549,645645,1,7,6,1,0,48
58550,645645,1,8,1,1,0,49
58551,645645,1,8,2,0,0,49
58552,645645,1,8,3,1,0,50
58553,645645,1,8,4,0,0,50
58554,645645,1,8,5,1,0,51
58555,645645,1,8,6,0,0,51
58556,645645,1,9,1,1,0,52
58557,645645,1,9,2,0,0,52
58558,645645,1,9,3,2,0,54
58559,645645,1,9,4,0,0,54
58560,645645,1,9,5,1,0,55
58561,645645,1,9,6,0,0,55
58562,645645,1,10,1,0,0,55
58563,645645,1,10,2,1,0,56
58564,645645,1,10,3,1,0,57
58565,645645,1,10,4,1,0,58
58566,645645,1,10,5,1,0,59
58567,645645,1,10,6,6,0,65
58568,645645,1,11,1,0,0,65
58569,645645,1,11,2,4,0,69
58570,645645,1,11,3,0,0,69
58571,645645,1,11,4,0,0,69
58572,645645,1,11,5,0,0,69
58573,645645,1,11,6,0,0,69
58574,645645,1,12,1,1,0,70
58575,645645,1,12,2,2,0,72
58576,645645,1,12,3,1,0,73
58577,645645,1,12,4,1,0,74
58578,645645,1,12,5,2,0,76
58579,645645,1,12,6,1,0,77
58580,645645,1,13,1,1,0,78
58581,645645,1,13,2,0,0,78
58582,645645,1,13,3,1,0,79
58583,645645,1,13,4,0,0,79
58584,645645,1,13,5,1,0,80
58585,645645,1,13,6,4,0,84
58586,645645,1,14,1,0,0,84
58587,645645,1,14,2,1,0,85
58588,645645,1,14,3,1,0,86
58589,645645,1,14,4,1,0,87
58590,645645,1,14,5,2,0,89
58591,645645,1,14,6,0,0,89
58592,645645,1,15,1,0,0,89
58593,645645,1,15,2,1,0,90
58594,645645,1,15,3,0,0,90
58595,645645,1,15,4,4,0,94
58596,645645,1,15,5,1,0,95
58597,645645,1,15,6,1,0,96
58598,645645,1,16,1,0,0,96
58599,645645,1,16,2,1,0,97
58600,645645,1,16,3,1,0,98
58601,645645,1,16,4,0,0,98
58602,645645,1,16,5,0,1,98
58603,645645,1,16,6,0,0,98
58604,645645,1,17,1,0,0,98
58605,645645,1,17,2,1,0,99
58606,645645,1,17,3,0,0,99
58607,645645,1,17,4,4,0,103
58608,645645,1,17,5,1,0,104
58609,645645,1,17,6,4,0,108
58610,645645,1,18,1,6,0,114
58611,645645,1,18,2,0,0,114
58612,645645,1,18,3,1,0,115
58613,645645,1,18,4,1,0,116
58614,645645,1,18,5,0,0,116
58615,645645,1,18,6,0,0,116
58616,645645,1,19,1,1,0,117
58617,645645,1,19,2,6,0,123
58618,645645,1,19,3,1,0,124
58619,645645,1,19,4,6,0,130
58620,645645,1,19,5,4,0,134
58621,645645,1,19,6,2,0,136
58622,645645,1,20,1,6,0,142
58623,645645,1,20,2,2,0,144
58624,645645,1,20,3,1,0,145
58625,645645,1,20,4,6,0,151
58626,645645,1,20,5,0,1,151
58627,645645,1,20,6,1,1,152
58748,645647,1,1,1,0,0,0
58749,645647,1,1,2,4,0,4
58750,645647,1,1,3,0,0,4
58751,645647,1,1,4,1,0,5
58752,645647,1,1,5,1,0,6
58753,645647,1,1,6,0,0,6
58754,645647,1,2,1,0,0,6
58755,645647,1,2,2,3,0,9
58756,645647,1,2,3,0,0,9
58757,645647,1,2,4,0,0,9
58758,645647,1,2,5,0,0,9
58759,645647,1,2,6,1,0,10
58760,645647,1,3,1,1,0,11
58761,645647,1,3,2,1,0,12
58762,645647,1,3,3,0,0,12
58763,645647,1,3,4,0,0,12
58764,645647,1,3,5,4,0,16
58765,645647,1,3,6,1,0,17
58766,645647,1,4,1,1,0,18
58767,645647,1,4,2,1,0,19
58768,645647,1,4,3,0,0,19
58769,645647,1,4,4,1,0,20
58770,645647,1,4,5,4,0,24
58771,645647,1,4,6,0,1,24
58772,645647,1,5,1,0,0,24
58773,645647,1,5,2,0,0,24
58774,645647,1,5,3,1,0,25
58775,645647,1,5,4,4,0,29
58776,645647,1,5,5,0,0,29
58777,645647,1,5,6,0,0,29
58778,645647,1,6,1,0,0,29
58779,645647,1,6,2,1,0,30
58780,645647,1,6,3,0,0,30
58781,645647,1,6,4,3,0,33
58782,645647,1,6,5,2,0,35
58783,645647,1,6,6,4,0,39
58784,645647,1,7,1,0,1,39
58785,645647,1,7,2,1,0,40
58786,645647,1,7,3,0,0,40
58787,645647,1,7,4,1,0,41
58788,645647,1,7,5,0,0,41
58789,645647,1,7,6,0,0,41
58790,645647,1,8,1,0,0,41
58791,645647,1,8,2,0,0,41
58792,645647,1,8,3,0,0,41
58793,645647,1,8,4,0,0,41
58794,645647,1,8,5,1,0,42
58795,645647,1,8,6,0,1,42
58796,645647,1,9,1,2,0,44
58797,645647,1,9,2,1,0,45
58798,645647,1,9,3,4,0,49
58799,645647,1,9,4,1,0,50
58800,645647,1,9,5,0,0,50
58801,645647,1,9,6,1,0,51
58802,645647,1,10,1,0,0,51
58803,645647,1,10,2,1,0,52
58804,645647,1,10,3,1,0,53
58805,645647,1,10,4,1,0,54
58806,645647,1,10,5,0,0,54
58807,645647,1,10,6,1,0,55
58808,645647,1,11,1,0,0,55
58809,645647,1,11,2,0,0,55
58810,645647,1,11,3,6,0,61
58811,645647,1,11,4,0,0,61
58812,645647,1,11,5,5,0,66
58813,645647,1,11,6,0,0,66
58814,645647,1,12,1,1,0,67
58815,645647,1,12,2,0,0,67
58816,645647,1,12,3,1,0,68
58817,645647,1,12,4,0,0,68
58818,645647,1,12,5,0,0,68
58819,645647,1,12,6,1,0,69
58820,645647,1,13,1,0,0,69
58821,645647,1,13,2,2,0,71
58822,645647,1,13,3,1,0,72
58823,645647,1,13,4,6,0,78
58824,645647,1,13,5,0,1,78
58825,645647,1,13,6,0,0,78
58826,645647,1,14,1,1,0,79
58827,645647,1,14,2,1,0,80
58828,645647,1,14,3,1,0,81
58829,645647,1,14,4,1,0,82
58830,645647,1,14,5,1,0,83
58831,645647,1,14,6,1,0,84
58832,645647,1,15,1,4,0,88
58833,645647,1,15,2,2,0,90
58834,645647,1,15,3,0,0,90
58835,645647,1,15,4,0,0,90
58836,645647,1,15,5,1,0,91
58837,645647,1,15,6,1,0,92
58838,645647,1,16,1,1,0,93
58839,645647,1,16,2,2,0,95
58840,645647,1,16,3,0,0,95
58841,645647,1,16,4,1,0,96
58842,645647,1,16,5,0,1,96
58843,645647,1,16,6,1,0,97
58844,645647,1,17,1,1,0,98
58845,645647,1,17,2,1,0,99
58846,645647,1,17,3,2,0,101
58847,645647,1,17,4,4,0,105
58848,645647,1,17,5,2,0,107
58849,645647,1,17,6,1,0,108
58850,645647,1,18,1,1,0,109
58851,645647,1,18,2,0,1,109
58852,645647,1,18,3,0,0,109
58853,645647,1,18,4,0,0,109
58854,645647,1,18,5,0,1,109
58855,645647,1,18,6,4,0,113
58856,645647,1,19,1,1,0,114
58857,645647,1,19,2,3,0,117
58858,645647,1,19,3,4,0,121
58859,645647,1,19,4,0,0,121
58860,645647,1,19,5,6,0,127
58861,645647,1,19,6,2,0,129
58862,645647,1,20,1,0,0,129
58863,645647,1,20,2,1,0,130
58864,645647,1,20,3,1,0,131
58865,645647,1,20,4,1,0,132
58866,645647,1,20,5,1,0,133
58867,645647,1,20,6,2,0,135
58988,647247,1,1,1,0,0,0
58989,647247,1,1,2,0,0,0
58990,647247,1,1,3,4,0,4
58991,647247,1,1,4,1,0,5
58992,647247,1,1,5,0,0,5
58993,647247,1,1,6,4,0,9
58994,647247,1,2,1,1,0,10
58995,647247,1,2,2,0,0,10
58996,647247,1,2,3,4,0,14
58997,647247,1,2,4,4,0,18
58998,647247,1,2,5,1,0,19
58999,647247,1,2,6,0,0,19
59000,647247,1,3,1,4,0,23
59001,647247,1,3,2,1,0,24
59002,647247,1,3,3,4,0,28
59003,647247,1,3,4,4,0,32
59004,647247,1,3,5,0,0,32
59005,647247,1,3,6,4,0,36
59006,647247,1,4,1,6,0,42
59007,647247,1,4,2,4,0,46
59008,647247,1,4,3,0,0,46
59009,647247,1,4,4,0,0,46
59010,647247,1,4,5,1,0,47
59011,647247,1,4,6,1,0,48
59012,647247,1,5,1,2,0,50
59013,647247,1,5,2,1,0,51
59014,647247,1,5,3,1,0,52
59015,647247,1,5,4,4,0,56
59016,647247,1,5,5,0,1,56
59017,647247,1,5,6,4,0,60
59018,647247,1,6,1,4,0,64
59019,647247,1,6,2,4,0,68
59020,647247,1,6,3,0,0,68
59021,647247,1,6,4,1,0,69
59022,647247,1,6,5,1,0,70
59023,647247,1,6,6,4,0,74
59024,647247,1,7,1,0,0,74
59025,647247,1,7,2,1,0,75
59026,647247,1,7,3,0,0,75
59027,647247,1,7,4,6,0,81
59028,647247,1,7,5,0,0,81
59029,647247,1,7,6,1,0,82
59030,647247,1,8,1,1,0,83
59031,647247,1,8,2,1,1,84
59032,647247,1,8,3,0,0,84
59033,647247,1,8,4,0,0,84
59034,647247,1,8,5,0,1,84
59035,647247,1,8,6,2,0,86
59036,647247,1,9,1,1,0,87
59037,647247,1,9,2,0,0,87
59038,647247,1,9,3,0,0,87
59039,647247,1,9,4,1,0,88
59040,647247,1,9,5,1,0,89
59041,647247,1,9,6,1,0,90
59042,647247,1,10,1,4,0,94
59043,647247,1,10,2,8,0,102
59044,647247,1,10,3,6,0,108
59045,647247,1,10,4,0,0,108
59046,647247,1,10,5,6,0,114
59047,647247,1,10,6,0,0,114
59048,647247,1,11,1,2,0,116
59049,647247,1,11,2,1,0,117
59050,647247,1,11,3,0,0,117
59051,647247,1,11,4,6,0,123
59052,647247,1,11,5,1,0,124
59053,647247,1,11,6,0,0,124
59054,647247,1,12,1,0,0,124
59055,647247,1,12,2,0,0,124
59056,647247,1,12,3,0,1,124
59057,647247,1,12,4,0,0,124
59058,647247,1,12,5,1,0,125
59059,647247,1,12,6,4,0,129
59060,647247,1,13,1,4,0,133
59061,647247,1,13,2,1,0,134
59062,647247,1,13,3,1,0,135
59063,647247,1,13,4,4,0,139
59064,647247,1,13,5,1,0,140
59065,647247,1,13,6,3,0,143
59066,647247,1,14,1,2,0,145
59067,647247,1,14,2,1,0,146
59068,647247,1,14,3,0,1,146
59069,647247,1,14,4,1,0,147
59070,647247,1,14,5,4,0,151
59071,647247,1,14,6,0,0,151
59072,647247,1,15,1,0,0,151
59073,647247,1,15,2,2,0,153
59074,647247,1,15,3,1,0,154
59075,647247,1,15,4,1,0,155
59076,647247,1,15,5,1,0,156
59077,647247,1,15,6,1,0,157
59078,647247,1,16,1,4,0,161
59079,647247,1,16,2,4,0,165
59080,647247,1,16,3,1,0,166
59081,647247,1,16,4,1,0,167
59082,647247,1,16,5,4,0,171
59083,647247,1,16,6,1,0,172
59084,647247,1,17,1,1,0,173
59085,647247,1,17,2,1,0,174
59086,647247,1,17,3,0,1,174
59087,647247,1,17,4,1,0,175
59088,647247,1,17,5,1,0,176
59089,647247,1,17,6,0,0,176
59090,647247,1,18,1,0,0,176
59091,647247,1,18,2,4,0,180
59092,647247,1,18,3,0,0,180
59093,647247,1,18,4,0,1,180
59094,647247,1,18,5,1,0,181
59095,647247,1,18,6,1,0,182
59096,647247,1,19,1,1,0,183
59097,647247,1,19,2,1,0,184
59098,647247,1,19,3,1,0,185
59099,647247,1,19,4,4,0,189
59100,647247,1,19,5,0,0,189
59101,647247,1,19,6,1,0,190
59102,647247,1,20,1,0,0,190
59103,647247,1,20,2,2,0,192
59104,647247,1,20,3,1,0,193
59105,647247,1,20,4,1,0,194
59106,647247,1,20,5,1,0,195
59107,647247,1,20,6,6,0,201
59226,648681,1,1,1,0,0,0
59227,648681,1,1,2,0,0,0
59228,648681,1,1,3,4,0,4
59229,648681,1,1,4,1,0,5
59230,648681,1,1,5,0,0,5
59231,648681,1,1,6,0,0,5
59232,648681,1,2,1,0,0,5
59233,648681,1,2,2,1,0,6
59234,648681,1,2,3,0,0,6
59235,648681,1,2,4,0,0,6
59236,648681,1,2,5,0,1,6
59237,648681,1,2,6,0,0,6
59238,648681,1,3,1,0,0,6
59239,648681,1,3,2,2,0,8
59240,648681,1,3,3,1,0,9
59241,648681,1,3,4,1,0,10
59242,648681,1,3,5,0,0,10
59243,648681,1,3,6,1,0,11
59244,648681,1,4,1,4,0,15
59245,648681,1,4,2,6,0,21
59246,648681,1,4,3,1,0,22
59247,648681,1,4,4,1,0,23
59248,648681,1,4,5,0,0,23
59249,648681,1,4,6,2,0,25
59250,648681,1,5,1,0,0,25
59251,648681,1,5,2,4,0,29
59252,648681,1,5,3,0,0,29
59253,648681,1,5,4,6,0,35
59254,648681,1,5,5,6,0,41
59255,648681,1,5,6,2,0,43
59256,648681,1,6,1,4,0,47
59257,648681,1,6,2,0,0,47
59258,648681,1,6,3,1,0,48
59259,648681,1,6,4,4,0,52
59260,648681,1,6,5,1,0,53
59261,648681,1,6,6,6,0,59
59262,648681,1,7,1,1,0,60
59263,648681,1,7,2,1,0,61
59264,648681,1,7,3,1,0,62
59265,648681,1,7,4,6,0,68
59266,648681,1,7,5,6,0,74
59267,648681,1,7,6,6,0,80
59309,648683,1,1,1,0,0,0
59310,648683,1,1,2,0,0,0
59311,648683,1,1,3,0,0,0
59312,648683,1,1,4,0,0,0
59313,648683,1,1,5,0,0,0
59314,648683,1,1,6,0,0,0
59315,648683,1,2,1,1,0,1
59316,648683,1,2,2,5,0,6
59317,648683,1,2,3,0,0,6
59318,648683,1,2,4,6,0,12
59319,648683,1,2,5,0,0,12
59320,648683,1,2,6,1,0,13
59321,648683,1,3,1,1,0,14
59322,648683,1,3,2,1,0,15
59323,648683,1,3,3,0,1,15
59324,648683,1,3,4,0,0,15
59325,648683,1,3,5,1,0,16
59326,648683,1,3,6,0,0,16
59327,648683,1,4,1,0,0,16
59328,648683,1,4,2,4,0,20
59329,648683,1,4,3,0,0,20
59330,648683,1,4,4,0,1,20
59331,648683,1,4,5,0,0,20
59332,648683,1,4,6,2,0,22
59333,648683,1,5,1,1,0,23
59334,648683,1,5,2,4,0,27
59335,648683,1,5,3,0,0,27
59336,648683,1,5,4,0,0,27
59337,648683,1,5,5,0,0,27
59338,648683,1,5,6,1,0,28
59339,648683,1,6,1,4,0,32
59340,648683,1,6,2,2,0,34
59341,648683,1,6,3,0,0,34
59342,648683,1,6,4,0,0,34
59343,648683,1,6,5,0,0,34
59344,648683,1,6,6,0,0,34
59345,648683,1,7,1,2,0,36
59346,648683,1,7,2,0,0,36
59347,648683,1,7,3,1,0,37
59348,648683,1,7,4,1,0,38
59349,648683,1,7,5,4,0,42
59350,648683,1,7,6,1,0,43
59351,648683,1,8,1,1,0,44
59352,648683,1,8,2,0,0,44
59353,648683,1,8,3,0,1,44
59354,648683,1,8,4,1,0,45
59355,648683,1,8,5,1,0,46
59356,648683,1,8,6,0,0,46
59357,648683,1,9,1,1,0,47
59358,648683,1,9,2,0,0,47
59359,648683,1,9,3,1,0,48
59360,648683,1,9,4,6,0,54
59361,648683,1,9,5,1,0,55
59362,648683,1,9,6,1,0,56
59363,648683,1,10,1,1,0,57
59364,648683,1,10,2,0,0,57
59365,648683,1,10,3,0,0,57
59366,648683,1,10,4,0,0,57
59367,648683,1,10,5,1,0,58
59368,648683,1,10,6,1,0,59
59369,648683,1,11,1,1,0,60
59370,648683,1,11,2,1,0,61
59371,648683,1,11,3,6,0,67
59372,648683,1,11,4,1,0,68
59373,648683,1,11,5,0,1,68
59374,648683,1,11,6,0,0,68
59375,648683,1,12,1,1,0,69
59376,648683,1,12,2,0,0,69
59377,648683,1,12,3,1,0,70
59378,648683,1,12,4,2,0,72
59379,648683,1,12,5,0,0,72
59380,648683,1,12,6,0,0,72
59381,648683,1,13,1,1,0,73
59382,648683,1,13,2,1,0,74
59383,648683,1,13,3,1,0,75
59384,648683,1,13,4,0,1,75
59385,648683,1,13,5,1,0,76
59386,648683,1,13,6,1,0,77
59387,648683,1,14,1,0,0,77
59388,648683,1,14,2,1,0,78
59389,648683,1,14,3,1,0,79
59390,648683,1,14,4,2,0,81
59391,648683,1,14,5,0,1,81
59392,648683,1,14,6,0,0,81
59393,648683,1,15,1,0,0,81
59394,648683,1,15,2,1,0,82
59395,648683,1,15,3,0,0,82
59396,648683,1,15,4,0,0,82
59397,648683,1,15,5,0,0,82
59398,648683,1,15,6,4,0,86
59399,648683,1,16,1,1,0,87
59400,648683,1,16,2,1,0,88
59401,648683,1,16,3,1,0,89
59402,648683,1,16,4,1,0,90
59403,648683,1,16,5,6,0,96
59404,648683,1,16,6,1,0,97
59405,648683,1,17,1,0,0,97
59406,648683,1,17,2,6,0,103
59407,648683,1,17,3,0,1,103
59408,648683,1,17,4,0,0,103
59409,648683,1,17,5,0,0,103
59410,648683,1,17,6,1,0,104
59411,648683,1,18,1,1,0,105
59412,648683,1,18,2,3,0,108
59413,648683,1,18,3,0,0,108
59414,648683,1,18,4,0,0,108
59415,648683,1,18,5,1,0,109
59416,648683,1,18,6,1,0,110
59417,648683,1,19,1,1,0,111
59418,648683,1,19,2,2,0,113
59419,648683,1,19,3,2,0,115
59420,648683,1,19,4,1,0,116
59421,648683,1,19,5,0,0,116
59422,648683,1,19,6,0,0,116
59423,648683,1,20,1,1,0,117
59424,648683,1,20,2,6,0,123
59425,648683,1,20,3,1,0,124
59426,648683,1,20,4,1,0,125
59427,648683,1,20,5,1,0,126
59428,648683,1,20,6,2,0,128
59519,649101,1,1,1,0,0,0
59520,649101,1,1,2,0,0,0
59521,649101,1,1,3,0,0,0
59522,649101,1,1,4,0,0,0
59523,649101,1,1,5,0,1,0
59524,649101,1,1,6,0,0,0
59525,649101,1,2,1,4,0,4
59526,649101,1,2,2,0,0,4
59527,649101,1,2,3,0,0,4
59528,649101,1,2,4,0,1,4
59529,649101,1,2,5,0,0,4
59530,649101,1,2,6,0,1,4
59531,649101,1,3,1,0,0,4
59532,649101,1,3,2,4,0,8
59533,649101,1,3,3,1,0,9
59534,649101,1,3,4,0,0,9
59535,649101,1,3,5,0,0,9
59536,649101,1,3,6,0,0,9
59537,649101,1,4,1,0,0,9
59538,649101,1,4,2,2,0,11
59539,649101,1,4,3,1,0,12
59540,649101,1,4,4,0,0,12
59541,649101,1,4,5,0,0,12
59542,649101,1,4,6,1,0,13
59543,649101,1,5,1,0,0,13
59544,649101,1,5,2,0,0,13
59545,649101,1,5,3,0,0,13
59546,649101,1,5,4,0,0,13
59547,649101,1,5,5,0,0,13
59548,649101,1,5,6,0,0,13
59549,649101,1,6,1,0,0,13
59550,649101,1,6,2,1,0,14
59551,649101,1,6,3,1,0,15
59552,649101,1,6,4,3,0,18
59553,649101,1,6,5,0,0,18
59554,649101,1,6,6,0,0,18
59555,649101,1,7,1,1,0,19
59556,649101,1,7,2,1,0,20
59557,649101,1,7,3,1,0,21
59558,649101,1,7,4,0,1,21
59559,649101,1,7,5,1,0,22
59560,649101,1,7,6,0,0,22
59561,649101,1,8,1,1,0,23
59562,649101,1,8,2,1,0,24
59563,649101,1,8,3,1,0,25
59564,649101,1,8,4,4,0,29
59565,649101,1,8,5,0,0,29
59566,649101,1,8,6,1,0,30
59567,649101,1,9,1,1,0,31
59568,649101,1,9,2,1,0,32
59569,649101,1,9,3,0,0,32
59570,649101,1,9,4,4,0,36
59571,649101,1,9,5,0,0,36
59572,649101,1,9,6,0,0,36
59573,649101,1,10,1,0,0,36
59574,649101,1,10,2,1,0,37
59575,649101,1,10,3,1,0,38
59576,649101,1,10,4,1,0,39
59577,649101,1,10,5,1,0,40
59578,649101,1,10,6,1,1,41
59579,649101,1,11,1,1,0,42
59580,649101,1,11,2,0,0,42
59581,649101,1,11,3,1,0,43
59582,649101,1,11,4,1,0,44
59583,649101,1,11,5,1,0,45
59584,649101,1,11,6,0,0,45
59585,649101,1,12,1,2,0,47
59586,649101,1,12,2,1,0,48
59587,649101,1,12,3,0,0,48
59588,649101,1,12,4,1,0,49
59589,649101,1,12,5,1,0,50
59590,649101,1,12,6,0,0,50
59591,649101,1,13,1,1,0,51
59592,649101,1,13,2,1,0,52
59593,649101,1,13,3,1,0,53
59594,649101,1,13,4,5,0,58
59595,649101,1,13,5,0,0,58
59596,649101,1,13,6,1,0,59
59597,649101,1,14,1,1,0,60
59598,649101,1,14,2,0,0,60
59599,649101,1,14,3,0,0,60
59600,649101,1,14,4,1,0,61
59601,649101,1,14,5,0,0,61
59602,649101,1,14,6,1,0,62
59603,649101,1,15,1,1,0,63
59604,649101,1,15,2,6,0,69
59605,649101,1,15,3,0,0,69
59606,649101,1,15,4,1,0,70
59607,649101,1,15,5,0,1,70
59608,649101,1,15,6,0,0,70
59609,649101,1,16,1,1,0,71
59610,649101,1,16,2,0,0,71
59611,649101,1,16,3,0,0,71
59612,649101,1,16,4,1,1,72
59613,649101,1,16,5,1,0,73
59614,649101,1,16,6,1,0,74
59615,649101,1,17,1,1,0,75
59616,649101,1,17,2,1,0,76
59617,649101,1,17,3,1,0,77
59618,649101,1,17,4,1,0,78
59619,649101,1,17,5,1,0,79
59620,649101,1,17,6,0,0,79
59621,649101,1,18,1,1,0,80
59622,649101,1,18,2,1,0,81
59623,649101,1,18,3,0,0,81
59624,649101,1,18,4,1,0,82
59625,649101,1,18,5,0,0,82
59626,649101,1,18,6,0,0,82
59627,649101,1,19,1,4,0,86
59628,649101,1,19,2,4,0,90
59629,649101,1,19,3,2,0,92
59630,649101,1,19,4,0,0,92
59631,649101,1,19,5,1,0,93
59632,649101,1,19,6,1,0,94
59633,649101,1,20,1,1,0,95
59634,649101,1,20,2,1,0,96
59635,649101,1,20,3,1,0,97
59636,649101,1,20,4,1,0,98
59637,649101,1,20,5,0,1,98
59638,649101,1,20,6,0,1,98
59726,649103,1,1,1,0,0,0
59727,649103,1,1,2,0,0,0
59728,649103,1,1,3,4,0,4
59729,649103,1,1,4,0,0,4
59730,649103,1,1,5,1,0,5
59731,649103,1,1,6,0,0,5
59732,649103,1,2,1,5,0,10
59733,649103,1,2,2,4,0,14
59734,649103,1,2,3,0,0,14
59735,649103,1,2,4,4,0,18
59736,649103,1,2,5,1,0,19
59737,649103,1,2,6,1,0,20
59738,649103,1,3,1,1,0,21
59739,649103,1,3,2,1,0,22
59740,649103,1,3,3,1,0,23
59741,649103,1,3,4,4,0,27
59742,649103,1,3,5,1,0,28
59743,649103,1,3,6,0,0,28
59744,649103,1,4,1,2,0,30
59745,649103,1,4,2,0,0,30
59746,649103,1,4,3,0,0,30
59747,649103,1,4,4,1,0,31
59748,649103,1,4,5,0,0,31
59749,649103,1,4,6,1,0,32
59750,649103,1,5,1,0,0,32
59751,649103,1,5,2,1,0,33
59752,649103,1,5,3,4,0,37
59753,649103,1,5,4,0,1,37
59754,649103,1,5,5,0,0,37
59755,649103,1,5,6,0,0,37
59756,649103,1,6,1,1,0,38
59757,649103,1,6,2,4,0,42
59758,649103,1,6,3,1,0,43
59759,649103,1,6,4,1,0,44
59760,649103,1,6,5,0,0,44
59761,649103,1,6,6,0,0,44
59762,649103,1,7,1,1,0,45
59763,649103,1,7,2,1,0,46
59764,649103,1,7,3,0,0,46
59765,649103,1,7,4,1,0,47
59766,649103,1,7,5,1,0,48
59767,649103,1,7,6,1,0,49
59768,649103,1,8,1,1,0,50
59769,649103,1,8,2,4,0,54
59770,649103,1,8,3,0,0,54
59771,649103,1,8,4,4,0,58
59772,649103,1,8,5,1,0,59
59773,649103,1,8,6,1,0,60
59774,649103,1,9,1,0,0,60
59775,649103,1,9,2,0,0,60
59776,649103,1,9,3,1,0,61
59777,649103,1,9,4,0,0,61
59778,649103,1,9,5,0,0,61
59779,649103,1,9,6,1,0,62
59780,649103,1,10,1,0,0,62
59781,649103,1,10,2,0,0,62
59782,649103,1,10,3,2,0,64
59783,649103,1,10,4,1,0,65
59784,649103,1,10,5,1,0,66
59785,649103,1,10,6,1,0,67
59786,649103,1,11,1,1,0,68
59787,649103,1,11,2,0,0,68
59788,649103,1,11,3,1,0,69
59789,649103,1,11,4,2,0,71
59790,649103,1,11,5,0,0,71
59791,649103,1,11,6,6,0,77
59792,649103,1,12,1,2,0,79
59793,649103,1,12,2,0,0,79
59794,649103,1,12,3,4,0,83
59795,649103,1,12,4,1,0,84
59796,649103,1,12,5,1,0,85
59797,649103,1,12,6,6,0,91
59798,649103,1,13,1,1,0,92
59799,649103,1,13,2,0,0,92
59800,649103,1,13,3,1,0,93
59801,649103,1,13,4,1,0,94
59802,649103,1,13,5,6,0,100
59803,649103,1,13,6,1,0,101
59804,649103,1,14,1,1,0,102
59805,649103,1,14,2,6,0,108
59806,649103,1,14,3,1,0,109
59807,649103,1,14,4,1,0,110
59808,649103,1,14,5,1,0,111
59809,649103,1,14,6,1,0,112
59810,649103,1,15,1,0,0,112
59811,649103,1,15,2,1,0,113
59812,649103,1,15,3,2,0,115
59813,649103,1,15,4,0,1,115
59814,649103,1,15,5,0,0,115
59815,649103,1,15,6,0,0,115
59816,649103,1,16,1,2,0,117
59817,649103,1,16,2,1,0,118
59818,649103,1,16,3,0,0,118
59819,649103,1,16,4,1,0,119
59820,649103,1,16,5,1,0,120
59821,649103,1,16,6,0,0,120
59822,649103,1,17,1,0,0,120
59823,649103,1,17,2,0,0,120
59824,649103,1,17,3,2,0,122
59825,649103,1,17,4,7,0,129
59826,649103,1,17,5,2,0,131
59827,649103,1,17,6,2,0,133
59828,649103,1,18,1,4,0,137
59829,649103,1,18,2,0,1,137
59830,649103,1,18,3,0,0,137
59831,649103,1,18,4,1,0,138
59832,649103,1,18,5,1,0,139
59833,649103,1,18,6,1,0,140
59834,649103,1,19,1,1,0,141
59835,649103,1,19,2,1,0,142
59836,649103,1,19,3,2,0,144
59837,649103,1,19,4,1,0,145
59838,649103,1,19,5,2,0,147
59839,649103,1,19,6,0,1,147
59840,649103,1,20,1,0,0,147
59841,649103,1,20,2,2,0,149
59842,649103,1,20,3,0,0,149
59843,649103,1,20,4,1,0,150
59844,649103,1,20,5,0,0,150
59845,649103,1,20,6,0,1,150
59966,657631,1,1,1,1,0,1
59967,657631,1,1,2,0,0,1
59968,657631,1,1,3,0,0,1
59969,657631,1,1,4,1,0,2
59970,657631,1,1,5,0,0,2
59971,657631,1,1,6,1,0,3
59972,657631,1,2,1,0,1,3
59973,657631,1,2,2,0,0,3
59974,657631,1,2,3,0,0,3
59975,657631,1,2,4,1,0,4
59976,657631,1,2,5,0,0,4
59977,657631,1,2,6,0,0,4
59978,657631,1,3,1,0,0,4
59979,657631,1,3,2,0,0,4
59980,657631,1,3,3,1,0,5
59981,657631,1,3,4,0,0,5
59982,657631,1,3,5,0,0,5
59983,657631,1,3,6,1,0,6
59984,657631,1,4,1,1,0,7
59985,657631,1,4,2,0,0,7
59986,657631,1,4,3,0,0,7
59987,657631,1,4,4,0,0,7
59988,657631,1,4,5,0,0,7
59989,657631,1,4,6,0,0,7
59990,657631,1,5,1,0,1,7
59991,657631,1,5,2,0,0,7
59992,657631,1,5,3,0,0,7
59993,657631,1,5,4,0,0,7
59994,657631,1,5,5,0,0,7
59995,657631,1,5,6,1,0,8
59996,657631,1,6,1,1,0,9
59997,657631,1,6,2,1,0,10
59998,657631,1,6,3,0,0,10
59999,657631,1,6,4,4,0,14
60000,657631,1,6,5,1,0,15
60001,657631,1,6,6,1,0,16
60002,657631,1,7,1,6,0,22
60003,657631,1,7,2,0,0,22
60004,657631,1,7,3,6,0,28
60005,657631,1,7,4,0,0,28
60006,657631,1,7,5,0,0,28
60007,657631,1,7,6,1,0,29
60008,657631,1,8,1,0,1,29
60009,657631,1,8,2,2,0,31
60010,657631,1,8,3,1,0,32
60011,657631,1,8,4,1,0,33
60012,657631,1,8,5,0,0,33
60013,657631,1,8,6,4,0,37
60014,657631,1,9,1,1,0,38
60015,657631,1,9,2,2,0,40
60016,657631,1,9,3,1,0,41
60017,657631,1,9,4,6,0,47
60018,657631,1,9,5,1,0,48
60019,657631,1,9,6,0,0,48
60020,657631,1,10,1,1,0,49
60021,657631,1,10,2,4,0,53
60022,657631,1,10,3,1,0,54
60023,657631,1,10,4,0,0,54
60024,657631,1,10,5,4,0,58
60025,657631,1,10,6,1,0,59
60026,657631,1,11,1,4,0,63
60027,657631,1,11,2,1,0,64
60028,657631,1,11,3,0,1,64
60029,657631,1,11,4,0,0,64
60030,657631,1,11,5,6,0,70
60031,657631,1,11,6,2,0,72
60032,657631,1,12,1,1,0,73
60033,657631,1,12,2,1,0,74
60034,657631,1,12,3,0,0,74
60035,657631,1,12,4,1,0,75
60036,657631,1,12,5,1,0,76
60037,657631,1,12,6,0,0,76
60038,657631,1,13,1,1,0,77
60039,657631,1,13,2,1,0,78
60040,657631,1,13,3,1,0,79
60041,657631,1,13,4,4,0,83
60042,657631,1,13,5,0,0,83
60043,657631,1,13,6,6,0,89
60044,657631,1,14,1,0,0,89
60045,657631,1,14,2,4,0,93
60046,657631,1,14,3,0,1,93
60047,657631,1,14,4,0,0,93
60048,657631,1,14,5,0,0,93
60049,657631,1,14,6,1,0,94
60050,657631,1,15,1,1,0,95
60051,657631,1,15,2,1,0,96
60052,657631,1,15,3,1,0,97
60053,657631,1,15,4,1,0,98
60054,657631,1,15,5,0,0,98
60055,657631,1,15,6,2,0,100
60056,657631,1,16,1,0,1,100
60057,657631,1,16,2,0,0,100
60058,657631,1,16,3,0,0,100
60059,657631,1,16,4,1,0,101
60060,657631,1,16,5,1,0,102
60061,657631,1,16,6,1,0,103
60062,657631,1,17,1,1,0,104
60063,657631,1,17,2,0,0,104
60064,657631,1,17,3,4,0,108
60065,657631,1,17,4,1,0,109
60066,657631,1,17,5,4,0,113
60067,657631,1,17,6,1,0,114
60068,657631,1,18,1,2,0,116
60069,657631,1,18,2,1,0,117
60070,657631,1,18,3,2,0,119
60071,657631,1,18,4,0,0,119
60072,657631,1,18,5,1,0,120
60073,657631,1,18,6,0,1,120
60074,657631,1,19,1,0,0,120
60075,657631,1,19,2,6,0,126
60076,657631,1,19,3,4,0,130
60077,657631,1,19,4,1,0,131
60078,657631,1,19,5,0,1,131
60079,657631,1,19,6,1,0,132
60080,657631,1,20,1,1,0,133
60081,657631,1,20,2,1,0,134
60082,657631,1,20,3,1,0,135
60083,657631,1,20,4,0,0,135
60084,657631,1,20,5,1,0,136
60085,657631,1,20,6,1,0,137
60206,657633,1,1,1,1,0,1
60207,657633,1,1,2,0,0,1
60208,657633,1,1,3,0,0,1
60209,657633,1,1,4,1,0,2
60210,657633,1,1,5,0,0,2
60211,657633,1,1,6,1,0,3
60212,657633,1,2,1,0,0,3
60213,657633,1,2,2,0,0,3
60214,657633,1,2,3,4,0,7
60215,657633,1,2,4,1,0,8
60216,657633,1,2,5,1,0,9
60217,657633,1,2,6,0,1,9
60218,657633,1,3,1,1,0,10
60219,657633,1,3,2,1,0,11
60220,657633,1,3,3,3,0,14
60221,657633,1,3,4,0,0,14
60222,657633,1,3,5,0,0,14
60223,657633,1,3,6,4,0,18
60224,657633,1,4,1,0,0,18
60225,657633,1,4,2,0,0,18
60226,657633,1,4,3,2,0,20
60227,657633,1,4,4,0,0,20
60228,657633,1,4,5,2,0,22
60229,657633,1,4,6,6,0,28
60230,657633,1,5,1,1,0,29
60231,657633,1,5,2,0,0,29
60232,657633,1,5,3,0,0,29
60233,657633,1,5,4,1,0,30
60234,657633,1,5,5,0,0,30
60235,657633,1,5,6,0,0,30
60236,657633,1,6,1,1,0,31
60237,657633,1,6,2,0,0,31
60238,657633,1,6,3,4,0,35
60239,657633,1,6,4,5,0,40
60240,657633,1,6,5,1,0,41
60241,657633,1,6,6,0,1,41
60242,657633,1,7,1,1,0,42
60243,657633,1,7,2,1,0,43
60244,657633,1,7,3,0,0,43
60245,657633,1,7,4,1,0,44
60246,657633,1,7,5,0,0,44
60247,657633,1,7,6,0,0,44
60248,657633,1,8,1,1,0,45
60249,657633,1,8,2,1,0,46
60250,657633,1,8,3,1,0,47
60251,657633,1,8,4,0,0,47
60252,657633,1,8,5,1,0,48
60253,657633,1,8,6,4,0,52
60254,657633,1,9,1,1,0,53
60255,657633,1,9,2,2,0,55
60256,657633,1,9,3,1,0,56
60257,657633,1,9,4,1,0,57
60258,657633,1,9,5,2,0,59
60259,657633,1,9,6,0,0,59
60260,657633,1,10,1,0,1,59
60261,657633,1,10,2,1,0,60
60262,657633,1,10,3,1,0,61
60263,657633,1,10,4,0,0,61
60264,657633,1,10,5,1,0,62
60265,657633,1,10,6,0,0,62
60266,657633,1,11,1,0,0,62
60267,657633,1,11,2,0,0,62
60268,657633,1,11,3,1,0,63
60269,657633,1,11,4,1,0,64
60270,657633,1,11,5,1,0,65
60271,657633,1,11,6,1,0,66
60272,657633,1,12,1,2,0,68
60273,657633,1,12,2,1,0,69
60274,657633,1,12,3,1,0,70
60275,657633,1,12,4,0,0,70
60276,657633,1,12,5,1,0,71
60277,657633,1,12,6,1,0,72
60278,657633,1,13,1,1,0,73
60279,657633,1,13,2,1,0,74
60280,657633,1,13,3,6,0,80
60281,657633,1,13,4,1,0,81
60282,657633,1,13,5,1,0,82
60283,657633,1,13,6,0,0,82
60284,657633,1,14,1,0,0,82
60285,657633,1,14,2,1,0,83
60286,657633,1,14,3,1,0,84
60287,657633,1,14,4,0,1,84
60288,657633,1,14,5,1,0,85
60289,657633,1,14,6,1,0,86
60290,657633,1,15,1,0,0,86
60291,657633,1,15,2,1,0,87
60292,657633,1,15,3,1,0,88
60293,657633,1,15,4,0,0,88
60294,657633,1,15,5,1,0,89
60295,657633,1,15,6,0,0,89
60296,657633,1,16,1,1,0,90
60297,657633,1,16,2,0,0,90
60298,657633,1,16,3,1,0,91
60299,657633,1,16,4,4,0,95
60300,657633,1,16,5,1,0,96
60301,657633,1,16,6,1,0,97
60302,657633,1,17,1,3,0,100
60303,657633,1,17,2,4,0,104
60304,657633,1,17,3,1,0,105
60305,657633,1,17,4,1,0,106
60306,657633,1,17,5,1,0,107
60307,657633,1,17,6,1,0,108
60308,657633,1,18,1,2,0,110
60309,657633,1,18,2,4,0,114
60310,657633,1,18,3,4,0,118
60311,657633,1,18,4,2,0,120
60312,657633,1,18,5,2,0,122
60313,657633,1,18,6,4,0,126
60314,657633,1,19,1,1,0,127
60315,657633,1,19,2,1,0,128
60316,657633,1,19,3,1,0,129
60317,657633,1,19,4,1,0,130
60318,657633,1,19,5,2,0,132
60319,657633,1,19,6,6,0,138
60320,657633,1,20,1,4,0,142
60321,657633,1,20,2,0,1,142
60322,657633,1,20,3,0,0,142
60323,657633,1,20,4,1,0,143
60324,657633,1,20,5,0,0,143
60325,657633,1,20,6,2,0,145
60441,657635,1,1,1,0,0,0
60442,657635,1,1,2,0,0,0
60443,657635,1,1,3,6,0,6
60444,657635,1,1,4,4,0,10
60445,657635,1,1,5,1,0,11
60446,657635,1,1,6,2,0,13
60447,657635,1,2,1,1,0,14
60448,657635,1,2,2,0,0,14
60449,657635,1,2,3,0,0,14
60450,657635,1,2,4,0,0,14
60451,657635,1,2,5,1,0,15
60452,657635,1,2,6,1,0,16
60453,657635,1,3,1,5,0,21
60454,657635,1,3,2,0,0,21
60455,657635,1,3,3,0,0,21
60456,657635,1,3,4,1,0,22
60457,657635,1,3,5,1,0,23
60458,657635,1,3,6,4,0,27
60459,657635,1,4,1,0,0,27
60460,657635,1,4,2,0,0,27
60461,657635,1,4,3,1,0,28
60462,657635,1,4,4,1,0,29
60463,657635,1,4,5,0,0,29
60464,657635,1,4,6,4,0,33
60465,657635,1,5,1,4,0,37
60466,657635,1,5,2,4,0,41
60467,657635,1,5,3,0,0,41
60468,657635,1,5,4,4,0,45
60469,657635,1,5,5,4,0,49
60470,657635,1,5,6,0,0,49
60471,657635,1,6,1,1,0,50
60472,657635,1,6,2,1,0,51
60473,657635,1,6,3,0,0,51
60474,657635,1,6,4,0,0,51
60475,657635,1,6,5,0,0,51
60476,657635,1,6,6,1,0,52
60477,657635,1,7,1,0,0,52
60478,657635,1,7,2,1,0,53
60479,657635,1,7,3,1,0,54
60480,657635,1,7,4,1,0,55
60481,657635,1,7,5,0,0,55
60482,657635,1,7,6,0,0,55
60483,657635,1,8,1,1,0,56
60484,657635,1,8,2,1,0,57
60485,657635,1,8,3,1,0,58
60486,657635,1,8,4,0,0,58
60487,657635,1,8,5,4,0,62
60488,657635,1,8,6,1,0,63
60489,657635,1,9,1,1,0,64
60490,657635,1,9,2,1,0,65
60491,657635,1,9,3,1,0,66
60492,657635,1,9,4,2,0,68
60493,657635,1,9,5,1,0,69
60494,657635,1,9,6,4,0,73
60495,657635,1,10,1,1,0,74
60496,657635,1,10,2,1,0,75
60497,657635,1,10,3,4,0,79
60498,657635,1,10,4,4,0,83
60499,657635,1,10,5,6,0,89
60500,657635,1,10,6,1,0,90
60501,657635,1,11,1,1,0,91
60502,657635,1,11,2,1,0,92
60503,657635,1,11,3,2,0,94
60504,657635,1,11,4,1,0,95
60505,657635,1,11,5,2,0,97
60506,657635,1,11,6,1,0,98
60507,657635,1,12,1,0,0,98
60508,657635,1,12,2,0,0,98
60509,657635,1,12,3,1,0,99
60510,657635,1,12,4,0,0,99
60511,657635,1,12,5,1,0,100
60512,657635,1,12,6,0,1,100
60513,657635,1,13,1,0,0,100
60514,657635,1,13,2,4,0,104
60515,657635,1,13,3,8,0,112
60516,657635,1,13,4,6,0,118
60517,657635,1,13,5,6,0,124
60518,657635,1,13,6,0,0,124
60519,657635,1,14,1,1,0,125
60520,657635,1,14,2,1,0,126
60521,657635,1,14,3,1,0,127
60522,657635,1,14,4,5,0,132
60523,657635,1,14,5,1,1,133
60524,657635,1,14,6,0,0,133
60525,657635,1,15,1,2,0,135
60526,657635,1,15,2,4,0,139
60527,657635,1,15,3,6,0,145
60528,657635,1,15,4,1,0,146
60529,657635,1,15,5,2,0,148
60530,657635,1,15,6,1,0,149
60531,657635,1,16,1,1,0,150
60532,657635,1,16,2,2,0,152
60533,657635,1,16,3,1,0,153
60534,657635,1,16,4,0,0,153
60535,657635,1,16,5,1,0,154
60536,657635,1,16,6,6,0,160
60537,657635,1,17,1,4,0,164
60538,657635,1,17,2,1,0,165
60539,657635,1,17,3,4,0,169
60540,657635,1,17,4,0,0,169
60541,657635,1,17,5,1,0,170
60542,657635,1,17,6,1,0,171
60543,657635,1,18,1,2,0,173
60544,657635,1,18,2,1,0,174
60545,657635,1,18,3,2,0,176
60546,657635,1,18,4,2,0,178
60547,657635,1,18,5,0,0,178
60548,657635,1,18,6,2,0,180
60549,657635,1,19,1,2,0,182
60550,657635,1,19,2,1,0,183
60551,657635,1,19,3,1,0,184
60552,657635,1,19,4,6,0,190
60553,657635,1,19,5,6,0,196
60554,657635,1,19,6,2,0,198
60555,657635,1,20,1,6,0,204
60556,657635,1,20,2,4,0,208
60557,657635,1,20,3,0,0,208
60558,657635,1,20,4,1,0,209
60559,657635,1,20,5,1,0,210
60560,657635,1,20,6,1,1,211
60677,659545,1,1,1,2,0,2
60678,659545,1,1,2,0,0,2
60679,659545,1,1,3,0,0,2
60680,659545,1,1,4,0,0,2
60681,659545,1,1,5,1,0,3
60682,659545,1,1,6,2,0,5
60683,659545,1,2,1,1,0,6
60684,659545,1,2,2,1,0,7
60685,659545,1,2,3,3,0,10
60686,659545,1,2,4,4,0,14
60687,659545,1,2,5,0,1,14
60688,659545,1,2,6,0,0,14
60689,659545,1,3,1,1,0,15
60690,659545,1,3,2,1,0,16
60691,659545,1,3,3,0,0,16
60692,659545,1,3,4,1,0,17
60693,659545,1,3,5,0,0,17
60694,659545,1,3,6,1,0,18
60695,659545,1,4,1,3,0,21
60696,659545,1,4,2,0,1,21
60697,659545,1,4,3,0,0,21
60698,659545,1,4,4,1,0,22
60699,659545,1,4,5,0,0,22
60700,659545,1,4,6,1,0,23
60701,659545,1,5,1,0,0,23
60702,659545,1,5,2,0,0,23
60703,659545,1,5,3,1,0,24
60704,659545,1,5,4,1,0,25
60705,659545,1,5,5,1,0,26
60706,659545,1,5,6,0,0,26
60707,659545,1,6,1,5,0,31
60708,659545,1,6,2,1,0,32
60709,659545,1,6,3,0,0,32
60710,659545,1,6,4,4,0,36
60711,659545,1,6,5,0,0,36
60712,659545,1,6,6,1,0,37
60713,659545,1,7,1,1,0,38
60714,659545,1,7,2,2,0,40
60715,659545,1,7,3,1,0,41
60716,659545,1,7,4,1,0,42
60717,659545,1,7,5,0,0,42
60718,659545,1,7,6,1,0,43
60719,659545,1,8,1,1,0,44
60720,659545,1,8,2,1,0,45
60721,659545,1,8,3,0,0,45
60722,659545,1,8,4,1,0,46
60723,659545,1,8,5,3,0,49
60724,659545,1,8,6,1,0,50
60725,659545,1,9,1,1,0,51
60726,659545,1,9,2,0,1,51
60727,659545,1,9,3,1,0,52
60728,659545,1,9,4,0,0,52
60729,659545,1,9,5,0,0,52
60730,659545,1,9,6,0,0,52
60731,659545,1,10,1,0,0,52
60732,659545,1,10,2,0,0,52
60733,659545,1,10,3,2,0,54
60734,659545,1,10,4,0,0,54
60735,659545,1,10,5,2,0,56
60736,659545,1,10,6,1,0,57
60737,659545,1,11,1,0,0,57
60738,659545,1,11,2,0,0,57
60739,659545,1,11,3,1,0,58
60740,659545,1,11,4,0,0,58
60741,659545,1,11,5,0,0,58
60742,659545,1,11,6,1,0,59
60743,659545,1,12,1,6,0,65
60744,659545,1,12,2,1,0,66
60745,659545,1,12,3,4,0,70
60746,659545,1,12,4,4,0,74
60747,659545,1,12,5,1,0,75
60748,659545,1,12,6,1,0,76
60749,659545,1,13,1,3,0,79
60750,659545,1,13,2,2,0,81
60751,659545,1,13,3,1,0,82
60752,659545,1,13,4,1,0,83
60753,659545,1,13,5,1,0,84
60754,659545,1,13,6,2,0,86
60755,659545,1,14,1,2,0,88
60756,659545,1,14,2,4,0,92
60757,659545,1,14,3,1,0,93
60758,659545,1,14,4,4,0,97
60759,659545,1,14,5,1,0,98
60760,659545,1,14,6,1,0,99
60761,659545,1,15,1,1,0,100
60762,659545,1,15,2,6,0,106
60763,659545,1,15,3,0,1,106
60764,659545,1,15,4,4,0,110
60765,659545,1,15,5,1,0,111
60766,659545,1,15,6,1,0,112
60767,659545,1,16,1,1,0,113
60768,659545,1,16,2,2,0,115
60769,659545,1,16,3,6,0,121
60770,659545,1,16,4,1,0,122
60771,659545,1,16,5,1,0,123
60772,659545,1,16,6,1,0,124
60773,659545,1,17,1,1,0,125
60774,659545,1,17,2,2,0,127
60775,659545,1,17,3,1,0,128
60776,659545,1,17,4,1,0,129
60777,659545,1,17,5,1,0,130
60778,659545,1,17,6,4,0,134
60779,659545,1,18,1,1,0,135
60780,659545,1,18,2,0,1,135
60781,659545,1,18,3,1,0,136
60782,659545,1,18,4,6,0,142
60783,659545,1,18,5,0,0,142
60784,659545,1,18,6,1,0,143
60785,659545,1,19,1,4,0,147
60786,659545,1,19,2,1,0,148
60787,659545,1,19,3,1,0,149
60788,659545,1,19,4,0,0,149
60789,659545,1,19,5,1,0,150
60790,659545,1,19,6,2,0,152
60791,659545,1,20,1,2,0,154
60792,659545,1,20,2,1,0,155
60793,659545,1,20,3,0,0,155
60794,659545,1,20,4,4,0,159
60795,659545,1,20,5,2,0,161
60796,659545,1,20,6,0,0,161
60917,659547,1,1,1,0,0,0
60918,659547,1,1,2,0,0,0
60919,659547,1,1,3,0,0,0
60920,659547,1,1,4,0,0,0
60921,659547,1,1,5,0,0,0
60922,659547,1,1,6,6,0,6
60923,659547,1,2,1,0,0,6
60924,659547,1,2,2,1,0,7
60925,659547,1,2,3,1,0,8
60926,659547,1,2,4,0,0,8
60927,659547,1,2,5,0,0,8
60928,659547,1,2,6,1,0,9
60929,659547,1,3,1,2,0,11
60930,659547,1,3,2,0,0,11
60931,659547,1,3,3,0,0,11
60932,659547,1,3,4,0,0,11
60933,659547,1,3,5,4,0,15
60934,659547,1,3,6,0,0,15
60935,659547,1,4,1,0,0,15
60936,659547,1,4,2,2,0,17
60937,659547,1,4,3,1,0,18
60938,659547,1,4,4,1,0,19
60939,659547,1,4,5,1,0,20
60940,659547,1,4,6,6,0,26
60941,659547,1,5,1,0,0,26
60942,659547,1,5,2,0,0,26
60943,659547,1,5,3,0,0,26
60944,659547,1,5,4,1,0,27
60945,659547,1,5,5,4,0,31
60946,659547,1,5,6,1,0,32
60947,659547,1,6,1,0,0,32
60948,659547,1,6,2,4,0,36
60949,659547,1,6,3,0,0,36
60950,659547,1,6,4,0,1,36
60951,659547,1,6,5,0,0,36
60952,659547,1,6,6,1,0,37
60953,659547,1,7,1,1,0,38
60954,659547,1,7,2,0,0,38
60955,659547,1,7,3,0,0,38
60956,659547,1,7,4,1,0,39
60957,659547,1,7,5,4,0,43
60958,659547,1,7,6,0,0,43
60959,659547,1,8,1,3,0,46
60960,659547,1,8,2,1,0,47
60961,659547,1,8,3,4,0,51
60962,659547,1,8,4,0,0,51
60963,659547,1,8,5,1,0,52
60964,659547,1,8,6,4,0,56
60965,659547,1,9,1,0,0,56
60966,659547,1,9,2,1,0,57
60967,659547,1,9,3,0,0,57
60968,659547,1,9,4,1,0,58
60969,659547,1,9,5,0,0,58
60970,659547,1,9,6,2,0,60
60971,659547,1,10,1,0,0,60
60972,659547,1,10,2,1,0,61
60973,659547,1,10,3,1,0,62
60974,659547,1,10,4,6,0,68
60975,659547,1,10,5,1,0,69
60976,659547,1,10,6,0,0,69
60977,659547,1,11,1,2,0,71
60978,659547,1,11,2,0,0,71
60979,659547,1,11,3,1,0,72
60980,659547,1,11,4,4,0,76
60981,659547,1,11,5,2,0,78
60982,659547,1,11,6,1,0,79
60983,659547,1,12,1,1,0,80
60984,659547,1,12,2,1,0,81
60985,659547,1,12,3,1,0,82
60986,659547,1,12,4,6,0,88
60987,659547,1,12,5,0,0,88
60988,659547,1,12,6,1,0,89
60989,659547,1,13,1,4,0,93
60990,659547,1,13,2,1,0,94
60991,659547,1,13,3,0,0,94
60992,659547,1,13,4,1,0,95
60993,659547,1,13,5,1,0,96
60994,659547,1,13,6,2,0,98
60995,659547,1,14,1,1,0,99
60996,659547,1,14,2,1,0,100
60997,659547,1,14,3,4,0,104
60998,659547,1,14,4,3,0,107
60999,659547,1,14,5,1,0,108
61000,659547,1,14,6,2,0,110
61001,659547,1,15,1,1,0,111
61002,659547,1,15,2,1,0,112
61003,659547,1,15,3,0,0,112
61004,659547,1,15,4,1,0,113
61005,659547,1,15,5,1,0,114
61006,659547,1,15,6,6,0,120
61007,659547,1,16,1,0,0,120
61008,659547,1,16,2,4,0,124
61009,659547,1,16,3,6,0,130
61010,659547,1,16,4,0,0,130
61011,659547,1,16,5,0,0,130
61012,659547,1,16,6,4,0,134
61013,659547,1,17,1,1,0,135
61014,659547,1,17,2,1,0,136
61015,659547,1,17,3,2,0,138
61016,659547,1,17,4,0,0,138
61017,659547,1,17,5,1,0,139
61018,659547,1,17,6,0,0,139
61019,659547,1,18,1,1,0,140
61020,659547,1,18,2,1,0,141
61021,659547,1,18,3,2,0,143
61022,659547,1,18,4,4,0,147
61023,659547,1,18,5,6,0,153
61024,659547,1,18,6,1,0,154
61025,659547,1,19,1,1,0,155
61026,659547,1,19,2,1,0,156
61027,659547,1,19,3,1,0,157
61028,659547,1,19,4,6,0,163
61029,659547,1,19,5,2,0,165
61030,659547,1,19,6,1,0,166
61031,659547,1,20,1,6,0,172
61032,659547,1,20,2,2,0,174
61033,659547,1,20,3,2,0,176
61034,659547,1,20,4,1,0,177
61035,659547,1,20,5,1,0,178
61036,659547,1,20,6,1,0,179
61157,660107,1,1,1,0,0,0
61158,660107,1,1,2,1,0,1
61159,660107,1,1,3,1,0,2
61160,660107,1,1,4,1,0,3
61161,660107,1,1,5,1,0,4
61162,660107,1,1,6,0,0,4
61163,660107,1,2,1,3,0,7
61164,660107,1,2,2,4,0,11
61165,660107,1,2,3,0,1,11
61166,660107,1,2,4,0,0,11
61167,660107,1,2,5,1,0,12
61168,660107,1,2,6,0,0,12
61169,660107,1,3,1,0,0,12
61170,660107,1,3,2,0,0,12
61171,660107,1,3,3,0,1,12
61172,660107,1,3,4,0,0,12
61173,660107,1,3,5,0,0,12
61174,660107,1,3,6,1,0,13
61175,660107,1,4,1,0,0,13
61176,660107,1,4,2,1,0,14
61177,660107,1,4,3,0,0,14
61178,660107,1,4,4,0,1,14
61179,660107,1,4,5,0,0,14
61180,660107,1,4,6,0,0,14
61181,660107,1,5,1,4,0,18
61182,660107,1,5,2,1,0,19
61183,660107,1,5,3,0,0,19
61184,660107,1,5,4,1,0,20
61185,660107,1,5,5,0,0,20
61186,660107,1,5,6,4,0,24
61187,660107,1,6,1,0,0,24
61188,660107,1,6,2,0,0,24
61189,660107,1,6,3,0,0,24
61190,660107,1,6,4,0,0,24
61191,660107,1,6,5,1,0,25
61192,660107,1,6,6,0,0,25
61193,660107,1,7,1,1,0,26
61194,660107,1,7,2,0,0,26
61195,660107,1,7,3,1,0,27
61196,660107,1,7,4,0,0,27
61197,660107,1,7,5,2,0,29
61198,660107,1,7,6,1,0,30
61199,660107,1,8,1,2,0,32
61200,660107,1,8,2,1,0,33
61201,660107,1,8,3,4,0,37
61202,660107,1,8,4,1,0,38
61203,660107,1,8,5,1,0,39
61204,660107,1,8,6,0,0,39
61205,660107,1,9,1,0,0,39
61206,660107,1,9,2,1,0,40
61207,660107,1,9,3,1,0,41
61208,660107,1,9,4,0,1,41
61209,660107,1,9,5,4,0,45
61210,660107,1,9,6,0,0,45
61211,660107,1,10,1,0,0,45
61212,660107,1,10,2,0,0,45
61213,660107,1,10,3,1,0,46
61214,660107,1,10,4,1,0,47
61215,660107,1,10,5,0,0,47
61216,660107,1,10,6,1,0,48
61217,660107,1,11,1,0,0,48
61218,660107,1,11,2,1,0,49
61219,660107,1,11,3,1,0,50
61220,660107,1,11,4,0,0,50
61221,660107,1,11,5,0,1,50
61222,660107,1,11,6,0,0,50
61223,660107,1,12,1,0,0,50
61224,660107,1,12,2,0,0,50
61225,660107,1,12,3,2,0,52
61226,660107,1,12,4,2,0,54
61227,660107,1,12,5,1,0,55
61228,660107,1,12,6,0,0,55
61229,660107,1,13,1,0,0,55
61230,660107,1,13,2,1,0,56
61231,660107,1,13,3,0,1,56
61232,660107,1,13,4,0,0,56
61233,660107,1,13,5,1,0,57
61234,660107,1,13,6,0,0,57
61235,660107,1,14,1,1,0,58
61236,660107,1,14,2,0,0,58
61237,660107,1,14,3,0,0,58
61238,660107,1,14,4,1,0,59
61239,660107,1,14,5,1,0,60
61240,660107,1,14,6,0,0,60
61241,660107,1,15,1,1,0,61
61242,660107,1,15,2,1,0,62
61243,660107,1,15,3,0,0,62
61244,660107,1,15,4,1,0,63
61245,660107,1,15,5,1,0,64
61246,660107,1,15,6,5,0,69
61247,660107,1,16,1,2,0,71
61248,660107,1,16,2,1,0,72
61249,660107,1,16,3,2,0,74
61250,660107,1,16,4,1,0,75
61251,660107,1,16,5,0,0,75
61252,660107,1,16,6,1,0,76
61253,660107,1,17,1,0,0,76
61254,660107,1,17,2,1,0,77
61255,660107,1,17,3,2,0,79
61256,660107,1,17,4,4,0,83
61257,660107,1,17,5,1,0,84
61258,660107,1,17,6,0,0,84
61259,660107,1,18,1,1,0,85
61260,660107,1,18,2,1,0,86
61261,660107,1,18,3,0,0,86
61262,660107,1,18,4,0,0,86
61263,660107,1,18,5,0,1,86
61264,660107,1,18,6,1,0,87
61265,660107,1,19,1,1,0,88
61266,660107,1,19,2,1,0,89
61267,660107,1,19,3,1,0,90
61268,660107,1,19,4,0,1,90
61269,660107,1,19,5,0,0,90
61270,660107,1,19,6,0,1,90
61271,660107,1,20,1,0,1,90
61349,660235,1,1,1,1,0,1
61350,660235,1,1,2,0,0,1
61351,660235,1,1,3,0,0,1
61352,660235,1,1,4,4,0,5
61353,660235,1,1,5,6,0,11
61354,660235,1,1,6,0,0,11
61355,660235,1,2,1,4,0,15
61356,660235,1,2,2,4,0,19
61357,660235,1,2,3,1,0,20
61358,660235,1,2,4,0,0,20
61359,660235,1,2,5,4,0,24
61360,660235,1,2,6,2,0,26
61361,660235,1,3,1,4,0,30
61362,660235,1,3,2,1,0,31
61363,660235,1,3,3,1,0,32
61364,660235,1,3,4,4,0,36
61365,660235,1,3,5,0,0,36
61366,660235,1,3,6,1,0,37
61367,660235,1,4,1,0,0,37
61368,660235,1,4,2,6,0,43
61369,660235,1,4,3,1,0,44
61370,660235,1,4,4,4,0,48
61371,660235,1,4,5,4,0,52
61372,660235,1,4,6,0,0,52
61373,660235,1,5,1,1,0,53
61374,660235,1,5,2,1,0,54
61375,660235,1,5,3,1,0,55
61376,660235,1,5,4,6,0,61
61377,660235,1,5,5,2,0,63
61378,660235,1,5,6,0,0,63
61379,660235,1,6,1,1,0,64
61380,660235,1,6,2,4,0,68
61381,660235,1,6,3,0,1,68
61382,660235,1,6,4,4,0,72
61383,660235,1,6,5,4,0,76
61384,660235,1,6,6,6,0,82
61385,660235,1,7,1,2,0,84
61386,660235,1,7,2,0,0,84
61387,660235,1,7,3,4,0,88
61388,660235,1,7,4,1,0,89
61389,660235,1,7,5,1,0,90
61390,660235,1,7,6,1,0,91
61391,660235,1,8,1,4,0,95
61392,660235,1,8,2,1,0,96
61393,660235,1,8,3,1,0,97
61394,660235,1,8,4,1,0,98
61395,660235,1,8,5,0,0,98
61396,660235,1,8,6,0,0,98
61397,660235,1,9,1,1,0,99
61398,660235,1,9,2,0,0,99
61399,660235,1,9,3,2,0,101
61400,660235,1,9,4,1,0,102
61401,660235,1,9,5,1,0,103
61402,660235,1,9,6,1,0,104
61403,660235,1,10,1,0,1,104
61404,660235,1,10,2,4,0,108
61405,660235,1,10,3,0,0,108
61406,660235,1,10,4,1,0,109
61407,660235,1,10,5,5,0,114
61408,660235,1,10,6,1,0,115
61409,660235,1,11,1,2,0,117
61410,660235,1,11,2,2,0,119
61411,660235,1,11,3,0,0,119
61412,660235,1,11,4,0,0,119
61413,660235,1,11,5,2,0,121
61414,660235,1,11,6,0,0,121
61415,660235,1,12,1,4,0,125
61416,660235,1,12,2,1,0,126
61417,660235,1,12,3,1,0,127
61418,660235,1,12,4,1,0,128
61419,660235,1,12,5,1,0,129
61420,660235,1,12,6,0,0,129
61421,660235,1,13,1,4,0,133
61422,660235,1,13,2,6,0,139
61423,660235,1,13,3,0,0,139
61424,660235,1,13,4,0,0,139
61425,660235,1,13,5,4,0,143
61426,660235,1,13,6,6,0,149
61427,660235,1,14,1,6,0,155
61428,660235,1,14,2,1,0,156
61429,660235,1,14,3,1,0,157
61430,660235,1,14,4,0,0,157
61431,660235,1,14,5,7,0,164
61432,660235,1,14,6,0,0,164
61433,660235,1,15,1,2,0,166
61434,660235,1,15,2,2,0,168
61435,660235,1,15,3,0,1,168
61436,660235,1,15,4,1,0,169
61437,660235,1,15,5,4,0,173
61438,660235,1,15,6,0,0,173
61439,660235,1,16,1,1,0,174
61440,660235,1,16,2,0,0,174
61441,660235,1,16,3,2,0,176
61442,660235,1,16,4,6,0,182
61443,660235,1,16,5,1,0,183
61444,660235,1,16,6,0,1,183
61445,660235,1,17,1,0,0,183
61446,660235,1,17,2,2,0,185
61447,660235,1,17,3,4,0,189
61448,660235,1,17,4,1,0,190
61449,660235,1,17,5,2,0,192
61450,660235,1,17,6,2,0,194
61451,660235,1,18,1,4,0,198
61452,660235,1,18,2,4,0,202
61453,660235,1,18,3,2,0,204
61454,660235,1,18,4,1,0,205
61455,660235,1,18,5,0,0,205
61456,660235,1,18,6,6,0,211
61457,660235,1,19,1,1,1,212
61458,660235,1,19,2,0,1,212
61459,660235,1,19,3,1,0,213
61460,660235,1,19,4,4,0,217
61461,660235,1,19,5,0,0,217
61462,660235,1,19,6,4,0,221
61463,660235,1,20,1,1,0,222
61464,660235,1,20,2,0,0,222
61465,660235,1,20,3,1,0,223
61466,660235,1,20,4,0,1,223
61467,660235,1,20,5,1,0,224
61468,660235,1,20,6,1,0,225
61582,661695,1,1,1,0,0,0
61583,661695,1,1,2,1,0,1
61584,661695,1,1,3,1,0,2
61585,661695,1,1,4,1,0,3
61586,661695,1,1,5,1,0,4
61587,661695,1,1,6,1,0,5
61588,661695,1,2,1,0,0,5
61589,661695,1,2,2,1,0,6
61590,661695,1,2,3,1,0,7
61591,661695,1,2,4,6,0,13
61592,661695,1,2,5,4,0,17
61593,661695,1,2,6,4,0,21
61594,661695,1,3,1,3,0,24
61595,661695,1,3,2,2,0,26
61596,661695,1,3,3,1,0,27
61597,661695,1,3,4,0,0,27
61598,661695,1,3,5,1,0,28
61599,661695,1,3,6,4,0,32
61600,661695,1,4,1,0,0,32
61601,661695,1,4,2,4,0,36
61602,661695,1,4,3,1,0,37
61603,661695,1,4,4,1,0,38
61604,661695,1,4,5,0,1,38
61605,661695,1,4,6,1,0,39
61606,661695,1,5,1,1,0,40
61607,661695,1,5,2,0,0,40
61608,661695,1,5,3,1,0,41
61609,661695,1,5,4,0,0,41
61610,661695,1,5,5,0,0,41
61611,661695,1,5,6,4,0,45
61612,661695,1,6,1,4,0,49
61613,661695,1,6,2,0,0,49
61614,661695,1,6,3,1,0,50
61615,661695,1,6,4,0,0,50
61616,661695,1,6,5,1,0,51
61617,661695,1,6,6,4,0,55
61618,661695,1,7,1,0,0,55
61619,661695,1,7,2,0,0,55
61620,661695,1,7,3,1,0,56
61621,661695,1,7,4,0,1,56
61622,661695,1,7,5,1,0,57
61623,661695,1,7,6,1,0,58
61624,661695,1,8,1,1,0,59
61625,661695,1,8,2,0,0,59
61626,661695,1,8,3,1,0,60
61627,661695,1,8,4,0,0,60
61628,661695,1,8,5,0,0,60
61629,661695,1,8,6,1,0,61
61630,661695,1,9,1,1,0,62
61631,661695,1,9,2,0,0,62
61632,661695,1,9,3,0,0,62
61633,661695,1,9,4,3,0,65
61634,661695,1,9,5,1,0,66
61635,661695,1,9,6,0,1,66
61636,661695,1,10,1,0,0,66
61637,661695,1,10,2,1,0,67
61638,661695,1,10,3,1,0,68
61639,661695,1,10,4,1,0,69
61640,661695,1,10,5,1,0,70
61641,661695,1,10,6,0,0,70
61642,661695,1,11,1,4,0,74
61643,661695,1,11,2,0,0,74
61644,661695,1,11,3,6,0,80
61645,661695,1,11,4,1,0,81
61646,661695,1,11,5,6,0,87
61647,661695,1,11,6,1,0,88
61648,661695,1,12,1,0,0,88
61649,661695,1,12,2,1,0,89
61650,661695,1,12,3,4,0,93
61651,661695,1,12,4,7,0,100
61652,661695,1,12,5,1,0,101
61653,661695,1,12,6,0,0,101
61654,661695,1,13,1,2,0,103
61655,661695,1,13,2,0,1,103
61656,661695,1,13,3,1,0,104
61657,661695,1,13,4,0,0,104
61658,661695,1,13,5,0,1,104
61659,661695,1,13,6,1,0,105
61660,661695,1,14,1,1,0,106
61661,661695,1,14,2,1,0,107
61662,661695,1,14,3,0,0,107
61663,661695,1,14,4,1,0,108
61664,661695,1,14,5,2,0,110
61665,661695,1,14,6,1,0,111
61666,661695,1,15,1,6,0,117
61667,661695,1,15,2,1,0,118
61668,661695,1,15,3,6,0,124
61669,661695,1,15,4,4,0,128
61670,661695,1,15,5,6,0,134
61671,661695,1,15,6,0,0,134
61672,661695,1,16,1,1,0,135
61673,661695,1,16,2,0,0,135
61674,661695,1,16,3,1,0,136
61675,661695,1,16,4,1,0,137
61676,661695,1,16,5,1,0,138
61677,661695,1,16,6,1,0,139
61678,661695,1,17,1,1,0,140
61679,661695,1,17,2,1,0,141
61680,661695,1,17,3,1,0,142
61681,661695,1,17,4,0,0,142
61682,661695,1,17,5,0,0,142
61683,661695,1,17,6,1,0,143
61684,661695,1,18,1,6,0,149
61685,661695,1,18,2,2,0,151
61686,661695,1,18,3,4,0,155
61687,661695,1,18,4,6,0,161
61688,661695,1,18,5,0,0,161
61689,661695,1,18,6,4,0,165
61690,661695,1,19,1,2,0,167
61691,661695,1,19,2,1,0,168
61692,661695,1,19,3,1,0,169
61693,661695,1,19,4,4,0,173
61694,661695,1,19,5,1,0,174
61695,661695,1,19,6,1,0,175
61696,661695,1,20,1,0,0,175
61697,661695,1,20,2,1,0,176
61698,661695,1,20,3,0,0,176
61699,661695,1,20,4,6,0,182
61700,661695,1,20,5,6,0,188
61701,661695,1,20,6,1,0,189
61822,661697,1,1,1,1,0,1
61823,661697,1,1,2,1,0,2
61824,661697,1,1,3,0,0,2
61825,661697,1,1,4,0,0,2
61826,661697,1,1,5,0,0,2
61827,661697,1,1,6,0,0,2
61828,661697,1,2,1,0,0,2
61829,661697,1,2,2,0,0,2
61830,661697,1,2,3,4,0,6
61831,661697,1,2,4,0,0,6
61832,661697,1,2,5,0,0,6
61833,661697,1,2,6,0,0,6
61834,661697,1,3,1,0,0,6
61835,661697,1,3,2,4,0,10
61836,661697,1,3,3,4,0,14
61837,661697,1,3,4,0,0,14
61838,661697,1,3,5,1,0,15
61839,661697,1,3,6,1,0,16
61840,661697,1,4,1,0,0,16
61841,661697,1,4,2,0,0,16
61842,661697,1,4,3,1,0,17
61843,661697,1,4,4,4,0,21
61844,661697,1,4,5,1,0,22
61845,661697,1,4,6,0,1,22
61846,661697,1,5,1,4,0,26
61847,661697,1,5,2,1,0,27
61848,661697,1,5,3,0,0,27
61849,661697,1,5,4,0,0,27
61850,661697,1,5,5,0,0,27
61851,661697,1,5,6,0,0,27
61852,661697,1,6,1,4,0,31
61853,661697,1,6,2,0,0,31
61854,661697,1,6,3,6,0,37
61855,661697,1,6,4,0,0,37
61856,661697,1,6,5,0,1,37
61857,661697,1,6,6,0,0,37
61858,661697,1,7,1,0,0,37
61859,661697,1,7,2,4,0,41
61860,661697,1,7,3,0,0,41
61861,661697,1,7,4,2,0,43
61862,661697,1,7,5,6,0,49
61863,661697,1,7,6,0,0,49
61864,661697,1,8,1,1,0,50
61865,661697,1,8,2,0,0,50
61866,661697,1,8,3,1,0,51
61867,661697,1,8,4,0,0,51
61868,661697,1,8,5,1,0,52
61869,661697,1,8,6,1,0,53
61870,661697,1,9,1,1,0,54
61871,661697,1,9,2,0,0,54
61872,661697,1,9,3,6,0,60
61873,661697,1,9,4,2,0,62
61874,661697,1,9,5,1,0,63
61875,661697,1,9,6,1,0,64
61876,661697,1,10,1,1,0,65
61877,661697,1,10,2,1,0,66
61878,661697,1,10,3,0,0,66
61879,661697,1,10,4,0,1,66
61880,661697,1,10,5,0,0,66
61881,661697,1,10,6,0,0,66
61882,661697,1,11,1,0,0,66
61883,661697,1,11,2,1,0,67
61884,661697,1,11,3,0,1,67
61885,661697,1,11,4,4,0,71
61886,661697,1,11,5,1,0,72
61887,661697,1,11,6,0,0,72
61888,661697,1,12,1,0,0,72
61889,661697,1,12,2,0,0,72
61890,661697,1,12,3,1,0,73
61891,661697,1,12,4,0,0,73
61892,661697,1,12,5,1,0,74
61893,661697,1,12,6,2,0,76
61894,661697,1,13,1,0,0,76
61895,661697,1,13,2,4,0,80
61896,661697,1,13,3,4,0,84
61897,661697,1,13,4,1,0,85
61898,661697,1,13,5,1,0,86
61899,661697,1,13,6,0,0,86
61900,661697,1,14,1,2,0,88
61901,661697,1,14,2,1,0,89
61902,661697,1,14,3,0,0,89
61903,661697,1,14,4,2,0,91
61904,661697,1,14,5,1,0,92
61905,661697,1,14,6,1,0,93
61906,661697,1,15,1,1,0,94
61907,661697,1,15,2,1,0,95
61908,661697,1,15,3,4,0,99
61909,661697,1,15,4,1,0,100
61910,661697,1,15,5,1,0,101
61911,661697,1,15,6,0,0,101
61912,661697,1,16,1,1,0,102
61913,661697,1,16,2,2,0,104
61914,661697,1,16,3,2,0,106
61915,661697,1,16,4,7,0,113
61916,661697,1,16,5,6,0,119
61917,661697,1,16,6,1,0,120
61918,661697,1,17,1,1,0,121
61919,661697,1,17,2,2,0,123
61920,661697,1,17,3,1,0,124
61921,661697,1,17,4,0,0,124
61922,661697,1,17,5,1,0,125
61923,661697,1,17,6,2,0,127
61924,661697,1,18,1,6,0,133
61925,661697,1,18,2,1,0,134
61926,661697,1,18,3,2,0,136
61927,661697,1,18,4,1,1,137
61928,661697,1,18,5,1,0,138
61929,661697,1,18,6,4,0,142
61930,661697,1,19,1,1,0,143
61931,661697,1,19,2,1,0,144
61932,661697,1,19,3,1,0,145
61933,661697,1,19,4,2,0,147
61934,661697,1,19,5,4,0,151
61935,661697,1,19,6,0,0,151
61936,661697,1,20,1,2,0,153
61937,661697,1,20,2,1,0,154
61938,661697,1,20,3,2,0,156
61939,661697,1,20,4,0,0,156
61940,661697,1,20,5,1,0,157
61941,661697,1,20,6,2,0,159
62056,667731,1,1,1,0,0,0
62057,667731,1,1,2,4,0,4
62058,667731,1,1,3,2,0,6
62059,667731,1,1,4,1,0,7
62060,667731,1,1,5,4,0,11
62061,667731,1,1,6,6,0,17
62062,667731,1,2,1,0,0,17
62063,667731,1,2,2,1,0,18
62064,667731,1,2,3,0,0,18
62065,667731,1,2,4,0,0,18
62066,667731,1,2,5,0,0,18
62067,667731,1,2,6,6,0,24
62068,667731,1,3,1,0,0,24
62069,667731,1,3,2,1,0,25
62070,667731,1,3,3,1,0,26
62071,667731,1,3,4,0,0,26
62072,667731,1,3,5,0,1,26
62073,667731,1,3,6,1,0,27
62074,667731,1,4,1,0,1,27
62075,667731,1,4,2,0,0,27
62076,667731,1,4,3,0,0,27
62077,667731,1,4,4,4,0,31
62078,667731,1,4,5,0,0,31
62079,667731,1,4,6,0,0,31
62080,667731,1,5,1,0,0,31
62081,667731,1,5,2,1,0,32
62082,667731,1,5,3,4,0,36
62083,667731,1,5,4,0,0,36
62084,667731,1,5,5,1,0,37
62085,667731,1,5,6,1,0,38
62086,667731,1,6,1,4,0,42
62087,667731,1,6,2,2,0,44
62088,667731,1,6,3,0,0,44
62089,667731,1,6,4,0,0,44
62090,667731,1,6,5,1,0,45
62091,667731,1,6,6,1,0,46
62092,667731,1,7,1,1,0,47
62093,667731,1,7,2,1,0,48
62094,667731,1,7,3,1,0,49
62095,667731,1,7,4,0,0,49
62096,667731,1,7,5,4,0,53
62097,667731,1,7,6,0,0,53
62098,667731,1,8,1,2,0,55
62099,667731,1,8,2,0,0,55
62100,667731,1,8,3,1,0,56
62101,667731,1,8,4,1,0,57
62102,667731,1,8,5,0,0,57
62103,667731,1,8,6,2,0,59
62104,667731,1,9,1,1,0,60
62105,667731,1,9,2,0,0,60
62106,667731,1,9,3,1,0,61
62107,667731,1,9,4,1,0,62
62108,667731,1,9,5,1,0,63
62109,667731,1,9,6,1,0,64
62110,667731,1,10,1,2,0,66
62111,667731,1,10,2,2,0,68
62112,667731,1,10,3,1,0,69
62113,667731,1,10,4,6,0,75
62114,667731,1,10,5,0,1,75
62115,667731,1,10,6,1,0,76
62116,667731,1,11,1,0,0,76
62117,667731,1,11,2,1,0,77
62118,667731,1,11,3,0,0,77
62119,667731,1,11,4,0,0,77
62120,667731,1,11,5,6,0,83
62121,667731,1,11,6,1,0,84
62122,667731,1,12,1,1,0,85
62123,667731,1,12,2,0,0,85
62124,667731,1,12,3,0,0,85
62125,667731,1,12,4,0,1,85
62126,667731,1,12,5,1,0,86
62127,667731,1,12,6,0,0,86
62128,667731,1,13,1,1,0,87
62129,667731,1,13,2,1,0,88
62130,667731,1,13,3,1,0,89
62131,667731,1,13,4,0,0,89
62132,667731,1,13,5,2,0,91
62133,667731,1,13,6,2,0,93
62134,667731,1,14,1,2,0,95
62135,667731,1,14,2,0,0,95
62136,667731,1,14,3,0,0,95
62137,667731,1,14,4,1,0,96
62138,667731,1,14,5,0,0,96
62139,667731,1,14,6,0,0,96
62140,667731,1,15,1,1,0,97
62141,667731,1,15,2,0,0,97
62142,667731,1,15,3,0,0,97
62143,667731,1,15,4,1,0,98
62144,667731,1,15,5,0,0,98
62145,667731,1,15,6,1,0,99
62146,667731,1,16,1,4,0,103
62147,667731,1,16,2,6,0,109
62148,667731,1,16,3,1,0,110
62149,667731,1,16,4,1,0,111
62150,667731,1,16,5,1,0,112
62151,667731,1,16,6,1,0,113
62152,667731,1,17,1,1,0,114
62153,667731,1,17,2,6,0,120
62154,667731,1,17,3,1,0,121
62155,667731,1,17,4,1,0,122
62156,667731,1,17,5,2,0,124
62157,667731,1,17,6,6,0,130
62158,667731,1,18,1,0,1,130
62159,667731,1,18,2,1,0,131
62160,667731,1,18,3,1,0,132
62161,667731,1,18,4,6,0,138
62162,667731,1,18,5,2,0,140
62163,667731,1,18,6,4,0,144
62164,667731,1,19,1,0,0,144
62165,667731,1,19,2,4,0,148
62166,667731,1,19,3,1,0,149
62167,667731,1,19,4,4,0,153
62168,667731,1,19,5,6,0,159
62169,667731,1,19,6,6,0,165
62170,667731,1,20,1,1,0,166
62171,667731,1,20,2,0,1,166
62172,667731,1,20,3,4,0,170
62173,667731,1,20,4,4,0,174
62174,667731,1,20,5,6,0,180
62175,667731,1,20,6,0,1,180
62296,667887,1,1,1,4,0,4
62297,667887,1,1,2,1,0,5
62298,667887,1,1,3,0,0,5
62299,667887,1,1,4,0,0,5
62300,667887,1,1,5,4,0,9
62301,667887,1,1,6,0,0,9
62302,667887,1,2,1,0,0,9
62303,667887,1,2,2,4,0,13
62304,667887,1,2,3,1,0,14
62305,667887,1,2,4,0,0,14
62306,667887,1,2,5,6,0,20
62307,667887,1,2,6,0,0,20
62308,667887,1,3,1,4,0,24
62309,667887,1,3,2,0,0,24
62310,667887,1,3,3,0,0,24
62311,667887,1,3,4,0,1,24
62312,667887,1,3,5,0,0,24
62313,667887,1,3,6,0,0,24
62314,667887,1,4,1,0,0,24
62315,667887,1,4,2,0,0,24
62316,667887,1,4,3,0,1,24
62317,667887,1,4,4,1,0,25
62318,667887,1,4,5,0,0,25
62319,667887,1,4,6,4,0,29
62320,667887,1,5,1,1,0,30
62321,667887,1,5,2,0,0,30
62322,667887,1,5,3,0,0,30
62323,667887,1,5,4,1,0,31
62324,667887,1,5,5,0,0,31
62325,667887,1,5,6,0,0,31
62326,667887,1,6,1,4,0,35
62327,667887,1,6,2,1,0,36
62328,667887,1,6,3,2,0,38
62329,667887,1,6,4,4,0,42
62330,667887,1,6,5,1,0,43
62331,667887,1,6,6,0,0,43
62332,667887,1,7,1,1,0,44
62333,667887,1,7,2,4,0,48
62334,667887,1,7,3,2,0,50
62335,667887,1,7,4,1,0,51
62336,667887,1,7,5,1,0,52
62337,667887,1,7,6,1,0,53
62338,667887,1,8,1,0,0,53
62339,667887,1,8,2,4,0,57
62340,667887,1,8,3,4,0,61
62341,667887,1,8,4,4,0,65
62342,667887,1,8,5,2,0,67
62343,667887,1,8,6,1,0,68
62344,667887,1,9,1,1,0,69
62345,667887,1,9,2,4,0,73
62346,667887,1,9,3,1,0,74
62347,667887,1,9,4,1,0,75
62348,667887,1,9,5,0,0,75
62349,667887,1,9,6,1,0,76
62350,667887,1,10,1,0,0,76
62351,667887,1,10,2,1,0,77
62352,667887,1,10,3,1,0,78
62353,667887,1,10,4,0,1,78
62354,667887,1,10,5,0,0,78
62355,667887,1,10,6,1,0,79
62356,667887,1,11,1,6,0,85
62357,667887,1,11,2,0,0,85
62358,667887,1,11,3,0,1,85
62359,667887,1,11,4,0,0,85
62360,667887,1,11,5,0,0,85
62361,667887,1,11,6,1,0,86
62362,667887,1,12,1,0,0,86
62363,667887,1,12,2,1,0,87
62364,667887,1,12,3,2,0,89
62365,667887,1,12,4,0,0,89
62366,667887,1,12,5,1,0,90
62367,667887,1,12,6,0,0,90
62368,667887,1,13,1,0,0,90
62369,667887,1,13,2,0,0,90
62370,667887,1,13,3,1,0,91
62371,667887,1,13,4,1,0,92
62372,667887,1,13,5,1,0,93
62373,667887,1,13,6,6,0,99
62374,667887,1,14,1,1,0,100
62375,667887,1,14,2,1,0,101
62376,667887,1,14,3,1,0,102
62377,667887,1,14,4,4,0,106
62378,667887,1,14,5,1,0,107
62379,667887,1,14,6,1,0,108
62380,667887,1,15,1,1,0,109
62381,667887,1,15,2,4,0,113
62382,667887,1,15,3,2,0,115
62383,667887,1,15,4,1,0,116
62384,667887,1,15,5,6,0,122
62385,667887,1,15,6,0,1,122
62386,667887,1,16,1,1,0,123
62387,667887,1,16,2,1,0,124
62388,667887,1,16,3,2,0,126
62389,667887,1,16,4,4,0,130
62390,667887,1,16,5,6,0,136
62391,667887,1,16,6,1,0,137
62392,667887,1,17,1,1,0,138
62393,667887,1,17,2,0,0,138
62394,667887,1,17,3,1,0,139
62395,667887,1,17,4,1,0,140
62396,667887,1,17,5,1,0,141
62397,667887,1,17,6,0,0,141
62398,667887,1,18,1,0,1,141
62399,667887,1,18,2,4,0,145
62400,667887,1,18,3,1,0,146
62401,667887,1,18,4,1,0,147
62402,667887,1,18,5,4,0,151
62403,667887,1,18,6,1,0,152
62404,667887,1,19,1,0,0,152
62405,667887,1,19,2,4,0,156
62406,667887,1,19,3,4,0,160
62407,667887,1,19,4,6,0,166
62408,667887,1,19,5,4,0,170
62409,667887,1,19,6,4,0,174
62410,667887,1,20,1,1,0,175
62411,667887,1,20,2,1,0,176
62412,667887,1,20,3,4,0,180
62413,667887,1,20,4,2,0,182
62414,667887,1,20,5,1,0,183
62415,667887,1,20,6,0,1,183
62536,668959,1,1,1,0,0,0
62537,668959,1,1,2,0,0,0
62538,668959,1,1,3,4,0,4
62539,668959,1,1,4,2,0,6
62540,668959,1,1,5,0,0,6
62541,668959,1,1,6,4,0,10
62542,668959,1,2,1,1,0,11
62543,668959,1,2,2,0,0,11
62544,668959,1,2,3,4,0,15
62545,668959,1,2,4,0,0,15
62546,668959,1,2,5,4,0,19
62547,668959,1,2,6,1,0,20
62548,668959,1,3,1,2,0,22
62549,668959,1,3,2,4,0,26
62550,668959,1,3,3,4,0,30
62551,668959,1,3,4,1,0,31
62552,668959,1,3,5,0,0,31
62553,668959,1,3,6,1,0,32
62554,668959,1,4,1,1,0,33
62555,668959,1,4,2,0,0,33
62556,668959,1,4,3,4,0,37
62557,668959,1,4,4,5,0,42
62558,668959,1,4,5,6,0,48
62559,668959,1,4,6,0,0,48
62560,668959,1,5,1,0,0,48
62561,668959,1,5,2,0,0,48
62562,668959,1,5,3,1,0,49
62563,668959,1,5,4,1,0,50
62564,668959,1,5,5,4,0,54
62565,668959,1,5,6,0,0,54
62566,668959,1,6,1,4,0,58
62567,668959,1,6,2,0,0,58
62568,668959,1,6,3,1,0,59
62569,668959,1,6,4,6,0,65
62570,668959,1,6,5,1,0,66
62571,668959,1,6,6,4,0,70
62572,668959,1,7,1,0,0,70
62573,668959,1,7,2,0,0,70
62574,668959,1,7,3,0,0,70
62575,668959,1,7,4,1,0,71
62576,668959,1,7,5,1,0,72
62577,668959,1,7,6,1,0,73
62578,668959,1,8,1,0,1,73
62579,668959,1,8,2,1,0,74
62580,668959,1,8,3,0,0,74
62581,668959,1,8,4,2,0,76
62582,668959,1,8,5,0,0,76
62583,668959,1,8,6,1,0,77
62584,668959,1,9,1,0,0,77
62585,668959,1,9,2,1,0,78
62586,668959,1,9,3,0,0,78
62587,668959,1,9,4,1,0,79
62588,668959,1,9,5,1,0,80
62589,668959,1,9,6,2,0,82
62590,668959,1,10,1,1,0,83
62591,668959,1,10,2,0,1,83
62592,668959,1,10,3,1,0,84
62593,668959,1,10,4,0,0,84
62594,668959,1,10,5,1,0,85
62595,668959,1,10,6,1,0,86
62596,668959,1,11,1,0,0,86
62597,668959,1,11,2,1,0,87
62598,668959,1,11,3,1,0,88
62599,668959,1,11,4,1,0,89
62600,668959,1,11,5,1,0,90
62601,668959,1,11,6,4,0,94
62602,668959,1,12,1,0,0,94
62603,668959,1,12,2,6,0,100
62604,668959,1,12,3,1,0,101
62605,668959,1,12,4,1,0,102
62606,668959,1,12,5,6,0,108
62607,668959,1,12,6,1,0,109
62608,668959,1,13,1,6,0,115
62609,668959,1,13,2,2,0,117
62610,668959,1,13,3,2,0,119
62611,668959,1,13,4,6,0,125
62612,668959,1,13,5,1,0,126
62613,668959,1,13,6,3,0,129
62614,668959,1,14,1,0,0,129
62615,668959,1,14,2,0,0,129
62616,668959,1,14,3,4,0,133
62617,668959,1,14,4,1,0,134
62618,668959,1,14,5,1,0,135
62619,668959,1,14,6,1,0,136
62620,668959,1,15,1,1,0,137
62621,668959,1,15,2,4,0,141
62622,668959,1,15,3,1,0,142
62623,668959,1,15,4,1,0,143
62624,668959,1,15,5,4,0,147
62625,668959,1,15,6,2,0,149
62626,668959,1,16,1,3,0,152
62627,668959,1,16,2,0,0,152
62628,668959,1,16,3,1,0,153
62629,668959,1,16,4,2,0,155
62630,668959,1,16,5,1,0,156
62631,668959,1,16,6,1,0,157
62632,668959,1,17,1,4,0,161
62633,668959,1,17,2,1,0,162
62634,668959,1,17,3,4,0,166
62635,668959,1,17,4,1,0,167
62636,668959,1,17,5,1,0,168
62637,668959,1,17,6,1,0,169
62638,668959,1,18,1,6,0,175
62639,668959,1,18,2,1,0,176
62640,668959,1,18,3,0,1,176
62641,668959,1,18,4,1,0,177
62642,668959,1,18,5,4,0,181
62643,668959,1,18,6,6,0,187
62644,668959,1,19,1,1,0,188
62645,668959,1,19,2,1,0,189
62646,668959,1,19,3,1,0,190
62647,668959,1,19,4,6,0,196
62648,668959,1,19,5,1,0,197
62649,668959,1,19,6,1,0,198
62650,668959,1,20,1,1,0,199
62651,668959,1,20,2,1,1,200
62652,668959,1,20,3,0,0,200
62653,668959,1,20,4,0,1,200
62654,668959,1,20,5,2,0,202
62655,668959,1,20,6,2,0,204
62776,668969,1,1,1,0,0,0
62777,668969,1,1,2,0,0,0
62778,668969,1,1,3,3,0,3
62779,668969,1,1,4,0,0,3
62780,668969,1,1,5,0,0,3
62781,668969,1,1,6,0,0,3
62782,668969,1,2,1,0,1,3
62783,668969,1,2,2,0,0,3
62784,668969,1,2,3,3,0,6
62785,668969,1,2,4,1,0,7
62786,668969,1,2,5,1,0,8
62787,668969,1,2,6,4,0,12
62788,668969,1,3,1,0,0,12
62789,668969,1,3,2,2,0,14
62790,668969,1,3,3,0,1,14
62791,668969,1,3,4,4,0,18
62792,668969,1,3,5,0,0,18
62793,668969,1,3,6,0,0,18
62794,668969,1,4,1,0,0,18
62795,668969,1,4,2,0,0,18
62796,668969,1,4,3,0,0,18
62797,668969,1,4,4,1,0,19
62798,668969,1,4,5,1,0,20
62799,668969,1,4,6,1,0,21
62800,668969,1,5,1,1,0,22
62801,668969,1,5,2,0,0,22
62802,668969,1,5,3,1,0,23
62803,668969,1,5,4,1,0,24
62804,668969,1,5,5,4,0,28
62805,668969,1,5,6,0,0,28
62806,668969,1,6,1,1,0,29
62807,668969,1,6,2,6,0,35
62808,668969,1,6,3,0,0,35
62809,668969,1,6,4,4,0,39
62810,668969,1,6,5,0,0,39
62811,668969,1,6,6,3,0,42
62812,668969,1,7,1,1,0,43
62813,668969,1,7,2,0,0,43
62814,668969,1,7,3,1,0,44
62815,668969,1,7,4,0,0,44
62816,668969,1,7,5,1,0,45
62817,668969,1,7,6,1,0,46
62818,668969,1,8,1,1,0,47
62819,668969,1,8,2,1,0,48
62820,668969,1,8,3,1,0,49
62821,668969,1,8,4,0,1,49
62822,668969,1,8,5,1,0,50
62823,668969,1,8,6,0,0,50
62824,668969,1,9,1,2,0,52
62825,668969,1,9,2,0,0,52
62826,668969,1,9,3,1,0,53
62827,668969,1,9,4,0,0,53
62828,668969,1,9,5,1,0,54
62829,668969,1,9,6,1,0,55
62830,668969,1,10,1,0,0,55
62831,668969,1,10,2,0,0,55
62832,668969,1,10,3,1,0,56
62833,668969,1,10,4,1,0,57
62834,668969,1,10,5,4,0,61
62835,668969,1,10,6,1,0,62
62836,668969,1,11,1,0,1,62
62837,668969,1,11,2,0,0,62
62838,668969,1,11,3,1,0,63
62839,668969,1,11,4,1,0,64
62840,668969,1,11,5,1,0,65
62841,668969,1,11,6,0,0,65
62842,668969,1,12,1,1,0,66
62843,668969,1,12,2,0,0,66
62844,668969,1,12,3,0,0,66
62845,668969,1,12,4,1,0,67
62846,668969,1,12,5,1,0,68
62847,668969,1,12,6,1,0,69
62848,668969,1,13,1,1,0,70
62849,668969,1,13,2,1,0,71
62850,668969,1,13,3,0,0,71
62851,668969,1,13,4,4,0,75
62852,668969,1,13,5,4,0,79
62853,668969,1,13,6,1,0,80
62854,668969,1,14,1,1,0,81
62855,668969,1,14,2,4,0,85
62856,668969,1,14,3,4,0,89
62857,668969,1,14,4,1,0,90
62858,668969,1,14,5,1,0,91
62859,668969,1,14,6,1,0,92
62860,668969,1,15,1,0,0,92
62861,668969,1,15,2,1,0,93
62862,668969,1,15,3,0,0,93
62863,668969,1,15,4,0,1,93
62864,668969,1,15,5,1,0,94
62865,668969,1,15,6,0,0,94
62866,668969,1,16,1,1,0,95
62867,668969,1,16,2,0,0,95
62868,668969,1,16,3,4,0,99
62869,668969,1,16,4,0,0,99
62870,668969,1,16,5,1,0,100
62871,668969,1,16,6,1,0,101
62872,668969,1,17,1,1,0,102
62873,668969,1,17,2,1,0,103
62874,668969,1,17,3,6,0,109
62875,668969,1,17,4,0,0,109
62876,668969,1,17,5,0,0,109
62877,668969,1,17,6,4,0,113
62878,668969,1,18,1,2,0,115
62879,668969,1,18,2,2,0,117
62880,668969,1,18,3,2,0,119
62881,668969,1,18,4,1,0,120
62882,668969,1,18,5,1,0,121
62883,668969,1,18,6,2,0,123
62884,668969,1,19,1,1,0,124
62885,668969,1,19,2,1,0,125
62886,668969,1,19,3,1,0,126
62887,668969,1,19,4,4,0,130
62888,668969,1,19,5,4,0,134
62889,668969,1,19,6,2,0,136
62890,668969,1,20,1,0,0,136
62891,668969,1,20,2,1,0,137
62892,668969,1,20,3,1,1,138
62893,668969,1,20,4,2,0,140
62894,668969,1,20,5,0,1,140
62895,668969,1,20,6,2,0,142
63003,682897,1,1,1,0,1,0
63004,682897,1,1,2,1,0,1
63005,682897,1,1,3,0,0,1
63006,682897,1,1,4,0,0,1
63007,682897,1,1,5,0,0,1
63008,682897,1,1,6,0,0,1
63009,682897,1,2,1,1,0,2
63010,682897,1,2,2,0,0,2
63011,682897,1,2,3,6,0,8
63012,682897,1,2,4,0,0,8
63013,682897,1,2,5,0,0,8
63014,682897,1,2,6,0,0,8
63015,682897,1,3,1,1,0,9
63016,682897,1,3,2,1,0,10
63017,682897,1,3,3,1,0,11
63018,682897,1,3,4,0,0,11
63019,682897,1,3,5,0,0,11
63020,682897,1,3,6,4,0,15
63021,682897,1,4,1,0,0,15
63022,682897,1,4,2,0,0,15
63023,682897,1,4,3,1,0,16
63024,682897,1,4,4,1,0,17
63025,682897,1,4,5,0,0,17
63026,682897,1,4,6,0,0,17
63027,682897,1,5,1,6,0,23
63028,682897,1,5,2,4,0,27
63029,682897,1,5,3,4,0,31
63030,682897,1,5,4,1,0,32
63031,682897,1,5,5,0,0,32
63032,682897,1,5,6,0,0,32
63033,682897,1,6,1,4,0,36
63034,682897,1,6,2,0,1,36
63035,682897,1,6,3,0,1,36
63036,682897,1,6,4,0,0,36
63037,682897,1,6,5,0,0,36
63038,682897,1,6,6,0,0,36
63039,682897,1,7,1,0,1,36
63040,682897,1,7,2,1,0,37
63041,682897,1,7,3,0,0,37
63042,682897,1,7,4,0,0,37
63043,682897,1,7,5,0,0,37
63044,682897,1,7,6,1,0,38
63045,682897,1,8,1,0,0,38
63046,682897,1,8,2,0,0,38
63047,682897,1,8,3,3,0,41
63048,682897,1,8,4,0,0,41
63049,682897,1,8,5,1,0,42
63050,682897,1,8,6,1,0,43
63051,682897,1,9,1,1,0,44
63052,682897,1,9,2,1,0,45
63053,682897,1,9,3,0,0,45
63054,682897,1,9,4,0,0,45
63055,682897,1,9,5,2,0,47
63056,682897,1,9,6,1,0,48
63057,682897,1,10,1,1,0,49
63058,682897,1,10,2,0,0,49
63059,682897,1,10,3,0,1,49
63060,682897,1,10,4,1,0,50
63061,682897,1,10,5,0,0,50
63062,682897,1,10,6,0,0,50
63063,682897,1,11,1,0,0,50
63064,682897,1,11,2,3,0,53
63065,682897,1,11,3,0,0,53
63066,682897,1,11,4,0,0,53
63067,682897,1,11,5,0,0,53
63068,682897,1,11,6,1,0,54
63069,682897,1,12,1,0,0,54
63070,682897,1,12,2,1,0,55
63071,682897,1,12,3,1,0,56
63072,682897,1,12,4,1,0,57
63073,682897,1,12,5,0,0,57
63074,682897,1,12,6,1,1,58
63075,682897,1,13,1,1,0,59
63076,682897,1,13,2,0,0,59
63077,682897,1,13,3,0,0,59
63078,682897,1,13,4,0,0,59
63079,682897,1,13,5,1,0,60
63080,682897,1,13,6,0,0,60
63081,682897,1,14,1,0,0,60
63082,682897,1,14,2,4,0,64
63083,682897,1,14,3,4,0,68
63084,682897,1,14,4,0,0,68
63085,682897,1,14,5,1,0,69
63086,682897,1,14,6,0,1,69
63087,682897,1,15,1,0,1,69
63088,682897,1,15,2,0,0,69
63089,682897,1,15,3,0,0,69
63090,682897,1,15,4,0,0,69
63091,682897,1,15,5,0,0,69
63092,682897,1,15,6,0,0,69
63093,682897,1,16,1,0,0,69
63094,682897,1,16,2,0,0,69
63095,682897,1,16,3,0,0,69
63096,682897,1,16,4,1,0,70
63097,682897,1,16,5,0,0,70
63098,682897,1,16,6,0,0,70
63099,682897,1,17,1,1,0,71
63100,682897,1,17,2,0,1,71
63101,682897,1,17,3,0,0,71
63102,682897,1,17,4,0,0,71
63103,682897,1,17,5,1,0,72
63104,682897,1,17,6,0,0,72
63105,682897,1,18,1,0,1,72
63178,682901,1,1,1,1,0,1
63179,682901,1,1,2,0,0,1
63180,682901,1,1,3,0,0,1
63181,682901,1,1,4,1,0,2
63182,682901,1,1,5,0,0,2
63183,682901,1,1,6,2,0,4
63184,682901,1,2,1,4,0,8
63185,682901,1,2,2,4,0,12
63186,682901,1,2,3,2,0,14
63187,682901,1,2,4,0,0,14
63188,682901,1,2,5,0,1,14
63189,682901,1,2,6,2,0,16
63190,682901,1,3,1,0,0,16
63191,682901,1,3,2,0,0,16
63192,682901,1,3,3,1,0,17
63193,682901,1,3,4,4,0,21
63194,682901,1,3,5,1,0,22
63195,682901,1,3,6,1,0,23
63196,682901,1,4,1,0,0,23
63197,682901,1,4,2,4,0,27
63198,682901,1,4,3,4,0,31
63199,682901,1,4,4,1,0,32
63200,682901,1,4,5,1,0,33
63201,682901,1,4,6,2,0,35
63202,682901,1,5,1,0,0,35
63203,682901,1,5,2,0,0,35
63204,682901,1,5,3,0,0,35
63205,682901,1,5,4,1,0,36
63206,682901,1,5,5,1,0,37
63207,682901,1,5,6,4,0,41
63208,682901,1,6,1,4,0,45
63209,682901,1,6,2,1,0,46
63210,682901,1,6,3,6,0,52
63211,682901,1,6,4,0,0,52
63212,682901,1,6,5,0,0,52
63213,682901,1,6,6,4,0,56
63214,682901,1,7,1,0,0,56
63215,682901,1,7,2,0,1,56
63216,682901,1,7,3,2,0,58
63217,682901,1,7,4,6,0,64
63218,682901,1,7,5,1,0,65
63219,682901,1,7,6,1,0,66
63220,682901,1,8,1,2,0,68
63221,682901,1,8,2,1,0,69
63222,682901,1,8,3,1,0,70
63223,682901,1,8,4,0,0,70
63224,682901,1,8,5,1,0,71
63225,682901,1,8,6,1,0,72
63226,682901,1,9,1,0,0,72
63227,682901,1,9,2,4,0,76
63228,682901,1,9,3,1,0,77
63229,682901,1,9,4,1,0,78
63230,682901,1,9,5,0,1,78
63231,682901,1,9,6,1,0,79
63232,682901,1,10,1,1,0,80
63233,682901,1,10,2,2,0,82
63234,682901,1,10,3,1,0,83
63235,682901,1,10,4,1,0,84
63236,682901,1,10,5,1,0,85
63237,682901,1,10,6,0,0,85
63238,682901,1,11,1,1,0,86
63239,682901,1,11,2,0,0,86
63240,682901,1,11,3,1,0,87
63241,682901,1,11,4,1,0,88
63242,682901,1,11,5,1,0,89
63243,682901,1,11,6,1,0,90
63244,682901,1,12,1,1,0,91
63245,682901,1,12,2,6,0,97
63246,682901,1,12,3,1,0,98
63247,682901,1,12,4,1,0,99
63248,682901,1,12,5,0,0,99
63249,682901,1,12,6,0,0,99
63250,682901,1,13,1,0,0,99
63251,682901,1,13,2,1,0,100
63252,682901,1,13,3,1,0,101
63253,682901,1,13,4,1,0,102
63254,682901,1,13,5,0,0,102
63255,682901,1,13,6,2,0,104
63256,682901,1,14,1,0,0,104
63257,682901,1,14,2,1,0,105
63258,682901,1,14,3,0,0,105
63259,682901,1,14,4,1,0,106
63260,682901,1,14,5,0,0,106
63261,682901,1,14,6,4,0,110
63262,682901,1,15,1,1,0,111
63263,682901,1,15,2,0,0,111
63264,682901,1,15,3,0,1,111
63265,682901,1,15,4,2,0,113
63266,682901,1,15,5,1,0,114
63267,682901,1,15,6,1,0,115
63268,682901,1,16,1,1,0,116
63269,682901,1,16,2,4,0,120
63270,682901,1,16,3,0,0,120
63271,682901,1,16,4,4,0,124
63272,682901,1,16,5,4,0,128
63273,682901,1,16,6,1,0,129
63274,682901,1,17,1,0,0,129
63275,682901,1,17,2,1,0,130
63276,682901,1,17,3,0,0,130
63277,682901,1,17,4,1,0,131
63278,682901,1,17,5,0,0,131
63279,682901,1,17,6,0,1,131
63280,682901,1,18,1,0,0,131
63281,682901,1,18,2,1,0,132
63282,682901,1,18,3,0,0,132
63283,682901,1,18,4,1,0,133
63284,682901,1,18,5,6,0,139
63285,682901,1,18,6,1,0,140
63286,682901,1,19,1,2,0,142
63287,682901,1,19,2,1,0,143
63288,682901,1,19,3,1,0,144
63289,682901,1,19,4,1,0,145
63290,682901,1,19,5,1,0,146
63291,682901,1,19,6,0,0,146
63292,682901,1,20,1,2,0,148
63293,682901,1,20,2,6,0,154
63294,682901,1,20,3,1,0,155
63295,682901,1,20,4,1,0,156
63296,682901,1,20,5,6,0,162
63297,682901,1,20,6,1,0,163
63418,682907,1,1,1,0,0,0
63419,682907,1,1,2,2,0,2
63420,682907,1,1,3,0,0,2
63421,682907,1,1,4,1,0,3
63422,682907,1,1,5,0,0,3
63423,682907,1,1,6,0,0,3
63424,682907,1,2,1,0,0,3
63425,682907,1,2,2,3,0,6
63426,682907,1,2,3,0,0,6
63427,682907,1,2,4,0,0,6
63428,682907,1,2,5,4,0,10
63429,682907,1,2,6,1,0,11
63430,682907,1,3,1,1,0,12
63431,682907,1,3,2,0,0,12
63432,682907,1,3,3,1,0,13
63433,682907,1,3,4,1,0,14
63434,682907,1,3,5,0,0,14
63435,682907,1,3,6,0,0,14
63436,682907,1,4,1,2,0,16
63437,682907,1,4,2,1,0,17
63438,682907,1,4,3,1,0,18
63439,682907,1,4,4,1,0,19
63440,682907,1,4,5,0,0,19
63441,682907,1,4,6,0,1,19
63442,682907,1,5,1,3,0,22
63443,682907,1,5,2,4,0,26
63444,682907,1,5,3,0,0,26
63445,682907,1,5,4,1,0,27
63446,682907,1,5,5,1,0,28
63447,682907,1,5,6,0,0,28
63448,682907,1,6,1,1,0,29
63449,682907,1,6,2,0,0,29
63450,682907,1,6,3,0,0,29
63451,682907,1,6,4,1,0,30
63452,682907,1,6,5,4,0,34
63453,682907,1,6,6,4,0,38
63454,682907,1,7,1,0,1,38
63455,682907,1,7,2,1,0,39
63456,682907,1,7,3,0,1,39
63457,682907,1,7,4,0,0,39
63458,682907,1,7,5,0,0,39
63459,682907,1,7,6,1,0,40
63460,682907,1,8,1,2,0,42
63461,682907,1,8,2,0,0,42
63462,682907,1,8,3,0,0,42
63463,682907,1,8,4,1,0,43
63464,682907,1,8,5,4,0,47
63465,682907,1,8,6,1,0,48
63466,682907,1,9,1,1,0,49
63467,682907,1,9,2,4,0,53
63468,682907,1,9,3,0,0,53
63469,682907,1,9,4,0,0,53
63470,682907,1,9,5,0,0,53
63471,682907,1,9,6,0,0,53
63472,682907,1,10,1,0,0,53
63473,682907,1,10,2,1,0,54
63474,682907,1,10,3,0,0,54
63475,682907,1,10,4,0,0,54
63476,682907,1,10,5,0,0,54
63477,682907,1,10,6,0,0,54
63478,682907,1,11,1,1,0,55
63479,682907,1,11,2,1,0,56
63480,682907,1,11,3,1,0,57
63481,682907,1,11,4,1,0,58
63482,682907,1,11,5,1,0,59
63483,682907,1,11,6,0,0,59
63484,682907,1,12,1,1,0,60
63485,682907,1,12,2,1,0,61
63486,682907,1,12,3,0,0,61
63487,682907,1,12,4,0,0,61
63488,682907,1,12,5,1,0,62
63489,682907,1,12,6,1,0,63
63490,682907,1,13,1,4,0,67
63491,682907,1,13,2,0,0,67
63492,682907,1,13,3,5,0,72
63493,682907,1,13,4,1,0,73
63494,682907,1,13,5,0,0,73
63495,682907,1,13,6,1,0,74
63496,682907,1,14,1,1,0,75
63497,682907,1,14,2,0,0,75
63498,682907,1,14,3,0,0,75
63499,682907,1,14,4,1,0,76
63500,682907,1,14,5,0,0,76
63501,682907,1,14,6,0,0,76
63502,682907,1,15,1,2,0,78
63503,682907,1,15,2,1,0,79
63504,682907,1,15,3,1,0,80
63505,682907,1,15,4,4,0,84
63506,682907,1,15,5,1,0,85
63507,682907,1,15,6,1,0,86
63508,682907,1,16,1,1,0,87
63509,682907,1,16,2,1,0,88
63510,682907,1,16,3,1,0,89
63511,682907,1,16,4,2,0,91
63512,682907,1,16,5,1,0,92
63513,682907,1,16,6,1,0,93
63514,682907,1,17,1,0,0,93
63515,682907,1,17,2,5,0,98
63516,682907,1,17,3,0,0,98
63517,682907,1,17,4,1,0,99
63518,682907,1,17,5,4,0,103
63519,682907,1,17,6,4,0,107
63520,682907,1,18,1,4,0,111
63521,682907,1,18,2,0,0,111
63522,682907,1,18,3,1,0,112
63523,682907,1,18,4,1,0,113
63524,682907,1,18,5,1,0,114
63525,682907,1,18,6,1,0,115
63526,682907,1,19,1,4,0,119
63527,682907,1,19,2,0,0,119
63528,682907,1,19,3,2,0,121
63529,682907,1,19,4,1,0,122
63530,682907,1,19,5,2,0,124
63531,682907,1,19,6,0,1,124
63532,682907,1,20,1,0,0,124
63533,682907,1,20,2,1,0,125
63534,682907,1,20,3,1,0,126
63535,682907,1,20,4,0,0,126
63536,682907,1,20,5,0,0,126
63537,682907,1,20,6,0,1,126
63631,682909,1,1,1,0,0,0
63632,682909,1,1,2,1,0,1
63633,682909,1,1,3,0,1,1
63634,682909,1,1,4,4,0,5
63635,682909,1,1,5,0,0,5
63636,682909,1,1,6,0,0,5
63637,682909,1,2,1,0,0,5
63638,682909,1,2,2,1,0,6
63639,682909,1,2,3,4,0,10
63640,682909,1,2,4,4,0,14
63641,682909,1,2,5,0,1,14
63642,682909,1,2,6,0,0,14
63643,682909,1,3,1,0,0,14
63644,682909,1,3,2,0,0,14
63645,682909,1,3,3,1,0,15
63646,682909,1,3,4,0,0,15
63647,682909,1,3,5,0,0,15
63648,682909,1,3,6,4,0,19
63649,682909,1,4,1,0,1,19
63650,682909,1,4,2,4,0,23
63651,682909,1,4,3,0,0,23
63652,682909,1,4,4,0,0,23
63653,682909,1,4,5,4,0,27
63654,682909,1,4,6,0,0,27
63655,682909,1,5,1,4,0,31
63656,682909,1,5,2,4,0,35
63657,682909,1,5,3,0,1,35
63658,682909,1,5,4,0,0,35
63659,682909,1,5,5,2,0,37
63660,682909,1,5,6,0,0,37
63661,682909,1,6,1,0,0,37
63662,682909,1,6,2,0,0,37
63663,682909,1,6,3,0,0,37
63664,682909,1,6,4,0,0,37
63665,682909,1,6,5,0,0,37
63666,682909,1,6,6,1,0,38
63667,682909,1,7,1,1,0,39
63668,682909,1,7,2,1,0,40
63669,682909,1,7,3,1,0,41
63670,682909,1,7,4,2,0,43
63671,682909,1,7,5,4,0,47
63672,682909,1,7,6,1,0,48
63673,682909,1,8,1,1,0,49
63674,682909,1,8,2,1,0,50
63675,682909,1,8,3,0,0,50
63676,682909,1,8,4,1,0,51
63677,682909,1,8,5,1,0,52
63678,682909,1,8,6,1,0,53
63679,682909,1,9,1,1,0,54
63680,682909,1,9,2,1,0,55
63681,682909,1,9,3,0,0,55
63682,682909,1,9,4,1,0,56
63683,682909,1,9,5,0,0,56
63684,682909,1,9,6,2,0,58
63685,682909,1,10,1,1,0,59
63686,682909,1,10,2,1,0,60
63687,682909,1,10,3,0,0,60
63688,682909,1,10,4,1,0,61
63689,682909,1,10,5,1,0,62
63690,682909,1,10,6,0,0,62
63691,682909,1,11,1,0,0,62
63692,682909,1,11,2,1,0,63
63693,682909,1,11,3,1,0,64
63694,682909,1,11,4,1,0,65
63695,682909,1,11,5,0,0,65
63696,682909,1,11,6,1,0,66
63697,682909,1,12,1,4,0,70
63698,682909,1,12,2,0,0,70
63699,682909,1,12,3,1,0,71
63700,682909,1,12,4,2,0,73
63701,682909,1,12,5,1,0,74
63702,682909,1,12,6,1,0,75
63703,682909,1,13,1,1,0,76
63704,682909,1,13,2,0,0,76
63705,682909,1,13,3,2,0,78
63706,682909,1,13,4,1,0,79
63707,682909,1,13,5,6,0,85
63708,682909,1,13,6,1,0,86
63709,682909,1,14,1,0,0,86
63710,682909,1,14,2,0,0,86
63711,682909,1,14,3,0,0,86
63712,682909,1,14,4,1,0,87
63713,682909,1,14,5,0,1,87
63714,682909,1,14,6,4,0,91
63715,682909,1,15,1,0,0,91
63716,682909,1,15,2,1,0,92
63717,682909,1,15,3,1,0,93
63718,682909,1,15,4,1,0,94
63719,682909,1,15,5,0,0,94
63720,682909,1,15,6,1,0,95
63721,682909,1,16,1,2,0,97
63722,682909,1,16,2,1,0,98
63723,682909,1,16,3,1,0,99
63724,682909,1,16,4,2,0,101
63725,682909,1,16,5,1,0,102
63726,682909,1,16,6,1,0,103
63727,682909,1,17,1,4,0,107
63728,682909,1,17,2,1,0,108
63729,682909,1,17,3,0,0,108
63730,682909,1,17,4,1,0,109
63731,682909,1,17,5,1,0,110
63732,682909,1,17,6,1,0,111
63733,682909,1,18,1,1,0,112
63734,682909,1,18,2,4,0,116
63735,682909,1,18,3,4,0,120
63736,682909,1,18,4,4,0,124
63737,682909,1,18,5,1,0,125
63738,682909,1,18,6,1,0,126
63739,682909,1,19,1,1,0,127
63740,682909,1,19,2,0,0,127
63741,682909,1,19,3,1,0,128
63742,682909,1,19,4,1,0,129
63743,682909,1,19,5,1,0,130
63744,682909,1,19,6,2,0,132
63745,682909,1,20,1,1,0,133
63746,682909,1,20,2,0,0,133
63747,682909,1,20,3,1,0,134
63748,682909,1,20,4,4,0,138
63749,682909,1,20,5,1,0,139
63750,682909,1,20,6,1,0,140
63871,682913,1,1,1,0,0,0
63872,682913,1,1,2,1,0,1
63873,682913,1,1,3,0,0,1
63874,682913,1,1,4,1,0,2
63875,682913,1,1,5,1,0,3
63876,682913,1,1,6,0,0,3
63877,682913,1,2,1,2,0,5
63878,682913,1,2,2,0,0,5
63879,682913,1,2,3,0,0,5
63880,682913,1,2,4,1,0,6
63881,682913,1,2,5,0,0,6
63882,682913,1,2,6,4,0,10
63883,682913,1,3,1,0,0,10
63884,682913,1,3,2,1,0,11
63885,682913,1,3,3,0,0,11
63886,682913,1,3,4,0,0,11
63887,682913,1,3,5,1,0,12
63888,682913,1,3,6,1,0,13
63889,682913,1,4,1,1,0,14
63890,682913,1,4,2,1,0,15
63891,682913,1,4,3,1,0,16
63892,682913,1,4,4,1,0,17
63893,682913,1,4,5,2,0,19
63894,682913,1,4,6,0,1,19
63895,682913,1,5,1,0,0,19
63896,682913,1,5,2,0,0,19
63897,682913,1,5,3,0,0,19
63898,682913,1,5,4,0,0,19
63899,682913,1,5,5,4,0,23
63900,682913,1,5,6,4,0,27
63901,682913,1,6,1,4,0,31
63902,682913,1,6,2,0,0,31
63903,682913,1,6,3,0,0,31
63904,682913,1,6,4,4,0,35
63905,682913,1,6,5,4,0,39
63906,682913,1,6,6,6,0,45
63907,682913,1,7,1,0,0,45
63908,682913,1,7,2,1,0,46
63909,682913,1,7,3,0,0,46
63910,682913,1,7,4,0,0,46
63911,682913,1,7,5,0,0,46
63912,682913,1,7,6,3,0,49
63913,682913,1,8,1,1,0,50
63914,682913,1,8,2,1,0,51
63915,682913,1,8,3,0,0,51
63916,682913,1,8,4,0,1,51
63917,682913,1,8,5,0,0,51
63918,682913,1,8,6,0,0,51
63919,682913,1,9,1,0,0,51
63920,682913,1,9,2,0,0,51
63921,682913,1,9,3,0,0,51
63922,682913,1,9,4,1,0,52
63923,682913,1,9,5,1,0,53
63924,682913,1,9,6,0,1,53
63925,682913,1,10,1,1,0,54
63926,682913,1,10,2,0,0,54
63927,682913,1,10,3,0,0,54
63928,682913,1,10,4,0,0,54
63929,682913,1,10,5,0,0,54
63930,682913,1,10,6,1,0,55
63931,682913,1,11,1,0,0,55
63932,682913,1,11,2,0,0,55
63933,682913,1,11,3,1,0,56
63934,682913,1,11,4,1,0,57
63935,682913,1,11,5,0,0,57
63936,682913,1,11,6,1,0,58
63937,682913,1,12,1,2,0,60
63938,682913,1,12,2,0,0,60
63939,682913,1,12,3,0,0,60
63940,682913,1,12,4,4,0,64
63941,682913,1,12,5,1,0,65
63942,682913,1,12,6,0,0,65
63943,682913,1,13,1,3,0,68
63944,682913,1,13,2,1,0,69
63945,682913,1,13,3,1,0,70
63946,682913,1,13,4,1,0,71
63947,682913,1,13,5,0,0,71
63948,682913,1,13,6,0,0,71
63949,682913,1,14,1,1,0,72
63950,682913,1,14,2,2,0,74
63951,682913,1,14,3,0,0,74
63952,682913,1,14,4,4,0,78
63953,682913,1,14,5,0,0,78
63954,682913,1,14,6,1,0,79
63955,682913,1,15,1,3,0,82
63956,682913,1,15,2,1,0,83
63957,682913,1,15,3,1,0,84
63958,682913,1,15,4,6,0,90
63959,682913,1,15,5,4,0,94
63960,682913,1,15,6,1,0,95
63961,682913,1,16,1,4,0,99
63962,682913,1,16,2,2,0,101
63963,682913,1,16,3,0,0,101
63964,682913,1,16,4,4,0,105
63965,682913,1,16,5,2,0,107
63966,682913,1,16,6,4,0,111
63967,682913,1,17,1,2,0,113
63968,682913,1,17,2,4,0,117
63969,682913,1,17,3,1,0,118
63970,682913,1,17,4,0,0,118
63971,682913,1,17,5,1,0,119
63972,682913,1,17,6,4,0,123
63973,682913,1,18,1,1,0,124
63974,682913,1,18,2,1,0,125
63975,682913,1,18,3,1,0,126
63976,682913,1,18,4,0,0,126
63977,682913,1,18,5,2,0,128
63978,682913,1,18,6,1,0,129
63979,682913,1,19,1,0,1,129
63980,682913,1,19,2,4,0,133
63981,682913,1,19,3,0,1,133
63982,682913,1,19,4,0,0,133
63983,682913,1,19,5,1,0,134
63984,682913,1,19,6,1,0,135
63985,682913,1,20,1,0,0,135
63986,682913,1,20,2,1,0,136
63987,682913,1,20,3,4,0,140
63988,682913,1,20,4,0,0,140
63989,682913,1,20,5,0,0,140
63990,682913,1,20,6,1,0,141
64111,682919,1,1,1,0,0,0
64112,682919,1,1,2,1,0,1
64113,682919,1,1,3,1,0,2
64114,682919,1,1,4,0,0,2
64115,682919,1,1,5,0,0,2
64116,682919,1,1,6,4,0,6
64117,682919,1,2,1,0,0,6
64118,682919,1,2,2,2,0,8
64119,682919,1,2,3,0,0,8
64120,682919,1,2,4,0,0,8
64121,682919,1,2,5,4,0,12
64122,682919,1,2,6,0,0,12
64123,682919,1,3,1,2,0,14
64124,682919,1,3,2,2,0,16
64125,682919,1,3,3,4,0,20
64126,682919,1,3,4,6,0,26
64127,682919,1,3,5,1,0,27
64128,682919,1,3,6,0,0,27
64129,682919,1,4,1,1,0,28
64130,682919,1,4,2,0,1,28
64131,682919,1,4,3,4,0,32
64132,682919,1,4,4,0,0,32
64133,682919,1,4,5,4,0,36
64134,682919,1,4,6,0,0,36
64135,682919,1,5,1,0,0,36
64136,682919,1,5,2,0,0,36
64137,682919,1,5,3,1,0,37
64138,682919,1,5,4,6,0,43
64139,682919,1,5,5,0,0,43
64140,682919,1,5,6,0,0,43
64141,682919,1,6,1,0,0,43
64142,682919,1,6,2,0,0,43
64143,682919,1,6,3,1,0,44
64144,682919,1,6,4,4,0,48
64145,682919,1,6,5,0,0,48
64146,682919,1,6,6,0,0,48
64147,682919,1,7,1,1,0,49
64148,682919,1,7,2,0,0,49
64149,682919,1,7,3,1,0,50
64150,682919,1,7,4,1,0,51
64151,682919,1,7,5,1,0,52
64152,682919,1,7,6,4,0,56
64153,682919,1,8,1,1,0,57
64154,682919,1,8,2,1,0,58
64155,682919,1,8,3,2,0,60
64156,682919,1,8,4,1,0,61
64157,682919,1,8,5,1,0,62
64158,682919,1,8,6,1,0,63
64159,682919,1,9,1,2,0,65
64160,682919,1,9,2,1,0,66
64161,682919,1,9,3,1,0,67
64162,682919,1,9,4,1,0,68
64163,682919,1,9,5,0,0,68
64164,682919,1,9,6,1,0,69
64165,682919,1,10,1,0,1,69
64166,682919,1,10,2,1,0,70
64167,682919,1,10,3,0,0,70
64168,682919,1,10,4,1,0,71
64169,682919,1,10,5,0,0,71
64170,682919,1,10,6,0,0,71
64171,682919,1,11,1,6,0,77
64172,682919,1,11,2,1,0,78
64173,682919,1,11,3,0,0,78
64174,682919,1,11,4,1,0,79
64175,682919,1,11,5,0,0,79
64176,682919,1,11,6,1,0,80
64177,682919,1,12,1,1,0,81
64178,682919,1,12,2,0,0,81
64179,682919,1,12,3,1,0,82
64180,682919,1,12,4,1,0,83
64181,682919,1,12,5,1,0,84
64182,682919,1,12,6,1,0,85
64183,682919,1,13,1,2,0,87
64184,682919,1,13,2,1,0,88
64185,682919,1,13,3,0,1,88
64186,682919,1,13,4,1,0,89
64187,682919,1,13,5,3,0,92
64188,682919,1,13,6,1,0,93
64189,682919,1,14,1,6,0,99
64190,682919,1,14,2,1,0,100
64191,682919,1,14,3,4,0,104
64192,682919,1,14,4,1,0,105
64193,682919,1,14,5,0,0,105
64194,682919,1,14,6,1,0,106
64195,682919,1,15,1,0,0,106
64196,682919,1,15,2,4,0,110
64197,682919,1,15,3,1,0,111
64198,682919,1,15,4,6,0,117
64199,682919,1,15,5,1,0,118
64200,682919,1,15,6,1,0,119
64201,682919,1,16,1,1,0,120
64202,682919,1,16,2,1,0,121
64203,682919,1,16,3,6,0,127
64204,682919,1,16,4,6,0,133
64205,682919,1,16,5,6,0,139
64206,682919,1,16,6,1,0,140
64207,682919,1,17,1,4,0,144
64208,682919,1,17,2,4,0,148
64209,682919,1,17,3,1,0,149
64210,682919,1,17,4,0,0,149
64211,682919,1,17,5,2,0,151
64212,682919,1,17,6,6,0,157
64213,682919,1,18,1,0,0,157
64214,682919,1,18,2,1,0,158
64215,682919,1,18,3,1,0,159
64216,682919,1,18,4,0,0,159
64217,682919,1,18,5,1,0,160
64218,682919,1,18,6,1,0,161
64219,682919,1,19,1,6,0,167
64220,682919,1,19,2,6,0,173
64221,682919,1,19,3,1,0,174
64222,682919,1,19,4,0,0,174
64223,682919,1,19,5,1,0,175
64224,682919,1,19,6,4,0,179
64225,682919,1,20,1,0,0,179
64226,682919,1,20,2,1,0,180
64227,682919,1,20,3,1,0,181
64228,682919,1,20,4,4,0,185
64229,682919,1,20,5,4,0,189
64230,682919,1,20,6,0,1,189
64314,682925,1,1,1,1,0,1
64315,682925,1,1,2,0,0,1
64316,682925,1,1,3,0,1,1
64317,682925,1,1,4,0,0,1
64318,682925,1,1,5,0,0,1
64319,682925,1,1,6,0,0,1
64320,682925,1,2,1,0,0,1
64321,682925,1,2,2,4,0,5
64322,682925,1,2,3,1,0,6
64323,682925,1,2,4,3,0,9
64324,682925,1,2,5,0,0,9
64325,682925,1,2,6,0,0,9
64326,682925,1,3,1,1,0,10
64327,682925,1,3,2,0,0,10
64328,682925,1,3,3,0,0,10
64329,682925,1,3,4,5,0,15
64330,682925,1,3,5,6,0,21
64331,682925,1,3,6,4,0,25
64332,682925,1,4,1,1,0,26
64333,682925,1,4,2,1,0,27
64334,682925,1,4,3,0,0,27
64335,682925,1,4,4,4,0,31
64336,682925,1,4,5,0,0,31
64337,682925,1,4,6,0,0,31
64338,682925,1,5,1,4,0,35
64339,682925,1,5,2,4,0,39
64340,682925,1,5,3,0,0,39
64341,682925,1,5,4,1,0,40
64342,682925,1,5,5,6,0,46
64343,682925,1,5,6,2,0,48
64344,682925,1,6,1,1,0,49
64345,682925,1,6,2,1,0,50
64346,682925,1,6,3,1,0,51
64347,682925,1,6,4,4,0,55
64348,682925,1,6,5,0,0,55
64349,682925,1,6,6,0,0,55
64350,682925,1,7,1,1,0,56
64351,682925,1,7,2,1,0,57
64352,682925,1,7,3,4,0,61
64353,682925,1,7,4,4,0,65
64354,682925,1,7,5,0,0,65
64355,682925,1,7,6,1,0,66
64356,682925,1,8,1,4,0,70
64357,682925,1,8,2,1,0,71
64358,682925,1,8,3,1,0,72
64359,682925,1,8,4,1,0,73
64360,682925,1,8,5,0,1,73
64361,682925,1,8,6,2,0,75
64362,682925,1,9,1,0,0,75
64363,682925,1,9,2,0,0,75
64364,682925,1,9,3,1,0,76
64365,682925,1,9,4,0,1,76
64366,682925,1,9,5,0,0,76
64367,682925,1,9,6,1,0,77
64368,682925,1,10,1,0,0,77
64369,682925,1,10,2,0,0,77
64370,682925,1,10,3,3,0,80
64371,682925,1,10,4,2,0,82
64372,682925,1,10,5,1,0,83
64373,682925,1,10,6,1,0,84
64374,682925,1,11,1,2,0,86
64375,682925,1,11,2,1,0,87
64376,682925,1,11,3,4,0,91
64377,682925,1,11,4,1,0,92
64378,682925,1,11,5,1,0,93
64379,682925,1,11,6,0,0,93
64380,682925,1,12,1,4,0,97
64381,682925,1,12,2,0,0,97
64382,682925,1,12,3,4,0,101
64383,682925,1,12,4,0,0,101
64384,682925,1,12,5,2,0,103
64385,682925,1,12,6,0,0,103
64386,682925,1,13,1,0,0,103
64387,682925,1,13,2,0,1,103
64388,682925,1,13,3,2,0,105
64389,682925,1,13,4,0,0,105
64390,682925,1,13,5,0,0,105
64391,682925,1,13,6,0,0,105
64392,682925,1,14,1,2,0,107
64393,682925,1,14,2,2,0,109
64394,682925,1,14,3,1,0,110
64395,682925,1,14,4,1,0,111
64396,682925,1,14,5,2,0,113
64397,682925,1,14,6,1,0,114
64398,682925,1,15,1,0,0,114
64399,682925,1,15,2,3,0,117
64400,682925,1,15,3,1,0,118
64401,682925,1,15,4,4,0,122
64402,682925,1,15,5,0,0,122
64403,682925,1,15,6,4,0,126
64404,682925,1,16,1,2,0,128
64405,682925,1,16,2,0,0,128
64406,682925,1,16,3,1,0,129
64407,682925,1,16,4,0,1,129
64408,682925,1,16,5,0,0,129
64409,682925,1,16,6,1,0,130
64410,682925,1,17,1,1,0,131
64411,682925,1,17,2,0,0,131
64412,682925,1,17,3,6,0,137
64413,682925,1,17,4,0,0,137
64414,682925,1,17,5,1,0,138
64415,682925,1,17,6,7,0,145
64416,682925,1,18,1,2,0,147
64417,682925,1,18,2,1,0,148
64418,682925,1,18,3,0,0,148
64419,682925,1,18,4,0,1,148
64420,682925,1,18,5,1,0,149
64421,682925,1,18,6,0,0,149
64422,682925,1,19,1,0,0,149
64423,682925,1,19,2,1,0,150
64424,682925,1,19,3,1,0,151
64425,682925,1,19,4,0,0,151
64426,682925,1,19,5,4,0,155
64427,682925,1,19,6,4,0,159
64428,682925,1,20,1,2,0,161
64429,682925,1,20,2,2,0,163
64430,682925,1,20,3,1,0,164
64431,682925,1,20,4,6,0,170
64432,682925,1,20,5,1,0,171
64433,682925,1,20,6,1,0,172
64466,682933,1,1,1,0,0,0
64467,682933,1,1,2,0,0,0
64468,682933,1,1,3,0,1,0
64469,682933,1,1,4,0,0,0
64470,682933,1,1,5,0,0,0
64471,682933,1,1,6,0,0,0
64472,682933,1,2,1,0,0,0
64473,682933,1,2,2,0,0,0
64474,682933,1,2,3,1,0,1
64475,682933,1,2,4,0,1,1
64476,682933,1,2,5,0,1,1
64477,682933,1,2,6,0,0,1
64478,682933,1,3,1,0,0,1
64479,682933,1,3,2,1,0,2
64480,682933,1,3,3,0,0,2
64481,682933,1,3,4,0,0,2
64482,682933,1,3,5,0,0,2
64483,682933,1,3,6,0,0,2
64484,682933,1,4,1,0,0,2
64485,682933,1,4,2,4,0,6
64486,682933,1,4,3,2,0,8
64487,682933,1,4,4,1,0,9
64488,682933,1,4,5,0,0,9
64489,682933,1,4,6,0,1,9
64490,682933,1,5,1,0,0,9
64491,682933,1,5,2,0,0,9
64492,682933,1,5,3,0,0,9
64493,682933,1,5,4,1,0,10
64494,682933,1,5,5,0,0,10
64495,682933,1,5,6,1,0,11
64496,682933,1,6,1,0,0,11
64497,682933,1,6,2,0,0,11
64498,682933,1,6,3,0,0,11
64499,682933,1,6,4,4,0,15
64500,682933,1,6,5,0,0,15
64501,682933,1,6,6,0,0,15
64502,682933,1,7,1,1,0,16
64503,682933,1,7,2,3,0,19
64504,682933,1,7,3,4,0,23
64505,682933,1,7,4,1,0,24
64506,682933,1,7,5,1,1,25
64507,682933,1,7,6,0,0,25
64508,682933,1,8,1,1,0,26
64509,682933,1,8,2,1,0,27
64510,682933,1,8,3,0,0,27
64511,682933,1,8,4,0,0,27
64512,682933,1,8,5,1,0,28
64513,682933,1,8,6,1,0,29
64514,682933,1,9,1,4,0,33
64515,682933,1,9,2,0,1,33
64516,682933,1,9,3,1,0,34
64517,682933,1,9,4,1,0,35
64518,682933,1,9,5,0,0,35
64519,682933,1,9,6,0,0,35
64520,682933,1,10,1,0,0,35
64521,682933,1,10,2,1,0,36
64522,682933,1,10,3,0,1,36
64523,682933,1,10,4,2,0,38
64524,682933,1,10,5,1,0,39
64525,682933,1,10,6,0,1,39
64526,682933,1,11,1,0,1,39
64527,682933,1,11,2,0,0,39
64528,682933,1,11,3,0,1,39
64559,682937,1,1,1,0,0,0
64560,682937,1,1,2,2,0,2
64561,682937,1,1,3,1,0,3
64562,682937,1,1,4,0,0,3
64563,682937,1,1,5,0,1,3
64564,682937,1,1,6,0,0,3
64565,682937,1,2,1,2,0,5
64566,682937,1,2,2,4,0,9
64567,682937,1,2,3,0,0,9
64568,682937,1,2,4,0,0,9
64569,682937,1,2,5,0,0,9
64570,682937,1,2,6,1,0,10
64571,682937,1,3,1,1,0,11
64572,682937,1,3,2,6,0,17
64573,682937,1,3,3,4,0,21
64574,682937,1,3,4,4,0,25
64575,682937,1,3,5,4,0,29
64576,682937,1,3,6,4,0,33
64577,682937,1,4,1,1,0,34
64578,682937,1,4,2,4,0,38
64579,682937,1,4,3,0,0,38
64580,682937,1,4,4,0,0,38
64581,682937,1,4,5,1,0,39
64582,682937,1,4,6,0,0,39
64583,682937,1,5,1,2,0,41
64584,682937,1,5,2,4,0,45
64585,682937,1,5,3,0,1,45
64586,682937,1,5,4,0,0,45
64587,682937,1,5,5,0,0,45
64588,682937,1,5,6,1,0,46
64589,682937,1,6,1,0,0,46
64590,682937,1,6,2,0,0,46
64591,682937,1,6,3,1,0,47
64592,682937,1,6,4,4,0,51
64593,682937,1,6,5,3,0,54
64594,682937,1,6,6,4,0,58
64595,682937,1,7,1,1,0,59
64596,682937,1,7,2,1,0,60
64597,682937,1,7,3,0,0,60
64598,682937,1,7,4,1,0,61
64599,682937,1,7,5,1,0,62
64600,682937,1,7,6,4,0,66
64601,682937,1,8,1,0,0,66
64602,682937,1,8,2,1,0,67
64603,682937,1,8,3,4,0,71
64604,682937,1,8,4,1,0,72
64605,682937,1,8,5,2,0,74
64606,682937,1,8,6,1,0,75
64607,682937,1,9,1,1,0,76
64608,682937,1,9,2,1,0,77
64609,682937,1,9,3,1,0,78
64610,682937,1,9,4,6,0,84
64611,682937,1,9,5,0,1,84
64612,682937,1,9,6,1,0,85
64613,682937,1,10,1,2,0,87
64614,682937,1,10,2,2,0,89
64615,682937,1,10,3,1,0,90
64616,682937,1,10,4,0,0,90
64617,682937,1,10,5,1,0,91
64618,682937,1,10,6,1,0,92
64619,682937,1,11,1,0,1,92
64620,682937,1,11,2,1,0,93
64621,682937,1,11,3,0,0,93
64622,682937,1,11,4,0,0,93
64623,682937,1,11,5,1,0,94
64624,682937,1,11,6,0,0,94
64625,682937,1,12,1,2,0,96
64626,682937,1,12,2,1,0,97
64627,682937,1,12,3,0,0,97
64628,682937,1,12,4,1,0,98
64629,682937,1,12,5,1,0,99
64630,682937,1,12,6,1,0,100
64631,682937,1,13,1,0,0,100
64632,682937,1,13,2,1,0,101
64633,682937,1,13,3,0,0,101
64634,682937,1,13,4,1,0,102
64635,682937,1,13,5,0,0,102
64636,682937,1,13,6,0,1,102
64637,682937,1,14,1,1,0,103
64638,682937,1,14,2,1,0,104
64639,682937,1,14,3,0,0,104
64640,682937,1,14,4,1,0,105
64641,682937,1,14,5,2,0,107
64642,682937,1,14,6,1,0,108
64643,682937,1,15,1,1,0,109
64644,682937,1,15,2,1,0,110
64645,682937,1,15,3,0,0,110
64646,682937,1,15,4,1,0,111
64647,682937,1,15,5,2,0,113
64648,682937,1,15,6,1,0,114
64649,682937,1,16,1,2,0,116
64650,682937,1,16,2,0,0,116
64651,682937,1,16,3,3,0,119
64652,682937,1,16,4,1,0,120
64653,682937,1,16,5,0,1,120
64654,682937,1,16,6,0,0,120
64655,682937,1,17,1,1,0,121
64656,682937,1,17,2,1,0,122
64657,682937,1,17,3,1,0,123
64658,682937,1,17,4,4,0,127
64659,682937,1,17,5,0,1,127
64660,682937,1,17,6,1,0,128
64661,682937,1,18,1,1,0,129
64662,682937,1,18,2,0,0,129
64663,682937,1,18,3,1,0,130
64664,682937,1,18,4,1,0,131
64665,682937,1,18,5,0,0,131
64666,682937,1,18,6,2,0,133
64667,682937,1,19,1,0,1,133
64668,682937,1,19,2,1,0,134
64669,682937,1,19,3,0,0,134
64670,682937,1,19,4,1,0,135
64671,682937,1,19,5,0,1,135
64672,682937,1,19,6,0,0,135
64673,682937,1,20,1,4,0,139
64674,682937,1,20,2,2,0,141
64675,682937,1,20,3,2,0,143
64676,682937,1,20,4,0,0,143
64677,682937,1,20,5,1,0,144
64678,682937,1,20,6,1,0,145
64791,682945,1,1,1,0,0,0
64792,682945,1,1,2,0,0,0
64793,682945,1,1,3,4,0,4
64794,682945,1,1,4,0,0,4
64795,682945,1,1,5,0,0,4
64796,682945,1,1,6,1,0,5
64797,682945,1,2,1,1,0,6
64798,682945,1,2,2,0,0,6
64799,682945,1,2,3,0,0,6
64800,682945,1,2,4,4,0,10
64801,682945,1,2,5,0,0,10
64802,682945,1,2,6,1,0,11
64803,682945,1,3,1,1,0,12
64804,682945,1,3,2,0,0,12
64805,682945,1,3,3,0,0,12
64806,682945,1,3,4,0,0,12
64807,682945,1,3,5,1,0,13
64808,682945,1,3,6,1,0,14
64809,682945,1,4,1,1,0,15
64810,682945,1,4,2,2,0,17
64811,682945,1,4,3,0,0,17
64812,682945,1,4,4,4,0,21
64813,682945,1,4,5,0,0,21
64814,682945,1,4,6,1,0,22
64815,682945,1,5,1,0,0,22
64816,682945,1,5,2,0,0,22
64817,682945,1,5,3,0,0,22
64818,682945,1,5,4,0,0,22
64819,682945,1,5,5,0,0,22
64820,682945,1,5,6,7,0,29
64821,682945,1,6,1,0,0,29
64822,682945,1,6,2,4,0,33
64823,682945,1,6,3,0,0,33
64824,682945,1,6,4,1,0,34
64825,682945,1,6,5,0,1,34
64826,682945,1,6,6,3,0,37
64827,682945,1,7,1,0,0,37
64828,682945,1,7,2,1,0,38
64829,682945,1,7,3,1,0,39
64830,682945,1,7,4,0,0,39
64831,682945,1,7,5,0,0,39
64832,682945,1,7,6,1,0,40
64833,682945,1,8,1,1,0,41
64834,682945,1,8,2,0,0,41
64835,682945,1,8,3,1,0,42
64836,682945,1,8,4,0,1,42
64837,682945,1,8,5,0,0,42
64838,682945,1,8,6,0,0,42
64839,682945,1,9,1,1,0,43
64840,682945,1,9,2,1,0,44
64841,682945,1,9,3,4,0,48
64842,682945,1,9,4,0,0,48
64843,682945,1,9,5,1,0,49
64844,682945,1,9,6,1,0,50
64845,682945,1,10,1,5,0,55
64846,682945,1,10,2,0,0,55
64847,682945,1,10,3,0,0,55
64848,682945,1,10,4,1,0,56
64849,682945,1,10,5,2,0,58
64850,682945,1,10,6,4,0,62
64851,682945,1,11,1,0,0,62
64852,682945,1,11,2,4,0,66
64853,682945,1,11,3,1,0,67
64854,682945,1,11,4,0,0,67
64855,682945,1,11,5,1,0,68
64856,682945,1,11,6,1,0,69
64857,682945,1,12,1,4,0,73
64858,682945,1,12,2,4,0,77
64859,682945,1,12,3,2,0,79
64860,682945,1,12,4,1,0,80
64861,682945,1,12,5,1,0,81
64862,682945,1,12,6,0,0,81
64863,682945,1,13,1,0,1,81
64864,682945,1,13,2,1,0,82
64865,682945,1,13,3,1,0,83
64866,682945,1,13,4,0,0,83
64867,682945,1,13,5,0,0,83
64868,682945,1,13,6,4,0,87
64869,682945,1,14,1,0,0,87
64870,682945,1,14,2,1,0,88
64871,682945,1,14,3,1,0,89
64872,682945,1,14,4,0,0,89
64873,682945,1,14,5,1,0,90
64874,682945,1,14,6,1,0,91
64875,682945,1,15,1,1,0,92
64876,682945,1,15,2,6,0,98
64877,682945,1,15,3,2,0,100
64878,682945,1,15,4,4,0,104
64879,682945,1,15,5,0,0,104
64880,682945,1,15,6,4,0,108
64881,682945,1,16,1,1,0,109
64882,682945,1,16,2,1,0,110
64883,682945,1,16,3,4,0,114
64884,682945,1,16,4,6,0,120
64885,682945,1,16,5,1,0,121
64886,682945,1,16,6,0,0,121
64887,682945,1,17,1,1,0,122
64888,682945,1,17,2,1,0,123
64889,682945,1,17,3,4,0,127
64890,682945,1,17,4,1,0,128
64891,682945,1,17,5,0,0,128
64892,682945,1,17,6,1,0,129
64893,682945,1,18,1,4,0,133
64894,682945,1,18,2,1,0,134
64895,682945,1,18,3,6,0,140
64896,682945,1,18,4,0,0,140
64897,682945,1,18,5,1,0,141
64898,682945,1,18,6,0,1,141
64899,682945,1,19,1,1,0,142
64900,682945,1,19,2,0,0,142
64901,682945,1,19,3,0,0,142
64902,682945,1,19,4,0,0,142
64903,682945,1,19,5,0,0,142
64904,682945,1,19,6,0,0,142
64905,682945,1,20,1,1,0,143
64906,682945,1,20,2,1,0,144
64907,682945,1,20,3,4,0,148
64908,682945,1,20,4,2,0,150
64909,682945,1,20,5,0,0,150
64910,682945,1,20,6,1,0,151
65025,682953,1,1,1,1,0,1
65026,682953,1,1,2,4,0,5
65027,682953,1,1,3,4,0,9
65028,682953,1,1,4,0,0,9
65029,682953,1,1,5,4,0,13
65030,682953,1,1,6,0,0,13
65031,682953,1,2,1,0,0,13
65032,682953,1,2,2,0,0,13
65033,682953,1,2,3,0,0,13
65034,682953,1,2,4,4,0,17
65035,682953,1,2,5,1,0,18
65036,682953,1,2,6,0,0,18
65037,682953,1,3,1,1,0,19
65038,682953,1,3,2,4,0,23
65039,682953,1,3,3,0,0,23
65040,682953,1,3,4,1,0,24
65041,682953,1,3,5,4,0,28
65042,682953,1,3,6,4,0,32
65043,682953,1,4,1,0,0,32
65044,682953,1,4,2,2,0,34
65045,682953,1,4,3,0,0,34
65046,682953,1,4,4,0,0,34
65047,682953,1,4,5,0,1,34
65048,682953,1,4,6,0,0,34
65049,682953,1,5,1,1,0,35
65050,682953,1,5,2,1,0,36
65051,682953,1,5,3,3,0,39
65052,682953,1,5,4,4,0,43
65053,682953,1,5,5,0,0,43
65054,682953,1,5,6,0,0,43
65055,682953,1,6,1,0,0,43
65056,682953,1,6,2,0,0,43
65057,682953,1,6,3,4,0,47
65058,682953,1,6,4,0,0,47
65059,682953,1,6,5,0,0,47
65060,682953,1,6,6,0,0,47
65061,682953,1,7,1,1,0,48
65062,682953,1,7,2,1,0,49
65063,682953,1,7,3,1,0,50
65064,682953,1,7,4,1,0,51
65065,682953,1,7,5,1,0,52
65066,682953,1,7,6,0,0,52
65067,682953,1,8,1,6,0,58
65068,682953,1,8,2,1,0,59
65069,682953,1,8,3,0,0,59
65070,682953,1,8,4,6,0,65
65071,682953,1,8,5,1,0,66
65072,682953,1,8,6,1,0,67
65073,682953,1,9,1,0,0,67
65074,682953,1,9,2,0,0,67
65075,682953,1,9,3,0,0,67
65076,682953,1,9,4,1,0,68
65077,682953,1,9,5,1,0,69
65078,682953,1,9,6,1,0,70
65079,682953,1,10,1,2,0,72
65080,682953,1,10,2,1,0,73
65081,682953,1,10,3,1,0,74
65082,682953,1,10,4,0,0,74
65083,682953,1,10,5,1,0,75
65084,682953,1,10,6,0,0,75
65085,682953,1,11,1,2,0,77
65086,682953,1,11,2,2,0,79
65087,682953,1,11,3,4,0,83
65088,682953,1,11,4,0,0,83
65089,682953,1,11,5,0,0,83
65090,682953,1,11,6,1,0,84
65091,682953,1,12,1,0,1,84
65092,682953,1,12,2,0,0,84
65093,682953,1,12,3,1,0,85
65094,682953,1,12,4,1,0,86
65095,682953,1,12,5,1,0,87
65096,682953,1,12,6,0,0,87
65097,682953,1,13,1,0,0,87
65098,682953,1,13,2,1,0,88
65099,682953,1,13,3,1,0,89
65100,682953,1,13,4,1,0,90
65101,682953,1,13,5,4,0,94
65102,682953,1,13,6,1,0,95
65103,682953,1,14,1,1,0,96
65104,682953,1,14,2,0,0,96
65105,682953,1,14,3,1,0,97
65106,682953,1,14,4,0,0,97
65107,682953,1,14,5,2,0,99
65108,682953,1,14,6,1,0,100
65109,682953,1,15,1,1,0,101
65110,682953,1,15,2,1,0,102
65111,682953,1,15,3,1,0,103
65112,682953,1,15,4,1,0,104
65113,682953,1,15,5,2,0,106
65114,682953,1,15,6,0,0,106
65115,682953,1,16,1,1,0,107
65116,682953,1,16,2,1,0,108
65117,682953,1,16,3,0,0,108
65118,682953,1,16,4,1,0,109
65119,682953,1,16,5,1,0,110
65120,682953,1,16,6,0,0,110
65121,682953,1,17,1,0,1,110
65122,682953,1,17,2,0,0,110
65123,682953,1,17,3,1,0,111
65124,682953,1,17,4,0,0,111
65125,682953,1,17,5,4,0,115
65126,682953,1,17,6,0,0,115
65127,682953,1,18,1,1,0,116
65128,682953,1,18,2,1,0,117
65129,682953,1,18,3,1,0,118
65130,682953,1,18,4,0,0,118
65131,682953,1,18,5,0,0,118
65132,682953,1,18,6,0,0,118
65133,682953,1,19,1,3,0,121
65134,682953,1,19,2,6,0,127
65135,682953,1,19,3,1,0,128
65136,682953,1,19,4,0,0,128
65137,682953,1,19,5,2,0,130
65138,682953,1,19,6,1,1,131
65139,682953,1,20,1,0,0,131
65140,682953,1,20,2,0,1,131
65141,682953,1,20,3,0,0,131
65142,682953,1,20,4,1,0,132
65143,682953,1,20,5,0,0,132
65144,682953,1,20,6,1,0,133
65251,682957,1,1,1,1,0,1
65252,682957,1,1,2,0,0,1
65253,682957,1,1,3,0,0,1
65254,682957,1,1,4,0,0,1
65255,682957,1,1,5,0,0,1
65256,682957,1,1,6,0,0,1
65257,682957,1,2,1,0,0,1
65258,682957,1,2,2,1,0,2
65259,682957,1,2,3,2,0,4
65260,682957,1,2,4,0,1,4
65261,682957,1,2,5,0,0,4
65262,682957,1,2,6,0,0,4
65263,682957,1,3,1,1,0,5
65264,682957,1,3,2,0,0,5
65265,682957,1,3,3,0,0,5
65266,682957,1,3,4,0,0,5
65267,682957,1,3,5,3,0,8
65268,682957,1,3,6,4,0,12
65269,682957,1,4,1,0,0,12
65270,682957,1,4,2,0,1,12
65271,682957,1,4,3,0,0,12
65272,682957,1,4,4,1,0,13
65273,682957,1,4,5,0,0,13
65274,682957,1,4,6,0,0,13
65275,682957,1,5,1,0,0,13
65276,682957,1,5,2,0,0,13
65277,682957,1,5,3,1,0,14
65278,682957,1,5,4,6,0,20
65279,682957,1,5,5,0,0,20
65280,682957,1,5,6,1,0,21
65281,682957,1,6,1,0,0,21
65282,682957,1,6,2,0,0,21
65283,682957,1,6,3,0,0,21
65284,682957,1,6,4,4,0,25
65285,682957,1,6,5,6,0,31
65286,682957,1,6,6,1,0,32
65287,682957,1,7,1,4,0,36
65288,682957,1,7,2,1,0,37
65289,682957,1,7,3,4,0,41
65290,682957,1,7,4,1,0,42
65291,682957,1,7,5,0,0,42
65292,682957,1,7,6,1,0,43
65293,682957,1,8,1,1,0,44
65294,682957,1,8,2,1,0,45
65295,682957,1,8,3,1,0,46
65296,682957,1,8,4,1,0,47
65297,682957,1,8,5,4,0,51
65298,682957,1,8,6,0,0,51
65299,682957,1,9,1,1,0,52
65300,682957,1,9,2,1,0,53
65301,682957,1,9,3,0,0,53
65302,682957,1,9,4,1,0,54
65303,682957,1,9,5,0,0,54
65304,682957,1,9,6,1,0,55
65305,682957,1,10,1,1,0,56
65306,682957,1,10,2,1,0,57
65307,682957,1,10,3,2,0,59
65308,682957,1,10,4,4,0,63
65309,682957,1,10,5,1,0,64
65310,682957,1,10,6,4,0,68
65311,682957,1,11,1,1,0,69
65312,682957,1,11,2,1,0,70
65313,682957,1,11,3,1,0,71
65314,682957,1,11,4,6,0,77
65315,682957,1,11,5,1,0,78
65316,682957,1,11,6,1,0,79
65317,682957,1,12,1,2,0,81
65318,682957,1,12,2,1,0,82
65319,682957,1,12,3,1,0,83
65320,682957,1,12,4,1,0,84
65321,682957,1,12,5,4,0,88
65322,682957,1,12,6,0,0,88
65323,682957,1,13,1,1,0,89
65324,682957,1,13,2,1,0,90
65325,682957,1,13,3,1,0,91
65326,682957,1,13,4,0,0,91
65327,682957,1,13,5,2,0,93
65328,682957,1,13,6,4,0,97
65329,682957,1,14,1,1,0,98
65330,682957,1,14,2,0,0,98
65331,682957,1,14,3,1,0,99
65332,682957,1,14,4,0,0,99
65333,682957,1,14,5,1,0,100
65334,682957,1,14,6,8,0,108
65335,682957,1,15,1,1,0,109
65336,682957,1,15,2,1,0,110
65337,682957,1,15,3,0,0,110
65338,682957,1,15,4,1,0,111
65339,682957,1,15,5,1,0,112
65340,682957,1,15,6,4,0,116
65341,682957,1,16,1,1,0,117
65342,682957,1,16,2,2,0,119
65343,682957,1,16,3,1,0,120
65344,682957,1,16,4,2,0,122
65345,682957,1,16,5,1,0,123
65346,682957,1,16,6,0,0,123
65347,682957,1,17,1,1,0,124
65348,682957,1,17,2,0,1,124
65349,682957,1,17,3,2,0,126
65350,682957,1,17,4,1,0,127
65351,682957,1,17,5,0,0,127
65352,682957,1,17,6,2,0,129
65353,682957,1,18,1,0,0,129
65354,682957,1,18,2,4,0,133
65355,682957,1,18,3,0,1,133
65356,682957,1,18,4,0,0,133
65357,682957,1,18,5,1,0,134
65358,682957,1,18,6,1,0,135
65359,682957,1,19,1,4,0,139
65360,682957,1,19,2,1,0,140
65361,682957,1,19,3,1,0,141
65362,682957,1,19,4,1,0,142
65363,682957,1,19,5,1,0,143
65364,682957,1,19,6,1,0,144
65365,682957,1,20,1,1,0,145
65366,682957,1,20,2,1,0,146
65367,682957,1,20,3,1,0,147
65368,682957,1,20,4,4,0,151
65369,682957,1,20,5,2,0,153
65370,682957,1,20,6,0,1,153
65476,682959,1,1,1,0,0,0
65477,682959,1,1,2,0,0,0
65478,682959,1,1,3,4,0,4
65479,682959,1,1,4,0,0,4
65480,682959,1,1,5,0,0,4
65481,682959,1,1,6,0,0,4
65482,682959,1,2,1,5,0,9
65483,682959,1,2,2,0,0,9
65484,682959,1,2,3,1,0,10
65485,682959,1,2,4,0,0,10
65486,682959,1,2,5,0,0,10
65487,682959,1,2,6,0,0,10
65488,682959,1,3,1,0,1,10
65489,682959,1,3,2,0,0,10
65490,682959,1,3,3,4,0,14
65491,682959,1,3,4,3,0,17
65492,682959,1,3,5,4,0,21
65493,682959,1,3,6,0,0,21
65494,682959,1,4,1,0,0,21
65495,682959,1,4,2,0,0,21
65496,682959,1,4,3,1,0,22
65497,682959,1,4,4,0,0,22
65498,682959,1,4,5,0,1,22
65499,682959,1,4,6,0,0,22
65500,682959,1,5,1,0,0,22
65501,682959,1,5,2,0,0,22
65502,682959,1,5,3,6,0,28
65503,682959,1,5,4,4,0,32
65504,682959,1,5,5,0,0,32
65505,682959,1,5,6,0,0,32
65506,682959,1,6,1,0,0,32
65507,682959,1,6,2,1,0,33
65508,682959,1,6,3,1,0,34
65509,682959,1,6,4,4,0,38
65510,682959,1,6,5,1,0,39
65511,682959,1,6,6,0,0,39
65512,682959,1,7,1,0,0,39
65513,682959,1,7,2,1,0,40
65514,682959,1,7,3,0,0,40
65515,682959,1,7,4,0,0,40
65516,682959,1,7,5,1,0,41
65517,682959,1,7,6,2,0,43
65518,682959,1,8,1,1,0,44
65519,682959,1,8,2,1,0,45
65520,682959,1,8,3,0,0,45
65521,682959,1,8,4,0,0,45
65522,682959,1,8,5,6,0,51
65523,682959,1,8,6,0,0,51
65524,682959,1,9,1,0,0,51
65525,682959,1,9,2,1,0,52
65526,682959,1,9,3,2,0,54
65527,682959,1,9,4,1,0,55
65528,682959,1,9,5,2,0,57
65529,682959,1,9,6,1,0,58
65530,682959,1,10,1,1,0,59
65531,682959,1,10,2,1,0,60
65532,682959,1,10,3,0,0,60
65533,682959,1,10,4,0,0,60
65534,682959,1,10,5,1,0,61
65535,682959,1,10,6,0,0,61
65536,682959,1,11,1,0,1,61
65537,682959,1,11,2,0,0,61
65538,682959,1,11,3,6,0,67
65539,682959,1,11,4,0,1,67
65540,682959,1,11,5,0,0,67
65541,682959,1,11,6,2,0,69
65542,682959,1,12,1,1,0,70
65543,682959,1,12,2,1,0,71
65544,682959,1,12,3,1,0,72
65545,682959,1,12,4,0,0,72
65546,682959,1,12,5,1,0,73
65547,682959,1,12,6,1,0,74
65548,682959,1,13,1,0,0,74
65549,682959,1,13,2,1,0,75
65550,682959,1,13,3,0,0,75
65551,682959,1,13,4,2,0,77
65552,682959,1,13,5,1,0,78
65553,682959,1,13,6,0,0,78
65554,682959,1,14,1,0,0,78
65555,682959,1,14,2,1,0,79
65556,682959,1,14,3,1,0,80
65557,682959,1,14,4,1,0,81
65558,682959,1,14,5,0,1,81
65559,682959,1,14,6,0,0,81
65560,682959,1,15,1,1,0,82
65561,682959,1,15,2,0,0,82
65562,682959,1,15,3,1,0,83
65563,682959,1,15,4,1,0,84
65564,682959,1,15,5,0,0,84
65565,682959,1,15,6,0,0,84
65566,682959,1,16,1,4,0,88
65567,682959,1,16,2,0,0,88
65568,682959,1,16,3,0,0,88
65569,682959,1,16,4,2,0,90
65570,682959,1,16,5,4,0,94
65571,682959,1,16,6,1,0,95
65572,682959,1,17,1,1,0,96
65573,682959,1,17,2,1,0,97
65574,682959,1,17,3,4,0,101
65575,682959,1,17,4,0,0,101
65576,682959,1,17,5,2,0,103
65577,682959,1,17,6,4,0,107
65578,682959,1,18,1,6,0,113
65579,682959,1,18,2,6,0,119
65580,682959,1,18,3,1,0,120
65581,682959,1,18,4,4,0,124
65582,682959,1,18,5,2,0,126
65583,682959,1,18,6,2,0,128
65584,682959,1,19,1,1,0,129
65585,682959,1,19,2,6,0,135
65586,682959,1,19,3,6,0,141
65587,682959,1,19,4,1,0,142
65588,682959,1,19,5,6,0,148
65589,682959,1,19,6,4,0,152
65590,682959,1,20,1,0,1,152
65591,682959,1,20,2,4,0,156
65592,682959,1,20,3,0,0,156
65593,682959,1,20,4,6,0,162
65594,682959,1,20,5,2,0,164
65595,682959,1,20,6,2,0,166
65703,682961,1,1,1,1,0,1
65704,682961,1,1,2,0,0,1
65705,682961,1,1,3,4,0,5
65706,682961,1,1,4,0,0,5
65707,682961,1,1,5,0,0,5
65708,682961,1,1,6,0,0,5
65709,682961,1,2,1,2,0,7
65710,682961,1,2,2,4,0,11
65711,682961,1,2,3,2,0,13
65712,682961,1,2,4,4,0,17
65713,682961,1,2,5,0,0,17
65714,682961,1,2,6,0,0,17
65715,682961,1,3,1,6,0,23
65716,682961,1,3,2,0,0,23
65717,682961,1,3,3,1,0,24
65718,682961,1,3,4,1,0,25
65719,682961,1,3,5,1,0,26
65720,682961,1,3,6,6,0,32
65721,682961,1,4,1,0,0,32
65722,682961,1,4,2,1,0,33
65723,682961,1,4,3,6,0,39
65724,682961,1,4,4,1,0,40
65725,682961,1,4,5,1,0,41
65726,682961,1,4,6,0,1,41
65727,682961,1,5,1,0,0,41
65728,682961,1,5,2,0,1,41
65729,682961,1,5,3,0,0,41
65730,682961,1,5,4,1,0,42
65731,682961,1,5,5,1,0,43
65732,682961,1,5,6,0,0,43
65733,682961,1,6,1,1,0,44
65734,682961,1,6,2,1,0,45
65735,682961,1,6,3,0,0,45
65736,682961,1,6,4,2,0,47
65737,682961,1,6,5,1,0,48
65738,682961,1,6,6,0,0,48
65739,682961,1,7,1,1,0,49
65740,682961,1,7,2,0,1,49
65741,682961,1,7,3,0,0,49
65742,682961,1,7,4,0,0,49
65743,682961,1,7,5,0,0,49
65744,682961,1,7,6,1,0,50
65745,682961,1,8,1,0,0,50
65746,682961,1,8,2,1,0,51
65747,682961,1,8,3,1,0,52
65748,682961,1,8,4,1,0,53
65749,682961,1,8,5,0,0,53
65750,682961,1,8,6,1,0,54
65751,682961,1,9,1,4,0,58
65752,682961,1,9,2,0,0,58
65753,682961,1,9,3,2,0,60
65754,682961,1,9,4,0,0,60
65755,682961,1,9,5,1,0,61
65756,682961,1,9,6,1,0,62
65757,682961,1,10,1,1,0,63
65758,682961,1,10,2,1,0,64
65759,682961,1,10,3,0,0,64
65760,682961,1,10,4,0,0,64
65761,682961,1,10,5,0,0,64
65762,682961,1,10,6,1,0,65
65763,682961,1,11,1,4,0,69
65764,682961,1,11,2,2,0,71
65765,682961,1,11,3,1,0,72
65766,682961,1,11,4,1,0,73
65767,682961,1,11,5,0,0,73
65768,682961,1,11,6,1,0,74
65769,682961,1,12,1,1,0,75
65770,682961,1,12,2,1,0,76
65771,682961,1,12,3,1,0,77
65772,682961,1,12,4,1,0,78
65773,682961,1,12,5,6,0,84
65774,682961,1,12,6,0,0,84
65775,682961,1,13,1,0,0,84
65776,682961,1,13,2,1,0,85
65777,682961,1,13,3,0,0,85
65778,682961,1,13,4,1,0,86
65779,682961,1,13,5,0,0,86
65780,682961,1,13,6,1,0,87
65781,682961,1,14,1,2,0,89
65782,682961,1,14,2,2,0,91
65783,682961,1,14,3,0,1,91
65784,682961,1,14,4,0,0,91
65785,682961,1,14,5,1,0,92
65786,682961,1,14,6,1,0,93
65787,682961,1,15,1,1,0,94
65788,682961,1,15,2,1,0,95
65789,682961,1,15,3,4,0,99
65790,682961,1,15,4,1,0,100
65791,682961,1,15,5,1,0,101
65792,682961,1,15,6,6,0,107
65793,682961,1,16,1,0,0,107
65794,682961,1,16,2,1,0,108
65795,682961,1,16,3,2,0,110
65796,682961,1,16,4,0,0,110
65797,682961,1,16,5,1,0,111
65798,682961,1,16,6,1,0,112
65799,682961,1,17,1,2,0,114
65800,682961,1,17,2,1,0,115
65801,682961,1,17,3,4,0,119
65802,682961,1,17,4,1,0,120
65803,682961,1,17,5,1,0,121
65804,682961,1,17,6,0,1,121
65805,682961,1,18,1,2,0,123
65806,682961,1,18,2,1,0,124
65807,682961,1,18,3,0,0,124
65808,682961,1,18,4,3,0,127
65809,682961,1,18,5,0,0,127
65810,682961,1,18,6,1,0,128
65811,682961,1,19,1,6,0,134
65812,682961,1,19,2,4,0,138
65813,682961,1,19,3,4,0,142
65814,682961,1,19,4,1,0,143
65815,682961,1,19,5,2,0,145
65816,682961,1,19,6,0,0,145
65817,682961,1,20,1,1,0,146
65818,682961,1,20,2,1,0,147
65819,682961,1,20,3,1,0,148
65820,682961,1,20,4,8,0,156
65821,682961,1,20,5,4,0,160
65822,682961,1,20,6,0,1,160
65906,682963,1,1,1,2,0,2
65907,682963,1,1,2,3,0,5
65908,682963,1,1,3,4,0,9
65909,682963,1,1,4,0,1,9
65910,682963,1,1,5,0,0,9
65911,682963,1,1,6,1,0,10
65912,682963,1,2,1,2,0,12
65913,682963,1,2,2,1,0,13
65914,682963,1,2,3,0,0,13
65915,682963,1,2,4,0,0,13
65916,682963,1,2,5,0,0,13
65917,682963,1,2,6,0,0,13
65918,682963,1,3,1,1,0,14
65919,682963,1,3,2,1,0,15
65920,682963,1,3,3,0,0,15
65921,682963,1,3,4,0,0,15
65922,682963,1,3,5,1,0,16
65923,682963,1,3,6,1,0,17
65924,682963,1,4,1,4,0,21
65925,682963,1,4,2,2,0,23
65926,682963,1,4,3,4,0,27
65927,682963,1,4,4,1,0,28
65928,682963,1,4,5,4,0,32
65929,682963,1,4,6,2,0,34
65930,682963,1,5,1,4,0,38
65931,682963,1,5,2,0,0,38
65932,682963,1,5,3,0,0,38
65933,682963,1,5,4,4,0,42
65934,682963,1,5,5,1,0,43
65935,682963,1,5,6,0,0,43
65936,682963,1,6,1,1,1,44
65937,682963,1,6,2,0,0,44
65938,682963,1,6,3,0,0,44
65939,682963,1,6,4,0,0,44
65940,682963,1,6,5,0,0,44
65941,682963,1,6,6,0,0,44
65942,682963,1,7,1,1,0,45
65943,682963,1,7,2,1,0,46
65944,682963,1,7,3,1,0,47
65945,682963,1,7,4,0,0,47
65946,682963,1,7,5,0,0,47
65947,682963,1,7,6,0,0,47
65948,682963,1,8,1,2,0,49
65949,682963,1,8,2,2,0,51
65950,682963,1,8,3,1,0,52
65951,682963,1,8,4,0,0,52
65952,682963,1,8,5,0,0,52
65953,682963,1,8,6,1,0,53
65954,682963,1,9,1,1,0,54
65955,682963,1,9,2,1,0,55
65956,682963,1,9,3,1,0,56
65957,682963,1,9,4,1,0,57
65958,682963,1,9,5,1,0,58
65959,682963,1,9,6,0,0,58
65960,682963,1,10,1,0,0,58
65961,682963,1,10,2,4,0,62
65962,682963,1,10,3,1,0,63
65963,682963,1,10,4,1,0,64
65964,682963,1,10,5,1,0,65
65965,682963,1,10,6,1,0,66
65966,682963,1,11,1,1,0,67
65967,682963,1,11,2,0,0,67
65968,682963,1,11,3,5,0,72
65969,682963,1,11,4,0,0,72
65970,682963,1,11,5,1,0,73
65971,682963,1,11,6,1,0,74
65972,682963,1,12,1,1,0,75
65973,682963,1,12,2,2,0,77
65974,682963,1,12,3,4,0,81
65975,682963,1,12,4,2,0,83
65976,682963,1,12,5,6,0,89
65977,682963,1,12,6,1,0,90
65978,682963,1,13,1,4,0,94
65979,682963,1,13,2,1,0,95
65980,682963,1,13,3,6,0,101
65981,682963,1,13,4,1,0,102
65982,682963,1,13,5,1,0,103
65983,682963,1,13,6,4,0,107
65984,682963,1,14,1,0,0,107
65985,682963,1,14,2,6,0,113
65986,682963,1,14,3,1,0,114
65987,682963,1,14,4,1,0,115
65988,682963,1,14,5,0,1,115
65989,682963,1,14,6,1,0,116
65990,682963,1,15,1,2,0,118
65991,682963,1,15,2,0,0,118
65992,682963,1,15,3,2,0,120
65993,682963,1,15,4,4,0,124
65994,682963,1,15,5,1,0,125
65995,682963,1,15,6,2,0,127
65996,682963,1,16,1,1,0,128
65997,682963,1,16,2,1,0,129
65998,682963,1,16,3,0,1,129
65999,682963,1,16,4,0,0,129
66000,682963,1,16,5,0,0,129
66001,682963,1,16,6,1,0,130
66002,682963,1,17,1,1,0,131
66003,682963,1,17,2,1,0,132
66004,682963,1,17,3,1,0,133
66005,682963,1,17,4,1,0,134
66006,682963,1,17,5,1,0,135
66007,682963,1,17,6,1,0,136
66008,682963,1,18,1,1,0,137
66009,682963,1,18,2,0,0,137
66010,682963,1,18,3,6,0,143
66011,682963,1,18,4,1,0,144
66012,682963,1,18,5,1,0,145
66013,682963,1,18,6,1,0,146
66014,682963,1,19,1,0,0,146
66015,682963,1,19,2,0,0,146
66016,682963,1,19,3,6,0,152
66017,682963,1,19,4,1,0,153
66018,682963,1,19,5,4,0,157
66019,682963,1,19,6,1,0,158
66020,682963,1,20,1,1,0,159
66021,682963,1,20,2,1,0,160
66022,682963,1,20,3,6,0,166
66023,682963,1,20,4,0,0,166
66024,682963,1,20,5,4,0,170
66025,682963,1,20,6,2,0,172
66141,682965,1,1,1,1,0,1
66142,682965,1,1,2,0,0,1
66143,682965,1,1,3,0,0,1
66144,682965,1,1,4,2,0,3
66145,682965,1,1,5,0,0,3
66146,682965,1,1,6,1,0,4
66147,682965,1,2,1,0,0,4
66148,682965,1,2,2,0,0,4
66149,682965,1,2,3,0,1,4
66150,682965,1,2,4,0,0,4
66151,682965,1,2,5,0,0,4
66152,682965,1,2,6,1,0,5
66153,682965,1,3,1,4,0,9
66154,682965,1,3,2,0,0,9
66155,682965,1,3,3,0,0,9
66156,682965,1,3,4,0,0,9
66157,682965,1,3,5,1,0,10
66158,682965,1,3,6,1,0,11
66159,682965,1,4,1,1,0,12
66160,682965,1,4,2,1,0,13
66161,682965,1,4,3,0,0,13
66162,682965,1,4,4,1,0,14
66163,682965,1,4,5,1,0,15
66164,682965,1,4,6,0,0,15
66165,682965,1,5,1,1,0,16
66166,682965,1,5,2,4,0,20
66167,682965,1,5,3,3,0,23
66168,682965,1,5,4,0,0,23
66169,682965,1,5,5,0,0,23
66170,682965,1,5,6,0,0,23
66171,682965,1,6,1,1,0,24
66172,682965,1,6,2,1,0,25
66173,682965,1,6,3,1,0,26
66174,682965,1,6,4,1,0,27
66175,682965,1,6,5,0,0,27
66176,682965,1,6,6,4,0,31
66177,682965,1,7,1,1,0,32
66178,682965,1,7,2,0,0,32
66179,682965,1,7,3,1,0,33
66180,682965,1,7,4,1,0,34
66181,682965,1,7,5,1,0,35
66182,682965,1,7,6,6,0,41
66183,682965,1,8,1,1,0,42
66184,682965,1,8,2,0,0,42
66185,682965,1,8,3,1,0,43
66186,682965,1,8,4,2,0,45
66187,682965,1,8,5,1,0,46
66188,682965,1,8,6,1,0,47
66189,682965,1,9,1,1,0,48
66190,682965,1,9,2,0,0,48
66191,682965,1,9,3,1,0,49
66192,682965,1,9,4,0,0,49
66193,682965,1,9,5,0,0,49
66194,682965,1,9,6,1,0,50
66195,682965,1,10,1,1,0,51
66196,682965,1,10,2,1,0,52
66197,682965,1,10,3,1,0,53
66198,682965,1,10,4,4,0,57
66199,682965,1,10,5,1,0,58
66200,682965,1,10,6,6,0,64
66201,682965,1,11,1,0,0,64
66202,682965,1,11,2,0,0,64
66203,682965,1,11,3,0,1,64
66204,682965,1,11,4,1,0,65
66205,682965,1,11,5,0,0,65
66206,682965,1,11,6,0,0,65
66207,682965,1,12,1,1,0,66
66208,682965,1,12,2,0,0,66
66209,682965,1,12,3,2,0,68
66210,682965,1,12,4,4,0,72
66211,682965,1,12,5,0,0,72
66212,682965,1,12,6,1,0,73
66213,682965,1,13,1,6,0,79
66214,682965,1,13,2,0,0,79
66215,682965,1,13,3,2,0,81
66216,682965,1,13,4,0,0,81
66217,682965,1,13,5,1,0,82
66218,682965,1,13,6,1,0,83
66219,682965,1,14,1,1,0,84
66220,682965,1,14,2,1,0,85
66221,682965,1,14,3,2,0,87
66222,682965,1,14,4,1,0,88
66223,682965,1,14,5,1,0,89
66224,682965,1,14,6,4,0,93
66225,682965,1,15,1,0,0,93
66226,682965,1,15,2,0,0,93
66227,682965,1,15,3,1,0,94
66228,682965,1,15,4,1,0,95
66229,682965,1,15,5,0,0,95
66230,682965,1,15,6,0,0,95
66231,682965,1,16,1,6,0,101
66232,682965,1,16,2,4,0,105
66233,682965,1,16,3,4,0,109
66234,682965,1,16,4,1,0,110
66235,682965,1,16,5,1,0,111
66236,682965,1,16,6,0,0,111
66237,682965,1,17,1,0,0,111
66238,682965,1,17,2,0,0,111
66239,682965,1,17,3,1,0,112
66240,682965,1,17,4,1,0,113
66241,682965,1,17,5,1,0,114
66242,682965,1,17,6,1,0,115
66243,682965,1,18,1,1,0,116
66244,682965,1,18,2,0,0,116
66245,682965,1,18,3,1,0,117
66246,682965,1,18,4,1,0,118
66247,682965,1,18,5,0,0,118
66248,682965,1,18,6,1,0,119
66249,682965,1,19,1,0,1,119
66250,682965,1,19,2,1,0,120
66251,682965,1,19,3,1,0,121
66252,682965,1,19,4,0,0,121
66253,682965,1,19,5,1,0,122
66254,682965,1,19,6,1,0,123
66255,682965,1,20,1,0,0,123
66256,682965,1,20,2,3,0,126
66257,682965,1,20,3,0,0,126
66258,682965,1,20,4,2,0,128
66259,682965,1,20,5,1,0,129
66260,682965,1,20,6,1,1,130
66368,685727,1,1,1,0,0,0
66369,685727,1,1,2,4,0,4
66370,685727,1,1,3,1,0,5
66371,685727,1,1,4,0,0,5
66372,685727,1,1,5,4,0,9
66373,685727,1,1,6,0,0,9
66374,685727,1,2,1,0,0,9
66375,685727,1,2,2,2,0,11
66376,685727,1,2,3,1,0,12
66377,685727,1,2,4,1,0,13
66378,685727,1,2,5,0,0,13
66379,685727,1,2,6,0,0,13
66380,685727,1,3,1,0,0,13
66381,685727,1,3,2,4,0,17
66382,685727,1,3,3,0,0,17
66383,685727,1,3,4,4,0,21
66384,685727,1,3,5,1,0,22
66385,685727,1,3,6,4,0,26
66386,685727,1,4,1,4,0,30
66387,685727,1,4,2,4,0,34
66388,685727,1,4,3,1,0,35
66389,685727,1,4,4,5,0,40
66390,685727,1,4,5,0,0,40
66391,685727,1,4,6,1,0,41
66392,685727,1,5,1,0,0,41
66393,685727,1,5,2,4,0,45
66394,685727,1,5,3,4,0,49
66395,685727,1,5,4,0,0,49
66396,685727,1,5,5,4,0,53
66397,685727,1,5,6,0,0,53
66398,685727,1,6,1,1,0,54
66399,685727,1,6,2,0,0,54
66400,685727,1,6,3,1,0,55
66401,685727,1,6,4,4,0,59
66402,685727,1,6,5,1,0,60
66403,685727,1,6,6,0,0,60
66404,685727,1,7,1,1,0,61
66405,685727,1,7,2,4,0,65
66406,685727,1,7,3,1,0,66
66407,685727,1,7,4,0,0,66
66408,685727,1,7,5,1,0,67
66409,685727,1,7,6,2,0,69
66410,685727,1,8,1,0,0,69
66411,685727,1,8,2,1,0,70
66412,685727,1,8,3,1,0,71
66413,685727,1,8,4,1,0,72
66414,685727,1,8,5,0,1,72
66415,685727,1,8,6,1,0,73
66416,685727,1,9,1,1,0,74
66417,685727,1,9,2,1,0,75
66418,685727,1,9,3,0,0,75
66419,685727,1,9,4,1,0,76
66420,685727,1,9,5,1,0,77
66421,685727,1,9,6,0,0,77
66422,685727,1,10,1,0,0,77
66423,685727,1,10,2,0,0,77
66424,685727,1,10,3,4,0,81
66425,685727,1,10,4,0,1,81
66426,685727,1,10,5,1,0,82
66427,685727,1,10,6,1,0,83
66428,685727,1,11,1,0,0,83
66429,685727,1,11,2,1,0,84
66430,685727,1,11,3,1,0,85
66431,685727,1,11,4,1,0,86
66432,685727,1,11,5,1,0,87
66433,685727,1,11,6,0,1,87
66434,685727,1,12,1,0,0,87
66435,685727,1,12,2,1,0,88
66436,685727,1,12,3,0,0,88
66437,685727,1,12,4,0,0,88
66438,685727,1,12,5,4,0,92
66439,685727,1,12,6,1,0,93
66440,685727,1,13,1,0,0,93
66441,685727,1,13,2,1,0,94
66442,685727,1,13,3,1,0,95
66443,685727,1,13,4,1,0,96
66444,685727,1,13,5,1,0,97
66445,685727,1,13,6,1,0,98
66446,685727,1,14,1,1,0,99
66447,685727,1,14,2,1,0,100
66448,685727,1,14,3,1,0,101
66449,685727,1,14,4,2,0,103
66450,685727,1,14,5,2,0,105
66451,685727,1,14,6,1,0,106
66452,685727,1,15,1,0,0,106
66453,685727,1,15,2,1,0,107
66454,685727,1,15,3,0,0,107
66455,685727,1,15,4,0,0,107
66456,685727,1,15,5,0,0,107
66457,685727,1,15,6,0,0,107
66458,685727,1,16,1,1,0,108
66459,685727,1,16,2,1,0,109
66460,685727,1,16,3,1,0,110
66461,685727,1,16,4,0,1,110
66462,685727,1,16,5,0,0,110
66463,685727,1,16,6,1,0,111
66464,685727,1,17,1,1,0,112
66465,685727,1,17,2,4,0,116
66466,685727,1,17,3,0,1,116
66467,685727,1,17,4,0,0,116
66468,685727,1,17,5,0,0,116
66469,685727,1,17,6,1,0,117
66470,685727,1,18,1,1,0,118
66471,685727,1,18,2,0,0,118
66472,685727,1,18,3,6,0,124
66473,685727,1,18,4,4,0,128
66474,685727,1,18,5,1,0,129
66475,685727,1,18,6,5,1,134
66476,685727,1,19,1,1,0,135
66477,685727,1,19,2,4,0,139
66478,685727,1,19,3,0,0,139
66479,685727,1,19,4,1,0,140
66480,685727,1,19,5,0,0,140
66481,685727,1,19,6,0,1,140
66482,685727,1,20,1,1,0,141
66483,685727,1,20,2,0,0,141
66484,685727,1,20,3,4,0,145
66485,685727,1,20,4,4,0,149
66486,685727,1,20,5,0,0,149
66487,685727,1,20,6,4,0,153
66543,685729,1,1,1,0,0,0
66544,685729,1,1,2,0,0,0
66545,685729,1,1,3,1,0,1
66546,685729,1,1,4,0,0,1
66547,685729,1,1,5,0,0,1
66548,685729,1,1,6,2,0,3
66549,685729,1,2,1,0,0,3
66550,685729,1,2,2,0,0,3
66551,685729,1,2,3,0,0,3
66552,685729,1,2,4,1,0,4
66553,685729,1,2,5,0,0,4
66554,685729,1,2,6,0,0,4
66555,685729,1,3,1,4,0,8
66556,685729,1,3,2,0,0,8
66557,685729,1,3,3,0,0,8
66558,685729,1,3,4,4,0,12
66559,685729,1,3,5,1,0,13
66560,685729,1,3,6,0,0,13
66561,685729,1,4,1,4,0,17
66562,685729,1,4,2,1,0,18
66563,685729,1,4,3,0,0,18
66564,685729,1,4,4,0,0,18
66565,685729,1,4,5,6,0,24
66566,685729,1,4,6,1,0,25
66567,685729,1,5,1,0,1,25
66568,685729,1,5,2,0,0,25
66569,685729,1,5,3,0,0,25
66570,685729,1,5,4,0,0,25
66571,685729,1,5,5,0,0,25
66572,685729,1,5,6,0,0,25
66573,685729,1,6,1,1,0,26
66574,685729,1,6,2,1,0,27
66575,685729,1,6,3,0,0,27
66576,685729,1,6,4,1,0,28
66577,685729,1,6,5,2,0,30
66578,685729,1,6,6,0,0,30
66579,685729,1,7,1,1,0,31
66580,685729,1,7,2,9,0,40
66581,685729,1,7,3,0,0,40
66582,685729,1,7,4,0,0,40
66583,685729,1,7,5,2,0,42
66584,685729,1,7,6,1,0,43
66585,685729,1,8,1,1,0,44
66586,685729,1,8,2,0,1,44
66587,685729,1,8,3,0,0,44
66588,685729,1,8,4,1,0,45
66589,685729,1,8,5,0,0,45
66590,685729,1,8,6,1,0,46
66591,685729,1,9,1,0,0,46
66592,685729,1,9,2,2,0,48
66593,685729,1,9,3,1,0,49
66594,685729,1,9,4,1,0,50
66595,685729,1,9,5,1,0,51
66596,685729,1,9,6,2,0,53
66597,685729,1,10,1,0,0,53
66598,685729,1,10,2,4,0,57
66599,685729,1,10,3,2,0,59
66600,685729,1,10,4,1,0,60
66601,685729,1,10,5,1,0,61
66602,685729,1,10,6,1,0,62
66603,685729,1,11,1,4,0,66
66604,685729,1,11,2,1,0,67
66605,685729,1,11,3,0,0,67
66606,685729,1,11,4,1,0,68
66607,685729,1,11,5,1,0,69
66608,685729,1,11,6,0,0,69
66609,685729,1,12,1,6,0,75
66610,685729,1,12,2,6,0,81
66611,685729,1,12,3,1,0,82
66612,685729,1,12,4,6,0,88
66613,685729,1,12,5,2,0,90
66614,685729,1,12,6,0,0,90
66615,685729,1,13,1,1,0,91
66616,685729,1,13,2,1,0,92
66617,685729,1,13,3,4,0,96
66618,685729,1,13,4,1,0,97
66619,685729,1,13,5,0,0,97
66620,685729,1,13,6,0,0,97
66621,685729,1,14,1,4,0,101
66622,685729,1,14,2,1,0,102
66623,685729,1,14,3,1,0,103
66624,685729,1,14,4,1,0,104
66625,685729,1,14,5,4,0,108
66626,685729,1,14,6,1,0,109
66627,685729,1,15,1,0,0,109
66628,685729,1,15,2,6,0,115
66629,685729,1,15,3,4,0,119
66630,685729,1,15,4,6,0,125
66631,685729,1,15,5,2,0,127
66632,685729,1,15,6,4,0,131
66633,685729,1,16,1,0,0,131
66634,685729,1,16,2,1,0,132
66635,685729,1,16,3,1,0,133
66636,685729,1,16,4,7,0,140
66637,685729,1,16,5,4,0,144
66638,685729,1,16,6,1,0,145
66639,685729,1,17,1,0,0,145
66640,685729,1,17,2,1,0,146
66641,685729,1,17,3,0,1,146
66642,685729,1,17,4,4,0,150
66643,685729,1,17,5,1,0,151
66644,685729,1,17,6,1,0,152
66645,685729,1,18,1,0,0,152
66646,685729,1,18,2,0,0,152
66647,685729,1,18,3,1,0,153
66648,685729,1,18,4,1,0,154
66649,685729,1,18,5,1,0,155
66650,685729,1,18,6,0,0,155
66651,685729,1,19,1,4,0,159
66652,685729,1,19,2,1,0,160
66653,685729,1,19,3,1,0,161
66654,685729,1,19,4,3,0,164
66655,685729,1,19,5,1,0,165
66656,685729,1,19,6,2,0,167
66657,685729,1,20,1,0,0,167
66658,685729,1,20,2,4,0,171
66659,685729,1,20,3,1,0,172
66660,685729,1,20,4,0,1,172
66661,685729,1,20,5,0,0,172
66662,685729,1,20,6,4,0,176
66783,690351,1,1,1,2,0,2
66784,690351,1,1,2,4,0,6
66785,690351,1,1,3,1,0,7
66786,690351,1,1,4,0,0,7
66787,690351,1,1,5,0,0,7
66788,690351,1,1,6,0,1,7
66789,690351,1,2,1,2,0,9
66790,690351,1,2,2,0,0,9
66791,690351,1,2,3,4,0,13
66792,690351,1,2,4,0,0,13
66793,690351,1,2,5,0,0,13
66794,690351,1,2,6,1,0,14
66795,690351,1,3,1,0,0,14
66796,690351,1,3,2,4,0,18
66797,690351,1,3,3,2,0,20
66798,690351,1,3,4,0,0,20
66799,690351,1,3,5,1,0,21
66800,690351,1,3,6,0,0,21
66801,690351,1,4,1,4,0,25
66802,690351,1,4,2,4,0,29
66803,690351,1,4,3,4,0,33
66804,690351,1,4,4,4,0,37
66805,690351,1,4,5,1,0,38
66806,690351,1,4,6,1,0,39
66807,690351,1,5,1,1,0,40
66808,690351,1,5,2,1,0,41
66809,690351,1,5,3,6,0,47
66810,690351,1,5,4,4,0,51
66811,690351,1,5,5,4,0,55
66812,690351,1,5,6,1,0,56
66813,690351,1,6,1,0,0,56
66814,690351,1,6,2,0,0,56
66815,690351,1,6,3,0,0,56
66816,690351,1,6,4,0,0,56
66817,690351,1,6,5,1,0,57
66818,690351,1,6,6,1,0,58
66819,690351,1,7,1,1,0,59
66820,690351,1,7,2,0,0,59
66821,690351,1,7,3,1,0,60
66822,690351,1,7,4,1,0,61
66823,690351,1,7,5,0,1,61
66824,690351,1,7,6,1,0,62
66825,690351,1,8,1,5,0,67
66826,690351,1,8,2,1,0,68
66827,690351,1,8,3,0,0,68
66828,690351,1,8,4,4,0,72
66829,690351,1,8,5,1,0,73
66830,690351,1,8,6,4,0,77
66831,690351,1,9,1,0,1,77
66832,690351,1,9,2,0,0,77
66833,690351,1,9,3,1,0,78
66834,690351,1,9,4,1,0,79
66835,690351,1,9,5,2,0,81
66836,690351,1,9,6,1,0,82
66837,690351,1,10,1,1,0,83
66838,690351,1,10,2,2,0,85
66839,690351,1,10,3,1,0,86
66840,690351,1,10,4,1,0,87
66841,690351,1,10,5,0,1,87
66842,690351,1,10,6,0,0,87
66843,690351,1,11,1,1,0,88
66844,690351,1,11,2,1,0,89
66845,690351,1,11,3,3,0,92
66846,690351,1,11,4,1,0,93
66847,690351,1,11,5,1,0,94
66848,690351,1,11,6,1,0,95
66849,690351,1,12,1,1,0,96
66850,690351,1,12,2,0,0,96
66851,690351,1,12,3,3,0,99
66852,690351,1,12,4,1,0,100
66853,690351,1,12,5,1,0,101
66854,690351,1,12,6,1,0,102
66855,690351,1,13,1,1,0,103
66856,690351,1,13,2,2,0,105
66857,690351,1,13,3,6,0,111
66858,690351,1,13,4,0,0,111
66859,690351,1,13,5,1,0,112
66860,690351,1,13,6,2,0,114
66861,690351,1,14,1,1,0,115
66862,690351,1,14,2,1,0,116
66863,690351,1,14,3,0,1,116
66864,690351,1,14,4,1,0,117
66865,690351,1,14,5,1,0,118
66866,690351,1,14,6,1,0,119
66867,690351,1,15,1,0,0,119
66868,690351,1,15,2,1,0,120
66869,690351,1,15,3,0,1,120
66870,690351,1,15,4,0,0,120
66871,690351,1,15,5,2,0,122
66872,690351,1,15,6,1,0,123
66873,690351,1,16,1,1,0,124
66874,690351,1,16,2,1,0,125
66875,690351,1,16,3,1,0,126
66876,690351,1,16,4,1,0,127
66877,690351,1,16,5,0,0,127
66878,690351,1,16,6,0,0,127
66879,690351,1,17,1,1,0,128
66880,690351,1,17,2,1,0,129
66881,690351,1,17,3,2,0,131
66882,690351,1,17,4,1,0,132
66883,690351,1,17,5,1,0,133
66884,690351,1,17,6,2,0,135
66885,690351,1,18,1,4,0,139
66886,690351,1,18,2,1,0,140
66887,690351,1,18,3,1,0,141
66888,690351,1,18,4,1,0,142
66889,690351,1,18,5,2,0,144
66890,690351,1,18,6,1,0,145
66891,690351,1,19,1,1,0,146
66892,690351,1,19,2,1,0,147
66893,690351,1,19,3,6,0,153
66894,690351,1,19,4,1,0,154
66895,690351,1,19,5,1,0,155
66896,690351,1,19,6,1,0,156
66897,690351,1,20,1,6,0,162
66898,690351,1,20,2,1,0,163
66899,690351,1,20,3,1,0,164
66900,690351,1,20,4,0,1,164
66901,690351,1,20,5,2,0,166
66902,690351,1,20,6,2,0,168
67023,690353,1,1,1,1,0,1
67024,690353,1,1,2,0,0,1
67025,690353,1,1,3,1,0,2
67026,690353,1,1,4,1,0,3
67027,690353,1,1,5,0,1,3
67028,690353,1,1,6,0,0,3
67029,690353,1,2,1,0,0,3
67030,690353,1,2,2,0,1,3
67031,690353,1,2,3,4,0,7
67032,690353,1,2,4,0,0,7
67033,690353,1,2,5,4,0,11
67034,690353,1,2,6,4,0,15
67035,690353,1,3,1,0,0,15
67036,690353,1,3,2,4,0,19
67037,690353,1,3,3,0,0,19
67038,690353,1,3,4,6,0,25
67039,690353,1,3,5,4,0,29
67040,690353,1,3,6,6,0,35
67041,690353,1,4,1,0,0,35
67042,690353,1,4,2,0,1,35
67043,690353,1,4,3,1,0,36
67044,690353,1,4,4,1,0,37
67045,690353,1,4,5,1,0,38
67046,690353,1,4,6,0,0,38
67047,690353,1,5,1,0,0,38
67048,690353,1,5,2,0,0,38
67049,690353,1,5,3,0,0,38
67050,690353,1,5,4,0,0,38
67051,690353,1,5,5,0,0,38
67052,690353,1,5,6,1,0,39
67053,690353,1,6,1,1,0,40
67054,690353,1,6,2,1,0,41
67055,690353,1,6,3,0,1,41
67056,690353,1,6,4,1,0,42
67057,690353,1,6,5,0,0,42
67058,690353,1,6,6,0,0,42
67059,690353,1,7,1,0,0,42
67060,690353,1,7,2,2,0,44
67061,690353,1,7,3,0,0,44
67062,690353,1,7,4,0,0,44
67063,690353,1,7,5,0,0,44
67064,690353,1,7,6,1,0,45
67065,690353,1,8,1,2,0,47
67066,690353,1,8,2,0,0,47
67067,690353,1,8,3,0,1,47
67068,690353,1,8,4,0,0,47
67069,690353,1,8,5,0,0,47
67070,690353,1,8,6,2,0,49
67071,690353,1,9,1,1,0,50
67072,690353,1,9,2,4,0,54
67073,690353,1,9,3,0,0,54
67074,690353,1,9,4,0,0,54
67075,690353,1,9,5,1,0,55
67076,690353,1,9,6,0,0,55
67077,690353,1,10,1,0,0,55
67078,690353,1,10,2,1,0,56
67079,690353,1,10,3,0,0,56
67080,690353,1,10,4,1,0,57
67081,690353,1,10,5,1,0,58
67082,690353,1,10,6,1,0,59
67083,690353,1,11,1,0,0,59
67084,690353,1,11,2,0,0,59
67085,690353,1,11,3,0,1,59
67086,690353,1,11,4,2,0,61
67087,690353,1,11,5,1,0,62
67088,690353,1,11,6,1,0,63
67089,690353,1,12,1,0,0,63
67090,690353,1,12,2,0,0,63
67091,690353,1,12,3,0,0,63
67092,690353,1,12,4,0,0,63
67093,690353,1,12,5,3,0,66
67094,690353,1,12,6,0,0,66
67095,690353,1,13,1,4,0,70
67096,690353,1,13,2,0,0,70
67097,690353,1,13,3,0,0,70
67098,690353,1,13,4,0,0,70
67099,690353,1,13,5,0,0,70
67100,690353,1,13,6,0,0,70
67101,690353,1,14,1,2,0,72
67102,690353,1,14,2,0,0,72
67103,690353,1,14,3,0,0,72
67104,690353,1,14,4,0,0,72
67105,690353,1,14,5,1,0,73
67106,690353,1,14,6,1,0,74
67107,690353,1,15,1,1,0,75
67108,690353,1,15,2,1,0,76
67109,690353,1,15,3,2,0,78
67110,690353,1,15,4,1,0,79
67111,690353,1,15,5,1,1,80
67112,690353,1,15,6,4,0,84
67113,690353,1,16,1,0,0,84
67114,690353,1,16,2,1,0,85
67115,690353,1,16,3,0,0,85
67116,690353,1,16,4,1,0,86
67117,690353,1,16,5,1,0,87
67118,690353,1,16,6,4,0,91
67119,690353,1,17,1,0,0,91
67120,690353,1,17,2,1,0,92
67121,690353,1,17,3,0,0,92
67122,690353,1,17,4,0,0,92
67123,690353,1,17,5,4,0,96
67124,690353,1,17,6,4,0,100
67125,690353,1,18,1,1,0,101
67126,690353,1,18,2,0,0,101
67127,690353,1,18,3,0,1,101
67128,690353,1,18,4,1,0,102
67129,690353,1,18,5,0,0,102
67130,690353,1,18,6,4,0,106
67131,690353,1,19,1,1,0,107
67132,690353,1,19,2,4,0,111
67133,690353,1,19,3,2,0,113
67134,690353,1,19,4,1,0,114
67135,690353,1,19,5,0,0,114
67136,690353,1,19,6,0,0,114
67137,690353,1,20,1,2,0,116
67138,690353,1,20,2,4,0,120
67139,690353,1,20,3,0,1,120
67140,690353,1,20,4,0,0,120
67141,690353,1,20,5,0,1,120
67262,702141,1,1,1,0,0,0
67263,702141,1,1,2,0,0,0
67264,702141,1,1,3,0,0,0
67265,702141,1,1,4,6,0,6
67266,702141,1,1,5,0,0,6
67267,702141,1,1,6,0,0,6
67268,702141,1,2,1,0,0,6
67269,702141,1,2,2,0,0,6
67270,702141,1,2,3,1,0,7
67271,702141,1,2,4,1,0,8
67272,702141,1,2,5,0,0,8
67273,702141,1,2,6,1,0,9
67274,702141,1,3,1,0,0,9
67275,702141,1,3,2,1,0,10
67276,702141,1,3,3,0,0,10
67277,702141,1,3,4,6,0,16
67278,702141,1,3,5,1,0,17
67279,702141,1,3,6,1,0,18
67280,702141,1,4,1,4,0,22
67281,702141,1,4,2,0,0,22
67282,702141,1,4,3,4,0,26
67283,702141,1,4,4,1,0,27
67284,702141,1,4,5,0,0,27
67285,702141,1,4,6,0,0,27
67286,702141,1,5,1,1,0,28
67287,702141,1,5,2,3,1,31
67288,702141,1,5,3,1,0,32
67289,702141,1,5,4,1,0,33
67290,702141,1,5,5,1,0,34
67291,702141,1,5,6,0,0,34
67292,702141,1,6,1,4,0,38
67293,702141,1,6,2,0,0,38
67294,702141,1,6,3,0,1,38
67295,702141,1,6,4,0,0,38
67296,702141,1,6,5,0,0,38
67297,702141,1,6,6,0,0,38
67298,702141,1,7,1,0,0,38
67299,702141,1,7,2,0,0,38
67300,702141,1,7,3,1,0,39
67301,702141,1,7,4,0,0,39
67302,702141,1,7,5,0,0,39
67303,702141,1,7,6,0,0,39
67304,702141,1,8,1,0,0,39
67305,702141,1,8,2,0,0,39
67306,702141,1,8,3,1,0,40
67307,702141,1,8,4,1,0,41
67308,702141,1,8,5,0,0,41
67309,702141,1,8,6,1,0,42
67310,702141,1,9,1,1,0,43
67311,702141,1,9,2,1,0,44
67312,702141,1,9,3,0,0,44
67313,702141,1,9,4,6,0,50
67314,702141,1,9,5,1,0,51
67315,702141,1,9,6,1,0,52
67316,702141,1,10,1,1,0,53
67317,702141,1,10,2,4,0,57
67318,702141,1,10,3,1,0,58
67319,702141,1,10,4,0,0,58
67320,702141,1,10,5,0,0,58
67321,702141,1,10,6,0,0,58
67322,702141,1,11,1,0,0,58
67323,702141,1,11,2,0,1,58
67324,702141,1,11,3,0,0,58
67325,702141,1,11,4,0,0,58
67326,702141,1,11,5,0,0,58
67327,702141,1,11,6,1,0,59
67328,702141,1,12,1,0,0,59
67329,702141,1,12,2,1,0,60
67330,702141,1,12,3,0,0,60
67331,702141,1,12,4,1,0,61
67332,702141,1,12,5,1,0,62
67333,702141,1,12,6,4,0,66
67334,702141,1,13,1,1,0,67
67335,702141,1,13,2,0,0,67
67336,702141,1,13,3,4,0,71
67337,702141,1,13,4,0,0,71
67338,702141,1,13,5,1,0,72
67339,702141,1,13,6,0,0,72
67340,702141,1,14,1,1,0,73
67341,702141,1,14,2,4,0,77
67342,702141,1,14,3,0,0,77
67343,702141,1,14,4,0,0,77
67344,702141,1,14,5,0,0,77
67345,702141,1,14,6,0,1,77
67346,702141,1,15,1,0,0,77
67347,702141,1,15,2,0,0,77
67348,702141,1,15,3,1,0,78
67349,702141,1,15,4,1,0,79
67350,702141,1,15,5,0,0,79
67351,702141,1,15,6,0,0,79
67352,702141,1,16,1,0,1,79
67353,702141,1,16,2,1,0,80
67354,702141,1,16,3,1,0,81
67355,702141,1,16,4,1,0,82
67356,702141,1,16,5,0,0,82
67357,702141,1,16,6,1,0,83
67358,702141,1,17,1,0,0,83
67359,702141,1,17,2,1,0,84
67360,702141,1,17,3,0,0,84
67361,702141,1,17,4,4,0,88
67362,702141,1,17,5,0,0,88
67363,702141,1,17,6,1,0,89
67364,702141,1,18,1,1,0,90
67365,702141,1,18,2,1,0,91
67366,702141,1,18,3,0,0,91
67367,702141,1,18,4,7,0,98
67368,702141,1,18,5,0,1,98
67369,702141,1,18,6,4,0,102
67370,702141,1,19,1,4,0,106
67371,702141,1,19,2,0,1,106
67372,702141,1,19,3,1,0,107
67373,702141,1,19,4,0,1,107
67374,702141,1,19,5,1,0,108
67375,702141,1,19,6,1,0,109
67376,702141,1,20,1,0,0,109
67377,702141,1,20,2,2,0,111
67378,702141,1,20,3,1,0,112
67379,702141,1,20,4,2,0,114
67380,702141,1,20,5,1,0,115
67381,702141,1,20,6,1,0,116
67497,702143,1,1,1,0,0,0
67498,702143,1,1,2,4,0,4
67499,702143,1,1,3,1,0,5
67500,702143,1,1,4,1,0,6
67501,702143,1,1,5,0,0,6
67502,702143,1,1,6,0,0,6
67503,702143,1,2,1,0,0,6
67504,702143,1,2,2,0,0,6
67505,702143,1,2,3,6,0,12
67506,702143,1,2,4,0,0,12
67507,702143,1,2,5,1,0,13
67508,702143,1,2,6,1,0,14
67509,702143,1,3,1,0,0,14
67510,702143,1,3,2,1,0,15
67511,702143,1,3,3,0,0,15
67512,702143,1,3,4,6,0,21
67513,702143,1,3,5,0,0,21
67514,702143,1,3,6,2,0,23
67515,702143,1,4,1,1,0,24
67516,702143,1,4,2,0,0,24
67517,702143,1,4,3,2,0,26
67518,702143,1,4,4,0,0,26
67519,702143,1,4,5,1,0,27
67520,702143,1,4,6,0,0,27
67521,702143,1,5,1,0,1,27
67522,702143,1,5,2,0,0,27
67523,702143,1,5,3,0,0,27
67524,702143,1,5,4,0,0,27
67525,702143,1,5,5,0,0,27
67526,702143,1,5,6,0,0,27
67527,702143,1,6,1,0,0,27
67528,702143,1,6,2,0,0,27
67529,702143,1,6,3,2,0,29
67530,702143,1,6,4,0,0,29
67531,702143,1,6,5,1,0,30
67532,702143,1,6,6,0,0,30
67533,702143,1,7,1,0,0,30
67534,702143,1,7,2,0,1,30
67535,702143,1,7,3,0,0,30
67536,702143,1,7,4,1,0,31
67537,702143,1,7,5,1,0,32
67538,702143,1,7,6,0,0,32
67539,702143,1,8,1,0,0,32
67540,702143,1,8,2,0,0,32
67541,702143,1,8,3,1,0,33
67542,702143,1,8,4,1,0,34
67543,702143,1,8,5,1,0,35
67544,702143,1,8,6,0,0,35
67545,702143,1,9,1,5,0,40
67546,702143,1,9,2,0,0,40
67547,702143,1,9,3,1,0,41
67548,702143,1,9,4,1,0,42
67549,702143,1,9,5,2,0,44
67550,702143,1,9,6,0,1,44
67551,702143,1,10,1,1,0,45
67552,702143,1,10,2,1,0,46
67553,702143,1,10,3,1,0,47
67554,702143,1,10,4,0,0,47
67555,702143,1,10,5,0,0,47
67556,702143,1,10,6,1,0,48
67557,702143,1,11,1,0,0,48
67558,702143,1,11,2,0,0,48
67559,702143,1,11,3,0,0,48
67560,702143,1,11,4,1,0,49
67561,702143,1,11,5,1,0,50
67562,702143,1,11,6,1,0,51
67563,702143,1,12,1,0,0,51
67564,702143,1,12,2,4,0,55
67565,702143,1,12,3,1,0,56
67566,702143,1,12,4,1,0,57
67567,702143,1,12,5,1,0,58
67568,702143,1,12,6,0,1,58
67569,702143,1,13,1,0,0,58
67570,702143,1,13,2,2,0,60
67571,702143,1,13,3,0,0,60
67572,702143,1,13,4,0,0,60
67573,702143,1,13,5,1,0,61
67574,702143,1,13,6,1,0,62
67575,702143,1,14,1,1,0,63
67576,702143,1,14,2,1,0,64
67577,702143,1,14,3,0,0,64
67578,702143,1,14,4,1,0,65
67579,702143,1,14,5,1,0,66
67580,702143,1,14,6,1,0,67
67581,702143,1,15,1,1,0,68
67582,702143,1,15,2,1,0,69
67583,702143,1,15,3,0,1,69
67584,702143,1,15,4,0,0,69
67585,702143,1,15,5,0,0,69
67586,702143,1,15,6,0,0,69
67587,702143,1,16,1,1,0,70
67588,702143,1,16,2,1,0,71
67589,702143,1,16,3,1,0,72
67590,702143,1,16,4,1,0,73
67591,702143,1,16,5,0,1,73
67592,702143,1,16,6,1,0,74
67593,702143,1,17,1,0,1,74
67594,702143,1,17,2,4,0,78
67595,702143,1,17,3,0,0,78
67596,702143,1,17,4,1,0,79
67597,702143,1,17,5,0,0,79
67598,702143,1,17,6,2,0,81
67599,702143,1,18,1,0,0,81
67600,702143,1,18,2,1,0,82
67601,702143,1,18,3,2,0,84
67602,702143,1,18,4,0,1,84
67603,702143,1,18,5,1,0,85
67604,702143,1,18,6,0,0,85
67605,702143,1,19,1,1,0,86
67606,702143,1,19,2,0,0,86
67607,702143,1,19,3,2,0,88
67608,702143,1,19,4,1,0,89
67609,702143,1,19,5,1,0,90
67610,702143,1,19,6,1,0,91
67611,702143,1,20,1,1,0,92
67612,702143,1,20,2,0,0,92
67613,702143,1,20,3,1,0,93
67614,702143,1,20,4,0,1,93
67615,702143,1,20,5,2,0,95
67616,702143,1,20,6,1,0,96
67737,722335,1,1,1,1,0,1
67738,722335,1,1,2,0,0,1
67739,722335,1,1,3,6,0,7
67740,722335,1,1,4,0,0,7
67741,722335,1,1,5,0,0,7
67742,722335,1,1,6,0,0,7
67743,722335,1,2,1,0,0,7
67744,722335,1,2,2,2,0,9
67745,722335,1,2,3,0,0,9
67746,722335,1,2,4,0,0,9
67747,722335,1,2,5,0,0,9
67748,722335,1,2,6,0,0,9
67749,722335,1,3,1,0,0,9
67750,722335,1,3,2,4,0,13
67751,722335,1,3,3,1,0,14
67752,722335,1,3,4,3,0,17
67753,722335,1,3,5,4,0,21
67754,722335,1,3,6,1,0,22
67755,722335,1,4,1,0,0,22
67756,722335,1,4,2,0,0,22
67757,722335,1,4,3,1,0,23
67758,722335,1,4,4,1,0,24
67759,722335,1,4,5,1,0,25
67760,722335,1,4,6,1,0,26
67761,722335,1,5,1,4,0,30
67762,722335,1,5,2,0,1,30
67763,722335,1,5,3,0,0,30
67764,722335,1,5,4,3,0,33
67765,722335,1,5,5,0,0,33
67766,722335,1,5,6,0,0,33
67767,722335,1,6,1,0,1,33
67768,722335,1,6,2,0,0,33
67769,722335,1,6,3,0,0,33
67770,722335,1,6,4,1,0,34
67771,722335,1,6,5,1,0,35
67772,722335,1,6,6,0,0,35
67773,722335,1,7,1,0,0,35
67774,722335,1,7,2,0,0,35
67775,722335,1,7,3,1,0,36
67776,722335,1,7,4,1,0,37
67777,722335,1,7,5,1,0,38
67778,722335,1,7,6,1,0,39
67779,722335,1,8,1,1,0,40
67780,722335,1,8,2,4,0,44
67781,722335,1,8,3,0,0,44
67782,722335,1,8,4,4,0,48
67783,722335,1,8,5,0,0,48
67784,722335,1,8,6,4,0,52
67785,722335,1,9,1,0,0,52
67786,722335,1,9,2,1,0,53
67787,722335,1,9,3,4,0,57
67788,722335,1,9,4,6,0,63
67789,722335,1,9,5,1,0,64
67790,722335,1,9,6,1,0,65
67791,722335,1,10,1,2,0,67
67792,722335,1,10,2,2,0,69
67793,722335,1,10,3,6,0,75
67794,722335,1,10,4,4,0,79
67795,722335,1,10,5,0,1,79
67796,722335,1,10,6,0,0,79
67797,722335,1,11,1,0,0,79
67798,722335,1,11,2,1,0,80
67799,722335,1,11,3,1,0,81
67800,722335,1,11,4,4,0,85
67801,722335,1,11,5,1,0,86
67802,722335,1,11,6,1,0,87
67803,722335,1,12,1,1,0,88
67804,722335,1,12,2,0,0,88
67805,722335,1,12,3,2,0,90
67806,722335,1,12,4,1,0,91
67807,722335,1,12,5,1,0,92
67808,722335,1,12,6,0,0,92
67809,722335,1,13,1,1,0,93
67810,722335,1,13,2,1,0,94
67811,722335,1,13,3,1,0,95
67812,722335,1,13,4,1,0,96
67813,722335,1,13,5,2,0,98
67814,722335,1,13,6,2,0,100
67815,722335,1,14,1,4,0,104
67816,722335,1,14,2,1,0,105
67817,722335,1,14,3,2,0,107
67818,722335,1,14,4,1,0,108
67819,722335,1,14,5,1,0,109
67820,722335,1,14,6,1,0,110
67821,722335,1,15,1,2,0,112
67822,722335,1,15,2,4,0,116
67823,722335,1,15,3,0,0,116
67824,722335,1,15,4,1,0,117
67825,722335,1,15,5,0,0,117
67826,722335,1,15,6,2,0,119
67827,722335,1,16,1,0,0,119
67828,722335,1,16,2,2,0,121
67829,722335,1,16,3,1,0,122
67830,722335,1,16,4,1,0,123
67831,722335,1,16,5,1,0,124
67832,722335,1,16,6,1,0,125
67833,722335,1,17,1,2,0,127
67834,722335,1,17,2,0,1,127
67835,722335,1,17,3,4,0,131
67836,722335,1,17,4,2,0,133
67837,722335,1,17,5,0,0,133
67838,722335,1,17,6,4,0,137
67839,722335,1,18,1,1,0,138
67840,722335,1,18,2,1,0,139
67841,722335,1,18,3,2,0,141
67842,722335,1,18,4,1,0,142
67843,722335,1,18,5,4,0,146
67844,722335,1,18,6,2,0,148
67845,722335,1,19,1,0,0,148
67846,722335,1,19,2,1,0,149
67847,722335,1,19,3,1,0,150
67848,722335,1,19,4,0,0,150
67849,722335,1,19,5,2,0,152
67850,722335,1,19,6,6,0,158
67851,722335,1,20,1,1,0,159
67852,722335,1,20,2,1,0,160
67853,722335,1,20,3,1,0,161
67854,722335,1,20,4,2,0,163
67855,722335,1,20,5,0,0,163
67856,722335,1,20,6,2,0,165
67973,722337,1,1,1,0,0,0
67974,722337,1,1,2,1,0,1
67975,722337,1,1,3,0,0,1
67976,722337,1,1,4,4,0,5
67977,722337,1,1,5,0,1,5
67978,722337,1,1,6,0,0,5
67979,722337,1,2,1,0,0,5
67980,722337,1,2,2,6,0,11
67981,722337,1,2,3,0,0,11
67982,722337,1,2,4,6,0,17
67983,722337,1,2,5,0,0,17
67984,722337,1,2,6,2,0,19
67985,722337,1,3,1,2,0,21
67986,722337,1,3,2,0,1,21
67987,722337,1,3,3,2,0,23
67988,722337,1,3,4,0,0,23
67989,722337,1,3,5,4,0,27
67990,722337,1,3,6,1,0,28
67991,722337,1,4,1,2,0,30
67992,722337,1,4,2,0,0,30
67993,722337,1,4,3,4,0,34
67994,722337,1,4,4,0,0,34
67995,722337,1,4,5,1,0,35
67996,722337,1,4,6,0,0,35
67997,722337,1,5,1,1,0,36
67998,722337,1,5,2,4,0,40
67999,722337,1,5,3,1,0,41
68000,722337,1,5,4,4,0,45
68001,722337,1,5,5,4,0,49
68002,722337,1,5,6,0,0,49
68003,722337,1,6,1,2,0,51
68004,722337,1,6,2,6,0,57
68005,722337,1,6,3,0,0,57
68006,722337,1,6,4,4,0,61
68007,722337,1,6,5,4,0,65
68008,722337,1,6,6,4,0,69
68009,722337,1,7,1,1,0,70
68010,722337,1,7,2,0,0,70
68011,722337,1,7,3,1,0,71
68012,722337,1,7,4,0,0,71
68013,722337,1,7,5,6,0,77
68014,722337,1,7,6,1,0,78
68015,722337,1,8,1,0,0,78
68016,722337,1,8,2,2,0,80
68017,722337,1,8,3,1,0,81
68018,722337,1,8,4,4,0,85
68019,722337,1,8,5,1,0,86
68020,722337,1,8,6,1,0,87
68021,722337,1,9,1,6,0,93
68022,722337,1,9,2,1,0,94
68023,722337,1,9,3,2,0,96
68024,722337,1,9,4,1,0,97
68025,722337,1,9,5,1,0,98
68026,722337,1,9,6,6,0,104
68027,722337,1,10,1,0,0,104
68028,722337,1,10,2,2,0,106
68029,722337,1,10,3,6,0,112
68030,722337,1,10,4,1,0,113
68031,722337,1,10,5,6,0,119
68032,722337,1,10,6,2,0,121
68033,722337,1,11,1,4,0,125
68034,722337,1,11,2,1,0,126
68035,722337,1,11,3,0,1,126
68036,722337,1,11,4,0,0,126
68037,722337,1,11,5,0,0,126
68038,722337,1,11,6,3,0,129
68039,722337,1,12,1,1,0,130
68040,722337,1,12,2,0,0,130
68041,722337,1,12,3,1,0,131
68042,722337,1,12,4,1,0,132
68043,722337,1,12,5,1,0,133
68044,722337,1,12,6,1,0,134
68045,722337,1,13,1,2,0,136
68046,722337,1,13,2,2,0,138
68047,722337,1,13,3,6,0,144
68048,722337,1,13,4,1,0,145
68049,722337,1,13,5,0,0,145
68050,722337,1,13,6,6,0,151
68051,722337,1,14,1,1,0,152
68052,722337,1,14,2,4,0,156
68053,722337,1,14,3,0,1,156
68054,722337,1,14,4,1,0,157
68055,722337,1,14,5,1,0,158
68056,722337,1,14,6,3,0,161
68057,722337,1,15,1,1,0,162
68058,722337,1,15,2,2,0,164
68059,722337,1,15,3,2,0,166
68060,722337,1,15,4,2,0,168
68061,722337,1,15,5,4,0,172
68062,722337,1,15,6,1,0,173
68063,722337,1,16,1,2,0,175
68064,722337,1,16,2,4,0,179
68065,722337,1,16,3,7,0,186
68066,722337,1,16,4,2,0,188
68067,722337,1,16,5,6,0,194
68068,722337,1,16,6,4,0,198
68069,722337,1,17,1,1,0,199
68070,722337,1,17,2,2,0,201
68071,722337,1,17,3,2,0,203
68072,722337,1,17,4,1,0,204
68073,722337,1,17,5,1,0,205
68074,722337,1,17,6,1,0,206
68075,722337,1,18,1,0,0,206
68076,722337,1,18,2,4,0,210
68077,722337,1,18,3,1,0,211
68078,722337,1,18,4,0,0,211
68079,722337,1,18,5,0,0,211
68080,722337,1,18,6,2,0,213
68081,722337,1,19,1,0,0,213
68082,722337,1,19,2,1,0,214
68083,722337,1,19,3,1,0,215
68084,722337,1,19,4,1,0,216
68085,722337,1,19,5,6,0,222
68086,722337,1,19,6,0,1,222
68087,722337,1,20,1,6,0,228
68088,722337,1,20,2,0,1,228
68089,722337,1,20,3,0,0,228
68090,722337,1,20,4,1,0,229
68091,722337,1,20,5,2,0,231
68092,722337,1,20,6,0,1,231
68209,727917,1,1,1,1,0,1
68210,727917,1,1,2,0,0,1
68211,727917,1,1,3,1,0,2
68212,727917,1,1,4,1,0,3
68213,727917,1,1,5,0,0,3
68214,727917,1,1,6,0,0,3
68215,727917,1,2,1,0,0,3
68216,727917,1,2,2,4,0,7
68217,727917,1,2,3,0,0,7
68218,727917,1,2,4,0,0,7
68219,727917,1,2,5,0,0,7
68220,727917,1,2,6,4,0,11
68221,727917,1,3,1,2,0,13
68222,727917,1,3,2,0,0,13
68223,727917,1,3,3,0,1,13
68224,727917,1,3,4,0,0,13
68225,727917,1,3,5,0,0,13
68226,727917,1,3,6,0,1,13
68227,727917,1,4,1,0,0,13
68228,727917,1,4,2,5,0,18
68229,727917,1,4,3,0,0,18
68230,727917,1,4,4,4,0,22
68231,727917,1,4,5,0,0,22
68232,727917,1,4,6,0,0,22
68233,727917,1,5,1,1,0,23
68234,727917,1,5,2,0,0,23
68235,727917,1,5,3,0,1,23
68236,727917,1,5,4,6,0,29
68237,727917,1,5,5,1,0,30
68238,727917,1,5,6,1,0,31
68239,727917,1,6,1,0,0,31
68240,727917,1,6,2,0,0,31
68241,727917,1,6,3,0,0,31
68242,727917,1,6,4,1,0,32
68243,727917,1,6,5,0,0,32
68244,727917,1,6,6,0,0,32
68245,727917,1,7,1,1,0,33
68246,727917,1,7,2,0,0,33
68247,727917,1,7,3,0,0,33
68248,727917,1,7,4,0,1,33
68249,727917,1,7,5,0,0,33
68250,727917,1,7,6,0,0,33
68251,727917,1,8,1,1,0,34
68252,727917,1,8,2,1,0,35
68253,727917,1,8,3,1,0,36
68254,727917,1,8,4,0,0,36
68255,727917,1,8,5,0,1,36
68256,727917,1,8,6,1,0,37
68257,727917,1,9,1,0,0,37
68258,727917,1,9,2,2,0,39
68259,727917,1,9,3,1,0,40
68260,727917,1,9,4,1,0,41
68261,727917,1,9,5,0,0,41
68262,727917,1,9,6,1,0,42
68263,727917,1,10,1,1,0,43
68264,727917,1,10,2,2,0,45
68265,727917,1,10,3,1,0,46
68266,727917,1,10,4,0,1,46
68267,727917,1,10,5,0,0,46
68268,727917,1,10,6,0,0,46
68269,727917,1,11,1,1,0,47
68270,727917,1,11,2,0,0,47
68271,727917,1,11,3,0,0,47
68272,727917,1,11,4,0,0,47
68273,727917,1,11,5,1,0,48
68274,727917,1,11,6,1,0,49
68275,727917,1,12,1,1,0,50
68276,727917,1,12,2,1,0,51
68277,727917,1,12,3,1,0,52
68278,727917,1,12,4,2,0,54
68279,727917,1,12,5,1,0,55
68280,727917,1,12,6,1,0,56
68281,727917,1,13,1,1,0,57
68282,727917,1,13,2,0,0,57
68283,727917,1,13,3,0,1,57
68284,727917,1,13,4,0,0,57
68285,727917,1,13,5,0,0,57
68286,727917,1,13,6,0,0,57
68287,727917,1,14,1,1,0,58
68288,727917,1,14,2,0,0,58
68289,727917,1,14,3,1,0,59
68290,727917,1,14,4,0,0,59
68291,727917,1,14,5,1,0,60
68292,727917,1,14,6,1,0,61
68293,727917,1,15,1,1,0,62
68294,727917,1,15,2,1,0,63
68295,727917,1,15,3,1,0,64
68296,727917,1,15,4,2,0,66
68297,727917,1,15,5,1,0,67
68298,727917,1,15,6,1,0,68
68299,727917,1,16,1,0,0,68
68300,727917,1,16,2,1,0,69
68301,727917,1,16,3,1,0,70
68302,727917,1,16,4,1,0,71
68303,727917,1,16,5,0,0,71
68304,727917,1,16,6,0,1,71
68305,727917,1,17,1,0,0,71
68306,727917,1,17,2,4,0,75
68307,727917,1,17,3,1,0,76
68308,727917,1,17,4,1,0,77
68309,727917,1,17,5,0,0,77
68310,727917,1,17,6,1,0,78
68311,727917,1,18,1,3,0,81
68312,727917,1,18,2,1,0,82
68313,727917,1,18,3,0,0,82
68314,727917,1,18,4,2,0,84
68315,727917,1,18,5,0,0,84
68316,727917,1,18,6,1,0,85
68317,727917,1,19,1,1,0,86
68318,727917,1,19,2,0,1,86
68319,727917,1,19,3,4,0,90
68320,727917,1,19,4,0,0,90
68321,727917,1,19,5,2,0,92
68322,727917,1,19,6,1,0,93
68323,727917,1,20,1,1,0,94
68324,727917,1,20,2,0,0,94
68325,727917,1,20,3,1,0,95
68326,727917,1,20,4,0,0,95
68327,727917,1,20,5,1,0,96
68328,727917,1,20,6,0,0,96
68413,730283,1,1,1,1,0,1
68414,730283,1,1,2,0,0,1
68415,730283,1,1,3,1,0,2
68416,730283,1,1,4,0,0,2
68417,730283,1,1,5,4,0,6
68418,730283,1,1,6,1,0,7
68419,730283,1,2,1,0,0,7
68420,730283,1,2,2,0,0,7
68421,730283,1,2,3,0,0,7
68422,730283,1,2,4,0,0,7
68423,730283,1,2,5,1,0,8
68424,730283,1,2,6,0,1,8
68425,730283,1,3,1,0,0,8
68426,730283,1,3,2,0,0,8
68427,730283,1,3,3,1,0,9
68428,730283,1,3,4,1,0,10
68429,730283,1,3,5,0,1,10
68430,730283,1,3,6,0,0,10
68431,730283,1,4,1,1,0,11
68432,730283,1,4,2,0,0,11
68433,730283,1,4,3,0,0,11
68434,730283,1,4,4,0,0,11
68435,730283,1,4,5,1,0,12
68436,730283,1,4,6,6,0,18
68437,730283,1,5,1,1,0,19
68438,730283,1,5,2,0,0,19
68439,730283,1,5,3,1,0,20
68440,730283,1,5,4,1,0,21
68441,730283,1,5,5,1,0,22
68442,730283,1,5,6,0,0,22
68443,730283,1,6,1,1,0,23
68444,730283,1,6,2,0,0,23
68445,730283,1,6,3,2,0,25
68446,730283,1,6,4,1,0,26
68447,730283,1,6,5,0,0,26
68448,730283,1,6,6,6,0,32
68449,730283,1,7,1,2,0,34
68450,730283,1,7,2,1,0,35
68451,730283,1,7,3,0,0,35
68452,730283,1,7,4,1,0,36
68453,730283,1,7,5,0,0,36
68454,730283,1,7,6,1,0,37
68455,730283,1,8,1,0,0,37
68456,730283,1,8,2,1,0,38
68457,730283,1,8,3,1,0,39
68458,730283,1,8,4,3,0,42
68459,730283,1,8,5,1,0,43
68460,730283,1,8,6,1,0,44
68461,730283,1,9,1,6,0,50
68462,730283,1,9,2,2,0,52
68463,730283,1,9,3,1,0,53
68464,730283,1,9,4,0,0,53
68465,730283,1,9,5,0,0,53
68466,730283,1,9,6,0,0,53
68467,730283,1,10,1,1,0,54
68468,730283,1,10,2,1,0,55
68469,730283,1,10,3,1,0,56
68470,730283,1,10,4,1,0,57
68471,730283,1,10,5,0,0,57
68472,730283,1,10,6,0,0,57
68473,730283,1,11,1,7,0,64
68474,730283,1,11,2,0,0,64
68475,730283,1,11,3,2,0,66
68476,730283,1,11,4,4,0,70
68477,730283,1,11,5,2,0,72
68478,730283,1,11,6,0,0,72
68479,730283,1,12,1,1,0,73
68480,730283,1,12,2,4,0,77
68481,730283,1,12,3,1,0,78
68482,730283,1,12,4,0,0,78
68483,730283,1,12,5,1,0,79
68484,730283,1,12,6,3,0,82
68485,730283,1,13,1,1,0,83
68486,730283,1,13,2,6,0,89
68487,730283,1,13,3,6,0,95
68488,730283,1,13,4,2,0,97
68489,730283,1,13,5,1,0,98
68490,730283,1,13,6,0,1,98
68491,730283,1,14,1,1,0,99
68492,730283,1,14,2,2,0,101
68493,730283,1,14,3,1,0,102
68494,730283,1,14,4,0,0,102
68495,730283,1,14,5,1,0,103
68496,730283,1,14,6,1,0,104
68497,730283,1,15,1,0,1,104
68498,730283,1,15,2,0,0,104
68499,730283,1,15,3,1,0,105
68500,730283,1,15,4,0,0,105
68501,730283,1,15,5,4,0,109
68502,730283,1,15,6,6,0,115
68503,730283,1,16,1,7,0,122
68504,730283,1,16,2,1,0,123
68505,730283,1,16,3,0,1,123
68506,730283,1,16,4,1,0,124
68507,730283,1,16,5,0,0,124
68508,730283,1,16,6,0,0,124
68509,730283,1,17,1,1,0,125
68510,730283,1,17,2,0,0,125
68511,730283,1,17,3,2,0,127
68512,730283,1,17,4,1,0,128
68513,730283,1,17,5,0,1,128
68514,730283,1,17,6,1,0,129
68515,730283,1,18,1,2,0,131
68516,730283,1,18,2,0,0,131
68517,730283,1,18,3,0,0,131
68518,730283,1,18,4,0,0,131
68519,730283,1,18,5,0,1,131
68520,730283,1,18,6,1,1,132
68611,730285,1,1,1,0,0,0
68612,730285,1,1,2,1,0,1
68613,730285,1,1,3,1,0,2
68614,730285,1,1,4,4,0,6
68615,730285,1,1,5,4,0,10
68616,730285,1,1,6,0,0,10
68617,730285,1,2,1,0,0,10
68618,730285,1,2,2,0,0,10
68619,730285,1,2,3,0,0,10
68620,730285,1,2,4,0,0,10
68621,730285,1,2,5,0,0,10
68622,730285,1,2,6,0,0,10
68623,730285,1,3,1,0,1,10
68624,730285,1,3,2,1,0,11
68625,730285,1,3,3,1,0,12
68626,730285,1,3,4,0,0,12
68627,730285,1,3,5,1,0,13
68628,730285,1,3,6,1,0,14
68629,730285,1,4,1,1,0,15
68630,730285,1,4,2,0,0,15
68631,730285,1,4,3,0,0,15
68632,730285,1,4,4,1,0,16
68633,730285,1,4,5,0,0,16
68634,730285,1,4,6,0,0,16
68635,730285,1,5,1,4,0,20
68636,730285,1,5,2,0,0,20
68637,730285,1,5,3,6,0,26
68638,730285,1,5,4,0,0,26
68639,730285,1,5,5,0,0,26
68640,730285,1,5,6,1,0,27
68641,730285,1,6,1,1,0,28
68642,730285,1,6,2,6,0,34
68643,730285,1,6,3,0,0,34
68644,730285,1,6,4,0,0,34
68645,730285,1,6,5,2,0,36
68646,730285,1,6,6,0,0,36
68647,730285,1,7,1,0,0,36
68648,730285,1,7,2,2,0,38
68649,730285,1,7,3,1,0,39
68650,730285,1,7,4,1,0,40
68651,730285,1,7,5,4,0,44
68652,730285,1,7,6,0,0,44
68653,730285,1,8,1,1,0,45
68654,730285,1,8,2,1,0,46
68655,730285,1,8,3,4,0,50
68656,730285,1,8,4,2,0,52
68657,730285,1,8,5,1,0,53
68658,730285,1,8,6,1,0,54
68659,730285,1,9,1,1,0,55
68660,730285,1,9,2,0,0,55
68661,730285,1,9,3,2,0,57
68662,730285,1,9,4,1,0,58
68663,730285,1,9,5,4,0,62
68664,730285,1,9,6,0,0,62
68665,730285,1,10,1,1,0,63
68666,730285,1,10,2,6,0,69
68667,730285,1,10,3,0,0,69
68668,730285,1,10,4,0,0,69
68669,730285,1,10,5,4,0,73
68670,730285,1,10,6,0,0,73
68671,730285,1,11,1,1,0,74
68672,730285,1,11,2,1,0,75
68673,730285,1,11,3,1,0,76
68674,730285,1,11,4,0,0,76
68675,730285,1,11,5,0,1,76
68676,730285,1,11,6,0,0,76
68677,730285,1,12,1,0,0,76
68678,730285,1,12,2,1,0,77
68679,730285,1,12,3,1,0,78
68680,730285,1,12,4,1,0,79
68681,730285,1,12,5,3,0,82
68682,730285,1,12,6,2,0,84
68683,730285,1,13,1,1,0,85
68684,730285,1,13,2,1,0,86
68685,730285,1,13,3,0,0,86
68686,730285,1,13,4,1,0,87
68687,730285,1,13,5,4,0,91
68688,730285,1,13,6,6,0,97
68689,730285,1,14,1,0,0,97
68690,730285,1,14,2,1,0,98
68691,730285,1,14,3,0,1,98
68692,730285,1,14,4,0,0,98
68693,730285,1,14,5,1,0,99
68694,730285,1,14,6,1,0,100
68695,730285,1,15,1,1,0,101
68696,730285,1,15,2,0,0,101
68697,730285,1,15,3,1,0,102
68698,730285,1,15,4,6,0,108
68699,730285,1,15,5,0,0,108
68700,730285,1,15,6,1,0,109
68701,730285,1,16,1,3,0,112
68702,730285,1,16,2,0,0,112
68703,730285,1,16,3,4,0,116
68704,730285,1,16,4,4,0,120
68705,730285,1,16,5,1,0,121
68706,730285,1,16,6,1,0,122
68707,730285,1,17,1,1,0,123
68708,730285,1,17,2,1,0,124
68709,730285,1,17,3,0,0,124
68710,730285,1,17,4,0,0,124
68711,730285,1,17,5,1,0,125
68712,730285,1,17,6,1,0,126
68713,730285,1,18,1,0,0,126
68714,730285,1,18,2,0,1,126
68715,730285,1,18,3,6,0,132
68716,730285,1,18,4,1,0,133
68717,730285,1,18,5,6,0,139
68718,730285,1,18,6,4,0,143
68719,730285,1,19,1,4,0,147
68720,730285,1,19,2,0,1,147
68721,730285,1,19,3,1,0,148
68722,730285,1,19,4,0,1,148
68723,730285,1,19,5,4,0,152
68724,730285,1,19,6,2,0,154
68725,730285,1,20,1,1,0,155
68726,730285,1,20,2,1,0,156
68727,730285,1,20,3,2,0,158
68728,730285,1,20,4,1,0,159
68729,730285,1,20,5,2,0,161
68730,730285,1,20,6,4,0,165
68846,736063,1,1,1,0,0,0
68847,736063,1,1,2,0,0,0
68848,736063,1,1,3,0,0,0
68849,736063,1,1,4,1,0,1
68850,736063,1,1,5,0,0,1
68851,736063,1,1,6,0,0,1
68852,736063,1,2,1,6,0,7
68853,736063,1,2,2,1,0,8
68854,736063,1,2,3,5,0,13
68855,736063,1,2,4,0,0,13
68856,736063,1,2,5,0,0,13
68857,736063,1,2,6,4,0,17
68858,736063,1,3,1,1,0,18
68859,736063,1,3,2,1,0,19
68860,736063,1,3,3,2,0,21
68861,736063,1,3,4,0,0,21
68862,736063,1,3,5,0,0,21
68863,736063,1,3,6,0,0,21
68864,736063,1,4,1,4,0,25
68865,736063,1,4,2,1,0,26
68866,736063,1,4,3,6,0,32
68867,736063,1,4,4,0,0,32
68868,736063,1,4,5,6,0,38
68869,736063,1,4,6,0,0,38
68870,736063,1,5,1,1,0,39
68871,736063,1,5,2,1,0,40
68872,736063,1,5,3,6,0,46
68873,736063,1,5,4,0,0,46
68874,736063,1,5,5,1,0,47
68875,736063,1,5,6,6,0,53
68876,736063,1,6,1,4,0,57
68877,736063,1,6,2,4,0,61
68878,736063,1,6,3,0,0,61
68879,736063,1,6,4,1,0,62
68880,736063,1,6,5,0,0,62
68881,736063,1,6,6,0,0,62
68882,736063,1,7,1,1,0,63
68883,736063,1,7,2,0,0,63
68884,736063,1,7,3,0,0,63
68885,736063,1,7,4,6,0,69
68886,736063,1,7,5,0,0,69
68887,736063,1,7,6,4,0,73
68888,736063,1,8,1,1,0,74
68889,736063,1,8,2,4,0,78
68890,736063,1,8,3,4,0,82
68891,736063,1,8,4,4,0,86
68892,736063,1,8,5,0,0,86
68893,736063,1,8,6,0,0,86
68894,736063,1,9,1,1,0,87
68895,736063,1,9,2,1,0,88
68896,736063,1,9,3,1,0,89
68897,736063,1,9,4,1,0,90
68898,736063,1,9,5,1,0,91
68899,736063,1,9,6,1,0,92
68900,736063,1,10,1,0,0,92
68901,736063,1,10,2,1,0,93
68902,736063,1,10,3,0,0,93
68903,736063,1,10,4,1,0,94
68904,736063,1,10,5,1,0,95
68905,736063,1,10,6,1,0,96
68906,736063,1,11,1,1,0,97
68907,736063,1,11,2,1,0,98
68908,736063,1,11,3,0,0,98
68909,736063,1,11,4,1,0,99
68910,736063,1,11,5,0,0,99
68911,736063,1,11,6,0,0,99
68912,736063,1,12,1,1,0,100
68913,736063,1,12,2,1,0,101
68914,736063,1,12,3,4,0,105
68915,736063,1,12,4,1,0,106
68916,736063,1,12,5,1,0,107
68917,736063,1,12,6,1,0,108
68918,736063,1,13,1,1,0,109
68919,736063,1,13,2,1,0,110
68920,736063,1,13,3,1,0,111
68921,736063,1,13,4,0,1,111
68922,736063,1,13,5,0,0,111
68923,736063,1,13,6,1,0,112
68924,736063,1,14,1,1,0,113
68925,736063,1,14,2,2,0,115
68926,736063,1,14,3,0,0,115
68927,736063,1,14,4,1,0,116
68928,736063,1,14,5,4,0,120
68929,736063,1,14,6,1,0,121
68930,736063,1,15,1,1,0,122
68931,736063,1,15,2,1,0,123
68932,736063,1,15,3,1,0,124
68933,736063,1,15,4,5,0,129
68934,736063,1,15,5,1,0,130
68935,736063,1,15,6,0,0,130
68936,736063,1,16,1,1,0,131
68937,736063,1,16,2,1,0,132
68938,736063,1,16,3,0,0,132
68939,736063,1,16,4,0,0,132
68940,736063,1,16,5,1,0,133
68941,736063,1,16,6,4,0,137
68942,736063,1,17,1,2,0,139
68943,736063,1,17,2,1,0,140
68944,736063,1,17,3,2,0,142
68945,736063,1,17,4,4,0,146
68946,736063,1,17,5,3,0,149
68947,736063,1,17,6,2,0,151
68948,736063,1,18,1,1,0,152
68949,736063,1,18,2,4,0,156
68950,736063,1,18,3,1,0,157
68951,736063,1,18,4,0,0,157
68952,736063,1,18,5,1,0,158
68953,736063,1,18,6,0,1,158
68954,736063,1,19,1,2,0,160
68955,736063,1,19,2,4,0,164
68956,736063,1,19,3,6,0,170
68957,736063,1,19,4,1,0,171
68958,736063,1,19,5,0,1,171
68959,736063,1,19,6,1,0,172
68960,736063,1,20,1,2,0,174
68961,736063,1,20,2,6,0,180
68962,736063,1,20,3,1,0,181
68963,736063,1,20,4,6,0,187
68964,736063,1,20,5,6,0,193
68965,736063,1,20,6,2,0,195
69080,742617,1,1,1,0,0,0
69081,742617,1,1,2,1,0,1
69082,742617,1,1,3,0,1,1
69083,742617,1,1,4,0,0,1
69084,742617,1,1,5,1,0,2
69085,742617,1,1,6,0,0,2
69086,742617,1,2,1,1,0,3
69087,742617,1,2,2,6,0,9
69088,742617,1,2,3,0,0,9
69089,742617,1,2,4,1,0,10
69090,742617,1,2,5,0,0,10
69091,742617,1,2,6,0,1,10
69092,742617,1,3,1,1,0,11
69093,742617,1,3,2,0,0,11
69094,742617,1,3,3,4,0,15
69095,742617,1,3,4,0,0,15
69096,742617,1,3,5,0,0,15
69097,742617,1,3,6,0,1,15
69098,742617,1,4,1,0,0,15
69099,742617,1,4,2,1,0,16
69100,742617,1,4,3,2,0,18
69101,742617,1,4,4,0,0,18
69102,742617,1,4,5,2,0,20
69103,742617,1,4,6,0,0,20
69104,742617,1,5,1,0,0,20
69105,742617,1,5,2,0,0,20
69106,742617,1,5,3,1,0,21
69107,742617,1,5,4,0,0,21
69108,742617,1,5,5,0,0,21
69109,742617,1,5,6,7,0,28
69110,742617,1,6,1,1,0,29
69111,742617,1,6,2,0,0,29
69112,742617,1,6,3,1,0,30
69113,742617,1,6,4,4,0,34
69114,742617,1,6,5,0,0,34
69115,742617,1,6,6,0,0,34
69116,742617,1,7,1,1,0,35
69117,742617,1,7,2,1,0,36
69118,742617,1,7,3,0,0,36
69119,742617,1,7,4,1,0,37
69120,742617,1,7,5,1,0,38
69121,742617,1,7,6,1,0,39
69122,742617,1,8,1,4,0,43
69123,742617,1,8,2,1,0,44
69124,742617,1,8,3,0,0,44
69125,742617,1,8,4,0,0,44
69126,742617,1,8,5,2,0,46
69127,742617,1,8,6,1,0,47
69128,742617,1,9,1,0,0,47
69129,742617,1,9,2,6,0,53
69130,742617,1,9,3,1,0,54
69131,742617,1,9,4,1,0,55
69132,742617,1,9,5,1,0,56
69133,742617,1,9,6,1,0,57
69134,742617,1,10,1,2,0,59
69135,742617,1,10,2,1,0,60
69136,742617,1,10,3,1,0,61
69137,742617,1,10,4,0,0,61
69138,742617,1,10,5,0,1,61
69139,742617,1,10,6,0,0,61
69140,742617,1,11,1,6,0,67
69141,742617,1,11,2,0,0,67
69142,742617,1,11,3,1,0,68
69143,742617,1,11,4,1,0,69
69144,742617,1,11,5,0,0,69
69145,742617,1,11,6,2,0,71
69146,742617,1,12,1,2,0,73
69147,742617,1,12,2,0,0,73
69148,742617,1,12,3,1,0,74
69149,742617,1,12,4,4,0,78
69150,742617,1,12,5,0,0,78
69151,742617,1,12,6,1,0,79
69152,742617,1,13,1,1,0,80
69153,742617,1,13,2,0,0,80
69154,742617,1,13,3,6,0,86
69155,742617,1,13,4,0,0,86
69156,742617,1,13,5,6,0,92
69157,742617,1,13,6,1,0,93
69158,742617,1,14,1,0,0,93
69159,742617,1,14,2,1,0,94
69160,742617,1,14,3,1,0,95
69161,742617,1,14,4,0,0,95
69162,742617,1,14,5,1,0,96
69163,742617,1,14,6,4,0,100
69164,742617,1,15,1,2,0,102
69165,742617,1,15,2,2,0,104
69166,742617,1,15,3,2,0,106
69167,742617,1,15,4,0,0,106
69168,742617,1,15,5,4,0,110
69169,742617,1,15,6,0,0,110
69170,742617,1,16,1,1,0,111
69171,742617,1,16,2,0,0,111
69172,742617,1,16,3,1,0,112
69173,742617,1,16,4,0,1,112
69174,742617,1,16,5,0,0,112
69175,742617,1,16,6,1,0,113
69176,742617,1,17,1,0,0,113
69177,742617,1,17,2,0,0,113
69178,742617,1,17,3,2,0,115
69179,742617,1,17,4,1,0,116
69180,742617,1,17,5,1,0,117
69181,742617,1,17,6,4,0,121
69182,742617,1,18,1,0,0,121
69183,742617,1,18,2,1,0,122
69184,742617,1,18,3,1,0,123
69185,742617,1,18,4,0,0,123
69186,742617,1,18,5,2,0,125
69187,742617,1,18,6,1,0,126
69188,742617,1,19,1,1,0,127
69189,742617,1,19,2,1,0,128
69190,742617,1,19,3,0,0,128
69191,742617,1,19,4,0,1,128
69192,742617,1,19,5,1,0,129
69193,742617,1,19,6,1,0,130
69194,742617,1,20,1,0,1,130
69195,742617,1,20,2,1,0,131
69196,742617,1,20,3,1,0,132
69197,742617,1,20,4,1,0,133
69198,742617,1,20,5,1,0,134
69199,742617,1,20,6,1,0,135
69315,743953,1,1,1,0,0,0
69316,743953,1,1,2,0,0,0
69317,743953,1,1,3,1,0,1
69318,743953,1,1,4,0,0,1
69319,743953,1,1,5,1,0,2
69320,743953,1,1,6,1,0,3
69321,743953,1,2,1,0,0,3
69322,743953,1,2,2,6,0,9
69323,743953,1,2,3,2,0,11
69324,743953,1,2,4,0,0,11
69325,743953,1,2,5,0,0,11
69326,743953,1,2,6,6,0,17
69327,743953,1,3,1,1,0,18
69328,743953,1,3,2,4,0,22
69329,743953,1,3,3,2,0,24
69330,743953,1,3,4,1,0,25
69331,743953,1,3,5,0,0,25
69332,743953,1,3,6,0,1,25
69333,743953,1,4,1,4,0,29
69334,743953,1,4,2,0,0,29
69335,743953,1,4,3,1,0,30
69336,743953,1,4,4,0,0,30
69337,743953,1,4,5,1,0,31
69338,743953,1,4,6,1,0,32
69339,743953,1,5,1,0,0,32
69340,743953,1,5,2,2,0,34
69341,743953,1,5,3,1,0,35
69342,743953,1,5,4,1,0,36
69343,743953,1,5,5,4,0,40
69344,743953,1,5,6,6,0,46
69345,743953,1,6,1,2,0,48
69346,743953,1,6,2,4,0,52
69347,743953,1,6,3,6,0,58
69348,743953,1,6,4,1,0,59
69349,743953,1,6,5,0,0,59
69350,743953,1,6,6,1,0,60
69351,743953,1,7,1,1,0,61
69352,743953,1,7,2,1,0,62
69353,743953,1,7,3,1,0,63
69354,743953,1,7,4,2,0,65
69355,743953,1,7,5,1,0,66
69356,743953,1,7,6,1,0,67
69357,743953,1,8,1,1,0,68
69358,743953,1,8,2,1,0,69
69359,743953,1,8,3,1,0,70
69360,743953,1,8,4,4,0,74
69361,743953,1,8,5,1,0,75
69362,743953,1,8,6,1,0,76
69363,743953,1,9,1,0,1,76
69364,743953,1,9,2,1,0,77
69365,743953,1,9,3,1,0,78
69366,743953,1,9,4,0,0,78
69367,743953,1,9,5,1,0,79
69368,743953,1,9,6,0,1,79
69369,743953,1,10,1,1,0,80
69370,743953,1,10,2,1,0,81
69371,743953,1,10,3,0,0,81
69372,743953,1,10,4,0,0,81
69373,743953,1,10,5,4,0,85
69374,743953,1,10,6,0,0,85
69375,743953,1,11,1,1,0,86
69376,743953,1,11,2,1,0,87
69377,743953,1,11,3,6,0,93
69378,743953,1,11,4,1,0,94
69379,743953,1,11,5,1,0,95
69380,743953,1,11,6,0,0,95
69381,743953,1,12,1,1,0,96
69382,743953,1,12,2,0,0,96
69383,743953,1,12,3,4,0,100
69384,743953,1,12,4,1,0,101
69385,743953,1,12,5,0,1,101
69386,743953,1,12,6,1,0,102
69387,743953,1,13,1,2,0,104
69388,743953,1,13,2,0,0,104
69389,743953,1,13,3,1,0,105
69390,743953,1,13,4,1,0,106
69391,743953,1,13,5,1,0,107
69392,743953,1,13,6,1,0,108
69393,743953,1,14,1,1,0,109
69394,743953,1,14,2,1,0,110
69395,743953,1,14,3,1,0,111
69396,743953,1,14,4,1,0,112
69397,743953,1,14,5,1,0,113
69398,743953,1,14,6,1,0,114
69399,743953,1,15,1,4,0,118
69400,743953,1,15,2,4,0,122
69401,743953,1,15,3,1,0,123
69402,743953,1,15,4,4,0,127
69403,743953,1,15,5,4,0,131
69404,743953,1,15,6,6,0,137
69405,743953,1,16,1,4,0,141
69406,743953,1,16,2,1,0,142
69407,743953,1,16,3,0,0,142
69408,743953,1,16,4,2,0,144
69409,743953,1,16,5,0,1,144
69410,743953,1,16,6,1,0,145
69411,743953,1,17,1,1,0,146
69412,743953,1,17,2,2,0,148
69413,743953,1,17,3,1,0,149
69414,743953,1,17,4,2,0,151
69415,743953,1,17,5,4,0,155
69416,743953,1,17,6,0,0,155
69417,743953,1,18,1,1,0,156
69418,743953,1,18,2,1,1,157
69419,743953,1,18,3,0,0,157
69420,743953,1,18,4,1,0,158
69421,743953,1,18,5,0,0,158
69422,743953,1,18,6,6,0,164
69423,743953,1,19,1,4,0,168
69424,743953,1,19,2,1,0,169
69425,743953,1,19,3,0,1,169
69426,743953,1,19,4,5,0,174
69427,743953,1,19,5,1,0,175
69428,743953,1,19,6,2,0,177
69429,743953,1,20,1,4,0,181
69430,743953,1,20,2,1,0,182
69431,743953,1,20,3,4,0,186
69432,743953,1,20,4,1,0,187
69433,743953,1,20,5,0,0,187
69434,743953,1,20,6,4,0,191
69533,743975,1,1,1,0,0,0
69534,743975,1,1,2,2,0,2
69535,743975,1,1,3,4,0,6
69536,743975,1,1,4,0,0,6
69537,743975,1,1,5,1,0,7
69538,743975,1,1,6,0,0,7
69539,743975,1,2,1,1,0,8
69540,743975,1,2,2,0,0,8
69541,743975,1,2,3,1,0,9
69542,743975,1,2,4,0,0,9
69543,743975,1,2,5,1,0,10
69544,743975,1,2,6,1,0,11
69545,743975,1,3,1,0,0,11
69546,743975,1,3,2,0,0,11
69547,743975,1,3,3,0,0,11
69548,743975,1,3,4,4,0,15
69549,743975,1,3,5,1,0,16
69550,743975,1,3,6,1,0,17
69551,743975,1,4,1,0,0,17
69552,743975,1,4,2,0,0,17
69553,743975,1,4,3,0,1,17
69554,743975,1,4,4,1,0,18
69555,743975,1,4,5,0,0,18
69556,743975,1,4,6,0,1,18
69557,743975,1,5,1,0,0,18
69558,743975,1,5,2,0,0,18
69559,743975,1,5,3,1,0,19
69560,743975,1,5,4,0,0,19
69561,743975,1,5,5,3,0,22
69562,743975,1,5,6,0,0,22
69563,743975,1,6,1,0,0,22
69564,743975,1,6,2,0,0,22
69565,743975,1,6,3,0,0,22
69566,743975,1,6,4,1,0,23
69567,743975,1,6,5,0,0,23
69568,743975,1,6,6,4,0,27
69569,743975,1,7,1,4,0,31
69570,743975,1,7,2,0,0,31
69571,743975,1,7,3,1,0,32
69572,743975,1,7,4,0,0,32
69573,743975,1,7,5,4,0,36
69574,743975,1,7,6,1,0,37
69575,743975,1,8,1,0,0,37
69576,743975,1,8,2,1,0,38
69577,743975,1,8,3,1,0,39
69578,743975,1,8,4,1,0,40
69579,743975,1,8,5,0,0,40
69580,743975,1,8,6,3,0,43
69581,743975,1,9,1,0,0,43
69582,743975,1,9,2,6,0,49
69583,743975,1,9,3,4,0,53
69584,743975,1,9,4,1,0,54
69585,743975,1,9,5,1,0,55
69586,743975,1,9,6,1,0,56
69587,743975,1,10,1,1,0,57
69588,743975,1,10,2,1,0,58
69589,743975,1,10,3,1,0,59
69590,743975,1,10,4,1,0,60
69591,743975,1,10,5,1,0,61
69592,743975,1,10,6,1,0,62
69593,743975,1,11,1,4,0,66
69594,743975,1,11,2,6,0,72
69595,743975,1,11,3,1,0,73
69596,743975,1,11,4,0,0,73
69597,743975,1,11,5,0,0,73
69598,743975,1,11,6,0,0,73
69599,743975,1,12,1,0,0,73
69600,743975,1,12,2,1,0,74
69601,743975,1,12,3,2,0,76
69602,743975,1,12,4,4,0,80
69603,743975,1,12,5,4,0,84
69604,743975,1,12,6,0,0,84
69605,743975,1,13,1,2,0,86
69606,743975,1,13,2,6,0,92
69607,743975,1,13,3,0,0,92
69608,743975,1,13,4,0,0,92
69609,743975,1,13,5,1,0,93
69610,743975,1,13,6,2,0,95
69611,743975,1,14,1,1,0,96
69612,743975,1,14,2,6,0,102
69613,743975,1,14,3,4,0,106
69614,743975,1,14,4,6,0,112
69615,743975,1,14,5,1,0,113
69616,743975,1,14,6,1,0,114
69617,743975,1,15,1,6,0,120
69618,743975,1,15,2,2,0,122
69619,743975,1,15,3,0,0,122
69620,743975,1,15,4,6,0,128
69621,743975,1,15,5,6,0,134
69622,743975,1,15,6,2,0,136
69623,743975,1,16,1,1,0,137
69624,743975,1,16,2,1,0,138
69625,743975,1,16,3,1,0,139
69626,743975,1,16,4,1,0,140
69627,743975,1,16,5,6,0,146
69628,743975,1,16,6,6,0,152
69629,743975,1,17,1,1,0,153
69630,743975,1,17,2,0,1,153
69631,743975,1,17,3,0,0,153
69632,743975,1,17,4,2,0,155
69633,743975,1,17,5,1,0,156
69634,743975,1,17,6,1,0,157
69635,743975,1,18,1,4,0,161
69636,743975,1,18,2,6,0,167
69637,743975,1,18,3,1,1,168
69638,743975,1,18,4,0,0,168
69639,743975,1,18,5,0,0,168
69640,743975,1,18,6,0,0,168
69641,743975,1,19,1,1,0,169
69642,743975,1,19,2,1,0,170
69643,743975,1,19,3,0,0,170
69644,743975,1,19,4,2,0,172
69645,743975,1,19,5,1,0,173
69646,743975,1,19,6,1,0,174
69647,743975,1,20,1,1,0,175
69648,743975,1,20,2,4,0,179
69649,743975,1,20,3,1,0,180
69650,743975,1,20,4,0,1,180
69651,743975,1,20,5,1,0,181
69652,743975,1,20,6,1,0,182
69773,754039,1,1,1,0,0,0
69774,754039,1,1,2,0,0,0
69775,754039,1,1,3,1,0,1
69776,754039,1,1,4,0,0,1
69777,754039,1,1,5,0,0,1
69778,754039,1,1,6,0,0,1
69779,754039,1,2,1,0,0,1
69780,754039,1,2,2,0,0,1
69781,754039,1,2,3,1,0,2
69782,754039,1,2,4,1,0,3
69783,754039,1,2,5,0,0,3
69784,754039,1,2,6,0,0,3
69785,754039,1,3,1,0,0,3
69786,754039,1,3,2,4,0,7
69787,754039,1,3,3,6,0,13
69788,754039,1,3,4,1,0,14
69789,754039,1,3,5,0,0,14
69790,754039,1,3,6,1,0,15
69791,754039,1,4,1,0,0,15
69792,754039,1,4,2,1,0,16
69793,754039,1,4,3,0,0,16
69794,754039,1,4,4,3,0,19
69795,754039,1,4,5,1,0,20
69796,754039,1,4,6,4,0,24
69797,754039,1,5,1,4,0,28
69798,754039,1,5,2,0,0,28
69799,754039,1,5,3,4,0,32
69800,754039,1,5,4,0,0,32
69801,754039,1,5,5,0,0,32
69802,754039,1,5,6,0,0,32
69803,754039,1,6,1,4,0,36
69804,754039,1,6,2,1,0,37
69805,754039,1,6,3,0,0,37
69806,754039,1,6,4,1,0,38
69807,754039,1,6,5,4,0,42
69808,754039,1,6,6,1,0,43
69809,754039,1,7,1,1,0,44
69810,754039,1,7,2,2,0,46
69811,754039,1,7,3,1,0,47
69812,754039,1,7,4,1,0,48
69813,754039,1,7,5,1,0,49
69814,754039,1,7,6,0,1,49
69815,754039,1,8,1,1,0,50
69816,754039,1,8,2,0,0,50
69817,754039,1,8,3,0,1,50
69818,754039,1,8,4,1,0,51
69819,754039,1,8,5,0,0,51
69820,754039,1,8,6,1,0,52
69821,754039,1,9,1,1,0,53
69822,754039,1,9,2,1,0,54
69823,754039,1,9,3,1,0,55
69824,754039,1,9,4,0,0,55
69825,754039,1,9,5,0,0,55
69826,754039,1,9,6,0,0,55
69827,754039,1,10,1,0,0,55
69828,754039,1,10,2,0,0,55
69829,754039,1,10,3,2,0,57
69830,754039,1,10,4,0,0,57
69831,754039,1,10,5,1,0,58
69832,754039,1,10,6,0,1,58
69833,754039,1,11,1,1,0,59
69834,754039,1,11,2,0,0,59
69835,754039,1,11,3,0,0,59
69836,754039,1,11,4,1,0,60
69837,754039,1,11,5,1,0,61
69838,754039,1,11,6,1,0,62
69839,754039,1,12,1,2,0,64
69840,754039,1,12,2,1,0,65
69841,754039,1,12,3,1,0,66
69842,754039,1,12,4,4,0,70
69843,754039,1,12,5,2,0,72
69844,754039,1,12,6,4,0,76
69845,754039,1,13,1,1,0,77
69846,754039,1,13,2,0,0,77
69847,754039,1,13,3,1,0,78
69848,754039,1,13,4,0,0,78
69849,754039,1,13,5,0,1,78
69850,754039,1,13,6,0,0,78
69851,754039,1,14,1,1,0,79
69852,754039,1,14,2,0,0,79
69853,754039,1,14,3,2,0,81
69854,754039,1,14,4,1,0,82
69855,754039,1,14,5,0,0,82
69856,754039,1,14,6,3,0,85
69857,754039,1,15,1,1,0,86
69858,754039,1,15,2,1,0,87
69859,754039,1,15,3,0,0,87
69860,754039,1,15,4,4,0,91
69861,754039,1,15,5,1,0,92
69862,754039,1,15,6,1,0,93
69863,754039,1,16,1,1,0,94
69864,754039,1,16,2,1,0,95
69865,754039,1,16,3,5,0,100
69866,754039,1,16,4,6,0,106
69867,754039,1,16,5,6,0,112
69868,754039,1,16,6,1,0,113
69869,754039,1,17,1,2,0,115
69870,754039,1,17,2,1,0,116
69871,754039,1,17,3,0,0,116
69872,754039,1,17,4,0,1,116
69873,754039,1,17,5,0,0,116
69874,754039,1,17,6,1,0,117
69875,754039,1,18,1,2,0,119
69876,754039,1,18,2,1,0,120
69877,754039,1,18,3,1,0,121
69878,754039,1,18,4,2,0,123
69879,754039,1,18,5,4,0,127
69880,754039,1,18,6,0,1,127
69881,754039,1,19,1,0,0,127
69882,754039,1,19,2,0,0,127
69883,754039,1,19,3,0,1,127
69884,754039,1,19,4,2,0,129
69885,754039,1,19,5,2,0,131
69886,754039,1,19,6,4,0,135
69887,754039,1,20,1,1,1,136
69888,754039,1,20,2,1,0,137
69889,754039,1,20,3,1,0,138
69890,754039,1,20,4,1,0,139
69891,754039,1,20,5,1,0,140
69892,754039,1,20,6,4,0,144
70006,754717,1,1,1,0,0,0
70007,754717,1,1,2,4,0,4
70008,754717,1,1,3,0,0,4
70009,754717,1,1,4,1,0,5
70010,754717,1,1,5,0,0,5
70011,754717,1,1,6,0,0,5
70012,754717,1,2,1,3,0,8
70013,754717,1,2,2,0,0,8
70014,754717,1,2,3,4,0,12
70015,754717,1,2,4,2,0,14
70016,754717,1,2,5,1,0,15
70017,754717,1,2,6,2,0,17
70018,754717,1,3,1,2,0,19
70019,754717,1,3,2,4,0,23
70020,754717,1,3,3,1,0,24
70021,754717,1,3,4,1,0,25
70022,754717,1,3,5,1,0,26
70023,754717,1,3,6,1,0,27
70024,754717,1,4,1,0,0,27
70025,754717,1,4,2,0,0,27
70026,754717,1,4,3,4,0,31
70027,754717,1,4,4,2,0,33
70028,754717,1,4,5,0,0,33
70029,754717,1,4,6,0,0,33
70030,754717,1,5,1,0,1,33
70031,754717,1,5,2,1,0,34
70032,754717,1,5,3,4,0,38
70033,754717,1,5,4,0,0,38
70034,754717,1,5,5,0,0,38
70035,754717,1,5,6,1,0,39
70036,754717,1,6,1,0,0,39
70037,754717,1,6,2,1,0,40
70038,754717,1,6,3,1,0,41
70039,754717,1,6,4,1,0,42
70040,754717,1,6,5,0,1,42
70041,754717,1,6,6,1,0,43
70042,754717,1,7,1,0,0,43
70043,754717,1,7,2,1,0,44
70044,754717,1,7,3,1,0,45
70045,754717,1,7,4,0,0,45
70046,754717,1,7,5,1,0,46
70047,754717,1,7,6,1,0,47
70048,754717,1,8,1,0,0,47
70049,754717,1,8,2,1,0,48
70050,754717,1,8,3,0,1,48
70051,754717,1,8,4,1,0,49
70052,754717,1,8,5,1,0,50
70053,754717,1,8,6,1,0,51
70054,754717,1,9,1,0,0,51
70055,754717,1,9,2,0,0,51
70056,754717,1,9,3,1,0,52
70057,754717,1,9,4,1,0,53
70058,754717,1,9,5,1,0,54
70059,754717,1,9,6,2,0,56
70060,754717,1,10,1,0,0,56
70061,754717,1,10,2,1,0,57
70062,754717,1,10,3,6,0,63
70063,754717,1,10,4,2,0,65
70064,754717,1,10,5,2,0,67
70065,754717,1,10,6,0,0,67
70066,754717,1,11,1,0,0,67
70067,754717,1,11,2,0,1,67
70068,754717,1,11,3,0,0,67
70069,754717,1,11,4,1,0,68
70070,754717,1,11,5,1,0,69
70071,754717,1,11,6,0,0,69
70072,754717,1,12,1,1,0,70
70073,754717,1,12,2,1,0,71
70074,754717,1,12,3,0,0,71
70075,754717,1,12,4,1,0,72
70076,754717,1,12,5,1,0,73
70077,754717,1,12,6,6,0,79
70078,754717,1,13,1,1,0,80
70079,754717,1,13,2,3,0,83
70080,754717,1,13,3,6,0,89
70081,754717,1,13,4,3,0,92
70082,754717,1,13,5,1,0,93
70083,754717,1,13,6,0,0,93
70084,754717,1,14,1,1,0,94
70085,754717,1,14,2,0,0,94
70086,754717,1,14,3,1,0,95
70087,754717,1,14,4,1,0,96
70088,754717,1,14,5,1,0,97
70089,754717,1,14,6,0,0,97
70090,754717,1,15,1,0,0,97
70091,754717,1,15,2,4,0,101
70092,754717,1,15,3,1,0,102
70093,754717,1,15,4,0,0,102
70094,754717,1,15,5,1,0,103
70095,754717,1,15,6,1,0,104
70096,754717,1,16,1,0,0,104
70097,754717,1,16,2,1,0,105
70098,754717,1,16,3,3,0,108
70099,754717,1,16,4,6,0,114
70100,754717,1,16,5,1,0,115
70101,754717,1,16,6,1,0,116
70102,754717,1,17,1,1,0,117
70103,754717,1,17,2,1,0,118
70104,754717,1,17,3,1,0,119
70105,754717,1,17,4,2,0,121
70106,754717,1,17,5,1,0,122
70107,754717,1,17,6,1,0,123
70108,754717,1,18,1,1,0,124
70109,754717,1,18,2,0,1,124
70110,754717,1,18,3,1,0,125
70111,754717,1,18,4,1,0,126
70112,754717,1,18,5,1,0,127
70113,754717,1,18,6,1,0,128
70114,754717,1,19,1,1,0,129
70115,754717,1,19,2,1,0,130
70116,754717,1,19,3,1,0,131
70117,754717,1,19,4,1,0,132
70118,754717,1,19,5,1,0,133
70119,754717,1,19,6,2,0,135
70120,754717,1,20,1,2,0,137
70121,754717,1,20,2,2,0,139
70122,754717,1,20,3,2,0,141
70123,754717,1,20,4,1,0,142
70124,754717,1,20,5,0,1,142
70125,754717,1,20,6,2,0,144
70240,754719,1,1,1,1,0,1
70241,754719,1,1,2,0,1,1
70242,754719,1,1,3,0,0,1
70243,754719,1,1,4,0,0,1
70244,754719,1,1,5,4,0,5
70245,754719,1,1,6,4,0,9
70246,754719,1,2,1,0,0,9
70247,754719,1,2,2,1,0,10
70248,754719,1,2,3,0,0,10
70249,754719,1,2,4,0,0,10
70250,754719,1,2,5,4,0,14
70251,754719,1,2,6,0,1,14
70252,754719,1,3,1,0,0,14
70253,754719,1,3,2,0,0,14
70254,754719,1,3,3,1,0,15
70255,754719,1,3,4,0,0,15
70256,754719,1,3,5,0,0,15
70257,754719,1,3,6,1,0,16
70258,754719,1,4,1,0,0,16
70259,754719,1,4,2,0,0,16
70260,754719,1,4,3,1,0,17
70261,754719,1,4,4,1,0,18
70262,754719,1,4,5,1,0,19
70263,754719,1,4,6,0,0,19
70264,754719,1,5,1,4,0,23
70265,754719,1,5,2,0,0,23
70266,754719,1,5,3,1,0,24
70267,754719,1,5,4,0,0,24
70268,754719,1,5,5,4,0,28
70269,754719,1,5,6,1,0,29
70270,754719,1,6,1,0,0,29
70271,754719,1,6,2,0,0,29
70272,754719,1,6,3,1,0,30
70273,754719,1,6,4,1,0,31
70274,754719,1,6,5,1,0,32
70275,754719,1,6,6,4,0,36
70276,754719,1,7,1,4,0,40
70277,754719,1,7,2,1,0,41
70278,754719,1,7,3,1,0,42
70279,754719,1,7,4,0,0,42
70280,754719,1,7,5,0,0,42
70281,754719,1,7,6,2,0,44
70282,754719,1,8,1,0,0,44
70283,754719,1,8,2,0,0,44
70284,754719,1,8,3,0,0,44
70285,754719,1,8,4,0,0,44
70286,754719,1,8,5,0,0,44
70287,754719,1,8,6,0,0,44
70288,754719,1,9,1,0,0,44
70289,754719,1,9,2,1,0,45
70290,754719,1,9,3,1,0,46
70291,754719,1,9,4,0,1,46
70292,754719,1,9,5,0,0,46
70293,754719,1,9,6,1,0,47
70294,754719,1,10,1,1,0,48
70295,754719,1,10,2,1,0,49
70296,754719,1,10,3,1,0,50
70297,754719,1,10,4,1,0,51
70298,754719,1,10,5,0,0,51
70299,754719,1,10,6,0,0,51
70300,754719,1,11,1,0,0,51
70301,754719,1,11,2,0,0,51
70302,754719,1,11,3,1,0,52
70303,754719,1,11,4,1,0,53
70304,754719,1,11,5,0,0,53
70305,754719,1,11,6,1,0,54
70306,754719,1,12,1,2,0,56
70307,754719,1,12,2,0,0,56
70308,754719,1,12,3,1,0,57
70309,754719,1,12,4,0,0,57
70310,754719,1,12,5,1,0,58
70311,754719,1,12,6,1,0,59
70312,754719,1,13,1,1,0,60
70313,754719,1,13,2,0,1,60
70314,754719,1,13,3,0,0,60
70315,754719,1,13,4,1,0,61
70316,754719,1,13,5,1,0,62
70317,754719,1,13,6,1,0,63
70318,754719,1,14,1,0,0,63
70319,754719,1,14,2,1,0,64
70320,754719,1,14,3,1,0,65
70321,754719,1,14,4,0,0,65
70322,754719,1,14,5,1,0,66
70323,754719,1,14,6,0,0,66
70324,754719,1,15,1,0,0,66
70325,754719,1,15,2,1,0,67
70326,754719,1,15,3,2,0,69
70327,754719,1,15,4,2,0,71
70328,754719,1,15,5,0,0,71
70329,754719,1,15,6,0,0,71
70330,754719,1,16,1,1,0,72
70331,754719,1,16,2,0,0,72
70332,754719,1,16,3,4,0,76
70333,754719,1,16,4,1,0,77
70334,754719,1,16,5,0,0,77
70335,754719,1,16,6,0,0,77
70336,754719,1,17,1,1,0,78
70337,754719,1,17,2,1,0,79
70338,754719,1,17,3,6,0,85
70339,754719,1,17,4,1,0,86
70340,754719,1,17,5,4,0,90
70341,754719,1,17,6,0,1,90
70342,754719,1,18,1,1,0,91
70343,754719,1,18,2,1,0,92
70344,754719,1,18,3,0,0,92
70345,754719,1,18,4,0,0,92
70346,754719,1,18,5,0,1,92
70347,754719,1,18,6,1,0,93
70348,754719,1,19,1,2,0,95
70349,754719,1,19,2,0,0,95
70350,754719,1,19,3,2,0,97
70351,754719,1,19,4,0,1,97
70352,754719,1,19,5,0,0,97
70353,754719,1,19,6,0,0,97
70354,754719,1,20,1,1,0,98
70355,754719,1,20,2,0,0,98
70356,754719,1,20,3,0,0,98
70357,754719,1,20,4,1,0,99
70358,754719,1,20,5,1,0,100
70359,754719,1,20,6,1,0,101
70436,754721,1,1,1,0,0,0
70437,754721,1,1,2,1,0,1
70438,754721,1,1,3,0,0,1
70439,754721,1,1,4,0,0,1
70440,754721,1,1,5,1,0,2
70441,754721,1,1,6,4,0,6
70442,754721,1,2,1,1,0,7
70443,754721,1,2,2,1,0,8
70444,754721,1,2,3,1,0,9
70445,754721,1,2,4,0,0,9
70446,754721,1,2,5,1,0,10
70447,754721,1,2,6,1,0,11
70448,754721,1,3,1,1,0,12
70449,754721,1,3,2,0,0,12
70450,754721,1,3,3,1,0,13
70451,754721,1,3,4,0,0,13
70452,754721,1,3,5,0,0,13
70453,754721,1,3,6,1,0,14
70454,754721,1,4,1,1,0,15
70455,754721,1,4,2,6,0,21
70456,754721,1,4,3,0,0,21
70457,754721,1,4,4,1,0,22
70458,754721,1,4,5,0,0,22
70459,754721,1,4,6,1,0,23
70460,754721,1,5,1,4,0,27
70461,754721,1,5,2,2,0,29
70462,754721,1,5,3,4,0,33
70463,754721,1,5,4,1,0,34
70464,754721,1,5,5,4,0,38
70465,754721,1,5,6,1,0,39
70466,754721,1,6,1,1,0,40
70467,754721,1,6,2,4,0,44
70468,754721,1,6,3,4,0,48
70469,754721,1,6,4,2,0,50
70470,754721,1,6,5,2,0,52
70471,754721,1,6,6,1,0,53
70472,754721,1,7,1,1,0,54
70473,754721,1,7,2,1,0,55
70474,754721,1,7,3,1,0,56
70475,754721,1,7,4,0,0,56
70476,754721,1,7,5,2,0,58
70477,754721,1,7,6,1,0,59
70478,754721,1,8,1,1,0,60
70479,754721,1,8,2,0,0,60
70480,754721,1,8,3,1,0,61
70481,754721,1,8,4,1,0,62
70482,754721,1,8,5,4,0,66
70483,754721,1,8,6,2,0,68
70484,754721,1,9,1,0,0,68
70485,754721,1,9,2,1,0,69
70486,754721,1,9,3,6,0,75
70487,754721,1,9,4,0,1,75
70488,754721,1,9,5,2,0,77
70489,754721,1,9,6,1,0,78
70490,754721,1,10,1,1,0,79
70491,754721,1,10,2,0,0,79
70492,754721,1,10,3,0,0,79
70493,754721,1,10,4,2,0,81
70494,754721,1,10,5,2,0,83
70495,754721,1,10,6,1,0,84
70496,754721,1,11,1,0,0,84
70497,754721,1,11,2,4,0,88
70498,754721,1,11,3,0,0,88
70499,754721,1,11,4,0,0,88
70500,754721,1,11,5,0,0,88
70501,754721,1,11,6,0,0,88
70502,754721,1,12,1,0,1,88
70503,754721,1,12,2,2,0,90
70504,754721,1,12,3,1,0,91
70505,754721,1,12,4,1,0,92
70506,754721,1,12,5,1,0,93
70507,754721,1,12,6,0,0,93
70508,754721,1,13,1,0,0,93
70509,754721,1,13,2,1,0,94
70510,754721,1,13,3,4,0,98
70511,754721,1,13,4,1,0,99
70512,754721,1,13,5,1,0,100
70513,754721,1,13,6,0,0,100
70514,754721,1,14,1,4,0,104
70515,754721,1,14,2,1,0,105
70516,754721,1,14,3,1,0,106
70517,754721,1,14,4,1,0,107
70518,754721,1,14,5,4,0,111
70519,754721,1,14,6,1,0,112
70520,754721,1,15,1,0,0,112
70521,754721,1,15,2,1,0,113
70522,754721,1,15,3,0,0,113
70523,754721,1,15,4,1,0,114
70524,754721,1,15,5,1,0,115
70525,754721,1,15,6,1,0,116
70526,754721,1,16,1,1,0,117
70527,754721,1,16,2,0,1,117
70528,754721,1,16,3,0,0,117
70529,754721,1,16,4,1,0,118
70530,754721,1,16,5,0,0,118
70531,754721,1,16,6,2,0,120
70532,754721,1,17,1,0,0,120
70533,754721,1,17,2,1,0,121
70534,754721,1,17,3,1,0,122
70535,754721,1,17,4,0,1,122
70536,754721,1,17,5,2,0,124
70537,754721,1,17,6,4,0,128
70538,754721,1,18,1,0,0,128
70539,754721,1,18,2,1,0,129
70540,754721,1,18,3,1,0,130
70541,754721,1,18,4,1,0,131
70542,754721,1,18,5,1,0,132
70543,754721,1,18,6,1,0,133
70544,754721,1,19,1,0,1,133
70545,754721,1,19,2,1,0,134
70546,754721,1,19,3,0,1,134
70547,754721,1,19,4,1,0,135
70548,754721,1,19,5,4,0,139
70549,754721,1,19,6,1,0,140
70550,754721,1,20,1,0,0,140
70551,754721,1,20,2,1,0,141
70552,754721,1,20,3,0,0,141
70553,754721,1,20,4,1,0,142
70554,754721,1,20,5,1,0,143
70555,754721,1,20,6,2,0,145
70675,800479,1,1,1,1,0,1
70676,800479,1,1,2,4,0,5
70677,800479,1,1,3,2,0,7
70678,800479,1,1,4,0,0,7
70679,800479,1,1,5,2,0,9
70680,800479,1,1,6,1,0,10
70681,800479,1,2,1,4,0,14
70682,800479,1,2,2,0,0,14
70683,800479,1,2,3,4,0,18
70684,800479,1,2,4,4,0,22
70685,800479,1,2,5,0,0,22
70686,800479,1,2,6,0,0,22
70687,800479,1,3,1,6,0,28
70688,800479,1,3,2,4,0,32
70689,800479,1,3,3,1,0,33
70690,800479,1,3,4,2,0,35
70691,800479,1,3,5,0,0,35
70692,800479,1,3,6,1,0,36
70693,800479,1,4,1,0,0,36
70694,800479,1,4,2,1,0,37
70695,800479,1,4,3,1,0,38
70696,800479,1,4,4,0,1,38
70697,800479,1,4,5,1,0,39
70698,800479,1,4,6,0,0,39
70699,800479,1,5,1,0,0,39
70700,800479,1,5,2,0,0,39
70701,800479,1,5,3,1,0,40
70702,800479,1,5,4,4,0,44
70703,800479,1,5,5,0,0,44
70704,800479,1,5,6,1,0,45
70705,800479,1,6,1,0,0,45
70706,800479,1,6,2,1,0,46
70707,800479,1,6,3,0,0,46
70708,800479,1,6,4,0,0,46
70709,800479,1,6,5,0,0,46
70710,800479,1,6,6,4,0,50
70711,800479,1,7,1,1,0,51
70712,800479,1,7,2,1,0,52
70713,800479,1,7,3,0,0,52
70714,800479,1,7,4,0,1,52
70715,800479,1,7,5,0,0,52
70716,800479,1,7,6,1,0,53
70717,800479,1,8,1,0,1,53
70718,800479,1,8,2,0,0,53
70719,800479,1,8,3,0,0,53
70720,800479,1,8,4,0,0,53
70721,800479,1,8,5,1,0,54
70722,800479,1,8,6,4,0,58
70723,800479,1,9,1,4,0,62
70724,800479,1,9,2,6,0,68
70725,800479,1,9,3,0,1,68
70726,800479,1,9,4,0,0,68
70727,800479,1,9,5,1,0,69
70728,800479,1,9,6,1,0,70
70729,800479,1,10,1,0,0,70
70730,800479,1,10,2,1,0,71
70731,800479,1,10,3,0,0,71
70732,800479,1,10,4,1,0,72
70733,800479,1,10,5,1,0,73
70734,800479,1,10,6,1,0,74
70735,800479,1,11,1,1,0,75
70736,800479,1,11,2,0,0,75
70737,800479,1,11,3,1,0,76
70738,800479,1,11,4,1,0,77
70739,800479,1,11,5,1,0,78
70740,800479,1,11,6,0,0,78
70741,800479,1,12,1,1,0,79
70742,800479,1,12,2,0,0,79
70743,800479,1,12,3,0,0,79
70744,800479,1,12,4,1,0,80
70745,800479,1,12,5,0,0,80
70746,800479,1,12,6,0,0,80
70747,800479,1,13,1,1,0,81
70748,800479,1,13,2,0,1,81
70749,800479,1,13,3,0,1,81
70750,800479,1,13,4,0,0,81
70751,800479,1,13,5,0,0,81
70752,800479,1,13,6,0,0,81
70753,800479,1,14,1,1,0,82
70754,800479,1,14,2,0,0,82
70755,800479,1,14,3,1,0,83
70756,800479,1,14,4,1,0,84
70757,800479,1,14,5,4,0,88
70758,800479,1,14,6,1,0,89
70759,800479,1,15,1,1,0,90
70760,800479,1,15,2,1,0,91
70761,800479,1,15,3,0,0,91
70762,800479,1,15,4,1,0,92
70763,800479,1,15,5,1,0,93
70764,800479,1,15,6,1,0,94
70765,800479,1,16,1,2,0,96
70766,800479,1,16,2,0,0,96
70767,800479,1,16,3,4,0,100
70768,800479,1,16,4,1,0,101
70769,800479,1,16,5,4,0,105
70770,800479,1,16,6,1,0,106
70771,800479,1,17,1,2,0,108
70772,800479,1,17,2,0,0,108
70773,800479,1,17,3,0,1,108
70774,800479,1,17,4,1,0,109
70775,800479,1,17,5,1,0,110
70776,800479,1,17,6,0,0,110
70777,800479,1,18,1,3,0,113
70778,800479,1,18,2,5,0,118
70779,800479,1,18,3,1,0,119
70780,800479,1,18,4,0,0,119
70781,800479,1,18,5,0,0,119
70782,800479,1,18,6,1,0,120
70783,800479,1,19,1,0,1,120
70784,800479,1,19,2,1,0,121
70785,800479,1,19,3,1,0,122
70786,800479,1,19,4,1,0,123
70787,800479,1,19,5,1,0,124
70788,800479,1,19,6,1,0,125
70789,800479,1,20,1,1,0,126
70790,800479,1,20,2,2,0,128
70791,800479,1,20,3,1,0,129
70792,800479,1,20,4,2,0,131
70793,800479,1,20,5,1,0,132
70794,800479,1,20,6,2,0,134
70915,800481,1,1,1,0,0,0
70916,800481,1,1,2,0,0,0
70917,800481,1,1,3,2,0,2
70918,800481,1,1,4,0,0,2
70919,800481,1,1,5,0,0,2
70920,800481,1,1,6,1,0,3
70921,800481,1,2,1,2,0,5
70922,800481,1,2,2,0,0,5
70923,800481,1,2,3,0,0,5
70924,800481,1,2,4,0,0,5
70925,800481,1,2,5,2,0,7
70926,800481,1,2,6,1,0,8
70927,800481,1,3,1,1,0,9
70928,800481,1,3,2,0,0,9
70929,800481,1,3,3,1,0,10
70930,800481,1,3,4,0,0,10
70931,800481,1,3,5,0,1,10
70932,800481,1,3,6,4,0,14
70933,800481,1,4,1,0,0,14
70934,800481,1,4,2,2,0,16
70935,800481,1,4,3,0,0,16
70936,800481,1,4,4,0,0,16
70937,800481,1,4,5,1,0,17
70938,800481,1,4,6,4,0,21
70939,800481,1,5,1,1,0,22
70940,800481,1,5,2,0,0,22
70941,800481,1,5,3,1,0,23
70942,800481,1,5,4,6,0,29
70943,800481,1,5,5,2,0,31
70944,800481,1,5,6,6,0,37
70945,800481,1,6,1,0,0,37
70946,800481,1,6,2,1,0,38
70947,800481,1,6,3,0,0,38
70948,800481,1,6,4,2,0,40
70949,800481,1,6,5,6,0,46
70950,800481,1,6,6,1,0,47
70951,800481,1,7,1,0,0,47
70952,800481,1,7,2,1,0,48
70953,800481,1,7,3,1,0,49
70954,800481,1,7,4,4,0,53
70955,800481,1,7,5,0,0,53
70956,800481,1,7,6,4,0,57
70957,800481,1,8,1,1,0,58
70958,800481,1,8,2,1,0,59
70959,800481,1,8,3,1,0,60
70960,800481,1,8,4,0,0,60
70961,800481,1,8,5,0,1,60
70962,800481,1,8,6,1,1,61
70963,800481,1,9,1,1,0,62
70964,800481,1,9,2,1,0,63
70965,800481,1,9,3,0,0,63
70966,800481,1,9,4,0,0,63
70967,800481,1,9,5,1,0,64
70968,800481,1,9,6,2,0,66
70969,800481,1,10,1,4,0,70
70970,800481,1,10,2,1,0,71
70971,800481,1,10,3,0,0,71
70972,800481,1,10,4,1,0,72
70973,800481,1,10,5,1,0,73
70974,800481,1,10,6,1,0,74
70975,800481,1,11,1,1,0,75
70976,800481,1,11,2,0,0,75
70977,800481,1,11,3,4,0,79
70978,800481,1,11,4,6,0,85
70979,800481,1,11,5,1,0,86
70980,800481,1,11,6,1,0,87
70981,800481,1,12,1,1,0,88
70982,800481,1,12,2,1,0,89
70983,800481,1,12,3,0,0,89
70984,800481,1,12,4,0,0,89
70985,800481,1,12,5,0,0,89
70986,800481,1,12,6,0,0,89
70987,800481,1,13,1,0,0,89
70988,800481,1,13,2,4,0,93
70989,800481,1,13,3,1,0,94
70990,800481,1,13,4,6,0,100
70991,800481,1,13,5,6,0,106
70992,800481,1,13,6,0,0,106
70993,800481,1,14,1,1,0,107
70994,800481,1,14,2,1,0,108
70995,800481,1,14,3,0,0,108
70996,800481,1,14,4,1,0,109
70997,800481,1,14,5,2,0,111
70998,800481,1,14,6,6,0,117
70999,800481,1,15,1,6,0,123
71000,800481,1,15,2,2,0,125
71001,800481,1,15,3,6,0,131
71002,800481,1,15,4,1,0,132
71003,800481,1,15,5,0,0,132
71004,800481,1,15,6,1,0,133
71005,800481,1,16,1,2,0,135
71006,800481,1,16,2,6,0,141
71007,800481,1,16,3,1,0,142
71008,800481,1,16,4,2,0,144
71009,800481,1,16,5,2,0,146
71010,800481,1,16,6,4,0,150
71011,800481,1,17,1,1,0,151
71012,800481,1,17,2,6,0,157
71013,800481,1,17,3,0,1,157
71014,800481,1,17,4,0,1,157
71015,800481,1,17,5,1,0,158
71016,800481,1,17,6,0,0,158
71017,800481,1,18,1,0,1,158
71018,800481,1,18,2,0,0,158
71019,800481,1,18,3,1,0,159
71020,800481,1,18,4,1,0,160
71021,800481,1,18,5,0,1,160
71022,800481,1,18,6,0,0,160
71023,800481,1,19,1,1,0,161
71024,800481,1,19,2,4,0,165
71025,800481,1,19,3,1,0,166
71026,800481,1,19,4,0,1,166
71027,800481,1,19,5,0,1,166
71028,800481,1,19,6,0,0,166
71029,800481,1,20,1,2,0,168
71030,800481,1,20,2,1,0,169
71031,800481,1,20,3,2,0,171
71032,800481,1,20,4,0,1,171
71121,817203,1,1,1,0,0,0
71122,817203,1,1,2,0,0,0
71123,817203,1,1,3,0,0,0
71124,817203,1,1,4,0,0,0
71125,817203,1,1,5,2,0,2
71126,817203,1,1,6,0,1,2
71127,817203,1,2,1,1,0,3
71128,817203,1,2,2,1,0,4
71129,817203,1,2,3,1,0,5
71130,817203,1,2,4,2,0,7
71131,817203,1,2,5,0,0,7
71132,817203,1,2,6,0,0,7
71133,817203,1,3,1,0,0,7
71134,817203,1,3,2,1,0,8
71135,817203,1,3,3,0,0,8
71136,817203,1,3,4,4,0,12
71137,817203,1,3,5,0,0,12
71138,817203,1,3,6,4,0,16
71139,817203,1,4,1,2,0,18
71140,817203,1,4,2,6,0,24
71141,817203,1,4,3,2,0,26
71142,817203,1,4,4,4,0,30
71143,817203,1,4,5,1,0,31
71144,817203,1,4,6,0,1,31
71145,817203,1,5,1,1,0,32
71146,817203,1,5,2,1,0,33
71147,817203,1,5,3,0,0,33
71148,817203,1,5,4,1,0,34
71149,817203,1,5,5,0,0,34
71150,817203,1,5,6,1,0,35
71151,817203,1,6,1,1,0,36
71152,817203,1,6,2,0,0,36
71153,817203,1,6,3,0,0,36
71154,817203,1,6,4,1,0,37
71155,817203,1,6,5,0,0,37
71156,817203,1,6,6,0,0,37
71157,817203,1,7,1,1,0,38
71158,817203,1,7,2,4,0,42
71159,817203,1,7,3,0,0,42
71160,817203,1,7,4,1,0,43
71161,817203,1,7,5,1,0,44
71162,817203,1,7,6,1,0,45
71163,817203,1,8,1,1,0,46
71164,817203,1,8,2,4,0,50
71165,817203,1,8,3,1,0,51
71166,817203,1,8,4,0,0,51
71167,817203,1,8,5,1,0,52
71168,817203,1,8,6,1,0,53
71169,817203,1,9,1,1,0,54
71170,817203,1,9,2,1,0,55
71171,817203,1,9,3,1,0,56
71172,817203,1,9,4,1,0,57
71173,817203,1,9,5,4,0,61
71174,817203,1,9,6,1,0,62
71175,817203,1,10,1,1,0,63
71176,817203,1,10,2,1,0,64
71177,817203,1,10,3,0,0,64
71178,817203,1,10,4,1,0,65
71179,817203,1,10,5,1,0,66
71180,817203,1,10,6,4,0,70
71181,817203,1,11,1,0,0,70
71182,817203,1,11,2,2,0,72
71183,817203,1,11,3,0,0,72
71184,817203,1,11,4,1,0,73
71185,817203,1,11,5,2,0,75
71186,817203,1,11,6,1,0,76
71187,817203,1,12,1,1,0,77
71188,817203,1,12,2,0,1,77
71189,817203,1,12,3,4,0,81
71190,817203,1,12,4,1,0,82
71191,817203,1,12,5,1,0,83
71192,817203,1,12,6,1,0,84
71193,817203,1,13,1,0,0,84
71194,817203,1,13,2,0,0,84
71195,817203,1,13,3,2,0,86
71196,817203,1,13,4,2,0,88
71197,817203,1,13,5,1,0,89
71198,817203,1,13,6,0,0,89
71199,817203,1,14,1,1,0,90
71200,817203,1,14,2,0,1,90
71201,817203,1,14,3,1,0,91
71202,817203,1,14,4,0,0,91
71203,817203,1,14,5,1,0,92
71204,817203,1,14,6,4,0,96
71205,817203,1,15,1,0,0,96
71206,817203,1,15,2,0,0,96
71207,817203,1,15,3,3,0,99
71208,817203,1,15,4,1,0,100
71209,817203,1,15,5,1,0,101
71210,817203,1,15,6,4,0,105
71211,817203,1,16,1,0,0,105
71212,817203,1,16,2,0,0,105
71213,817203,1,16,3,1,0,106
71214,817203,1,16,4,2,0,108
71215,817203,1,16,5,0,0,108
71216,817203,1,16,6,1,0,109
71217,817203,1,17,1,2,0,111
71218,817203,1,17,2,1,0,112
71219,817203,1,17,3,2,0,114
71220,817203,1,17,4,1,0,115
71221,817203,1,17,5,1,0,116
71222,817203,1,17,6,1,0,117
71223,817203,1,18,1,0,0,117
71224,817203,1,18,2,2,0,119
71225,817203,1,18,3,1,0,120
71226,817203,1,18,4,6,0,126
71227,817203,1,18,5,0,0,126
71228,817203,1,18,6,4,0,130
71229,817203,1,19,1,1,0,131
71230,817203,1,19,2,1,0,132
71231,817203,1,19,3,2,0,134
71232,817203,1,19,4,2,0,136
71233,817203,1,19,5,1,0,137
71234,817203,1,19,6,6,0,143
71235,817203,1,20,1,1,0,144
71236,817203,1,20,2,2,0,146
71237,817203,1,20,3,1,0,147
71238,817203,1,20,4,1,0,148
71239,817203,1,20,5,0,0,148
71240,817203,1,20,6,0,0,148
71354,817205,1,1,1,0,0,0
71355,817205,1,1,2,1,0,1
71356,817205,1,1,3,0,0,1
71357,817205,1,1,4,4,0,5
71358,817205,1,1,5,0,0,5
71359,817205,1,1,6,4,0,9
71360,817205,1,2,1,0,0,9
71361,817205,1,2,2,1,0,10
71362,817205,1,2,3,8,0,18
71363,817205,1,2,4,0,0,18
71364,817205,1,2,5,0,0,18
71365,817205,1,2,6,0,0,18
71366,817205,1,3,1,4,0,22
71367,817205,1,3,2,4,0,26
71368,817205,1,3,3,0,0,26
71369,817205,1,3,4,1,0,27
71370,817205,1,3,5,1,0,28
71371,817205,1,3,6,1,0,29
71372,817205,1,4,1,1,0,30
71373,817205,1,4,2,4,0,34
71374,817205,1,4,3,1,0,35
71375,817205,1,4,4,1,0,36
71376,817205,1,4,5,0,0,36
71377,817205,1,4,6,0,0,36
71378,817205,1,5,1,1,0,37
71379,817205,1,5,2,1,0,38
71380,817205,1,5,3,0,0,38
71381,817205,1,5,4,0,0,38
71382,817205,1,5,5,2,0,40
71383,817205,1,5,6,1,0,41
71384,817205,1,6,1,0,0,41
71385,817205,1,6,2,0,0,41
71386,817205,1,6,3,4,0,45
71387,817205,1,6,4,0,0,45
71388,817205,1,6,5,2,0,47
71389,817205,1,6,6,4,0,51
71390,817205,1,7,1,0,0,51
71391,817205,1,7,2,3,0,54
71392,817205,1,7,3,4,0,58
71393,817205,1,7,4,1,0,59
71394,817205,1,7,5,0,0,59
71395,817205,1,7,6,6,0,65
71396,817205,1,8,1,1,0,66
71397,817205,1,8,2,1,0,67
71398,817205,1,8,3,1,0,68
71399,817205,1,8,4,1,0,69
71400,817205,1,8,5,1,0,70
71401,817205,1,8,6,1,0,71
71402,817205,1,9,1,1,0,72
71403,817205,1,9,2,1,0,73
71404,817205,1,9,3,1,0,74
71405,817205,1,9,4,0,0,74
71406,817205,1,9,5,4,0,78
71407,817205,1,9,6,4,0,82
71408,817205,1,10,1,4,0,86
71409,817205,1,10,2,1,0,87
71410,817205,1,10,3,1,0,88
71411,817205,1,10,4,6,0,94
71412,817205,1,10,5,1,0,95
71413,817205,1,10,6,0,0,95
71414,817205,1,11,1,0,0,95
71415,817205,1,11,2,0,0,95
71416,817205,1,11,3,0,1,95
71417,817205,1,11,4,1,0,96
71418,817205,1,11,5,1,0,97
71419,817205,1,11,6,1,0,98
71420,817205,1,12,1,4,0,102
71421,817205,1,12,2,0,1,102
71422,817205,1,12,3,0,1,102
71423,817205,1,12,4,2,0,104
71424,817205,1,12,5,0,0,104
71425,817205,1,12,6,0,0,104
71426,817205,1,13,1,0,0,104
71427,817205,1,13,2,1,0,105
71428,817205,1,13,3,1,0,106
71429,817205,1,13,4,3,0,109
71430,817205,1,13,5,0,0,109
71431,817205,1,13,6,4,0,113
71432,817205,1,14,1,0,0,113
71433,817205,1,14,2,1,0,114
71434,817205,1,14,3,2,0,116
71435,817205,1,14,4,0,0,116
71436,817205,1,14,5,2,0,118
71437,817205,1,14,6,2,0,120
71438,817205,1,15,1,1,0,121
71439,817205,1,15,2,1,0,122
71440,817205,1,15,3,0,0,122
71441,817205,1,15,4,0,0,122
71442,817205,1,15,5,4,0,126
71443,817205,1,15,6,0,0,126
71444,817205,1,16,1,1,0,127
71445,817205,1,16,2,0,0,127
71446,817205,1,16,3,0,0,127
71447,817205,1,16,4,1,0,128
71448,817205,1,16,5,1,0,129
71449,817205,1,16,6,1,0,130
71450,817205,1,17,1,1,0,131
71451,817205,1,17,2,0,0,131
71452,817205,1,17,3,0,0,131
71453,817205,1,17,4,0,0,131
71454,817205,1,17,5,1,0,132
71455,817205,1,17,6,1,0,133
71456,817205,1,18,1,1,0,134
71457,817205,1,18,2,1,0,135
71458,817205,1,18,3,1,0,136
71459,817205,1,18,4,0,1,136
71460,817205,1,18,5,1,0,137
71461,817205,1,18,6,0,0,137
71462,817205,1,19,1,0,0,137
71463,817205,1,19,2,4,0,141
71464,817205,1,19,3,1,0,142
71465,817205,1,19,4,2,0,144
71466,817205,1,19,5,6,0,150
71467,817205,1,19,6,6,0,156
71468,817205,1,20,1,0,0,156
71469,817205,1,20,2,1,0,157
71470,817205,1,20,3,1,0,158
71471,817205,1,20,4,6,0,164
71472,817205,1,20,5,1,0,165
71473,817205,1,20,6,4,0,169
71590,848839,1,1,1,0,0,0
71591,848839,1,1,2,0,0,0
71592,848839,1,1,3,0,0,0
71593,848839,1,1,4,4,0,4
71594,848839,1,1,5,1,0,5
71595,848839,1,1,6,0,0,5
71596,848839,1,2,1,0,0,5
71597,848839,1,2,2,0,0,5
71598,848839,1,2,3,0,0,5
71599,848839,1,2,4,1,0,6
71600,848839,1,2,5,2,0,8
71601,848839,1,2,6,0,0,8
71602,848839,1,3,1,0,0,8
71603,848839,1,3,2,4,0,12
71604,848839,1,3,3,0,0,12
71605,848839,1,3,4,1,0,13
71606,848839,1,3,5,2,0,15
71607,848839,1,3,6,4,0,19
71608,848839,1,4,1,1,0,20
71609,848839,1,4,2,4,0,24
71610,848839,1,4,3,1,0,25
71611,848839,1,4,4,1,0,26
71612,848839,1,4,5,4,0,30
71613,848839,1,4,6,3,0,33
71614,848839,1,5,1,4,0,37
71615,848839,1,5,2,0,0,37
71616,848839,1,5,3,0,0,37
71617,848839,1,5,4,4,0,41
71618,848839,1,5,5,0,0,41
71619,848839,1,5,6,4,0,45
71620,848839,1,6,1,0,0,45
71621,848839,1,6,2,1,0,46
71622,848839,1,6,3,4,0,50
71623,848839,1,6,4,4,0,54
71624,848839,1,6,5,1,0,55
71625,848839,1,6,6,1,0,56
71626,848839,1,7,1,4,0,60
71627,848839,1,7,2,0,0,60
71628,848839,1,7,3,1,0,61
71629,848839,1,7,4,1,0,62
71630,848839,1,7,5,1,0,63
71631,848839,1,7,6,0,0,63
71632,848839,1,8,1,2,0,65
71633,848839,1,8,2,0,0,65
71634,848839,1,8,3,2,0,67
71635,848839,1,8,4,0,0,67
71636,848839,1,8,5,1,0,68
71637,848839,1,8,6,0,1,68
71638,848839,1,9,1,1,0,69
71639,848839,1,9,2,0,0,69
71640,848839,1,9,3,1,0,70
71641,848839,1,9,4,4,0,74
71642,848839,1,9,5,1,0,75
71643,848839,1,9,6,1,0,76
71644,848839,1,10,1,0,0,76
71645,848839,1,10,2,1,0,77
71646,848839,1,10,3,1,0,78
71647,848839,1,10,4,6,0,84
71648,848839,1,10,5,1,0,85
71649,848839,1,10,6,1,0,86
71650,848839,1,11,1,4,0,90
71651,848839,1,11,2,1,0,91
71652,848839,1,11,3,0,0,91
71653,848839,1,11,4,0,0,91
71654,848839,1,11,5,4,0,95
71655,848839,1,11,6,0,0,95
71656,848839,1,12,1,2,0,97
71657,848839,1,12,2,1,0,98
71658,848839,1,12,3,1,0,99
71659,848839,1,12,4,0,0,99
71660,848839,1,12,5,0,0,99
71661,848839,1,12,6,1,0,100
71662,848839,1,13,1,1,0,101
71663,848839,1,13,2,1,0,102
71664,848839,1,13,3,0,1,102
71665,848839,1,13,4,0,1,102
71666,848839,1,13,5,0,0,102
71667,848839,1,13,6,4,0,106
71668,848839,1,14,1,0,0,106
71669,848839,1,14,2,2,0,108
71670,848839,1,14,3,4,0,112
71671,848839,1,14,4,1,0,113
71672,848839,1,14,5,1,0,114
71673,848839,1,14,6,4,0,118
71674,848839,1,15,1,0,1,118
71675,848839,1,15,2,0,0,118
71676,848839,1,15,3,1,0,119
71677,848839,1,15,4,1,0,120
71678,848839,1,15,5,3,0,123
71679,848839,1,15,6,1,0,124
71680,848839,1,16,1,0,0,124
71681,848839,1,16,2,1,0,125
71682,848839,1,16,3,0,1,125
71683,848839,1,16,4,1,0,126
71684,848839,1,16,5,0,0,126
71685,848839,1,16,6,1,0,127
71686,848839,1,17,1,1,0,128
71687,848839,1,17,2,1,0,129
71688,848839,1,17,3,1,0,130
71689,848839,1,17,4,2,0,132
71690,848839,1,17,5,4,0,136
71691,848839,1,17,6,1,0,137
71692,848839,1,18,1,1,0,138
71693,848839,1,18,2,0,1,138
71694,848839,1,18,3,1,0,139
71695,848839,1,18,4,0,0,139
71696,848839,1,18,5,1,0,140
71697,848839,1,18,6,0,0,140
71698,848839,1,19,1,0,0,140
71699,848839,1,19,2,0,0,140
71700,848839,1,19,3,1,0,141
71701,848839,1,19,4,1,0,142
71702,848839,1,19,5,0,0,142
71703,848839,1,19,6,0,0,142
71704,848839,1,20,1,0,1,142
71705,848839,1,20,2,0,1,142
71706,848839,1,20,3,1,0,143
71707,848839,1,20,4,6,0,149
71708,848839,1,20,5,1,0,150
71709,848839,1,20,6,1,0,151
71817,848841,1,1,1,4,0,4
71818,848841,1,1,2,1,0,5
71819,848841,1,1,3,0,0,5
71820,848841,1,1,4,1,0,6
71821,848841,1,1,5,1,0,7
71822,848841,1,1,6,0,0,7
71823,848841,1,2,1,0,0,7
71824,848841,1,2,2,0,0,7
71825,848841,1,2,3,0,0,7
71826,848841,1,2,4,1,0,8
71827,848841,1,2,5,0,0,8
71828,848841,1,2,6,0,0,8
71829,848841,1,3,1,1,0,9
71830,848841,1,3,2,4,0,13
71831,848841,1,3,3,0,0,13
71832,848841,1,3,4,4,0,17
71833,848841,1,3,5,4,0,21
71834,848841,1,3,6,0,0,21
71835,848841,1,4,1,0,0,21
71836,848841,1,4,2,4,0,25
71837,848841,1,4,3,4,0,29
71838,848841,1,4,4,0,0,29
71839,848841,1,4,5,0,0,29
71840,848841,1,4,6,6,0,35
71841,848841,1,5,1,4,0,39
71842,848841,1,5,2,1,0,40
71843,848841,1,5,3,4,0,44
71844,848841,1,5,4,1,0,45
71845,848841,1,5,5,0,0,45
71846,848841,1,5,6,1,0,46
71847,848841,1,6,1,0,0,46
71848,848841,1,6,2,6,0,52
71849,848841,1,6,3,0,1,52
71850,848841,1,6,4,1,0,53
71851,848841,1,6,5,0,0,53
71852,848841,1,6,6,0,0,53
71853,848841,1,7,1,1,0,54
71854,848841,1,7,2,1,0,55
71855,848841,1,7,3,6,0,61
71856,848841,1,7,4,1,0,62
71857,848841,1,7,5,1,0,63
71858,848841,1,7,6,2,0,65
71859,848841,1,8,1,0,0,65
71860,848841,1,8,2,1,0,66
71861,848841,1,8,3,2,0,68
71862,848841,1,8,4,0,0,68
71863,848841,1,8,5,1,0,69
71864,848841,1,8,6,0,0,69
71865,848841,1,9,1,1,0,70
71866,848841,1,9,2,0,1,70
71867,848841,1,9,3,1,0,71
71868,848841,1,9,4,4,0,75
71869,848841,1,9,5,0,0,75
71870,848841,1,9,6,0,0,75
71871,848841,1,10,1,4,0,79
71872,848841,1,10,2,0,0,79
71873,848841,1,10,3,1,0,80
71874,848841,1,10,4,3,0,83
71875,848841,1,10,5,3,0,86
71876,848841,1,10,6,0,0,86
71877,848841,1,11,1,4,0,90
71878,848841,1,11,2,1,0,91
71879,848841,1,11,3,1,0,92
71880,848841,1,11,4,1,0,93
71881,848841,1,11,5,1,0,94
71882,848841,1,11,6,7,0,101
71883,848841,1,12,1,1,0,102
71884,848841,1,12,2,1,0,103
71885,848841,1,12,3,1,0,104
71886,848841,1,12,4,0,1,104
71887,848841,1,12,5,0,0,104
71888,848841,1,12,6,1,0,105
71889,848841,1,13,1,0,0,105
71890,848841,1,13,2,4,0,109
71891,848841,1,13,3,2,0,111
71892,848841,1,13,4,1,0,112
71893,848841,1,13,5,1,0,113
71894,848841,1,13,6,0,1,113
71895,848841,1,14,1,1,0,114
71896,848841,1,14,2,0,0,114
71897,848841,1,14,3,1,0,115
71898,848841,1,14,4,0,0,115
71899,848841,1,14,5,0,0,115
71900,848841,1,14,6,4,0,119
71901,848841,1,15,1,1,0,120
71902,848841,1,15,2,6,0,126
71903,848841,1,15,3,4,0,130
71904,848841,1,15,4,1,0,131
71905,848841,1,15,5,1,0,132
71906,848841,1,15,6,1,0,133
71907,848841,1,16,1,0,0,133
71908,848841,1,16,2,4,0,137
71909,848841,1,16,3,1,0,138
71910,848841,1,16,4,1,0,139
71911,848841,1,16,5,0,0,139
71912,848841,1,16,6,2,0,141
71913,848841,1,17,1,1,0,142
71914,848841,1,17,2,1,0,143
71915,848841,1,17,3,2,0,145
71916,848841,1,17,4,0,0,145
71917,848841,1,17,5,1,0,146
71918,848841,1,17,6,0,1,146
71919,848841,1,18,1,4,0,150
71920,848841,1,18,2,0,0,150
71921,848841,1,18,3,0,0,150
71922,848841,1,18,4,5,0,155
71923,848841,1,18,5,6,0,161
71924,848841,1,18,6,4,0,165
71925,848841,1,19,1,1,0,166
71926,848841,1,19,2,0,1,166
71927,848841,1,19,3,0,1,166
71928,848841,1,19,4,0,0,166
71929,848841,1,19,5,1,0,167
71930,848841,1,19,6,0,0,167
71931,848841,1,20,1,2,0,169
71932,848841,1,20,2,1,0,170
71933,848841,1,20,3,1,0,171
71934,848841,1,20,4,0,0,171
71935,848841,1,20,5,2,0,173
71936,848841,1,20,6,4,0,177
72057,858491,1,1,1,1,0,1
72058,858491,1,1,2,3,0,4
72059,858491,1,1,3,0,0,4
72060,858491,1,1,4,0,0,4
72061,858491,1,1,5,0,0,4
72062,858491,1,1,6,0,0,4
72063,858491,1,2,1,0,0,4
72064,858491,1,2,2,0,0,4
72065,858491,1,2,3,1,0,5
72066,858491,1,2,4,1,0,6
72067,858491,1,2,5,0,0,6
72068,858491,1,2,6,0,0,6
72069,858491,1,3,1,0,0,6
72070,858491,1,3,2,0,0,6
72071,858491,1,3,3,0,0,6
72072,858491,1,3,4,0,0,6
72073,858491,1,3,5,0,0,6
72074,858491,1,3,6,1,0,7
72075,858491,1,4,1,0,0,7
72076,858491,1,4,2,1,0,8
72077,858491,1,4,3,4,0,12
72078,858491,1,4,4,4,0,16
72079,858491,1,4,5,0,0,16
72080,858491,1,4,6,0,0,16
72081,858491,1,5,1,0,0,16
72082,858491,1,5,2,4,0,20
72083,858491,1,5,3,4,0,24
72084,858491,1,5,4,0,0,24
72085,858491,1,5,5,1,0,25
72086,858491,1,5,6,4,0,29
72087,858491,1,6,1,0,0,29
72088,858491,1,6,2,0,0,29
72089,858491,1,6,3,0,0,29
72090,858491,1,6,4,1,0,30
72091,858491,1,6,5,1,0,31
72092,858491,1,6,6,0,0,31
72093,858491,1,7,1,1,0,32
72094,858491,1,7,2,0,0,32
72095,858491,1,7,3,1,0,33
72096,858491,1,7,4,1,0,34
72097,858491,1,7,5,1,0,35
72098,858491,1,7,6,0,0,35
72099,858491,1,8,1,0,0,35
72100,858491,1,8,2,2,0,37
72101,858491,1,8,3,1,0,38
72102,858491,1,8,4,4,0,42
72103,858491,1,8,5,1,0,43
72104,858491,1,8,6,0,0,43
72105,858491,1,9,1,0,0,43
72106,858491,1,9,2,6,0,49
72107,858491,1,9,3,0,0,49
72108,858491,1,9,4,0,0,49
72109,858491,1,9,5,1,0,50
72110,858491,1,9,6,0,1,50
72111,858491,1,10,1,0,0,50
72112,858491,1,10,2,0,0,50
72113,858491,1,10,3,0,0,50
72114,858491,1,10,4,1,0,51
72115,858491,1,10,5,1,0,52
72116,858491,1,10,6,1,0,53
72117,858491,1,11,1,2,0,55
72118,858491,1,11,2,2,0,57
72119,858491,1,11,3,6,0,63
72120,858491,1,11,4,1,1,64
72121,858491,1,11,5,1,0,65
72122,858491,1,11,6,0,0,65
72123,858491,1,12,1,1,0,66
72124,858491,1,12,2,2,0,68
72125,858491,1,12,3,5,0,73
72126,858491,1,12,4,1,0,74
72127,858491,1,12,5,1,0,75
72128,858491,1,12,6,1,0,76
72129,858491,1,13,1,1,1,77
72130,858491,1,13,2,4,0,81
72131,858491,1,13,3,1,0,82
72132,858491,1,13,4,0,0,82
72133,858491,1,13,5,2,0,84
72134,858491,1,13,6,2,0,86
72135,858491,1,14,1,0,0,86
72136,858491,1,14,2,1,0,87
72137,858491,1,14,3,1,0,88
72138,858491,1,14,4,1,0,89
72139,858491,1,14,5,1,0,90
72140,858491,1,14,6,1,0,91
72141,858491,1,15,1,4,0,95
72142,858491,1,15,2,2,0,97
72143,858491,1,15,3,1,0,98
72144,858491,1,15,4,1,0,99
72145,858491,1,15,5,1,0,100
72146,858491,1,15,6,1,0,101
72147,858491,1,16,1,1,0,102
72148,858491,1,16,2,0,0,102
72149,858491,1,16,3,1,0,103
72150,858491,1,16,4,6,0,109
72151,858491,1,16,5,1,0,110
72152,858491,1,16,6,4,0,114
72153,858491,1,17,1,2,0,116
72154,858491,1,17,2,1,0,117
72155,858491,1,17,3,1,0,118
72156,858491,1,17,4,0,0,118
72157,858491,1,17,5,1,0,119
72158,858491,1,17,6,4,0,123
72159,858491,1,18,1,2,0,125
72160,858491,1,18,2,1,0,126
72161,858491,1,18,3,0,0,126
72162,858491,1,18,4,0,0,126
72163,858491,1,18,5,0,1,126
72164,858491,1,18,6,1,0,127
72165,858491,1,19,1,1,0,128
72166,858491,1,19,2,1,0,129
72167,858491,1,19,3,2,0,131
72168,858491,1,19,4,2,0,133
72169,858491,1,19,5,1,0,134
72170,858491,1,19,6,0,0,134
72171,858491,1,20,1,1,0,135
72172,858491,1,20,2,2,0,137
72173,858491,1,20,3,1,0,138
72174,858491,1,20,4,1,0,139
72175,858491,1,20,5,1,0,140
72176,858491,1,20,6,1,1,141
72275,860279,1,1,1,0,0,0
72276,860279,1,1,2,1,0,1
72277,860279,1,1,3,1,0,2
72278,860279,1,1,4,3,0,5
72279,860279,1,1,5,1,0,6
72280,860279,1,1,6,0,0,6
72281,860279,1,2,1,2,0,8
72282,860279,1,2,2,0,0,8
72283,860279,1,2,3,0,0,8
72284,860279,1,2,4,1,0,9
72285,860279,1,2,5,1,0,10
72286,860279,1,2,6,0,1,10
72287,860279,1,3,1,0,0,10
72288,860279,1,3,2,2,0,12
72289,860279,1,3,3,0,0,12
72290,860279,1,3,4,1,0,13
72291,860279,1,3,5,0,0,13
72292,860279,1,3,6,1,0,14
72293,860279,1,4,1,0,0,14
72294,860279,1,4,2,1,0,15
72295,860279,1,4,3,4,0,19
72296,860279,1,4,4,1,0,20
72297,860279,1,4,5,4,0,24
72298,860279,1,4,6,2,0,26
72299,860279,1,5,1,0,0,26
72300,860279,1,5,2,4,0,30
72301,860279,1,5,3,4,0,34
72302,860279,1,5,4,0,0,34
72303,860279,1,5,5,0,0,34
72304,860279,1,5,6,1,0,35
72305,860279,1,6,1,2,0,37
72306,860279,1,6,2,1,0,38
72307,860279,1,6,3,4,0,42
72308,860279,1,6,4,0,0,42
72309,860279,1,6,5,0,0,42
72310,860279,1,6,6,0,0,42
72311,860279,1,7,1,2,0,44
72312,860279,1,7,2,0,0,44
72313,860279,1,7,3,1,0,45
72314,860279,1,7,4,1,0,46
72315,860279,1,7,5,1,0,47
72316,860279,1,7,6,1,0,48
72317,860279,1,8,1,3,0,51
72318,860279,1,8,2,1,0,52
72319,860279,1,8,3,0,1,52
72320,860279,1,8,4,1,0,53
72321,860279,1,8,5,1,0,54
72322,860279,1,8,6,4,0,58
72323,860279,1,9,1,1,0,59
72324,860279,1,9,2,2,0,61
72325,860279,1,9,3,1,0,62
72326,860279,1,9,4,2,0,64
72327,860279,1,9,5,1,0,65
72328,860279,1,9,6,1,0,66
72329,860279,1,10,1,1,0,67
72330,860279,1,10,2,0,0,67
72331,860279,1,10,3,0,0,67
72332,860279,1,10,4,1,0,68
72333,860279,1,10,5,1,0,69
72334,860279,1,10,6,2,0,71
72335,860279,1,11,1,1,0,72
72336,860279,1,11,2,1,0,73
72337,860279,1,11,3,1,0,74
72338,860279,1,11,4,2,0,76
72339,860279,1,11,5,2,0,78
72340,860279,1,11,6,1,0,79
72341,860279,1,12,1,0,0,79
72342,860279,1,12,2,4,0,83
72343,860279,1,12,3,0,1,83
72344,860279,1,12,4,0,0,83
72345,860279,1,12,5,1,0,84
72346,860279,1,12,6,1,0,85
72347,860279,1,13,1,1,0,86
72348,860279,1,13,2,0,0,86
72349,860279,1,13,3,1,0,87
72350,860279,1,13,4,1,0,88
72351,860279,1,13,5,1,0,89
72352,860279,1,13,6,1,0,90
72353,860279,1,14,1,4,0,94
72354,860279,1,14,2,1,0,95
72355,860279,1,14,3,3,0,98
72356,860279,1,14,4,2,0,100
72357,860279,1,14,5,1,0,101
72358,860279,1,14,6,4,0,105
72359,860279,1,15,1,1,0,106
72360,860279,1,15,2,2,0,108
72361,860279,1,15,3,2,0,110
72362,860279,1,15,4,1,0,111
72363,860279,1,15,5,1,0,112
72364,860279,1,15,6,4,0,116
72365,860279,1,16,1,1,0,117
72366,860279,1,16,2,0,0,117
72367,860279,1,16,3,3,0,120
72368,860279,1,16,4,1,0,121
72369,860279,1,16,5,6,0,127
72370,860279,1,16,6,6,0,133
72371,860279,1,17,1,0,0,133
72372,860279,1,17,2,1,0,134
72373,860279,1,17,3,4,0,138
72374,860279,1,17,4,0,0,138
72375,860279,1,17,5,2,0,140
72376,860279,1,17,6,4,0,144
72377,860279,1,18,1,2,0,146
72378,860279,1,18,2,4,0,150
72379,860279,1,18,3,1,0,151
72380,860279,1,18,4,0,0,151
72381,860279,1,18,5,1,0,152
72382,860279,1,18,6,1,0,153
72383,860279,1,19,1,2,0,155
72384,860279,1,19,2,1,0,156
72385,860279,1,19,3,2,0,158
72386,860279,1,19,4,0,0,158
72387,860279,1,19,5,6,0,164
72388,860279,1,19,6,0,1,164
72389,860279,1,20,1,3,0,167
72390,860279,1,20,2,0,0,167
72391,860279,1,20,3,6,0,173
72392,860279,1,20,4,2,0,175
72393,860279,1,20,5,0,1,175
72394,860279,1,20,6,0,0,175
72515,860281,1,1,1,1,0,1
72516,860281,1,1,2,0,0,1
72517,860281,1,1,3,0,0,1
72518,860281,1,1,4,4,0,5
72519,860281,1,1,5,0,0,5
72520,860281,1,1,6,2,0,7
72521,860281,1,2,1,0,0,7
72522,860281,1,2,2,2,0,9
72523,860281,1,2,3,4,0,13
72524,860281,1,2,4,5,0,18
72525,860281,1,2,5,0,0,18
72526,860281,1,2,6,1,0,19
72527,860281,1,3,1,1,0,20
72528,860281,1,3,2,0,0,20
72529,860281,1,3,3,4,0,24
72530,860281,1,3,4,0,1,24
72531,860281,1,3,5,1,0,25
72532,860281,1,3,6,1,0,26
72533,860281,1,4,1,0,0,26
72534,860281,1,4,2,1,0,27
72535,860281,1,4,3,1,0,28
72536,860281,1,4,4,0,0,28
72537,860281,1,4,5,4,0,32
72538,860281,1,4,6,0,1,32
72539,860281,1,5,1,0,0,32
72540,860281,1,5,2,4,0,36
72541,860281,1,5,3,0,0,36
72542,860281,1,5,4,4,0,40
72543,860281,1,5,5,1,0,41
72544,860281,1,5,6,1,0,42
72545,860281,1,6,1,1,0,43
72546,860281,1,6,2,1,0,44
72547,860281,1,6,3,0,0,44
72548,860281,1,6,4,2,0,46
72549,860281,1,6,5,2,0,48
72550,860281,1,6,6,0,0,48
72551,860281,1,7,1,1,0,49
72552,860281,1,7,2,2,0,51
72553,860281,1,7,3,0,0,51
72554,860281,1,7,4,1,0,52
72555,860281,1,7,5,2,0,54
72556,860281,1,7,6,0,0,54
72557,860281,1,8,1,0,0,54
72558,860281,1,8,2,0,0,54
72559,860281,1,8,3,1,0,55
72560,860281,1,8,4,1,0,56
72561,860281,1,8,5,4,0,60
72562,860281,1,8,6,0,0,60
72563,860281,1,9,1,0,0,60
72564,860281,1,9,2,0,0,60
72565,860281,1,9,3,1,0,61
72566,860281,1,9,4,0,1,61
72567,860281,1,9,5,1,0,62
72568,860281,1,9,6,0,0,62
72569,860281,1,10,1,1,0,63
72570,860281,1,10,2,1,0,64
72571,860281,1,10,3,0,1,64
72572,860281,1,10,4,1,0,65
72573,860281,1,10,5,0,0,65
72574,860281,1,10,6,0,0,65
72575,860281,1,11,1,1,0,66
72576,860281,1,11,2,4,0,70
72577,860281,1,11,3,0,0,70
72578,860281,1,11,4,6,0,76
72579,860281,1,11,5,2,0,78
72580,860281,1,11,6,1,0,79
72581,860281,1,12,1,0,0,79
72582,860281,1,12,2,1,0,80
72583,860281,1,12,3,1,0,81
72584,860281,1,12,4,0,0,81
72585,860281,1,12,5,6,0,87
72586,860281,1,12,6,1,0,88
72587,860281,1,13,1,2,0,90
72588,860281,1,13,2,0,0,90
72589,860281,1,13,3,0,1,90
72590,860281,1,13,4,0,0,90
72591,860281,1,13,5,1,0,91
72592,860281,1,13,6,6,0,97
72593,860281,1,14,1,1,0,98
72594,860281,1,14,2,1,0,99
72595,860281,1,14,3,0,0,99
72596,860281,1,14,4,1,0,100
72597,860281,1,14,5,5,0,105
72598,860281,1,14,6,0,0,105
72599,860281,1,15,1,4,0,109
72600,860281,1,15,2,1,0,110
72601,860281,1,15,3,1,0,111
72602,860281,1,15,4,0,0,111
72603,860281,1,15,5,2,0,113
72604,860281,1,15,6,0,0,113
72605,860281,1,16,1,0,0,113
72606,860281,1,16,2,1,0,114
72607,860281,1,16,3,0,0,114
72608,860281,1,16,4,1,0,115
72609,860281,1,16,5,2,0,117
72610,860281,1,16,6,1,0,118
72611,860281,1,17,1,0,0,118
72612,860281,1,17,2,1,0,119
72613,860281,1,17,3,1,0,120
72614,860281,1,17,4,1,0,121
72615,860281,1,17,5,6,0,127
72616,860281,1,17,6,2,0,129
72617,860281,1,18,1,4,0,133
72618,860281,1,18,2,2,0,135
72619,860281,1,18,3,1,0,136
72620,860281,1,18,4,1,0,137
72621,860281,1,18,5,2,0,139
72622,860281,1,18,6,6,0,145
72623,860281,1,19,1,0,1,145
72624,860281,1,19,2,4,0,149
72625,860281,1,19,3,6,0,155
72626,860281,1,19,4,2,0,157
72627,860281,1,19,5,1,0,158
72628,860281,1,19,6,1,0,159
72629,860281,1,20,1,4,0,163
72630,860281,1,20,2,1,0,164
72631,860281,1,20,3,6,0,170
72632,860281,1,20,4,1,0,171
72633,860281,1,20,5,1,0,172
72634,860281,1,20,6,0,1,172
72751,868723,1,1,1,0,0,0
72752,868723,1,1,2,0,0,0
72753,868723,1,1,3,0,0,0
72754,868723,1,1,4,1,0,1
72755,868723,1,1,5,0,0,1
72756,868723,1,1,6,0,0,1
72757,868723,1,2,1,4,0,5
72758,868723,1,2,2,4,0,9
72759,868723,1,2,3,1,0,10
72760,868723,1,2,4,0,0,10
72761,868723,1,2,5,1,0,11
72762,868723,1,2,6,1,0,12
72763,868723,1,3,1,1,0,13
72764,868723,1,3,2,0,0,13
72765,868723,1,3,3,1,0,14
72766,868723,1,3,4,4,0,18
72767,868723,1,3,5,0,0,18
72768,868723,1,3,6,4,0,22
72769,868723,1,4,1,0,0,22
72770,868723,1,4,2,1,0,23
72771,868723,1,4,3,1,0,24
72772,868723,1,4,4,1,0,25
72773,868723,1,4,5,6,0,31
72774,868723,1,4,6,1,0,32
72775,868723,1,5,1,0,0,32
72776,868723,1,5,2,0,0,32
72777,868723,1,5,3,0,0,32
72778,868723,1,5,4,5,0,37
72779,868723,1,5,5,4,0,41
72780,868723,1,5,6,1,0,42
72781,868723,1,6,1,4,0,46
72782,868723,1,6,2,1,0,47
72783,868723,1,6,3,1,0,48
72784,868723,1,6,4,1,0,49
72785,868723,1,6,5,4,0,53
72786,868723,1,6,6,1,0,54
72787,868723,1,7,1,1,0,55
72788,868723,1,7,2,0,0,55
72789,868723,1,7,3,1,0,56
72790,868723,1,7,4,2,0,58
72791,868723,1,7,5,0,1,58
72792,868723,1,7,6,0,1,58
72793,868723,1,8,1,0,0,58
72794,868723,1,8,2,1,0,59
72795,868723,1,8,3,1,0,60
72796,868723,1,8,4,4,0,64
72797,868723,1,8,5,4,0,68
72798,868723,1,8,6,1,0,69
72799,868723,1,9,1,4,0,73
72800,868723,1,9,2,0,1,73
72801,868723,1,9,3,1,0,74
72802,868723,1,9,4,0,0,74
72803,868723,1,9,5,0,0,74
72804,868723,1,9,6,2,0,76
72805,868723,1,10,1,1,0,77
72806,868723,1,10,2,1,0,78
72807,868723,1,10,3,4,0,82
72808,868723,1,10,4,0,0,82
72809,868723,1,10,5,1,0,83
72810,868723,1,10,6,0,0,83
72811,868723,1,11,1,0,0,83
72812,868723,1,11,2,1,0,84
72813,868723,1,11,3,2,0,86
72814,868723,1,11,4,1,0,87
72815,868723,1,11,5,0,0,87
72816,868723,1,11,6,0,0,87
72817,868723,1,12,1,4,0,91
72818,868723,1,12,2,2,0,93
72819,868723,1,12,3,1,0,94
72820,868723,1,12,4,1,0,95
72821,868723,1,12,5,2,0,97
72822,868723,1,12,6,0,0,97
72823,868723,1,13,1,1,0,98
72824,868723,1,13,2,1,0,99
72825,868723,1,13,3,1,0,100
72826,868723,1,13,4,0,1,100
72827,868723,1,13,5,0,0,100
72828,868723,1,13,6,0,0,100
72829,868723,1,14,1,1,0,101
72830,868723,1,14,2,0,0,101
72831,868723,1,14,3,1,0,102
72832,868723,1,14,4,4,0,106
72833,868723,1,14,5,1,0,107
72834,868723,1,14,6,1,0,108
72835,868723,1,15,1,1,0,109
72836,868723,1,15,2,1,0,110
72837,868723,1,15,3,1,0,111
72838,868723,1,15,4,1,0,112
72839,868723,1,15,5,1,0,113
72840,868723,1,15,6,1,0,114
72841,868723,1,16,1,4,0,118
72842,868723,1,16,2,1,0,119
72843,868723,1,16,3,1,0,120
72844,868723,1,16,4,5,0,125
72845,868723,1,16,5,4,0,129
72846,868723,1,16,6,0,0,129
72847,868723,1,17,1,1,0,130
72848,868723,1,17,2,0,0,130
72849,868723,1,17,3,1,0,131
72850,868723,1,17,4,6,0,137
72851,868723,1,17,5,5,0,142
72852,868723,1,17,6,0,1,142
72853,868723,1,18,1,3,0,145
72854,868723,1,18,2,1,0,146
72855,868723,1,18,3,4,0,150
72856,868723,1,18,4,4,0,154
72857,868723,1,18,5,4,0,158
72858,868723,1,18,6,1,0,159
72859,868723,1,19,1,0,0,159
72860,868723,1,19,2,6,0,165
72861,868723,1,19,3,1,0,166
72862,868723,1,19,4,0,0,166
72863,868723,1,19,5,0,0,166
72864,868723,1,19,6,1,0,167
72865,868723,1,20,1,1,0,168
72866,868723,1,20,2,0,1,168
72867,868723,1,20,3,1,0,169
72868,868723,1,20,4,1,0,170
72869,868723,1,20,5,1,0,171
72870,868723,1,20,6,1,0,172
72988,868725,1,1,1,0,0,0
72989,868725,1,1,2,4,0,4
72990,868725,1,1,3,0,0,4
72991,868725,1,1,4,0,0,4
72992,868725,1,1,5,3,0,7
72993,868725,1,1,6,1,0,8
72994,868725,1,2,1,0,0,8
72995,868725,1,2,2,0,0,8
72996,868725,1,2,3,0,0,8
72997,868725,1,2,4,2,0,10
72998,868725,1,2,5,2,0,12
72999,868725,1,2,6,1,0,13
73000,868725,1,3,1,4,0,17
73001,868725,1,3,2,4,0,21
73002,868725,1,3,3,4,0,25
73003,868725,1,3,4,0,0,25
73004,868725,1,3,5,1,0,26
73005,868725,1,3,6,0,0,26
73006,868725,1,4,1,0,0,26
73007,868725,1,4,2,6,0,32
73008,868725,1,4,3,0,0,32
73009,868725,1,4,4,0,0,32
73010,868725,1,4,5,0,0,32
73011,868725,1,4,6,1,0,33
73012,868725,1,5,1,0,0,33
73013,868725,1,5,2,4,0,37
73014,868725,1,5,3,0,0,37
73015,868725,1,5,4,1,0,38
73016,868725,1,5,5,0,0,38
73017,868725,1,5,6,1,0,39
73018,868725,1,6,1,0,0,39
73019,868725,1,6,2,1,0,40
73020,868725,1,6,3,2,0,42
73021,868725,1,6,4,4,0,46
73022,868725,1,6,5,2,0,48
73023,868725,1,6,6,2,0,50
73024,868725,1,7,1,1,0,51
73025,868725,1,7,2,0,0,51
73026,868725,1,7,3,1,0,52
73027,868725,1,7,4,1,0,53
73028,868725,1,7,5,0,0,53
73029,868725,1,7,6,6,0,59
73030,868725,1,8,1,2,0,61
73031,868725,1,8,2,1,0,62
73032,868725,1,8,3,2,0,64
73033,868725,1,8,4,0,0,64
73034,868725,1,8,5,1,0,65
73035,868725,1,8,6,1,0,66
73036,868725,1,9,1,1,0,67
73037,868725,1,9,2,1,0,68
73038,868725,1,9,3,0,1,68
73039,868725,1,9,4,1,0,69
73040,868725,1,9,5,0,0,69
73041,868725,1,9,6,1,0,70
73042,868725,1,10,1,3,0,73
73043,868725,1,10,2,0,0,73
73044,868725,1,10,3,1,0,74
73045,868725,1,10,4,1,0,75
73046,868725,1,10,5,4,0,79
73047,868725,1,10,6,4,0,83
73048,868725,1,11,1,0,0,83
73049,868725,1,11,2,0,0,83
73050,868725,1,11,3,1,0,84
73051,868725,1,11,4,1,0,85
73052,868725,1,11,5,1,0,86
73053,868725,1,11,6,1,0,87
73054,868725,1,12,1,2,0,89
73055,868725,1,12,2,4,0,93
73056,868725,1,12,3,1,0,94
73057,868725,1,12,4,3,0,97
73058,868725,1,12,5,2,0,99
73059,868725,1,12,6,1,0,100
73060,868725,1,13,1,0,0,100
73061,868725,1,13,2,1,0,101
73062,868725,1,13,3,1,0,102
73063,868725,1,13,4,1,0,103
73064,868725,1,13,5,1,0,104
73065,868725,1,13,6,1,0,105
73066,868725,1,14,1,0,0,105
73067,868725,1,14,2,1,0,106
73068,868725,1,14,3,4,0,110
73069,868725,1,14,4,4,0,114
73070,868725,1,14,5,1,0,115
73071,868725,1,14,6,0,0,115
73072,868725,1,15,1,4,0,119
73073,868725,1,15,2,2,0,121
73074,868725,1,15,3,1,0,122
73075,868725,1,15,4,1,0,123
73076,868725,1,15,5,1,0,124
73077,868725,1,15,6,1,0,125
73078,868725,1,16,1,0,0,125
73079,868725,1,16,2,1,0,126
73080,868725,1,16,3,1,0,127
73081,868725,1,16,4,2,0,129
73082,868725,1,16,5,2,0,131
73083,868725,1,16,6,1,0,132
73084,868725,1,17,1,1,0,133
73085,868725,1,17,2,2,0,135
73086,868725,1,17,3,1,0,136
73087,868725,1,17,4,0,1,136
73088,868725,1,17,5,2,0,138
73089,868725,1,17,6,6,0,144
73090,868725,1,18,1,0,0,144
73091,868725,1,18,2,6,0,150
73092,868725,1,18,3,6,0,156
73093,868725,1,18,4,6,0,162
73094,868725,1,18,5,1,0,163
73095,868725,1,18,6,1,0,164
73096,868725,1,19,1,1,0,165
73097,868725,1,19,2,0,0,165
73098,868725,1,19,3,1,0,166
73099,868725,1,19,4,1,0,167
73100,868725,1,19,5,1,0,168
73101,868725,1,19,6,0,0,168
73102,868725,1,20,1,0,1,168
73103,868725,1,20,2,4,0,172
73104,868725,1,20,3,1,0,173
73105,868725,1,20,4,0,0,173
73106,868725,1,20,5,0,0,173
73107,868725,1,20,6,2,0,175
73226,875459,1,1,1,0,0,0
73227,875459,1,1,2,0,0,0
73228,875459,1,1,3,0,0,0
73229,875459,1,1,4,1,0,1
73230,875459,1,1,5,0,0,1
73231,875459,1,1,6,0,0,1
73232,875459,1,2,1,1,0,2
73233,875459,1,2,2,2,0,4
73234,875459,1,2,3,1,0,5
73235,875459,1,2,4,0,1,5
73236,875459,1,2,5,1,0,6
73237,875459,1,2,6,1,0,7
73238,875459,1,3,1,1,0,8
73239,875459,1,3,2,1,0,9
73240,875459,1,3,3,0,0,9
73241,875459,1,3,4,1,0,10
73242,875459,1,3,5,1,0,11
73243,875459,1,3,6,0,0,11
73244,875459,1,4,1,1,0,12
73245,875459,1,4,2,4,0,16
73246,875459,1,4,3,2,0,18
73247,875459,1,4,4,1,0,19
73248,875459,1,4,5,0,1,19
73249,875459,1,4,6,0,0,19
73250,875459,1,5,1,0,0,19
73251,875459,1,5,2,0,0,19
73252,875459,1,5,3,0,0,19
73253,875459,1,5,4,4,0,23
73254,875459,1,5,5,6,0,29
73255,875459,1,5,6,2,0,31
73256,875459,1,6,1,0,0,31
73257,875459,1,6,2,1,0,32
73258,875459,1,6,3,0,0,32
73259,875459,1,6,4,1,0,33
73260,875459,1,6,5,0,0,33
73261,875459,1,6,6,1,0,34
73262,875459,1,7,1,1,0,35
73263,875459,1,7,2,1,0,36
73264,875459,1,7,3,1,0,37
73265,875459,1,7,4,2,0,39
73266,875459,1,7,5,0,1,39
73267,875459,1,7,6,1,0,40
73268,875459,1,8,1,0,0,40
73269,875459,1,8,2,0,0,40
73270,875459,1,8,3,0,0,40
73271,875459,1,8,4,0,0,40
73272,875459,1,8,5,1,0,41
73273,875459,1,8,6,1,0,42
73274,875459,1,9,1,1,0,43
73275,875459,1,9,2,6,0,49
73276,875459,1,9,3,0,0,49
73277,875459,1,9,4,0,0,49
73278,875459,1,9,5,1,0,50
73279,875459,1,9,6,1,0,51
73280,875459,1,10,1,0,0,51
73281,875459,1,10,2,1,0,52
73282,875459,1,10,3,0,0,52
73283,875459,1,10,4,6,0,58
73284,875459,1,10,5,1,0,59
73285,875459,1,10,6,0,0,59
73286,875459,1,11,1,1,0,60
73287,875459,1,11,2,0,0,60
73288,875459,1,11,3,1,0,61
73289,875459,1,11,4,0,0,61
73290,875459,1,11,5,1,0,62
73291,875459,1,11,6,2,0,64
73292,875459,1,12,1,4,0,68
73293,875459,1,12,2,1,0,69
73294,875459,1,12,3,1,0,70
73295,875459,1,12,4,1,0,71
73296,875459,1,12,5,2,0,73
73297,875459,1,12,6,1,0,74
73298,875459,1,13,1,1,0,75
73299,875459,1,13,2,1,0,76
73300,875459,1,13,3,1,0,77
73301,875459,1,13,4,1,0,78
73302,875459,1,13,5,1,0,79
73303,875459,1,13,6,2,0,81
73304,875459,1,14,1,0,0,81
73305,875459,1,14,2,1,0,82
73306,875459,1,14,3,1,0,83
73307,875459,1,14,4,0,0,83
73308,875459,1,14,5,4,0,87
73309,875459,1,14,6,0,0,87
73310,875459,1,15,1,2,0,89
73311,875459,1,15,2,2,0,91
73312,875459,1,15,3,1,0,92
73313,875459,1,15,4,0,0,92
73314,875459,1,15,5,1,0,93
73315,875459,1,15,6,1,0,94
73316,875459,1,16,1,1,0,95
73317,875459,1,16,2,1,0,96
73318,875459,1,16,3,0,1,96
73319,875459,1,16,4,6,0,102
73320,875459,1,16,5,1,0,103
73321,875459,1,16,6,1,0,104
73322,875459,1,17,1,0,0,104
73323,875459,1,17,2,0,0,104
73324,875459,1,17,3,1,0,105
73325,875459,1,17,4,1,0,106
73326,875459,1,17,5,6,0,112
73327,875459,1,17,6,4,0,116
73328,875459,1,18,1,6,0,122
73329,875459,1,18,2,1,0,123
73330,875459,1,18,3,1,0,124
73331,875459,1,18,4,6,0,130
73332,875459,1,18,5,2,0,132
73333,875459,1,18,6,6,0,138
73334,875459,1,19,1,1,0,139
73335,875459,1,19,2,1,0,140
73336,875459,1,19,3,1,0,141
73337,875459,1,19,4,4,0,145
73338,875459,1,19,5,0,0,145
73339,875459,1,19,6,4,0,149
73340,875459,1,20,1,0,1,149
73341,875459,1,20,2,0,1,149
73342,875459,1,20,3,6,0,155
73343,875459,1,20,4,1,0,156
73344,875459,1,20,5,0,1,156
73345,875459,1,20,6,6,0,162
73464,875553,1,1,1,0,0,0
73465,875553,1,1,2,0,0,0
73466,875553,1,1,3,0,0,0
73467,875553,1,1,4,2,0,2
73468,875553,1,1,5,1,0,3
73469,875553,1,1,6,6,0,9
73470,875553,1,2,1,1,0,10
73471,875553,1,2,2,0,0,10
73472,875553,1,2,3,0,0,10
73473,875553,1,2,4,0,0,10
73474,875553,1,2,5,0,0,10
73475,875553,1,2,6,0,0,10
73476,875553,1,3,1,0,1,10
73477,875553,1,3,2,1,0,11
73478,875553,1,3,3,1,0,12
73479,875553,1,3,4,4,0,16
73480,875553,1,3,5,0,0,16
73481,875553,1,3,6,4,0,20
73482,875553,1,4,1,1,0,21
73483,875553,1,4,2,0,0,21
73484,875553,1,4,3,0,0,21
73485,875553,1,4,4,1,0,22
73486,875553,1,4,5,1,0,23
73487,875553,1,4,6,2,0,25
73488,875553,1,5,1,0,0,25
73489,875553,1,5,2,0,0,25
73490,875553,1,5,3,1,0,26
73491,875553,1,5,4,0,1,26
73492,875553,1,5,5,4,0,30
73493,875553,1,5,6,4,0,34
73494,875553,1,6,1,0,0,34
73495,875553,1,6,2,0,0,34
73496,875553,1,6,3,4,0,38
73497,875553,1,6,4,0,0,38
73498,875553,1,6,5,0,0,38
73499,875553,1,6,6,0,0,38
73500,875553,1,7,1,0,0,38
73501,875553,1,7,2,0,0,38
73502,875553,1,7,3,0,0,38
73503,875553,1,7,4,1,0,39
73504,875553,1,7,5,2,0,41
73505,875553,1,7,6,1,0,42
73506,875553,1,8,1,2,0,44
73507,875553,1,8,2,1,0,45
73508,875553,1,8,3,1,0,46
73509,875553,1,8,4,1,0,47
73510,875553,1,8,5,0,0,47
73511,875553,1,8,6,0,0,47
73512,875553,1,9,1,4,0,51
73513,875553,1,9,2,0,0,51
73514,875553,1,9,3,4,0,55
73515,875553,1,9,4,1,0,56
73516,875553,1,9,5,1,0,57
73517,875553,1,9,6,3,0,60
73518,875553,1,10,1,1,0,61
73519,875553,1,10,2,1,0,62
73520,875553,1,10,3,0,0,62
73521,875553,1,10,4,1,0,63
73522,875553,1,10,5,1,0,64
73523,875553,1,10,6,0,0,64
73524,875553,1,11,1,1,0,65
73525,875553,1,11,2,1,0,66
73526,875553,1,11,3,1,0,67
73527,875553,1,11,4,1,0,68
73528,875553,1,11,5,1,0,69
73529,875553,1,11,6,0,0,69
73530,875553,1,12,1,1,0,70
73531,875553,1,12,2,0,0,70
73532,875553,1,12,3,0,1,70
73533,875553,1,12,4,0,0,70
73534,875553,1,12,5,0,0,70
73535,875553,1,12,6,0,0,70
73536,875553,1,13,1,2,0,72
73537,875553,1,13,2,0,0,72
73538,875553,1,13,3,2,0,74
73539,875553,1,13,4,2,0,76
73540,875553,1,13,5,0,0,76
73541,875553,1,13,6,6,0,82
73542,875553,1,14,1,1,0,83
73543,875553,1,14,2,1,0,84
73544,875553,1,14,3,0,0,84
73545,875553,1,14,4,1,0,85
73546,875553,1,14,5,2,0,87
73547,875553,1,14,6,0,0,87
73548,875553,1,15,1,1,0,88
73549,875553,1,15,2,1,0,89
73550,875553,1,15,3,1,0,90
73551,875553,1,15,4,1,0,91
73552,875553,1,15,5,0,1,91
73553,875553,1,15,6,0,0,91
73554,875553,1,16,1,1,0,92
73555,875553,1,16,2,1,0,93
73556,875553,1,16,3,1,0,94
73557,875553,1,16,4,1,0,95
73558,875553,1,16,5,6,0,101
73559,875553,1,16,6,6,0,107
73560,875553,1,17,1,1,0,108
73561,875553,1,17,2,1,0,109
73562,875553,1,17,3,1,0,110
73563,875553,1,17,4,1,0,111
73564,875553,1,17,5,1,0,112
73565,875553,1,17,6,0,1,112
73566,875553,1,18,1,0,1,112
73567,875553,1,18,2,2,0,114
73568,875553,1,18,3,0,0,114
73569,875553,1,18,4,1,0,115
73570,875553,1,18,5,0,0,115
73571,875553,1,18,6,0,0,115
73572,875553,1,19,1,0,1,115
73573,875553,1,19,2,4,0,119
73574,875553,1,19,3,0,0,119
73575,875553,1,19,4,0,1,119
73576,875553,1,19,5,0,0,119
73577,875553,1,19,6,1,0,120
73578,875553,1,20,1,6,0,126
73579,875553,1,20,2,1,0,127
73580,875553,1,20,3,1,0,128
73581,875553,1,20,4,0,1,128
73582,875553,1,20,5,0,1,128
73692,883343,1,1,1,0,0,0
73693,883343,1,1,2,4,0,4
73694,883343,1,1,3,0,0,4
73695,883343,1,1,4,4,0,8
73696,883343,1,1,5,0,0,8
73697,883343,1,1,6,0,0,8
73698,883343,1,2,1,1,0,9
73699,883343,1,2,2,2,0,11
73700,883343,1,2,3,0,0,11
73701,883343,1,2,4,1,0,12
73702,883343,1,2,5,0,0,12
73703,883343,1,2,6,1,0,13
73704,883343,1,3,1,0,0,13
73705,883343,1,3,2,1,0,14
73706,883343,1,3,3,1,0,15
73707,883343,1,3,4,1,0,16
73708,883343,1,3,5,0,0,16
73709,883343,1,3,6,0,0,16
73710,883343,1,4,1,0,0,16
73711,883343,1,4,2,4,0,20
73712,883343,1,4,3,0,0,20
73713,883343,1,4,4,0,0,20
73714,883343,1,4,5,1,0,21
73715,883343,1,4,6,0,0,21
73716,883343,1,5,1,4,0,25
73717,883343,1,5,2,0,0,25
73718,883343,1,5,3,1,0,26
73719,883343,1,5,4,0,0,26
73720,883343,1,5,5,0,1,26
73721,883343,1,5,6,1,0,27
73722,883343,1,6,1,4,0,31
73723,883343,1,6,2,4,0,35
73724,883343,1,6,3,1,0,36
73725,883343,1,6,4,4,0,40
73726,883343,1,6,5,0,0,40
73727,883343,1,6,6,2,0,42
73728,883343,1,7,1,1,0,43
73729,883343,1,7,2,0,0,43
73730,883343,1,7,3,1,0,44
73731,883343,1,7,4,4,0,48
73732,883343,1,7,5,1,0,49
73733,883343,1,7,6,1,0,50
73734,883343,1,8,1,1,0,51
73735,883343,1,8,2,0,0,51
73736,883343,1,8,3,1,0,52
73737,883343,1,8,4,1,0,53
73738,883343,1,8,5,1,0,54
73739,883343,1,8,6,1,0,55
73740,883343,1,9,1,2,0,57
73741,883343,1,9,2,1,0,58
73742,883343,1,9,3,1,0,59
73743,883343,1,9,4,1,0,60
73744,883343,1,9,5,1,0,61
73745,883343,1,9,6,0,0,61
73746,883343,1,10,1,0,0,61
73747,883343,1,10,2,6,0,67
73748,883343,1,10,3,0,0,67
73749,883343,1,10,4,1,0,68
73750,883343,1,10,5,0,0,68
73751,883343,1,10,6,1,0,69
73752,883343,1,11,1,0,0,69
73753,883343,1,11,2,0,0,69
73754,883343,1,11,3,1,0,70
73755,883343,1,11,4,2,0,72
73756,883343,1,11,5,1,0,73
73757,883343,1,11,6,1,0,74
73758,883343,1,12,1,1,0,75
73759,883343,1,12,2,1,0,76
73760,883343,1,12,3,1,0,77
73761,883343,1,12,4,2,0,79
73762,883343,1,12,5,1,0,80
73763,883343,1,12,6,1,0,81
73764,883343,1,13,1,0,0,81
73765,883343,1,13,2,0,0,81
73766,883343,1,13,3,3,0,84
73767,883343,1,13,4,2,0,86
73768,883343,1,13,5,1,0,87
73769,883343,1,13,6,4,0,91
73770,883343,1,14,1,1,0,92
73771,883343,1,14,2,1,0,93
73772,883343,1,14,3,1,0,94
73773,883343,1,14,4,1,0,95
73774,883343,1,14,5,1,0,96
73775,883343,1,14,6,1,0,97
73776,883343,1,15,1,1,0,98
73777,883343,1,15,2,4,0,102
73778,883343,1,15,3,4,0,106
73779,883343,1,15,4,1,0,107
73780,883343,1,15,5,1,0,108
73781,883343,1,15,6,1,0,109
73782,883343,1,16,1,6,0,115
73783,883343,1,16,2,1,0,116
73784,883343,1,16,3,1,0,117
73785,883343,1,16,4,1,0,118
73786,883343,1,16,5,1,0,119
73787,883343,1,16,6,4,0,123
73788,883343,1,17,1,1,0,124
73789,883343,1,17,2,6,0,130
73790,883343,1,17,3,6,0,136
73791,883343,1,17,4,4,0,140
73792,883343,1,17,5,1,0,141
73793,883343,1,17,6,1,0,142
73794,883343,1,18,1,1,0,143
73795,883343,1,18,2,1,0,144
73796,883343,1,18,3,2,0,146
73797,883343,1,18,4,1,0,147
73798,883343,1,18,5,1,0,148
73799,883343,1,18,6,4,0,152
73800,883343,1,19,1,1,0,153
73801,883343,1,19,2,2,0,155
73802,883343,1,19,3,2,0,157
73803,883343,1,19,4,0,1,157
73804,883343,1,19,5,6,0,163
73805,883343,1,19,6,6,0,169
73806,883343,1,20,1,0,0,169
73807,883343,1,20,2,1,0,170
73808,883343,1,20,3,0,1,170
73809,883343,1,20,4,1,0,171
73810,883343,1,20,5,1,0,172
73811,883343,1,20,6,0,1,172
73918,883345,1,1,1,3,0,3
73919,883345,1,1,2,0,0,3
73920,883345,1,1,3,3,0,6
73921,883345,1,1,4,4,0,10
73922,883345,1,1,5,1,0,11
73923,883345,1,1,6,1,0,12
73924,883345,1,2,1,2,0,14
73925,883345,1,2,2,0,0,14
73926,883345,1,2,3,1,0,15
73927,883345,1,2,4,0,0,15
73928,883345,1,2,5,0,0,15
73929,883345,1,2,6,1,0,16
73930,883345,1,3,1,0,0,16
73931,883345,1,3,2,4,0,20
73932,883345,1,3,3,0,0,20
73933,883345,1,3,4,1,0,21
73934,883345,1,3,5,0,0,21
73935,883345,1,3,6,0,0,21
73936,883345,1,4,1,1,0,22
73937,883345,1,4,2,1,0,23
73938,883345,1,4,3,1,0,24
73939,883345,1,4,4,1,0,25
73940,883345,1,4,5,0,0,25
73941,883345,1,4,6,0,0,25
73942,883345,1,5,1,0,0,25
73943,883345,1,5,2,0,0,25
73944,883345,1,5,3,2,0,27
73945,883345,1,5,4,1,0,28
73946,883345,1,5,5,1,0,29
73947,883345,1,5,6,0,0,29
73948,883345,1,6,1,0,0,29
73949,883345,1,6,2,4,0,33
73950,883345,1,6,3,0,0,33
73951,883345,1,6,4,0,0,33
73952,883345,1,6,5,3,0,36
73953,883345,1,6,6,1,0,37
73954,883345,1,7,1,0,1,37
73955,883345,1,7,2,0,0,37
73956,883345,1,7,3,0,0,37
73957,883345,1,7,4,6,0,43
73958,883345,1,7,5,0,0,43
73959,883345,1,7,6,1,0,44
73960,883345,1,8,1,1,0,45
73961,883345,1,8,2,1,0,46
73962,883345,1,8,3,0,1,46
73963,883345,1,8,4,4,0,50
73964,883345,1,8,5,1,0,51
73965,883345,1,8,6,1,0,52
73966,883345,1,9,1,2,0,54
73967,883345,1,9,2,0,0,54
73968,883345,1,9,3,1,0,55
73969,883345,1,9,4,1,0,56
73970,883345,1,9,5,1,0,57
73971,883345,1,9,6,1,0,58
73972,883345,1,10,1,0,0,58
73973,883345,1,10,2,1,0,59
73974,883345,1,10,3,1,0,60
73975,883345,1,10,4,1,0,61
73976,883345,1,10,5,1,0,62
73977,883345,1,10,6,1,0,63
73978,883345,1,11,1,0,0,63
73979,883345,1,11,2,2,0,65
73980,883345,1,11,3,1,0,66
73981,883345,1,11,4,6,0,72
73982,883345,1,11,5,1,0,73
73983,883345,1,11,6,1,0,74
73984,883345,1,12,1,0,1,74
73985,883345,1,12,2,0,0,74
73986,883345,1,12,3,1,0,75
73987,883345,1,12,4,1,0,76
73988,883345,1,12,5,2,0,78
73989,883345,1,12,6,6,0,84
73990,883345,1,13,1,1,0,85
73991,883345,1,13,2,1,0,86
73992,883345,1,13,3,1,0,87
73993,883345,1,13,4,4,0,91
73994,883345,1,13,5,1,0,92
73995,883345,1,13,6,1,0,93
73996,883345,1,14,1,1,0,94
73997,883345,1,14,2,4,0,98
73998,883345,1,14,3,0,1,98
73999,883345,1,14,4,1,0,99
74000,883345,1,14,5,0,0,99
74001,883345,1,14,6,1,0,100
74002,883345,1,15,1,1,0,101
74003,883345,1,15,2,2,0,103
74004,883345,1,15,3,1,0,104
74005,883345,1,15,4,0,0,104
74006,883345,1,15,5,1,0,105
74007,883345,1,15,6,2,0,107
74008,883345,1,16,1,1,0,108
74009,883345,1,16,2,1,0,109
74010,883345,1,16,3,1,0,110
74011,883345,1,16,4,1,0,111
74012,883345,1,16,5,1,0,112
74013,883345,1,16,6,0,1,112
74014,883345,1,17,1,0,0,112
74015,883345,1,17,2,1,0,113
74016,883345,1,17,3,0,0,113
74017,883345,1,17,4,0,0,113
74018,883345,1,17,5,1,0,114
74019,883345,1,17,6,6,0,120
74020,883345,1,18,1,1,0,121
74021,883345,1,18,2,1,0,122
74022,883345,1,18,3,1,0,123
74023,883345,1,18,4,0,0,123
74024,883345,1,18,5,0,0,123
74025,883345,1,18,6,4,0,127
74026,883345,1,19,1,0,1,127
74027,883345,1,19,2,1,0,128
74028,883345,1,19,3,1,0,129
74029,883345,1,19,4,1,0,130
74030,883345,1,19,5,4,0,134
74031,883345,1,19,6,6,0,140
74032,883345,1,20,1,4,0,144
74033,883345,1,20,2,0,0,144
74034,883345,1,20,3,1,0,145
74035,883345,1,20,4,1,0,146
74036,883345,1,20,5,1,0,147
74037,883345,1,20,6,2,0,149
74158,884347,1,1,1,2,0,2
74159,884347,1,1,2,1,0,3
74160,884347,1,1,3,1,0,4
74161,884347,1,1,4,0,0,4
74162,884347,1,1,5,4,0,8
74163,884347,1,1,6,0,0,8
74164,884347,1,2,1,4,0,12
74165,884347,1,2,2,0,0,12
74166,884347,1,2,3,0,0,12
74167,884347,1,2,4,0,0,12
74168,884347,1,2,5,1,0,13
74169,884347,1,2,6,1,0,14
74170,884347,1,3,1,6,0,20
74171,884347,1,3,2,1,0,21
74172,884347,1,3,3,1,0,22
74173,884347,1,3,4,1,0,23
74174,884347,1,3,5,0,1,23
74175,884347,1,3,6,0,0,23
74176,884347,1,4,1,1,0,24
74177,884347,1,4,2,4,0,28
74178,884347,1,4,3,0,0,28
74179,884347,1,4,4,1,0,29
74180,884347,1,4,5,0,0,29
74181,884347,1,4,6,1,0,30
74182,884347,1,5,1,6,0,36
74183,884347,1,5,2,6,0,42
74184,884347,1,5,3,6,0,48
74185,884347,1,5,4,4,0,52
74186,884347,1,5,5,0,0,52
74187,884347,1,5,6,2,0,54
74188,884347,1,6,1,4,0,58
74189,884347,1,6,2,0,0,58
74190,884347,1,6,3,4,0,62
74191,884347,1,6,4,0,0,62
74192,884347,1,6,5,6,0,68
74193,884347,1,6,6,1,0,69
74194,884347,1,7,1,0,1,69
74195,884347,1,7,2,0,0,69
74196,884347,1,7,3,1,0,70
74197,884347,1,7,4,1,0,71
74198,884347,1,7,5,0,0,71
74199,884347,1,7,6,0,0,71
74200,884347,1,8,1,0,1,71
74201,884347,1,8,2,0,0,71
74202,884347,1,8,3,1,0,72
74203,884347,1,8,4,0,0,72
74204,884347,1,8,5,0,0,72
74205,884347,1,8,6,0,0,72
74206,884347,1,9,1,4,0,76
74207,884347,1,9,2,1,0,77
74208,884347,1,9,3,1,0,78
74209,884347,1,9,4,1,0,79
74210,884347,1,9,5,0,0,79
74211,884347,1,9,6,0,0,79
74212,884347,1,10,1,1,0,80
74213,884347,1,10,2,1,0,81
74214,884347,1,10,3,2,0,83
74215,884347,1,10,4,1,0,84
74216,884347,1,10,5,1,0,85
74217,884347,1,10,6,4,0,89
74218,884347,1,11,1,0,0,89
74219,884347,1,11,2,0,0,89
74220,884347,1,11,3,0,0,89
74221,884347,1,11,4,2,0,91
74222,884347,1,11,5,0,1,91
74223,884347,1,11,6,1,0,92
74224,884347,1,12,1,1,0,93
74225,884347,1,12,2,4,0,97
74226,884347,1,12,3,0,1,97
74227,884347,1,12,4,0,0,97
74228,884347,1,12,5,1,0,98
74229,884347,1,12,6,0,0,98
74230,884347,1,13,1,0,0,98
74231,884347,1,13,2,0,0,98
74232,884347,1,13,3,1,0,99
74233,884347,1,13,4,1,0,100
74234,884347,1,13,5,1,0,101
74235,884347,1,13,6,1,0,102
74236,884347,1,14,1,2,0,104
74237,884347,1,14,2,0,1,104
74238,884347,1,14,3,0,0,104
74239,884347,1,14,4,4,0,108
74240,884347,1,14,5,0,0,108
74241,884347,1,14,6,1,0,109
74242,884347,1,15,1,1,0,110
74243,884347,1,15,2,1,0,111
74244,884347,1,15,3,0,0,111
74245,884347,1,15,4,1,0,112
74246,884347,1,15,5,1,0,113
74247,884347,1,15,6,0,0,113
74248,884347,1,16,1,1,0,114
74249,884347,1,16,2,0,1,114
74250,884347,1,16,3,0,0,114
74251,884347,1,16,4,1,0,115
74252,884347,1,16,5,2,0,117
74253,884347,1,16,6,1,0,118
74254,884347,1,17,1,1,0,119
74255,884347,1,17,2,1,0,120
74256,884347,1,17,3,6,0,126
74257,884347,1,17,4,1,0,127
74258,884347,1,17,5,0,0,127
74259,884347,1,17,6,6,0,133
74260,884347,1,18,1,1,0,134
74261,884347,1,18,2,1,0,135
74262,884347,1,18,3,4,0,139
74263,884347,1,18,4,6,0,145
74264,884347,1,18,5,2,0,147
74265,884347,1,18,6,0,0,147
74266,884347,1,19,1,1,0,148
74267,884347,1,19,2,1,0,149
74268,884347,1,19,3,0,0,149
74269,884347,1,19,4,0,1,149
74270,884347,1,19,5,3,0,152
74271,884347,1,19,6,0,0,152
74272,884347,1,20,1,0,0,152
74273,884347,1,20,2,2,0,154
74274,884347,1,20,3,0,1,154
74275,884347,1,20,4,0,0,154
74276,884347,1,20,5,0,0,154
74277,884347,1,20,6,3,0,157
74394,884349,1,1,1,2,0,2
74395,884349,1,1,2,4,0,6
74396,884349,1,1,3,0,0,6
74397,884349,1,1,4,1,0,7
74398,884349,1,1,5,0,0,7
74399,884349,1,1,6,1,0,8
74400,884349,1,2,1,1,0,9
74401,884349,1,2,2,0,0,9
74402,884349,1,2,3,6,0,15
74403,884349,1,2,4,0,0,15
74404,884349,1,2,5,0,0,15
74405,884349,1,2,6,0,1,15
74406,884349,1,3,1,0,0,15
74407,884349,1,3,2,5,0,20
74408,884349,1,3,3,0,0,20
74409,884349,1,3,4,0,0,20
74410,884349,1,3,5,4,0,24
74411,884349,1,3,6,2,0,26
74412,884349,1,4,1,1,0,27
74413,884349,1,4,2,0,0,27
74414,884349,1,4,3,0,0,27
74415,884349,1,4,4,4,0,31
74416,884349,1,4,5,0,0,31
74417,884349,1,4,6,0,0,31
74418,884349,1,5,1,0,0,31
74419,884349,1,5,2,0,0,31
74420,884349,1,5,3,2,0,33
74421,884349,1,5,4,0,0,33
74422,884349,1,5,5,4,0,37
74423,884349,1,5,6,6,0,43
74424,884349,1,6,1,4,0,47
74425,884349,1,6,2,4,0,51
74426,884349,1,6,3,6,0,57
74427,884349,1,6,4,1,0,58
74428,884349,1,6,5,2,0,60
74429,884349,1,6,6,2,0,62
74430,884349,1,7,1,0,0,62
74431,884349,1,7,2,4,0,66
74432,884349,1,7,3,4,0,70
74433,884349,1,7,4,0,0,70
74434,884349,1,7,5,0,0,70
74435,884349,1,7,6,4,0,74
74436,884349,1,8,1,1,0,75
74437,884349,1,8,2,0,0,75
74438,884349,1,8,3,0,0,75
74439,884349,1,8,4,1,0,76
74440,884349,1,8,5,1,0,77
74441,884349,1,8,6,0,1,77
74442,884349,1,9,1,1,0,78
74443,884349,1,9,2,0,0,78
74444,884349,1,9,3,1,0,79
74445,884349,1,9,4,0,0,79
74446,884349,1,9,5,1,0,80
74447,884349,1,9,6,1,0,81
74448,884349,1,10,1,0,0,81
74449,884349,1,10,2,0,0,81
74450,884349,1,10,3,4,0,85
74451,884349,1,10,4,2,0,87
74452,884349,1,10,5,0,0,87
74453,884349,1,10,6,0,0,87
74454,884349,1,11,1,7,0,94
74455,884349,1,11,2,2,0,96
74456,884349,1,11,3,1,0,97
74457,884349,1,11,4,0,0,97
74458,884349,1,11,5,6,0,103
74459,884349,1,11,6,0,1,103
74460,884349,1,12,1,1,0,104
74461,884349,1,12,2,1,0,105
74462,884349,1,12,3,1,0,106
74463,884349,1,12,4,1,0,107
74464,884349,1,12,5,0,0,107
74465,884349,1,12,6,1,0,108
74466,884349,1,13,1,1,0,109
74467,884349,1,13,2,1,0,110
74468,884349,1,13,3,1,0,111
74469,884349,1,13,4,1,0,112
74470,884349,1,13,5,0,0,112
74471,884349,1,13,6,1,0,113
74472,884349,1,14,1,4,0,117
74473,884349,1,14,2,1,0,118
74474,884349,1,14,3,1,0,119
74475,884349,1,14,4,1,0,120
74476,884349,1,14,5,1,0,121
74477,884349,1,14,6,1,0,122
74478,884349,1,15,1,2,0,124
74479,884349,1,15,2,4,0,128
74480,884349,1,15,3,6,0,134
74481,884349,1,15,4,2,0,136
74482,884349,1,15,5,6,0,142
74483,884349,1,15,6,0,1,142
74484,884349,1,16,1,1,0,143
74485,884349,1,16,2,1,0,144
74486,884349,1,16,3,1,0,145
74487,884349,1,16,4,1,0,146
74488,884349,1,16,5,1,0,147
74489,884349,1,16,6,0,0,147
74490,884349,1,17,1,2,0,149
74491,884349,1,17,2,1,0,150
74492,884349,1,17,3,1,0,151
74493,884349,1,17,4,0,1,151
74494,884349,1,17,5,1,0,152
74495,884349,1,17,6,1,0,153
74496,884349,1,18,1,1,0,154
74497,884349,1,18,2,4,0,158
74498,884349,1,18,3,4,0,162
74499,884349,1,18,4,1,0,163
74500,884349,1,18,5,1,0,164
74501,884349,1,18,6,1,0,165
74502,884349,1,19,1,0,1,165
74503,884349,1,19,2,2,0,167
74504,884349,1,19,3,6,0,173
74505,884349,1,19,4,1,0,174
74506,884349,1,19,5,2,0,176
74507,884349,1,19,6,2,0,178
74508,884349,1,20,1,4,0,182
74509,884349,1,20,2,6,0,188
74510,884349,1,20,3,6,0,194
74511,884349,1,20,4,4,0,198
74512,884349,1,20,5,0,1,198
74513,884349,1,20,6,6,0,204
74634,884351,1,1,1,1,0,1
74635,884351,1,1,2,4,0,5
74636,884351,1,1,3,0,0,5
74637,884351,1,1,4,1,0,6
74638,884351,1,1,5,1,0,7
74639,884351,1,1,6,4,0,11
74640,884351,1,2,1,0,0,11
74641,884351,1,2,2,0,0,11
74642,884351,1,2,3,0,0,11
74643,884351,1,2,4,2,0,13
74644,884351,1,2,5,1,0,14
74645,884351,1,2,6,0,0,14
74646,884351,1,3,1,4,0,18
74647,884351,1,3,2,6,0,24
74648,884351,1,3,3,1,0,25
74649,884351,1,3,4,4,0,29
74650,884351,1,3,5,1,0,30
74651,884351,1,3,6,2,0,32
74652,884351,1,4,1,0,0,32
74653,884351,1,4,2,4,0,36
74654,884351,1,4,3,6,0,42
74655,884351,1,4,4,1,0,43
74656,884351,1,4,5,4,0,47
74657,884351,1,4,6,0,0,47
74658,884351,1,5,1,0,1,47
74659,884351,1,5,2,4,0,51
74660,884351,1,5,3,0,0,51
74661,884351,1,5,4,6,0,57
74662,884351,1,5,5,0,0,57
74663,884351,1,5,6,1,0,58
74664,884351,1,6,1,1,0,59
74665,884351,1,6,2,0,0,59
74666,884351,1,6,3,1,0,60
74667,884351,1,6,4,0,0,60
74668,884351,1,6,5,4,0,64
74669,884351,1,6,6,4,0,68
74670,884351,1,7,1,0,0,68
74671,884351,1,7,2,1,0,69
74672,884351,1,7,3,0,0,69
74673,884351,1,7,4,0,0,69
74674,884351,1,7,5,1,0,70
74675,884351,1,7,6,1,0,71
74676,884351,1,8,1,1,0,72
74677,884351,1,8,2,1,0,73
74678,884351,1,8,3,1,1,74
74679,884351,1,8,4,0,0,74
74680,884351,1,8,5,0,0,74
74681,884351,1,8,6,1,0,75
74682,884351,1,9,1,1,0,76
74683,884351,1,9,2,2,0,78
74684,884351,1,9,3,0,0,78
74685,884351,1,9,4,0,0,78
74686,884351,1,9,5,2,0,80
74687,884351,1,9,6,1,0,81
74688,884351,1,10,1,2,0,83
74689,884351,1,10,2,0,0,83
74690,884351,1,10,3,1,0,84
74691,884351,1,10,4,1,0,85
74692,884351,1,10,5,2,0,87
74693,884351,1,10,6,0,0,87
74694,884351,1,11,1,1,0,88
74695,884351,1,11,2,1,0,89
74696,884351,1,11,3,0,0,89
74697,884351,1,11,4,0,0,89
74698,884351,1,11,5,0,0,89
74699,884351,1,11,6,4,0,93
74700,884351,1,12,1,1,0,94
74701,884351,1,12,2,1,0,95
74702,884351,1,12,3,4,0,99
74703,884351,1,12,4,0,0,99
74704,884351,1,12,5,1,0,100
74705,884351,1,12,6,1,0,101
74706,884351,1,13,1,2,0,103
74707,884351,1,13,2,1,0,104
74708,884351,1,13,3,4,0,108
74709,884351,1,13,4,1,0,109
74710,884351,1,13,5,0,0,109
74711,884351,1,13,6,0,0,109
74712,884351,1,14,1,1,0,110
74713,884351,1,14,2,1,0,111
74714,884351,1,14,3,2,0,113
74715,884351,1,14,4,4,0,117
74716,884351,1,14,5,1,0,118
74717,884351,1,14,6,1,0,119
74718,884351,1,15,1,1,0,120
74719,884351,1,15,2,1,0,121
74720,884351,1,15,3,0,0,121
74721,884351,1,15,4,0,1,121
74722,884351,1,15,5,2,0,123
74723,884351,1,15,6,0,0,123
74724,884351,1,16,1,1,0,124
74725,884351,1,16,2,1,0,125
74726,884351,1,16,3,1,0,126
74727,884351,1,16,4,1,0,127
74728,884351,1,16,5,0,0,127
74729,884351,1,16,6,4,0,131
74730,884351,1,17,1,1,0,132
74731,884351,1,17,2,2,0,134
74732,884351,1,17,3,1,0,135
74733,884351,1,17,4,1,0,136
74734,884351,1,17,5,4,0,140
74735,884351,1,17,6,1,0,141
74736,884351,1,18,1,1,0,142
74737,884351,1,18,2,1,0,143
74738,884351,1,18,3,6,0,149
74739,884351,1,18,4,1,0,150
74740,884351,1,18,5,0,0,150
74741,884351,1,18,6,1,0,151
74742,884351,1,19,1,1,0,152
74743,884351,1,19,2,1,0,153
74744,884351,1,19,3,1,0,154
74745,884351,1,19,4,1,0,155
74746,884351,1,19,5,1,0,156
74747,884351,1,19,6,6,0,162
74748,884351,1,20,1,6,0,168
74749,884351,1,20,2,1,0,169
74750,884351,1,20,3,2,0,171
74751,884351,1,20,4,0,1,171
74752,884351,1,20,5,1,0,172
74753,884351,1,20,6,6,0,178
74870,885969,1,1,1,0,0,0
74871,885969,1,1,2,0,0,0
74872,885969,1,1,3,1,0,1
74873,885969,1,1,4,1,0,2
74874,885969,1,1,5,1,0,3
74875,885969,1,1,6,0,0,3
74876,885969,1,2,1,0,0,3
74877,885969,1,2,2,1,0,4
74878,885969,1,2,3,0,0,4
74879,885969,1,2,4,3,0,7
74880,885969,1,2,5,3,0,10
74881,885969,1,2,6,0,0,10
74882,885969,1,3,1,4,0,14
74883,885969,1,3,2,0,0,14
74884,885969,1,3,3,0,0,14
74885,885969,1,3,4,0,0,14
74886,885969,1,3,5,1,0,15
74887,885969,1,3,6,4,0,19
74888,885969,1,4,1,2,0,21
74889,885969,1,4,2,4,0,25
74890,885969,1,4,3,2,0,27
74891,885969,1,4,4,2,0,29
74892,885969,1,4,5,1,0,30
74893,885969,1,4,6,0,0,30
74894,885969,1,5,1,1,0,31
74895,885969,1,5,2,6,0,37
74896,885969,1,5,3,1,0,38
74897,885969,1,5,4,4,0,42
74898,885969,1,5,5,4,0,46
74899,885969,1,5,6,1,0,47
74900,885969,1,6,1,0,0,47
74901,885969,1,6,2,4,0,51
74902,885969,1,6,3,5,0,56
74903,885969,1,6,4,1,0,57
74904,885969,1,6,5,0,0,57
74905,885969,1,6,6,1,0,58
74906,885969,1,7,1,1,0,59
74907,885969,1,7,2,1,0,60
74908,885969,1,7,3,1,0,61
74909,885969,1,7,4,2,0,63
74910,885969,1,7,5,1,0,64
74911,885969,1,7,6,0,1,64
74912,885969,1,8,1,1,0,65
74913,885969,1,8,2,2,0,67
74914,885969,1,8,3,1,0,68
74915,885969,1,8,4,1,0,69
74916,885969,1,8,5,1,0,70
74917,885969,1,8,6,1,0,71
74918,885969,1,9,1,1,0,72
74919,885969,1,9,2,2,0,74
74920,885969,1,9,3,0,0,74
74921,885969,1,9,4,2,0,76
74922,885969,1,9,5,5,0,81
74923,885969,1,9,6,1,0,82
74924,885969,1,10,1,0,0,82
74925,885969,1,10,2,0,1,82
74926,885969,1,10,3,0,0,82
74927,885969,1,10,4,0,0,82
74928,885969,1,10,5,0,0,82
74929,885969,1,10,6,0,0,82
74930,885969,1,11,1,4,0,86
74931,885969,1,11,2,0,0,86
74932,885969,1,11,3,1,0,87
74933,885969,1,11,4,0,0,87
74934,885969,1,11,5,1,0,88
74935,885969,1,11,6,0,0,88
74936,885969,1,12,1,1,0,89
74937,885969,1,12,2,1,0,90
74938,885969,1,12,3,6,0,96
74939,885969,1,12,4,0,0,96
74940,885969,1,12,5,1,0,97
74941,885969,1,12,6,1,0,98
74942,885969,1,13,1,1,0,99
74943,885969,1,13,2,1,0,100
74944,885969,1,13,3,4,0,104
74945,885969,1,13,4,1,0,105
74946,885969,1,13,5,2,0,107
74947,885969,1,13,6,1,0,108
74948,885969,1,14,1,1,0,109
74949,885969,1,14,2,0,0,109
74950,885969,1,14,3,1,0,110
74951,885969,1,14,4,1,0,111
74952,885969,1,14,5,2,0,113
74953,885969,1,14,6,0,0,113
74954,885969,1,15,1,2,0,115
74955,885969,1,15,2,2,0,117
74956,885969,1,15,3,1,0,118
74957,885969,1,15,4,1,0,119
74958,885969,1,15,5,4,0,123
74959,885969,1,15,6,0,0,123
74960,885969,1,16,1,4,0,127
74961,885969,1,16,2,0,1,127
74962,885969,1,16,3,1,0,128
74963,885969,1,16,4,1,0,129
74964,885969,1,16,5,4,0,133
74965,885969,1,16,6,2,0,135
74966,885969,1,17,1,1,0,136
74967,885969,1,17,2,3,0,139
74968,885969,1,17,3,2,0,141
74969,885969,1,17,4,1,0,142
74970,885969,1,17,5,5,0,147
74971,885969,1,17,6,1,0,148
74972,885969,1,18,1,1,0,149
74973,885969,1,18,2,1,0,150
74974,885969,1,18,3,0,1,150
74975,885969,1,18,4,1,0,151
74976,885969,1,18,5,1,0,152
74977,885969,1,18,6,2,0,154
74978,885969,1,19,1,1,0,155
74979,885969,1,19,2,1,0,156
74980,885969,1,19,3,1,0,157
74981,885969,1,19,4,6,0,163
74982,885969,1,19,5,1,0,164
74983,885969,1,19,6,2,0,166
74984,885969,1,20,1,0,1,166
74985,885969,1,20,2,1,0,167
74986,885969,1,20,3,2,0,169
74987,885969,1,20,4,3,0,172
74988,885969,1,20,5,2,0,174
74989,885969,1,20,6,4,0,178
75110,885971,1,1,1,0,0,0
75111,885971,1,1,2,0,0,0
75112,885971,1,1,3,2,0,2
75113,885971,1,1,4,2,0,4
75114,885971,1,1,5,0,0,4
75115,885971,1,1,6,3,0,7
75116,885971,1,2,1,1,0,8
75117,885971,1,2,2,0,0,8
75118,885971,1,2,3,1,0,9
75119,885971,1,2,4,1,0,10
75120,885971,1,2,5,1,0,11
75121,885971,1,2,6,5,0,16
75122,885971,1,3,1,4,0,20
75123,885971,1,3,2,0,0,20
75124,885971,1,3,3,0,0,20
75125,885971,1,3,4,0,0,20
75126,885971,1,3,5,1,0,21
75127,885971,1,3,6,0,0,21
75128,885971,1,4,1,7,0,28
75129,885971,1,4,2,0,1,28
75130,885971,1,4,3,0,0,28
75131,885971,1,4,4,3,0,31
75132,885971,1,4,5,4,0,35
75133,885971,1,4,6,0,0,35
75134,885971,1,5,1,0,0,35
75135,885971,1,5,2,4,0,39
75136,885971,1,5,3,1,0,40
75137,885971,1,5,4,0,0,40
75138,885971,1,5,5,4,0,44
75139,885971,1,5,6,1,0,45
75140,885971,1,6,1,2,0,47
75141,885971,1,6,2,1,0,48
75142,885971,1,6,3,0,0,48
75143,885971,1,6,4,0,1,48
75144,885971,1,6,5,1,0,49
75145,885971,1,6,6,0,0,49
75146,885971,1,7,1,1,0,50
75147,885971,1,7,2,1,0,51
75148,885971,1,7,3,1,0,52
75149,885971,1,7,4,1,0,53
75150,885971,1,7,5,1,0,54
75151,885971,1,7,6,1,0,55
75152,885971,1,8,1,4,0,59
75153,885971,1,8,2,1,0,60
75154,885971,1,8,3,1,0,61
75155,885971,1,8,4,1,0,62
75156,885971,1,8,5,1,0,63
75157,885971,1,8,6,0,0,63
75158,885971,1,9,1,0,0,63
75159,885971,1,9,2,1,0,64
75160,885971,1,9,3,2,0,66
75161,885971,1,9,4,0,0,66
75162,885971,1,9,5,1,0,67
75163,885971,1,9,6,0,0,67
75164,885971,1,10,1,1,0,68
75165,885971,1,10,2,0,0,68
75166,885971,1,10,3,1,0,69
75167,885971,1,10,4,1,0,70
75168,885971,1,10,5,4,0,74
75169,885971,1,10,6,2,0,76
75170,885971,1,11,1,1,0,77
75171,885971,1,11,2,1,0,78
75172,885971,1,11,3,1,0,79
75173,885971,1,11,4,1,0,80
75174,885971,1,11,5,4,0,84
75175,885971,1,11,6,1,0,85
75176,885971,1,12,1,0,1,85
75177,885971,1,12,2,0,0,85
75178,885971,1,12,3,1,0,86
75179,885971,1,12,4,0,0,86
75180,885971,1,12,5,2,0,88
75181,885971,1,12,6,1,0,89
75182,885971,1,13,1,0,0,89
75183,885971,1,13,2,4,0,93
75184,885971,1,13,3,0,0,93
75185,885971,1,13,4,4,0,97
75186,885971,1,13,5,1,0,98
75187,885971,1,13,6,0,0,98
75188,885971,1,14,1,0,0,98
75189,885971,1,14,2,1,0,99
75190,885971,1,14,3,0,0,99
75191,885971,1,14,4,0,0,99
75192,885971,1,14,5,1,0,100
75193,885971,1,14,6,4,0,104
75194,885971,1,15,1,1,0,105
75195,885971,1,15,2,1,0,106
75196,885971,1,15,3,1,0,107
75197,885971,1,15,4,0,0,107
75198,885971,1,15,5,4,0,111
75199,885971,1,15,6,1,0,112
75200,885971,1,16,1,1,0,113
75201,885971,1,16,2,0,0,113
75202,885971,1,16,3,0,1,113
75203,885971,1,16,4,0,0,113
75204,885971,1,16,5,1,0,114
75205,885971,1,16,6,2,0,116
75206,885971,1,17,1,0,0,116
75207,885971,1,17,2,1,0,117
75208,885971,1,17,3,1,0,118
75209,885971,1,17,4,0,0,118
75210,885971,1,17,5,2,0,120
75211,885971,1,17,6,1,0,121
75212,885971,1,18,1,4,0,125
75213,885971,1,18,2,1,0,126
75214,885971,1,18,3,4,0,130
75215,885971,1,18,4,1,0,131
75216,885971,1,18,5,0,0,131
75217,885971,1,18,6,1,0,132
75218,885971,1,19,1,0,1,132
75219,885971,1,19,2,1,0,133
75220,885971,1,19,3,6,0,139
75221,885971,1,19,4,0,1,139
75222,885971,1,19,5,1,0,140
75223,885971,1,19,6,1,0,141
75224,885971,1,20,1,0,0,141
75225,885971,1,20,2,1,0,142
75226,885971,1,20,3,0,1,142
75227,885971,1,20,4,2,0,144
75228,885971,1,20,5,1,0,145
75229,885971,1,20,6,0,0,145
75350,894293,1,1,1,1,0,1
75351,894293,1,1,2,0,0,1
75352,894293,1,1,3,2,0,3
75353,894293,1,1,4,4,0,7
75354,894293,1,1,5,4,0,11
75355,894293,1,1,6,4,0,15
75356,894293,1,2,1,0,0,15
75357,894293,1,2,2,4,0,19
75358,894293,1,2,3,1,0,20
75359,894293,1,2,4,4,0,24
75360,894293,1,2,5,0,0,24
75361,894293,1,2,6,1,0,25
75362,894293,1,3,1,0,0,25
75363,894293,1,3,2,0,0,25
75364,894293,1,3,3,1,0,26
75365,894293,1,3,4,0,0,26
75366,894293,1,3,5,0,0,26
75367,894293,1,3,6,0,0,26
75368,894293,1,4,1,0,1,26
75369,894293,1,4,2,4,0,30
75370,894293,1,4,3,0,0,30
75371,894293,1,4,4,4,0,34
75372,894293,1,4,5,3,0,37
75373,894293,1,4,6,0,0,37
75374,894293,1,5,1,4,0,41
75375,894293,1,5,2,2,0,43
75376,894293,1,5,3,0,0,43
75377,894293,1,5,4,0,0,43
75378,894293,1,5,5,1,0,44
75379,894293,1,5,6,0,0,44
75380,894293,1,6,1,4,0,48
75381,894293,1,6,2,1,0,49
75382,894293,1,6,3,0,0,49
75383,894293,1,6,4,0,0,49
75384,894293,1,6,5,0,0,49
75385,894293,1,6,6,0,0,49
75386,894293,1,7,1,1,0,50
75387,894293,1,7,2,0,0,50
75388,894293,1,7,3,4,0,54
75389,894293,1,7,4,1,0,55
75390,894293,1,7,5,1,0,56
75391,894293,1,7,6,0,0,56
75392,894293,1,8,1,4,0,60
75393,894293,1,8,2,1,0,61
75394,894293,1,8,3,0,0,61
75395,894293,1,8,4,6,0,67
75396,894293,1,8,5,2,0,69
75397,894293,1,8,6,4,0,73
75398,894293,1,9,1,1,0,74
75399,894293,1,9,2,0,0,74
75400,894293,1,9,3,1,0,75
75401,894293,1,9,4,0,1,75
75402,894293,1,9,5,1,0,76
75403,894293,1,9,6,1,0,77
75404,894293,1,10,1,2,0,79
75405,894293,1,10,2,1,0,80
75406,894293,1,10,3,0,0,80
75407,894293,1,10,4,6,0,86
75408,894293,1,10,5,0,0,86
75409,894293,1,10,6,1,0,87
75410,894293,1,11,1,1,0,88
75411,894293,1,11,2,2,0,90
75412,894293,1,11,3,0,0,90
75413,894293,1,11,4,1,0,91
75414,894293,1,11,5,1,0,92
75415,894293,1,11,6,1,0,93
75416,894293,1,12,1,0,0,93
75417,894293,1,12,2,0,1,93
75418,894293,1,12,3,2,0,95
75419,894293,1,12,4,1,0,96
75420,894293,1,12,5,0,0,96
75421,894293,1,12,6,1,0,97
75422,894293,1,13,1,4,0,101
75423,894293,1,13,2,6,0,107
75424,894293,1,13,3,1,0,108
75425,894293,1,13,4,1,0,109
75426,894293,1,13,5,2,0,111
75427,894293,1,13,6,1,0,112
75428,894293,1,14,1,1,0,113
75429,894293,1,14,2,1,0,114
75430,894293,1,14,3,6,0,120
75431,894293,1,14,4,1,0,121
75432,894293,1,14,5,4,0,125
75433,894293,1,14,6,1,0,126
75434,894293,1,15,1,1,0,127
75435,894293,1,15,2,7,0,134
75436,894293,1,15,3,0,0,134
75437,894293,1,15,4,1,0,135
75438,894293,1,15,5,1,0,136
75439,894293,1,15,6,1,0,137
75440,894293,1,16,1,2,0,139
75441,894293,1,16,2,1,0,140
75442,894293,1,16,3,2,0,142
75443,894293,1,16,4,0,1,142
75444,894293,1,16,5,0,0,142
75445,894293,1,16,6,0,0,142
75446,894293,1,17,1,4,0,146
75447,894293,1,17,2,6,0,152
75448,894293,1,17,3,2,0,154
75449,894293,1,17,4,2,0,156
75450,894293,1,17,5,0,0,156
75451,894293,1,17,6,1,0,157
75452,894293,1,18,1,0,0,157
75453,894293,1,18,2,0,1,157
75454,894293,1,18,3,1,0,158
75455,894293,1,18,4,1,0,159
75456,894293,1,18,5,4,0,163
75457,894293,1,18,6,6,0,169
75458,894293,1,19,1,1,0,170
75459,894293,1,19,2,2,0,172
75460,894293,1,19,3,1,0,173
75461,894293,1,19,4,1,0,174
75462,894293,1,19,5,4,0,178
75463,894293,1,19,6,4,0,182
75464,894293,1,20,1,4,0,186
75465,894293,1,20,2,6,0,192
75466,894293,1,20,3,4,0,196
75467,894293,1,20,4,1,0,197
75468,894293,1,20,5,0,0,197
75469,894293,1,20,6,1,0,198
75590,895817,1,1,1,0,0,0
75591,895817,1,1,2,4,0,4
75592,895817,1,1,3,0,0,4
75593,895817,1,1,4,6,0,10
75594,895817,1,1,5,0,0,10
75595,895817,1,1,6,0,0,10
75596,895817,1,2,1,1,0,11
75597,895817,1,2,2,1,0,12
75598,895817,1,2,3,3,0,15
75599,895817,1,2,4,0,0,15
75600,895817,1,2,5,3,0,18
75601,895817,1,2,6,0,0,18
75602,895817,1,3,1,0,0,18
75603,895817,1,3,2,4,0,22
75604,895817,1,3,3,1,0,23
75605,895817,1,3,4,4,0,27
75606,895817,1,3,5,2,0,29
75607,895817,1,3,6,2,0,31
75608,895817,1,4,1,1,0,32
75609,895817,1,4,2,1,0,33
75610,895817,1,4,3,0,0,33
75611,895817,1,4,4,2,0,35
75612,895817,1,4,5,4,0,39
75613,895817,1,4,6,1,0,40
75614,895817,1,5,1,0,1,40
75615,895817,1,5,2,1,0,41
75616,895817,1,5,3,0,0,41
75617,895817,1,5,4,0,0,41
75618,895817,1,5,5,0,1,41
75619,895817,1,5,6,0,0,41
75620,895817,1,6,1,1,0,42
75621,895817,1,6,2,4,0,46
75622,895817,1,6,3,1,0,47
75623,895817,1,6,4,2,0,49
75624,895817,1,6,5,1,0,50
75625,895817,1,6,6,4,0,54
75626,895817,1,7,1,1,0,55
75627,895817,1,7,2,0,0,55
75628,895817,1,7,3,2,0,57
75629,895817,1,7,4,1,0,58
75630,895817,1,7,5,0,0,58
75631,895817,1,7,6,0,0,58
75632,895817,1,8,1,1,0,59
75633,895817,1,8,2,1,0,60
75634,895817,1,8,3,1,0,61
75635,895817,1,8,4,4,0,65
75636,895817,1,8,5,1,0,66
75637,895817,1,8,6,1,0,67
75638,895817,1,9,1,4,0,71
75639,895817,1,9,2,1,0,72
75640,895817,1,9,3,1,0,73
75641,895817,1,9,4,0,0,73
75642,895817,1,9,5,1,0,74
75643,895817,1,9,6,1,0,75
75644,895817,1,10,1,0,0,75
75645,895817,1,10,2,0,0,75
75646,895817,1,10,3,1,0,76
75647,895817,1,10,4,1,0,77
75648,895817,1,10,5,1,0,78
75649,895817,1,10,6,1,0,79
75650,895817,1,11,1,1,0,80
75651,895817,1,11,2,4,0,84
75652,895817,1,11,3,1,0,85
75653,895817,1,11,4,1,0,86
75654,895817,1,11,5,0,0,86
75655,895817,1,11,6,2,0,88
75656,895817,1,12,1,1,0,89
75657,895817,1,12,2,6,0,95
75658,895817,1,12,3,1,0,96
75659,895817,1,12,4,1,0,97
75660,895817,1,12,5,0,0,97
75661,895817,1,12,6,1,0,98
75662,895817,1,13,1,1,0,99
75663,895817,1,13,2,0,0,99
75664,895817,1,13,3,2,0,101
75665,895817,1,13,4,4,0,105
75666,895817,1,13,5,1,0,106
75667,895817,1,13,6,0,0,106
75668,895817,1,14,1,4,0,110
75669,895817,1,14,2,4,0,114
75670,895817,1,14,3,2,0,116
75671,895817,1,14,4,0,0,116
75672,895817,1,14,5,1,0,117
75673,895817,1,14,6,0,0,117
75674,895817,1,15,1,1,0,118
75675,895817,1,15,2,1,0,119
75676,895817,1,15,3,0,0,119
75677,895817,1,15,4,4,0,123
75678,895817,1,15,5,4,0,127
75679,895817,1,15,6,1,0,128
75680,895817,1,16,1,6,0,134
75681,895817,1,16,2,1,0,135
75682,895817,1,16,3,2,0,137
75683,895817,1,16,4,1,0,138
75684,895817,1,16,5,2,0,140
75685,895817,1,16,6,0,0,140
75686,895817,1,17,1,1,0,141
75687,895817,1,17,2,2,0,143
75688,895817,1,17,3,2,0,145
75689,895817,1,17,4,2,0,147
75690,895817,1,17,5,1,0,148
75691,895817,1,17,6,0,0,148
75692,895817,1,18,1,1,0,149
75693,895817,1,18,2,6,0,155
75694,895817,1,18,3,2,0,157
75695,895817,1,18,4,1,0,158
75696,895817,1,18,5,1,0,159
75697,895817,1,18,6,1,0,160
75698,895817,1,19,1,4,0,164
75699,895817,1,19,2,1,0,165
75700,895817,1,19,3,4,0,169
75701,895817,1,19,4,2,0,171
75702,895817,1,19,5,2,0,173
75703,895817,1,19,6,1,0,174
75704,895817,1,20,1,1,0,175
75705,895817,1,20,2,0,1,175
75706,895817,1,20,3,6,0,181
75707,895817,1,20,4,4,0,185
75708,895817,1,20,5,1,0,186
75709,895817,1,20,6,2,0,188
75827,895819,1,1,1,0,0,0
75828,895819,1,1,2,0,0,0
75829,895819,1,1,3,1,0,1
75830,895819,1,1,4,0,0,1
75831,895819,1,1,5,4,0,5
75832,895819,1,1,6,0,0,5
75833,895819,1,2,1,4,0,9
75834,895819,1,2,2,0,0,9
75835,895819,1,2,3,0,0,9
75836,895819,1,2,4,0,0,9
75837,895819,1,2,5,0,0,9
75838,895819,1,2,6,1,0,10
75839,895819,1,3,1,1,0,11
75840,895819,1,3,2,0,0,11
75841,895819,1,3,3,0,0,11
75842,895819,1,3,4,0,0,11
75843,895819,1,3,5,1,0,12
75844,895819,1,3,6,0,0,12
75845,895819,1,4,1,4,0,16
75846,895819,1,4,2,1,0,17
75847,895819,1,4,3,4,0,21
75848,895819,1,4,4,6,0,27
75849,895819,1,4,5,2,0,29
75850,895819,1,4,6,0,0,29
75851,895819,1,5,1,4,0,33
75852,895819,1,5,2,1,0,34
75853,895819,1,5,3,1,0,35
75854,895819,1,5,4,4,0,39
75855,895819,1,5,5,4,0,43
75856,895819,1,5,6,1,0,44
75857,895819,1,6,1,2,0,46
75858,895819,1,6,2,1,0,47
75859,895819,1,6,3,1,0,48
75860,895819,1,6,4,0,0,48
75861,895819,1,6,5,1,0,49
75862,895819,1,6,6,1,0,50
75863,895819,1,7,1,0,0,50
75864,895819,1,7,2,0,0,50
75865,895819,1,7,3,4,0,54
75866,895819,1,7,4,6,0,60
75867,895819,1,7,5,1,0,61
75868,895819,1,7,6,1,0,62
75869,895819,1,8,1,1,0,63
75870,895819,1,8,2,2,0,65
75871,895819,1,8,3,8,0,73
75872,895819,1,8,4,1,0,74
75873,895819,1,8,5,2,0,76
75874,895819,1,8,6,1,0,77
75875,895819,1,9,1,1,0,78
75876,895819,1,9,2,1,0,79
75877,895819,1,9,3,1,0,80
75878,895819,1,9,4,1,0,81
75879,895819,1,9,5,1,0,82
75880,895819,1,9,6,1,0,83
75881,895819,1,10,1,1,0,84
75882,895819,1,10,2,0,0,84
75883,895819,1,10,3,0,0,84
75884,895819,1,10,4,1,0,85
75885,895819,1,10,5,0,0,85
75886,895819,1,10,6,1,0,86
75887,895819,1,11,1,6,0,92
75888,895819,1,11,2,2,0,94
75889,895819,1,11,3,1,0,95
75890,895819,1,11,4,1,0,96
75891,895819,1,11,5,1,0,97
75892,895819,1,11,6,0,1,97
75893,895819,1,12,1,0,0,97
75894,895819,1,12,2,4,0,101
75895,895819,1,12,3,1,0,102
75896,895819,1,12,4,1,0,103
75897,895819,1,12,5,0,0,103
75898,895819,1,12,6,1,0,104
75899,895819,1,13,1,1,0,105
75900,895819,1,13,2,0,0,105
75901,895819,1,13,3,0,0,105
75902,895819,1,13,4,2,0,107
75903,895819,1,13,5,1,0,108
75904,895819,1,13,6,1,0,109
75905,895819,1,14,1,1,0,110
75906,895819,1,14,2,0,0,110
75907,895819,1,14,3,4,0,114
75908,895819,1,14,4,4,0,118
75909,895819,1,14,5,0,0,118
75910,895819,1,14,6,4,0,122
75911,895819,1,15,1,2,0,124
75912,895819,1,15,2,1,0,125
75913,895819,1,15,3,2,0,127
75914,895819,1,15,4,6,0,133
75915,895819,1,15,5,0,0,133
75916,895819,1,15,6,1,0,134
75917,895819,1,16,1,4,0,138
75918,895819,1,16,2,1,0,139
75919,895819,1,16,3,1,0,140
75920,895819,1,16,4,1,0,141
75921,895819,1,16,5,1,0,142
75922,895819,1,16,6,1,1,143
75923,895819,1,17,1,0,0,143
75924,895819,1,17,2,1,0,144
75925,895819,1,17,3,2,0,146
75926,895819,1,17,4,1,0,147
75927,895819,1,17,5,4,0,151
75928,895819,1,17,6,1,0,152
75929,895819,1,18,1,2,0,154
75930,895819,1,18,2,2,0,156
75931,895819,1,18,3,4,0,160
75932,895819,1,18,4,1,0,161
75933,895819,1,18,5,4,0,165
75934,895819,1,18,6,1,0,166
75935,895819,1,19,1,0,0,166
75936,895819,1,19,2,4,0,170
75937,895819,1,19,3,1,0,171
75938,895819,1,19,4,1,0,172
75939,895819,1,19,5,1,0,173
75940,895819,1,19,6,1,0,174
75941,895819,1,20,1,4,0,178
75942,895819,1,20,2,2,0,180
75943,895819,1,20,3,1,0,181
75944,895819,1,20,4,0,1,181
75945,895819,1,20,5,2,0,183
75946,895819,1,20,6,1,0,184
76067,895821,1,1,1,1,0,1
76068,895821,1,1,2,0,0,1
76069,895821,1,1,3,0,0,1
76070,895821,1,1,4,0,0,1
76071,895821,1,1,5,0,0,1
76072,895821,1,1,6,0,0,1
76073,895821,1,2,1,3,0,4
76074,895821,1,2,2,0,0,4
76075,895821,1,2,3,1,0,5
76076,895821,1,2,4,4,0,9
76077,895821,1,2,5,4,0,13
76078,895821,1,2,6,2,0,15
76079,895821,1,3,1,1,0,16
76080,895821,1,3,2,0,1,16
76081,895821,1,3,3,0,0,16
76082,895821,1,3,4,1,0,17
76083,895821,1,3,5,6,0,23
76084,895821,1,3,6,1,0,24
76085,895821,1,4,1,0,0,24
76086,895821,1,4,2,0,0,24
76087,895821,1,4,3,10,0,34
76088,895821,1,4,4,1,0,35
76089,895821,1,4,5,1,0,36
76090,895821,1,4,6,1,0,37
76091,895821,1,5,1,4,0,41
76092,895821,1,5,2,4,0,45
76093,895821,1,5,3,0,0,45
76094,895821,1,5,4,0,0,45
76095,895821,1,5,5,1,0,46
76096,895821,1,5,6,2,0,48
76097,895821,1,6,1,2,0,50
76098,895821,1,6,2,0,0,50
76099,895821,1,6,3,4,0,54
76100,895821,1,6,4,0,0,54
76101,895821,1,6,5,3,0,57
76102,895821,1,6,6,0,0,57
76103,895821,1,7,1,1,0,58
76104,895821,1,7,2,0,0,58
76105,895821,1,7,3,0,0,58
76106,895821,1,7,4,0,0,58
76107,895821,1,7,5,1,0,59
76108,895821,1,7,6,4,0,63
76109,895821,1,8,1,4,0,67
76110,895821,1,8,2,1,0,68
76111,895821,1,8,3,1,0,69
76112,895821,1,8,4,0,1,69
76113,895821,1,8,5,1,0,70
76114,895821,1,8,6,2,0,72
76115,895821,1,9,1,0,0,72
76116,895821,1,9,2,1,0,73
76117,895821,1,9,3,0,0,73
76118,895821,1,9,4,1,0,74
76119,895821,1,9,5,1,0,75
76120,895821,1,9,6,0,0,75
76121,895821,1,10,1,0,1,75
76122,895821,1,10,2,2,0,77
76123,895821,1,10,3,1,0,78
76124,895821,1,10,4,0,0,78
76125,895821,1,10,5,1,0,79
76126,895821,1,10,6,1,0,80
76127,895821,1,11,1,1,0,81
76128,895821,1,11,2,4,0,85
76129,895821,1,11,3,2,0,87
76130,895821,1,11,4,0,0,87
76131,895821,1,11,5,1,0,88
76132,895821,1,11,6,1,0,89
76133,895821,1,12,1,2,0,91
76134,895821,1,12,2,1,0,92
76135,895821,1,12,3,6,0,98
76136,895821,1,12,4,4,0,102
76137,895821,1,12,5,0,0,102
76138,895821,1,12,6,1,0,103
76139,895821,1,13,1,1,0,104
76140,895821,1,13,2,2,0,106
76141,895821,1,13,3,4,0,110
76142,895821,1,13,4,2,0,112
76143,895821,1,13,5,4,0,116
76144,895821,1,13,6,2,0,118
76145,895821,1,14,1,1,0,119
76146,895821,1,14,2,3,0,122
76147,895821,1,14,3,1,0,123
76148,895821,1,14,4,2,0,125
76149,895821,1,14,5,1,0,126
76150,895821,1,14,6,1,0,127
76151,895821,1,15,1,2,0,129
76152,895821,1,15,2,6,0,135
76153,895821,1,15,3,1,0,136
76154,895821,1,15,4,2,0,138
76155,895821,1,15,5,1,0,139
76156,895821,1,15,6,1,0,140
76157,895821,1,16,1,1,0,141
76158,895821,1,16,2,1,0,142
76159,895821,1,16,3,6,0,148
76160,895821,1,16,4,0,0,148
76161,895821,1,16,5,1,0,149
76162,895821,1,16,6,0,0,149
76163,895821,1,17,1,6,0,155
76164,895821,1,17,2,2,0,157
76165,895821,1,17,3,4,0,161
76166,895821,1,17,4,6,0,167
76167,895821,1,17,5,1,0,168
76168,895821,1,17,6,0,1,168
76169,895821,1,18,1,0,0,168
76170,895821,1,18,2,1,0,169
76171,895821,1,18,3,4,0,173
76172,895821,1,18,4,1,0,174
76173,895821,1,18,5,1,0,175
76174,895821,1,18,6,1,0,176
76175,895821,1,19,1,1,0,177
76176,895821,1,19,2,1,0,178
76177,895821,1,19,3,1,0,179
76178,895821,1,19,4,6,0,185
76179,895821,1,19,5,1,0,186
76180,895821,1,19,6,1,0,187
76181,895821,1,20,1,1,0,188
76182,895821,1,20,2,1,0,189
76183,895821,1,20,3,4,0,193
76184,895821,1,20,4,0,1,193
76185,895821,1,20,5,2,0,195
76186,895821,1,20,6,2,0,197
76307,902649,1,1,1,0,0,0
76308,902649,1,1,2,3,0,3
76309,902649,1,1,3,0,0,3
76310,902649,1,1,4,0,0,3
76311,902649,1,1,5,1,0,4
76312,902649,1,1,6,1,0,5
76313,902649,1,2,1,2,0,7
76314,902649,1,2,2,0,0,7
76315,902649,1,2,3,4,0,11
76316,902649,1,2,4,1,0,12
76317,902649,1,2,5,4,0,16
76318,902649,1,2,6,0,1,16
76319,902649,1,3,1,0,0,16
76320,902649,1,3,2,2,0,18
76321,902649,1,3,3,0,1,18
76322,902649,1,3,4,0,0,18
76323,902649,1,3,5,0,0,18
76324,902649,1,3,6,0,0,18
76325,902649,1,4,1,0,0,18
76326,902649,1,4,2,1,0,19
76327,902649,1,4,3,0,0,19
76328,902649,1,4,4,0,0,19
76329,902649,1,4,5,0,1,19
76330,902649,1,4,6,0,0,19
76331,902649,1,5,1,0,0,19
76332,902649,1,5,2,0,0,19
76333,902649,1,5,3,1,0,20
76334,902649,1,5,4,1,0,21
76335,902649,1,5,5,0,0,21
76336,902649,1,5,6,4,0,25
76337,902649,1,6,1,4,0,29
76338,902649,1,6,2,1,0,30
76339,902649,1,6,3,4,0,34
76340,902649,1,6,4,1,0,35
76341,902649,1,6,5,1,0,36
76342,902649,1,6,6,4,0,40
76343,902649,1,7,1,0,0,40
76344,902649,1,7,2,1,0,41
76345,902649,1,7,3,0,0,41
76346,902649,1,7,4,0,0,41
76347,902649,1,7,5,1,0,42
76348,902649,1,7,6,1,0,43
76349,902649,1,8,1,1,0,44
76350,902649,1,8,2,0,0,44
76351,902649,1,8,3,0,0,44
76352,902649,1,8,4,1,0,45
76353,902649,1,8,5,4,0,49
76354,902649,1,8,6,0,0,49
76355,902649,1,9,1,0,0,49
76356,902649,1,9,2,4,0,53
76357,902649,1,9,3,1,0,54
76358,902649,1,9,4,0,0,54
76359,902649,1,9,5,0,0,54
76360,902649,1,9,6,2,0,56
76361,902649,1,10,1,6,0,62
76362,902649,1,10,2,1,0,63
76363,902649,1,10,3,1,0,64
76364,902649,1,10,4,1,0,65
76365,902649,1,10,5,1,0,66
76366,902649,1,10,6,1,0,67
76367,902649,1,11,1,4,0,71
76368,902649,1,11,2,1,0,72
76369,902649,1,11,3,0,0,72
76370,902649,1,11,4,0,0,72
76371,902649,1,11,5,4,0,76
76372,902649,1,11,6,1,0,77
76373,902649,1,12,1,1,0,78
76374,902649,1,12,2,1,0,79
76375,902649,1,12,3,0,0,79
76376,902649,1,12,4,0,0,79
76377,902649,1,12,5,0,0,79
76378,902649,1,12,6,1,0,80
76379,902649,1,13,1,1,0,81
76380,902649,1,13,2,6,0,87
76381,902649,1,13,3,1,0,88
76382,902649,1,13,4,4,0,92
76383,902649,1,13,5,1,0,93
76384,902649,1,13,6,1,0,94
76385,902649,1,14,1,0,0,94
76386,902649,1,14,2,0,0,94
76387,902649,1,14,3,0,0,94
76388,902649,1,14,4,0,0,94
76389,902649,1,14,5,1,0,95
76390,902649,1,14,6,0,1,95
76391,902649,1,15,1,1,0,96
76392,902649,1,15,2,1,0,97
76393,902649,1,15,3,1,0,98
76394,902649,1,15,4,1,0,99
76395,902649,1,15,5,1,0,100
76396,902649,1,15,6,1,0,101
76397,902649,1,16,1,0,0,101
76398,902649,1,16,2,2,0,103
76399,902649,1,16,3,4,0,107
76400,902649,1,16,4,1,0,108
76401,902649,1,16,5,1,0,109
76402,902649,1,16,6,4,0,113
76403,902649,1,17,1,1,0,114
76404,902649,1,17,2,0,0,114
76405,902649,1,17,3,2,0,116
76406,902649,1,17,4,1,0,117
76407,902649,1,17,5,1,0,118
76408,902649,1,17,6,1,0,119
76409,902649,1,18,1,4,0,123
76410,902649,1,18,2,4,0,127
76411,902649,1,18,3,6,0,133
76412,902649,1,18,4,2,0,135
76413,902649,1,18,5,1,0,136
76414,902649,1,18,6,2,0,138
76415,902649,1,19,1,4,0,142
76416,902649,1,19,2,6,0,148
76417,902649,1,19,3,0,0,148
76418,902649,1,19,4,0,0,148
76419,902649,1,19,5,2,0,150
76420,902649,1,19,6,2,0,152
76421,902649,1,20,1,1,0,153
76422,902649,1,20,2,1,0,154
76423,902649,1,20,3,1,0,155
76424,902649,1,20,4,3,0,158
76425,902649,1,20,5,2,0,160
76426,902649,1,20,6,0,1,160
76547,902651,1,1,1,0,0,0
76548,902651,1,1,2,1,0,1
76549,902651,1,1,3,1,0,2
76550,902651,1,1,4,1,0,3
76551,902651,1,1,5,0,0,3
76552,902651,1,1,6,1,0,4
76553,902651,1,2,1,0,0,4
76554,902651,1,2,2,4,0,8
76555,902651,1,2,3,1,0,9
76556,902651,1,2,4,0,0,9
76557,902651,1,2,5,0,0,9
76558,902651,1,2,6,2,0,11
76559,902651,1,3,1,1,0,12
76560,902651,1,3,2,6,0,18
76561,902651,1,3,3,0,0,18
76562,902651,1,3,4,2,0,20
76563,902651,1,3,5,1,0,21
76564,902651,1,3,6,1,0,22
76565,902651,1,4,1,1,0,23
76566,902651,1,4,2,1,0,24
76567,902651,1,4,3,6,0,30
76568,902651,1,4,4,1,0,31
76569,902651,1,4,5,1,0,32
76570,902651,1,4,6,0,0,32
76571,902651,1,5,1,0,1,32
76572,902651,1,5,2,0,0,32
76573,902651,1,5,3,0,0,32
76574,902651,1,5,4,4,0,36
76575,902651,1,5,5,0,0,36
76576,902651,1,5,6,0,0,36
76577,902651,1,6,1,0,0,36
76578,902651,1,6,2,4,0,40
76579,902651,1,6,3,2,0,42
76580,902651,1,6,4,1,0,43
76581,902651,1,6,5,1,0,44
76582,902651,1,6,6,1,0,45
76583,902651,1,7,1,1,0,46
76584,902651,1,7,2,1,0,47
76585,902651,1,7,3,0,0,47
76586,902651,1,7,4,0,1,47
76587,902651,1,7,5,0,0,47
76588,902651,1,7,6,1,0,48
76589,902651,1,8,1,1,0,49
76590,902651,1,8,2,1,0,50
76591,902651,1,8,3,1,0,51
76592,902651,1,8,4,1,0,52
76593,902651,1,8,5,2,0,54
76594,902651,1,8,6,4,0,58
76595,902651,1,9,1,2,0,60
76596,902651,1,9,2,1,0,61
76597,902651,1,9,3,1,0,62
76598,902651,1,9,4,0,0,62
76599,902651,1,9,5,1,0,63
76600,902651,1,9,6,0,0,63
76601,902651,1,10,1,0,0,63
76602,902651,1,10,2,1,0,64
76603,902651,1,10,3,1,0,65
76604,902651,1,10,4,1,0,66
76605,902651,1,10,5,1,0,67
76606,902651,1,10,6,1,0,68
76607,902651,1,11,1,0,0,68
76608,902651,1,11,2,6,0,74
76609,902651,1,11,3,0,1,74
76610,902651,1,11,4,2,0,76
76611,902651,1,11,5,1,0,77
76612,902651,1,11,6,1,0,78
76613,902651,1,12,1,2,0,80
76614,902651,1,12,2,0,0,80
76615,902651,1,12,3,1,0,81
76616,902651,1,12,4,1,0,82
76617,902651,1,12,5,1,0,83
76618,902651,1,12,6,6,0,89
76619,902651,1,13,1,1,0,90
76620,902651,1,13,2,6,0,96
76621,902651,1,13,3,4,0,100
76622,902651,1,13,4,4,0,104
76623,902651,1,13,5,1,0,105
76624,902651,1,13,6,1,0,106
76625,902651,1,14,1,0,0,106
76626,902651,1,14,2,1,0,107
76627,902651,1,14,3,2,0,109
76628,902651,1,14,4,0,1,109
76629,902651,1,14,5,0,0,109
76630,902651,1,14,6,0,0,109
76631,902651,1,15,1,2,0,111
76632,902651,1,15,2,1,0,112
76633,902651,1,15,3,0,0,112
76634,902651,1,15,4,1,0,113
76635,902651,1,15,5,0,0,113
76636,902651,1,15,6,1,0,114
76637,902651,1,16,1,1,0,115
76638,902651,1,16,2,0,0,115
76639,902651,1,16,3,7,0,122
76640,902651,1,16,4,6,0,128
76641,902651,1,16,5,1,0,129
76642,902651,1,16,6,1,0,130
76643,902651,1,17,1,6,0,136
76644,902651,1,17,2,0,0,136
76645,902651,1,17,3,0,1,136
76646,902651,1,17,4,2,0,138
76647,902651,1,17,5,0,0,138
76648,902651,1,17,6,1,0,139
76649,902651,1,18,1,1,0,140
76650,902651,1,18,2,0,0,140
76651,902651,1,18,3,4,0,144
76652,902651,1,18,4,6,0,150
76653,902651,1,18,5,0,1,150
76654,902651,1,18,6,1,0,151
76655,902651,1,19,1,0,1,151
76656,902651,1,19,2,1,0,152
76657,902651,1,19,3,2,0,154
76658,902651,1,19,4,0,1,154
76659,902651,1,19,5,2,0,156
76660,902651,1,19,6,2,0,158
76661,902651,1,20,1,2,0,160
76662,902651,1,20,2,1,0,161
76663,902651,1,20,3,1,0,162
76664,902651,1,20,4,4,0,166
76665,902651,1,20,5,2,0,168
76666,902651,1,20,6,4,0,172
76787,903587,1,1,1,0,0,0
76788,903587,1,1,2,0,0,0
76789,903587,1,1,3,0,0,0
76790,903587,1,1,4,0,0,0
76791,903587,1,1,5,4,0,4
76792,903587,1,1,6,0,0,4
76793,903587,1,2,1,2,0,6
76794,903587,1,2,2,0,0,6
76795,903587,1,2,3,0,0,6
76796,903587,1,2,4,0,0,6
76797,903587,1,2,5,4,0,10
76798,903587,1,2,6,1,0,11
76799,903587,1,3,1,1,0,12
76800,903587,1,3,2,0,0,12
76801,903587,1,3,3,1,0,13
76802,903587,1,3,4,4,0,17
76803,903587,1,3,5,0,0,17
76804,903587,1,3,6,4,0,21
76805,903587,1,4,1,1,1,22
76806,903587,1,4,2,0,0,22
76807,903587,1,4,3,1,0,23
76808,903587,1,4,4,0,0,23
76809,903587,1,4,5,1,0,24
76810,903587,1,4,6,1,0,25
76811,903587,1,5,1,1,0,26
76812,903587,1,5,2,0,0,26
76813,903587,1,5,3,4,0,30
76814,903587,1,5,4,2,0,32
76815,903587,1,5,5,0,0,32
76816,903587,1,5,6,0,0,32
76817,903587,1,6,1,2,0,34
76818,903587,1,6,2,0,0,34
76819,903587,1,6,3,4,0,38
76820,903587,1,6,4,1,0,39
76821,903587,1,6,5,1,0,40
76822,903587,1,6,6,6,0,46
76823,903587,1,7,1,1,0,47
76824,903587,1,7,2,0,0,47
76825,903587,1,7,3,2,0,49
76826,903587,1,7,4,1,0,50
76827,903587,1,7,5,1,0,51
76828,903587,1,7,6,0,0,51
76829,903587,1,8,1,6,0,57
76830,903587,1,8,2,4,0,61
76831,903587,1,8,3,1,0,62
76832,903587,1,8,4,1,0,63
76833,903587,1,8,5,1,0,64
76834,903587,1,8,6,1,0,65
76835,903587,1,9,1,1,0,66
76836,903587,1,9,2,1,0,67
76837,903587,1,9,3,4,0,71
76838,903587,1,9,4,0,0,71
76839,903587,1,9,5,1,0,72
76840,903587,1,9,6,3,0,75
76841,903587,1,10,1,1,0,76
76842,903587,1,10,2,1,0,77
76843,903587,1,10,3,4,0,81
76844,903587,1,10,4,0,0,81
76845,903587,1,10,5,4,0,85
76846,903587,1,10,6,1,0,86
76847,903587,1,11,1,1,0,87
76848,903587,1,11,2,1,0,88
76849,903587,1,11,3,2,0,90
76850,903587,1,11,4,1,0,91
76851,903587,1,11,5,2,0,93
76852,903587,1,11,6,1,0,94
76853,903587,1,12,1,6,0,100
76854,903587,1,12,2,1,0,101
76855,903587,1,12,3,6,0,107
76856,903587,1,12,4,6,0,113
76857,903587,1,12,5,1,0,114
76858,903587,1,12,6,1,0,115
76859,903587,1,13,1,6,0,121
76860,903587,1,13,2,1,0,122
76861,903587,1,13,3,1,0,123
76862,903587,1,13,4,6,0,129
76863,903587,1,13,5,0,0,129
76864,903587,1,13,6,0,0,129
76865,903587,1,14,1,1,0,130
76866,903587,1,14,2,0,0,130
76867,903587,1,14,3,4,0,134
76868,903587,1,14,4,4,0,138
76869,903587,1,14,5,1,0,139
76870,903587,1,14,6,1,0,140
76871,903587,1,15,1,1,0,141
76872,903587,1,15,2,1,0,142
76873,903587,1,15,3,2,0,144
76874,903587,1,15,4,3,0,147
76875,903587,1,15,5,5,0,152
76876,903587,1,15,6,6,0,158
76877,903587,1,16,1,1,0,159
76878,903587,1,16,2,1,0,160
76879,903587,1,16,3,0,1,160
76880,903587,1,16,4,0,0,160
76881,903587,1,16,5,2,0,162
76882,903587,1,16,6,0,1,162
76883,903587,1,17,1,0,0,162
76884,903587,1,17,2,0,0,162
76885,903587,1,17,3,2,0,164
76886,903587,1,17,4,0,0,164
76887,903587,1,17,5,6,0,170
76888,903587,1,17,6,0,0,170
76889,903587,1,18,1,4,0,174
76890,903587,1,18,2,0,0,174
76891,903587,1,18,3,1,0,175
76892,903587,1,18,4,6,0,181
76893,903587,1,18,5,0,0,181
76894,903587,1,18,6,1,0,182
76895,903587,1,19,1,1,0,183
76896,903587,1,19,2,1,0,184
76897,903587,1,19,3,0,1,184
76898,903587,1,19,4,0,1,184
76899,903587,1,19,5,4,0,188
76900,903587,1,19,6,1,0,189
76901,903587,1,20,1,1,0,190
76902,903587,1,20,2,1,0,191
76903,903587,1,20,3,1,0,192
76904,903587,1,20,4,0,0,192
76905,903587,1,20,5,1,0,193
76906,903587,1,20,6,6,0,199
77025,903589,1,1,1,0,0,0
77026,903589,1,1,2,5,0,5
77027,903589,1,1,3,1,0,6
77028,903589,1,1,4,0,0,6
77029,903589,1,1,5,0,0,6
77030,903589,1,1,6,0,0,6
77031,903589,1,2,1,0,0,6
77032,903589,1,2,2,1,0,7
77033,903589,1,2,3,1,0,8
77034,903589,1,2,4,4,0,12
77035,903589,1,2,5,0,0,12
77036,903589,1,2,6,0,0,12
77037,903589,1,3,1,1,0,13
77038,903589,1,3,2,1,0,14
77039,903589,1,3,3,0,0,14
77040,903589,1,3,4,1,0,15
77041,903589,1,3,5,0,0,15
77042,903589,1,3,6,1,0,16
77043,903589,1,4,1,1,0,17
77044,903589,1,4,2,2,0,19
77045,903589,1,4,3,4,0,23
77046,903589,1,4,4,1,0,24
77047,903589,1,4,5,4,0,28
77048,903589,1,4,6,0,1,28
77049,903589,1,5,1,1,0,29
77050,903589,1,5,2,1,1,30
77051,903589,1,5,3,1,0,31
77052,903589,1,5,4,1,0,32
77053,903589,1,5,5,0,0,32
77054,903589,1,5,6,0,0,32
77055,903589,1,6,1,0,0,32
77056,903589,1,6,2,1,0,33
77057,903589,1,6,3,0,0,33
77058,903589,1,6,4,1,0,34
77059,903589,1,6,5,0,0,34
77060,903589,1,6,6,1,0,35
77061,903589,1,7,1,1,0,36
77062,903589,1,7,2,1,0,37
77063,903589,1,7,3,1,0,38
77064,903589,1,7,4,3,0,41
77065,903589,1,7,5,0,0,41
77066,903589,1,7,6,0,0,41
77067,903589,1,8,1,1,0,42
77068,903589,1,8,2,1,0,43
77069,903589,1,8,3,0,0,43
77070,903589,1,8,4,0,0,43
77071,903589,1,8,5,0,1,43
77072,903589,1,8,6,1,0,44
77073,903589,1,9,1,1,0,45
77074,903589,1,9,2,0,0,45
77075,903589,1,9,3,0,1,45
77076,903589,1,9,4,0,0,45
77077,903589,1,9,5,1,0,46
77078,903589,1,9,6,2,0,48
77079,903589,1,10,1,1,0,49
77080,903589,1,10,2,4,0,53
77081,903589,1,10,3,0,0,53
77082,903589,1,10,4,4,0,57
77083,903589,1,10,5,0,0,57
77084,903589,1,10,6,1,0,58
77085,903589,1,11,1,1,0,59
77086,903589,1,11,2,4,0,63
77087,903589,1,11,3,0,0,63
77088,903589,1,11,4,0,0,63
77089,903589,1,11,5,1,0,64
77090,903589,1,11,6,1,0,65
77091,903589,1,12,1,1,0,66
77092,903589,1,12,2,0,0,66
77093,903589,1,12,3,1,0,67
77094,903589,1,12,4,0,1,67
77095,903589,1,12,5,0,0,67
77096,903589,1,12,6,1,0,68
77097,903589,1,13,1,0,0,68
77098,903589,1,13,2,1,0,69
77099,903589,1,13,3,0,1,69
77100,903589,1,13,4,0,1,69
77101,903589,1,13,5,0,0,69
77102,903589,1,13,6,4,0,73
77103,903589,1,14,1,0,0,73
77104,903589,1,14,2,1,0,74
77105,903589,1,14,3,0,0,74
77106,903589,1,14,4,0,0,74
77107,903589,1,14,5,0,0,74
77108,903589,1,14,6,1,0,75
77109,903589,1,15,1,1,0,76
77110,903589,1,15,2,1,0,77
77111,903589,1,15,3,1,0,78
77112,903589,1,15,4,1,0,79
77113,903589,1,15,5,1,0,80
77114,903589,1,15,6,1,0,81
77115,903589,1,16,1,2,0,83
77116,903589,1,16,2,1,0,84
77117,903589,1,16,3,1,0,85
77118,903589,1,16,4,0,1,85
77119,903589,1,16,5,0,0,85
77120,903589,1,16,6,0,1,85
77121,903589,1,17,1,1,0,86
77122,903589,1,17,2,1,0,87
77123,903589,1,17,3,0,0,87
77124,903589,1,17,4,2,0,89
77125,903589,1,17,5,0,0,89
77126,903589,1,17,6,2,0,91
77127,903589,1,18,1,1,0,92
77128,903589,1,18,2,0,1,92
77232,913633,1,1,1,0,0,0
77233,913633,1,1,2,0,0,0
77234,913633,1,1,3,0,0,0
77235,913633,1,1,4,1,0,1
77236,913633,1,1,5,1,0,2
77237,913633,1,1,6,1,0,3
77238,913633,1,2,1,0,0,3
77239,913633,1,2,2,1,0,4
77240,913633,1,2,3,2,0,6
77241,913633,1,2,4,4,0,10
77242,913633,1,2,5,0,0,10
77243,913633,1,2,6,1,0,11
77244,913633,1,3,1,0,0,11
77245,913633,1,3,2,2,0,13
77246,913633,1,3,3,2,0,15
77247,913633,1,3,4,0,0,15
77248,913633,1,3,5,2,0,17
77249,913633,1,3,6,0,1,17
77250,913633,1,4,1,1,0,18
77251,913633,1,4,2,0,0,18
77252,913633,1,4,3,0,0,18
77253,913633,1,4,4,2,0,20
77254,913633,1,4,5,2,0,22
77255,913633,1,4,6,1,0,23
77256,913633,1,5,1,2,0,25
77257,913633,1,5,2,1,0,26
77258,913633,1,5,3,0,0,26
77259,913633,1,5,4,1,0,27
77260,913633,1,5,5,4,0,31
77261,913633,1,5,6,0,0,31
77262,913633,1,6,1,6,0,37
77263,913633,1,6,2,2,0,39
77264,913633,1,6,3,1,0,40
77265,913633,1,6,4,5,0,45
77266,913633,1,6,5,2,0,47
77267,913633,1,6,6,4,0,51
77268,913633,1,7,1,1,0,52
77269,913633,1,7,2,1,0,53
77270,913633,1,7,3,1,0,54
77271,913633,1,7,4,4,0,58
77272,913633,1,7,5,0,1,58
77273,913633,1,7,6,1,0,59
77274,913633,1,8,1,1,0,60
77275,913633,1,8,2,0,0,60
77276,913633,1,8,3,1,0,61
77277,913633,1,8,4,2,0,63
77278,913633,1,8,5,3,0,66
77279,913633,1,8,6,1,0,67
77280,913633,1,9,1,1,0,68
77281,913633,1,9,2,1,0,69
77282,913633,1,9,3,4,0,73
77283,913633,1,9,4,1,0,74
77284,913633,1,9,5,0,1,74
77285,913633,1,9,6,1,0,75
77286,913633,1,10,1,1,0,76
77287,913633,1,10,2,1,0,77
77288,913633,1,10,3,0,0,77
77289,913633,1,10,4,1,0,78
77290,913633,1,10,5,1,0,79
77291,913633,1,10,6,0,0,79
77292,913633,1,11,1,1,0,80
77293,913633,1,11,2,1,0,81
77294,913633,1,11,3,0,1,81
77295,913633,1,11,4,1,1,82
77296,913633,1,11,5,0,0,82
77297,913633,1,11,6,1,0,83
77298,913633,1,12,1,0,0,83
77299,913633,1,12,2,0,0,83
77300,913633,1,12,3,0,0,83
77301,913633,1,12,4,0,0,83
77302,913633,1,12,5,1,0,84
77303,913633,1,12,6,0,0,84
77304,913633,1,13,1,2,0,86
77305,913633,1,13,2,1,0,87
77306,913633,1,13,3,1,0,88
77307,913633,1,13,4,1,0,89
77308,913633,1,13,5,1,0,90
77309,913633,1,13,6,1,0,91
77310,913633,1,14,1,6,0,97
77311,913633,1,14,2,4,0,101
77312,913633,1,14,3,1,0,102
77313,913633,1,14,4,0,0,102
77314,913633,1,14,5,1,0,103
77315,913633,1,14,6,2,0,105
77316,913633,1,15,1,1,0,106
77317,913633,1,15,2,0,1,106
77318,913633,1,15,3,1,0,107
77319,913633,1,15,4,1,0,108
77320,913633,1,15,5,1,0,109
77321,913633,1,15,6,0,0,109
77322,913633,1,16,1,2,0,111
77323,913633,1,16,2,6,0,117
77324,913633,1,16,3,4,0,121
77325,913633,1,16,4,1,0,122
77326,913633,1,16,5,0,1,122
77327,913633,1,16,6,0,0,122
77328,913633,1,17,1,0,0,122
77329,913633,1,17,2,4,0,126
77330,913633,1,17,3,1,0,127
77331,913633,1,17,4,0,0,127
77332,913633,1,17,5,0,0,127
77333,913633,1,17,6,1,0,128
77334,913633,1,18,1,1,0,129
77335,913633,1,18,2,0,1,129
77336,913633,1,18,3,1,0,130
77337,913633,1,18,4,2,0,132
77338,913633,1,18,5,1,0,133
77339,913633,1,18,6,0,0,133
77340,913633,1,19,1,1,0,134
77341,913633,1,19,2,1,0,135
77342,913633,1,19,3,0,0,135
77343,913633,1,19,4,2,0,137
77344,913633,1,19,5,0,0,137
77345,913633,1,19,6,1,0,138
77346,913633,1,20,1,1,0,139
77347,913633,1,20,2,1,0,140
77348,913633,1,20,3,0,0,140
77349,913633,1,20,4,0,0,140
77350,913633,1,20,5,0,1,140
77351,913633,1,20,6,0,1,140
77457,913663,1,1,1,0,0,0
77458,913663,1,1,2,0,0,0
77459,913663,1,1,3,0,0,0
77460,913663,1,1,4,1,0,1
77461,913663,1,1,5,1,0,2
77462,913663,1,1,6,0,0,2
77463,913663,1,2,1,2,0,4
77464,913663,1,2,2,2,0,6
77465,913663,1,2,3,0,0,6
77466,913663,1,2,4,0,0,6
77467,913663,1,2,5,1,0,7
77468,913663,1,2,6,1,0,8
77469,913663,1,3,1,4,0,12
77470,913663,1,3,2,1,0,13
77471,913663,1,3,3,1,0,14
77472,913663,1,3,4,0,0,14
77473,913663,1,3,5,0,0,14
77474,913663,1,3,6,4,0,18
77475,913663,1,4,1,0,0,18
77476,913663,1,4,2,6,0,24
77477,913663,1,4,3,0,0,24
77478,913663,1,4,4,1,0,25
77479,913663,1,4,5,1,0,26
77480,913663,1,4,6,0,0,26
77481,913663,1,5,1,1,0,27
77482,913663,1,5,2,4,0,31
77483,913663,1,5,3,1,0,32
77484,913663,1,5,4,2,0,34
77485,913663,1,5,5,4,0,38
77486,913663,1,5,6,1,0,39
77487,913663,1,6,1,5,0,44
77488,913663,1,6,2,4,0,48
77489,913663,1,6,3,0,0,48
77490,913663,1,6,4,1,0,49
77491,913663,1,6,5,4,0,53
77492,913663,1,6,6,0,0,53
77493,913663,1,7,1,0,0,53
77494,913663,1,7,2,1,0,54
77495,913663,1,7,3,2,0,56
77496,913663,1,7,4,0,1,56
77497,913663,1,7,5,0,0,56
77498,913663,1,7,6,1,0,57
77499,913663,1,8,1,2,0,59
77500,913663,1,8,2,1,0,60
77501,913663,1,8,3,1,0,61
77502,913663,1,8,4,1,0,62
77503,913663,1,8,5,1,0,63
77504,913663,1,8,6,0,0,63
77505,913663,1,9,1,0,0,63
77506,913663,1,9,2,1,0,64
77507,913663,1,9,3,1,0,65
77508,913663,1,9,4,1,0,66
77509,913663,1,9,5,1,0,67
77510,913663,1,9,6,0,1,67
77511,913663,1,10,1,0,1,67
77512,913663,1,10,2,4,0,71
77513,913663,1,10,3,1,0,72
77514,913663,1,10,4,1,0,73
77515,913663,1,10,5,0,0,73
77516,913663,1,10,6,4,0,77
77517,913663,1,11,1,1,0,78
77518,913663,1,11,2,1,0,79
77519,913663,1,11,3,1,0,80
77520,913663,1,11,4,1,0,81
77521,913663,1,11,5,1,0,82
77522,913663,1,11,6,2,0,84
77523,913663,1,12,1,1,0,85
77524,913663,1,12,2,0,0,85
77525,913663,1,12,3,0,0,85
77526,913663,1,12,4,1,0,86
77527,913663,1,12,5,2,0,88
77528,913663,1,12,6,1,0,89
77529,913663,1,13,1,1,0,90
77530,913663,1,13,2,0,0,90
77531,913663,1,13,3,1,0,91
77532,913663,1,13,4,1,0,92
77533,913663,1,13,5,0,0,92
77534,913663,1,13,6,1,0,93
77535,913663,1,14,1,0,1,93
77536,913663,1,14,2,1,0,94
77537,913663,1,14,3,2,0,96
77538,913663,1,14,4,1,0,97
77539,913663,1,14,5,2,0,99
77540,913663,1,14,6,1,0,100
77541,913663,1,15,1,2,0,102
77542,913663,1,15,2,0,0,102
77543,913663,1,15,3,1,0,103
77544,913663,1,15,4,1,0,104
77545,913663,1,15,5,0,1,104
77546,913663,1,15,6,1,0,105
77547,913663,1,16,1,0,0,105
77548,913663,1,16,2,1,0,106
77549,913663,1,16,3,2,0,108
77550,913663,1,16,4,1,0,109
77551,913663,1,16,5,1,1,110
77552,913663,1,16,6,0,0,110
77553,913663,1,17,1,0,0,110
77554,913663,1,17,2,1,0,111
77555,913663,1,17,3,1,0,112
77556,913663,1,17,4,2,0,114
77557,913663,1,17,5,1,0,115
77558,913663,1,17,6,1,0,116
77559,913663,1,18,1,1,0,117
77560,913663,1,18,2,1,0,118
77561,913663,1,18,3,4,0,122
77562,913663,1,18,4,1,0,123
77563,913663,1,18,5,0,0,123
77564,913663,1,18,6,1,0,124
77565,913663,1,19,1,0,0,124
77566,913663,1,19,2,1,0,125
77567,913663,1,19,3,2,0,127
77568,913663,1,19,4,1,0,128
77569,913663,1,19,5,1,0,129
77570,913663,1,19,6,1,0,130
77571,913663,1,20,1,0,0,130
77572,913663,1,20,2,2,0,132
77573,913663,1,20,3,0,1,132
77574,913663,1,20,4,2,0,134
77575,913663,1,20,5,0,0,134
77576,913663,1,20,6,1,0,135
77666,914217,1,1,1,0,0,0
77667,914217,1,1,2,4,0,4
77668,914217,1,1,3,0,0,4
77669,914217,1,1,4,4,0,8
77670,914217,1,1,5,0,0,8
77671,914217,1,1,6,6,0,14
77672,914217,1,2,1,1,0,15
77673,914217,1,2,2,4,0,19
77674,914217,1,2,3,1,0,20
77675,914217,1,2,4,0,0,20
77676,914217,1,2,5,1,0,21
77677,914217,1,2,6,6,0,27
77678,914217,1,3,1,1,0,28
77679,914217,1,3,2,6,0,34
77680,914217,1,3,3,1,0,35
77681,914217,1,3,4,4,0,39
77682,914217,1,3,5,0,0,39
77683,914217,1,3,6,1,0,40
77684,914217,1,4,1,2,0,42
77685,914217,1,4,2,6,0,48
77686,914217,1,4,3,0,0,48
77687,914217,1,4,4,1,0,49
77688,914217,1,4,5,0,0,49
77689,914217,1,4,6,0,0,49
77690,914217,1,5,1,0,0,49
77691,914217,1,5,2,0,0,49
77692,914217,1,5,3,0,0,49
77693,914217,1,5,4,1,0,50
77694,914217,1,5,5,2,0,52
77695,914217,1,5,6,1,0,53
77696,914217,1,6,1,0,0,53
77697,914217,1,6,2,0,0,53
77698,914217,1,6,3,1,0,54
77699,914217,1,6,4,0,0,54
77700,914217,1,6,5,4,0,58
77701,914217,1,6,6,4,0,62
77702,914217,1,7,1,1,0,63
77703,914217,1,7,2,1,0,64
77704,914217,1,7,3,0,0,64
77705,914217,1,7,4,1,0,65
77706,914217,1,7,5,1,0,66
77707,914217,1,7,6,1,0,67
77708,914217,1,8,1,1,0,68
77709,914217,1,8,2,1,0,69
77710,914217,1,8,3,1,0,70
77711,914217,1,8,4,1,0,71
77712,914217,1,8,5,1,0,72
77713,914217,1,8,6,4,0,76
77714,914217,1,9,1,2,0,78
77715,914217,1,9,2,1,0,79
77716,914217,1,9,3,0,0,79
77717,914217,1,9,4,4,0,83
77718,914217,1,9,5,1,0,84
77719,914217,1,9,6,1,0,85
77720,914217,1,10,1,0,0,85
77721,914217,1,10,2,0,0,85
77722,914217,1,10,3,6,0,91
77723,914217,1,10,4,4,0,95
77724,914217,1,10,5,1,0,96
77725,914217,1,10,6,1,0,97
77726,914217,1,11,1,2,0,99
77727,914217,1,11,2,1,0,100
77728,914217,1,11,3,1,0,101
77729,914217,1,11,4,0,0,101
77730,914217,1,11,5,0,1,101
77731,914217,1,11,6,0,0,101
77732,914217,1,12,1,1,0,102
77733,914217,1,12,2,0,0,102
77734,914217,1,12,3,0,0,102
77735,914217,1,12,4,1,0,103
77736,914217,1,12,5,1,0,104
77737,914217,1,12,6,1,0,105
77738,914217,1,13,1,1,0,106
77739,914217,1,13,2,1,0,107
77740,914217,1,13,3,1,0,108
77741,914217,1,13,4,1,0,109
77742,914217,1,13,5,1,0,110
77743,914217,1,13,6,1,0,111
77744,914217,1,14,1,1,0,112
77745,914217,1,14,2,1,0,113
77746,914217,1,14,3,1,0,114
77747,914217,1,14,4,1,0,115
77748,914217,1,14,5,1,0,116
77749,914217,1,14,6,1,0,117
77750,914217,1,15,1,1,0,118
77751,914217,1,15,2,1,0,119
77752,914217,1,15,3,1,0,120
77753,914217,1,15,4,1,0,121
77754,914217,1,15,5,6,0,127
77755,914217,1,15,6,4,0,131
77756,914217,1,16,1,0,1,131
77757,914217,1,16,2,1,0,132
77758,914217,1,16,3,1,0,133
77759,914217,1,16,4,0,0,133
77760,914217,1,16,5,1,0,134
77761,914217,1,16,6,1,0,135
77762,914217,1,17,1,0,1,135
77763,914217,1,17,2,2,0,137
77764,914217,1,17,3,1,0,138
77765,914217,1,17,4,4,0,142
77766,914217,1,17,5,4,0,146
77767,914217,1,17,6,1,0,147
77768,914217,1,18,1,4,0,151
77769,914217,1,18,2,1,0,152
77770,914217,1,18,3,4,0,156
77771,914217,1,18,4,0,0,156
77772,914217,1,18,5,6,0,162
77773,914217,1,18,6,1,0,163
77774,914217,1,19,1,0,0,163
77775,914217,1,19,2,0,1,163
77776,914217,1,19,3,1,0,164
77777,914217,1,19,4,1,0,165
77778,914217,1,19,5,2,0,167
77779,914217,1,19,6,1,0,168
77780,914217,1,20,1,4,0,172
77781,914217,1,20,2,1,0,173
77782,914217,1,20,3,6,0,179
77783,914217,1,20,4,1,0,180
77784,914217,1,20,5,1,0,181
77785,914217,1,20,6,1,0,182
77906,914219,1,1,1,0,0,0
77907,914219,1,1,2,1,0,1
77908,914219,1,1,3,0,0,1
77909,914219,1,1,4,0,0,1
77910,914219,1,1,5,0,0,1
77911,914219,1,1,6,1,0,2
77912,914219,1,2,1,1,0,3
77913,914219,1,2,2,4,0,7
77914,914219,1,2,3,2,0,9
77915,914219,1,2,4,1,0,10
77916,914219,1,2,5,1,0,11
77917,914219,1,2,6,0,1,11
77918,914219,1,3,1,0,0,11
77919,914219,1,3,2,1,0,12
77920,914219,1,3,3,1,0,13
77921,914219,1,3,4,1,0,14
77922,914219,1,3,5,0,0,14
77923,914219,1,3,6,0,0,14
77924,914219,1,4,1,4,0,18
77925,914219,1,4,2,0,0,18
77926,914219,1,4,3,1,0,19
77927,914219,1,4,4,0,0,19
77928,914219,1,4,5,1,0,20
77929,914219,1,4,6,4,0,24
77930,914219,1,5,1,0,0,24
77931,914219,1,5,2,1,0,25
77932,914219,1,5,3,2,0,27
77933,914219,1,5,4,1,0,28
77934,914219,1,5,5,0,0,28
77935,914219,1,5,6,0,0,28
77936,914219,1,6,1,4,0,32
77937,914219,1,6,2,1,0,33
77938,914219,1,6,3,0,1,33
77939,914219,1,6,4,0,0,33
77940,914219,1,6,5,4,0,37
77941,914219,1,6,6,0,0,37
77942,914219,1,7,1,0,0,37
77943,914219,1,7,2,0,0,37
77944,914219,1,7,3,2,0,39
77945,914219,1,7,4,0,1,39
77946,914219,1,7,5,0,0,39
77947,914219,1,7,6,0,0,39
77948,914219,1,8,1,0,0,39
77949,914219,1,8,2,1,0,40
77950,914219,1,8,3,0,0,40
77951,914219,1,8,4,0,0,40
77952,914219,1,8,5,1,0,41
77953,914219,1,8,6,1,0,42
77954,914219,1,9,1,1,0,43
77955,914219,1,9,2,6,0,49
77956,914219,1,9,3,6,0,55
77957,914219,1,9,4,2,0,57
77958,914219,1,9,5,0,0,57
77959,914219,1,9,6,0,0,57
77960,914219,1,10,1,1,0,58
77961,914219,1,10,2,4,0,62
77962,914219,1,10,3,1,0,63
77963,914219,1,10,4,0,1,63
77964,914219,1,10,5,0,0,63
77965,914219,1,10,6,1,0,64
77966,914219,1,11,1,0,0,64
77967,914219,1,11,2,1,0,65
77968,914219,1,11,3,1,1,66
77969,914219,1,11,4,1,0,67
77970,914219,1,11,5,0,0,67
77971,914219,1,11,6,0,0,67
77972,914219,1,12,1,1,0,68
77973,914219,1,12,2,1,0,69
77974,914219,1,12,3,1,0,70
77975,914219,1,12,4,0,1,70
77976,914219,1,12,5,1,0,71
77977,914219,1,12,6,0,0,71
77978,914219,1,13,1,0,0,71
77979,914219,1,13,2,1,0,72
77980,914219,1,13,3,1,0,73
77981,914219,1,13,4,0,0,73
77982,914219,1,13,5,1,0,74
77983,914219,1,13,6,1,0,75
77984,914219,1,14,1,1,0,76
77985,914219,1,14,2,1,0,77
77986,914219,1,14,3,1,0,78
77987,914219,1,14,4,1,0,79
77988,914219,1,14,5,1,0,80
77989,914219,1,14,6,0,0,80
77990,914219,1,15,1,6,0,86
77991,914219,1,15,2,1,0,87
77992,914219,1,15,3,1,0,88
77993,914219,1,15,4,4,0,92
77994,914219,1,15,5,4,0,96
77995,914219,1,15,6,1,0,97
77996,914219,1,16,1,1,0,98
77997,914219,1,16,2,0,1,98
77998,914219,1,16,3,4,0,102
77999,914219,1,16,4,1,0,103
78000,914219,1,16,5,0,0,103
78001,914219,1,16,6,0,1,103
78002,914219,1,17,1,2,0,105
78003,914219,1,17,2,1,0,106
78004,914219,1,17,3,0,0,106
78005,914219,1,17,4,1,0,107
78006,914219,1,17,5,0,0,107
78007,914219,1,17,6,1,0,108
78008,914219,1,18,1,0,0,108
78009,914219,1,18,2,1,0,109
78010,914219,1,18,3,4,0,113
78011,914219,1,18,4,1,0,114
78012,914219,1,18,5,2,0,116
78013,914219,1,18,6,1,0,117
78014,914219,1,19,1,1,0,118
78015,914219,1,19,2,2,0,120
78016,914219,1,19,3,1,0,121
78017,914219,1,19,4,6,0,127
78018,914219,1,19,5,1,0,128
78019,914219,1,19,6,0,0,128
78020,914219,1,20,1,4,0,132
78021,914219,1,20,2,4,0,136
78022,914219,1,20,3,1,0,137
78023,914219,1,20,4,1,0,138
78024,914219,1,20,5,4,0,142
78025,914219,1,20,6,0,0,142
78086,914221,1,1,1,0,0,0
78087,914221,1,1,2,0,0,0
78088,914221,1,1,3,0,0,0
78089,914221,1,1,4,0,0,0
78090,914221,1,1,5,0,0,0
78091,914221,1,1,6,0,0,0
78092,914221,1,2,1,1,0,1
78093,914221,1,2,2,0,0,1
78094,914221,1,2,3,1,0,2
78095,914221,1,2,4,0,0,2
78096,914221,1,2,5,0,0,2
78097,914221,1,2,6,4,0,6
78098,914221,1,3,1,1,0,7
78099,914221,1,3,2,0,0,7
78100,914221,1,3,3,0,0,7
78101,914221,1,3,4,0,0,7
78102,914221,1,3,5,4,0,11
78103,914221,1,3,6,0,0,11
78104,914221,1,4,1,1,0,12
78105,914221,1,4,2,1,0,13
78106,914221,1,4,3,4,0,17
78107,914221,1,4,4,4,0,21
78108,914221,1,4,5,2,0,23
78109,914221,1,4,6,0,0,23
78110,914221,1,5,1,0,0,23
78111,914221,1,5,2,4,0,27
78112,914221,1,5,3,6,0,33
78113,914221,1,5,4,0,1,33
78114,914221,1,5,5,1,0,34
78115,914221,1,5,6,0,0,34
78116,914221,1,6,1,4,0,38
78117,914221,1,6,2,4,0,42
78118,914221,1,6,3,0,0,42
78119,914221,1,6,4,6,0,48
78120,914221,1,6,5,0,0,48
78121,914221,1,6,6,4,0,52
78122,914221,1,7,1,0,1,52
78123,914221,1,7,2,0,0,52
78124,914221,1,7,3,0,0,52
78125,914221,1,7,4,1,0,53
78126,914221,1,7,5,0,0,53
78127,914221,1,7,6,1,0,54
78128,914221,1,8,1,1,0,55
78129,914221,1,8,2,1,0,56
78130,914221,1,8,3,0,0,56
78131,914221,1,8,4,1,0,57
78132,914221,1,8,5,1,0,58
78133,914221,1,8,6,0,0,58
78134,914221,1,9,1,0,0,58
78135,914221,1,9,2,0,0,58
78136,914221,1,9,3,1,0,59
78137,914221,1,9,4,1,0,60
78138,914221,1,9,5,2,0,62
78139,914221,1,9,6,1,0,63
78140,914221,1,10,1,0,0,63
78141,914221,1,10,2,6,0,69
78142,914221,1,10,3,4,0,73
78143,914221,1,10,4,2,0,75
78144,914221,1,10,5,1,0,76
78145,914221,1,10,6,1,0,77
78146,914221,1,11,1,1,0,78
78147,914221,1,11,2,0,0,78
78148,914221,1,11,3,0,0,78
78149,914221,1,11,4,0,1,78
78150,914221,1,11,5,1,0,79
78151,914221,1,11,6,1,0,80
78152,914221,1,12,1,1,0,81
78153,914221,1,12,2,6,0,87
78154,914221,1,12,3,0,0,87
78155,914221,1,12,4,1,0,88
78156,914221,1,12,5,1,0,89
78157,914221,1,12,6,1,0,90
78158,914221,1,13,1,1,0,91
78159,914221,1,13,2,1,0,92
78160,914221,1,13,3,0,0,92
78161,914221,1,13,4,0,0,92
78162,914221,1,13,5,1,0,93
78163,914221,1,13,6,1,0,94
78164,914221,1,14,1,1,0,95
78165,914221,1,14,2,0,0,95
78166,914221,1,14,3,0,0,95
78167,914221,1,14,4,4,0,99
78168,914221,1,14,5,1,0,100
78169,914221,1,14,6,4,0,104
78170,914221,1,15,1,0,0,104
78171,914221,1,15,2,1,0,105
78172,914221,1,15,3,1,0,106
78173,914221,1,15,4,4,0,110
78174,914221,1,15,5,0,1,110
78175,914221,1,15,6,1,0,111
78176,914221,1,16,1,7,0,118
78177,914221,1,16,2,4,0,122
78178,914221,1,16,3,4,0,126
78179,914221,1,16,4,6,0,132
78180,914221,1,16,5,1,0,133
78181,914221,1,16,6,1,0,134
78182,914221,1,17,1,2,0,136
78183,914221,1,17,2,6,0,142
78184,914221,1,17,3,2,0,144
78185,914221,1,17,4,2,0,146
78186,914221,1,17,5,0,1,146
78187,914221,1,17,6,1,0,147
78188,914221,1,18,1,0,1,147
78189,914221,1,18,2,1,0,148
78190,914221,1,18,3,1,0,149
78191,914221,1,18,4,4,0,153
78192,914221,1,18,5,2,0,155
78193,914221,1,18,6,6,0,161
78194,914221,1,19,1,1,0,162
78195,914221,1,19,2,0,0,162
78196,914221,1,19,3,2,0,164
78197,914221,1,19,4,2,0,166
78198,914221,1,19,5,1,0,167
78199,914221,1,19,6,0,1,167
78200,914221,1,20,1,1,0,168
78201,914221,1,20,2,0,1,168
78202,914221,1,20,3,0,0,168
78203,914221,1,20,4,1,0,169
78204,914221,1,20,5,1,0,170
78205,914221,1,20,6,1,0,171
78326,914223,1,1,1,0,0,0
78327,914223,1,1,2,6,0,6
78328,914223,1,1,3,0,0,6
78329,914223,1,1,4,0,0,6
78330,914223,1,1,5,1,0,7
78331,914223,1,1,6,4,0,11
78332,914223,1,2,1,0,0,11
78333,914223,1,2,2,1,0,12
78334,914223,1,2,3,0,0,12
78335,914223,1,2,4,0,0,12
78336,914223,1,2,5,2,0,14
78337,914223,1,2,6,0,0,14
78338,914223,1,3,1,1,0,15
78339,914223,1,3,2,1,0,16
78340,914223,1,3,3,0,0,16
78341,914223,1,3,4,4,0,20
78342,914223,1,3,5,1,0,21
78343,914223,1,3,6,1,0,22
78344,914223,1,4,1,4,0,26
78345,914223,1,4,2,0,0,26
78346,914223,1,4,3,0,0,26
78347,914223,1,4,4,1,0,27
78348,914223,1,4,5,2,0,29
78349,914223,1,4,6,0,1,29
78350,914223,1,5,1,0,0,29
78351,914223,1,5,2,0,0,29
78352,914223,1,5,3,0,0,29
78353,914223,1,5,4,0,0,29
78354,914223,1,5,5,1,0,30
78355,914223,1,5,6,0,0,30
78356,914223,1,6,1,1,0,31
78357,914223,1,6,2,0,0,31
78358,914223,1,6,3,0,0,31
78359,914223,1,6,4,0,0,31
78360,914223,1,6,5,3,0,34
78361,914223,1,6,6,0,0,34
78362,914223,1,7,1,0,1,34
78363,914223,1,7,2,1,0,35
78364,914223,1,7,3,0,0,35
78365,914223,1,7,4,0,0,35
78366,914223,1,7,5,1,0,36
78367,914223,1,7,6,0,0,36
78368,914223,1,8,1,1,0,37
78369,914223,1,8,2,1,0,38
78370,914223,1,8,3,6,0,44
78371,914223,1,8,4,0,0,44
78372,914223,1,8,5,4,0,48
78373,914223,1,8,6,1,0,49
78374,914223,1,9,1,0,0,49
78375,914223,1,9,2,1,0,50
78376,914223,1,9,3,1,0,51
78377,914223,1,9,4,0,0,51
78378,914223,1,9,5,1,0,52
78379,914223,1,9,6,1,0,53
78380,914223,1,10,1,2,0,55
78381,914223,1,10,2,1,0,56
78382,914223,1,10,3,1,0,57
78383,914223,1,10,4,1,0,58
78384,914223,1,10,5,1,0,59
78385,914223,1,10,6,1,0,60
78386,914223,1,11,1,0,0,60
78387,914223,1,11,2,4,0,64
78388,914223,1,11,3,0,0,64
78389,914223,1,11,4,1,0,65
78390,914223,1,11,5,1,0,66
78391,914223,1,11,6,1,0,67
78392,914223,1,12,1,0,1,67
78393,914223,1,12,2,4,0,71
78394,914223,1,12,3,1,0,72
78395,914223,1,12,4,1,0,73
78396,914223,1,12,5,1,0,74
78397,914223,1,12,6,1,0,75
78398,914223,1,13,1,1,0,76
78399,914223,1,13,2,1,0,77
78400,914223,1,13,3,6,0,83
78401,914223,1,13,4,6,0,89
78402,914223,1,13,5,2,0,91
78403,914223,1,13,6,0,0,91
78404,914223,1,14,1,1,0,92
78405,914223,1,14,2,4,0,96
78406,914223,1,14,3,0,0,96
78407,914223,1,14,4,4,0,100
78408,914223,1,14,5,1,0,101
78409,914223,1,14,6,1,0,102
78410,914223,1,15,1,4,0,106
78411,914223,1,15,2,2,0,108
78412,914223,1,15,3,1,0,109
78413,914223,1,15,4,1,0,110
78414,914223,1,15,5,4,0,114
78415,914223,1,15,6,2,0,116
78416,914223,1,16,1,1,0,117
78417,914223,1,16,2,1,0,118
78418,914223,1,16,3,1,0,119
78419,914223,1,16,4,2,0,121
78420,914223,1,16,5,6,0,127
78421,914223,1,16,6,0,0,127
78422,914223,1,17,1,1,0,128
78423,914223,1,17,2,0,0,128
78424,914223,1,17,3,1,0,129
78425,914223,1,17,4,1,0,130
78426,914223,1,17,5,0,1,130
78427,914223,1,17,6,1,0,131
78428,914223,1,18,1,6,0,137
78429,914223,1,18,2,0,1,137
78430,914223,1,18,3,1,0,138
78431,914223,1,18,4,2,0,140
78432,914223,1,18,5,0,0,140
78433,914223,1,18,6,6,0,146
78434,914223,1,19,1,4,0,150
78435,914223,1,19,2,6,0,156
78436,914223,1,19,3,4,0,160
78437,914223,1,19,4,1,0,161
78438,914223,1,19,5,0,1,161
78439,914223,1,19,6,0,0,161
78440,914223,1,20,1,1,0,162
78441,914223,1,20,2,0,0,162
78442,914223,1,20,3,1,0,163
78443,914223,1,20,4,0,1,163
78444,914223,1,20,5,4,0,167
78445,914223,1,20,6,1,0,168
78552,914225,1,1,1,4,0,4
78553,914225,1,1,2,0,0,4
78554,914225,1,1,3,1,0,5
78555,914225,1,1,4,1,0,6
78556,914225,1,1,5,4,0,10
78557,914225,1,1,6,6,0,16
78558,914225,1,2,1,0,0,16
78559,914225,1,2,2,1,0,17
78560,914225,1,2,3,1,0,18
78561,914225,1,2,4,1,0,19
78562,914225,1,2,5,0,0,19
78563,914225,1,2,6,4,0,23
78564,914225,1,3,1,1,0,24
78565,914225,1,3,2,1,0,25
78566,914225,1,3,3,1,0,26
78567,914225,1,3,4,6,0,32
78568,914225,1,3,5,4,0,36
78569,914225,1,3,6,4,0,40
78570,914225,1,4,1,0,0,40
78571,914225,1,4,2,1,0,41
78572,914225,1,4,3,1,0,42
78573,914225,1,4,4,0,0,42
78574,914225,1,4,5,0,0,42
78575,914225,1,4,6,4,0,46
78576,914225,1,5,1,4,0,50
78577,914225,1,5,2,1,0,51
78578,914225,1,5,3,0,0,51
78579,914225,1,5,4,1,0,52
78580,914225,1,5,5,0,0,52
78581,914225,1,5,6,0,0,52
78582,914225,1,6,1,2,0,54
78583,914225,1,6,2,0,0,54
78584,914225,1,6,3,1,0,55
78585,914225,1,6,4,1,0,56
78586,914225,1,6,5,1,0,57
78587,914225,1,6,6,0,1,57
78588,914225,1,7,1,2,0,59
78589,914225,1,7,2,1,0,60
78590,914225,1,7,3,1,0,61
78591,914225,1,7,4,1,0,62
78592,914225,1,7,5,0,1,62
78593,914225,1,7,6,1,0,63
78594,914225,1,8,1,0,0,63
78595,914225,1,8,2,0,0,63
78596,914225,1,8,3,0,0,63
78597,914225,1,8,4,1,0,64
78598,914225,1,8,5,1,0,65
78599,914225,1,8,6,0,0,65
78600,914225,1,9,1,0,0,65
78601,914225,1,9,2,1,0,66
78602,914225,1,9,3,4,0,70
78603,914225,1,9,4,0,0,70
78604,914225,1,9,5,4,0,74
78605,914225,1,9,6,0,0,74
78606,914225,1,10,1,3,0,77
78607,914225,1,10,2,1,0,78
78608,914225,1,10,3,1,0,79
78609,914225,1,10,4,0,0,79
78610,914225,1,10,5,6,0,85
78611,914225,1,10,6,0,0,85
78612,914225,1,11,1,4,0,89
78613,914225,1,11,2,0,0,89
78614,914225,1,11,3,0,0,89
78615,914225,1,11,4,4,0,93
78616,914225,1,11,5,1,0,94
78617,914225,1,11,6,0,1,94
78618,914225,1,12,1,1,0,95
78619,914225,1,12,2,1,0,96
78620,914225,1,12,3,0,0,96
78621,914225,1,12,4,1,0,97
78622,914225,1,12,5,6,0,103
78623,914225,1,12,6,7,1,110
78624,914225,1,13,1,0,0,110
78625,914225,1,13,2,1,0,111
78626,914225,1,13,3,1,0,112
78627,914225,1,13,4,1,0,113
78628,914225,1,13,5,1,0,114
78629,914225,1,13,6,1,0,115
78630,914225,1,14,1,6,0,121
78631,914225,1,14,2,1,0,122
78632,914225,1,14,3,1,0,123
78633,914225,1,14,4,0,0,123
78634,914225,1,14,5,1,0,124
78635,914225,1,14,6,0,0,124
78636,914225,1,15,1,1,0,125
78637,914225,1,15,2,1,0,126
78638,914225,1,15,3,1,0,127
78639,914225,1,15,4,1,0,128
78640,914225,1,15,5,1,0,129
78641,914225,1,15,6,0,0,129
78642,914225,1,16,1,2,0,131
78643,914225,1,16,2,2,0,133
78644,914225,1,16,3,6,0,139
78645,914225,1,16,4,4,0,143
78646,914225,1,16,5,1,0,144
78647,914225,1,16,6,0,0,144
78648,914225,1,17,1,0,0,144
78649,914225,1,17,2,4,0,148
78650,914225,1,17,3,3,0,151
78651,914225,1,17,4,1,0,152
78652,914225,1,17,5,1,0,153
78653,914225,1,17,6,6,0,159
78654,914225,1,18,1,4,0,163
78655,914225,1,18,2,2,0,165
78656,914225,1,18,3,6,0,171
78657,914225,1,18,4,1,0,172
78658,914225,1,18,5,2,1,174
78659,914225,1,18,6,1,0,175
78660,914225,1,19,1,0,1,175
78661,914225,1,19,2,1,0,176
78662,914225,1,19,3,2,0,178
78663,914225,1,19,4,2,0,180
78664,914225,1,19,5,4,0,184
78665,914225,1,19,6,4,0,188
78666,914225,1,20,1,1,0,189
78667,914225,1,20,2,1,0,190
78668,914225,1,20,3,1,0,191
78669,914225,1,20,4,2,0,193
78670,914225,1,20,5,2,0,195
78671,914225,1,20,6,1,0,196
78769,915783,1,1,1,4,0,4
78770,915783,1,1,2,1,0,5
78771,915783,1,1,3,1,0,6
78772,915783,1,1,4,0,0,6
78773,915783,1,1,5,4,0,10
78774,915783,1,1,6,0,0,10
78775,915783,1,2,1,4,0,14
78776,915783,1,2,2,4,0,18
78777,915783,1,2,3,0,0,18
78778,915783,1,2,4,1,0,19
78779,915783,1,2,5,0,0,19
78780,915783,1,2,6,0,0,19
78781,915783,1,3,1,4,0,23
78782,915783,1,3,2,1,0,24
78783,915783,1,3,3,4,0,28
78784,915783,1,3,4,0,0,28
78785,915783,1,3,5,0,0,28
78786,915783,1,3,6,4,0,32
78787,915783,1,4,1,4,0,36
78788,915783,1,4,2,1,0,37
78789,915783,1,4,3,0,0,37
78790,915783,1,4,4,4,0,41
78791,915783,1,4,5,1,0,42
78792,915783,1,4,6,4,0,46
78793,915783,1,5,1,0,0,46
78794,915783,1,5,2,1,0,47
78795,915783,1,5,3,0,0,47
78796,915783,1,5,4,1,0,48
78797,915783,1,5,5,0,0,48
78798,915783,1,5,6,0,0,48
78799,915783,1,6,1,4,0,52
78800,915783,1,6,2,0,0,52
78801,915783,1,6,3,5,0,57
78802,915783,1,6,4,5,0,62
78803,915783,1,6,5,1,0,63
78804,915783,1,6,6,2,0,65
78805,915783,1,7,1,0,0,65
78806,915783,1,7,2,1,0,66
78807,915783,1,7,3,0,0,66
78808,915783,1,7,4,1,0,67
78809,915783,1,7,5,1,0,68
78810,915783,1,7,6,0,0,68
78811,915783,1,8,1,1,0,69
78812,915783,1,8,2,1,0,70
78813,915783,1,8,3,1,0,71
78814,915783,1,8,4,1,0,72
78815,915783,1,8,5,1,0,73
78816,915783,1,8,6,6,0,79
78817,915783,1,9,1,1,0,80
78818,915783,1,9,2,0,0,80
78819,915783,1,9,3,1,0,81
78820,915783,1,9,4,2,0,83
78821,915783,1,9,5,1,0,84
78822,915783,1,9,6,4,0,88
78823,915783,1,10,1,1,0,89
78824,915783,1,10,2,1,0,90
78825,915783,1,10,3,1,0,91
78826,915783,1,10,4,0,1,91
78827,915783,1,10,5,0,0,91
78828,915783,1,10,6,1,0,92
78829,915783,1,11,1,2,0,94
78830,915783,1,11,2,1,0,95
78831,915783,1,11,3,1,0,96
78832,915783,1,11,4,1,0,97
78833,915783,1,11,5,1,0,98
78834,915783,1,11,6,1,0,99
78835,915783,1,12,1,0,0,99
78836,915783,1,12,2,1,0,100
78837,915783,1,12,3,0,0,100
78838,915783,1,12,4,1,0,101
78839,915783,1,12,5,0,1,101
78840,915783,1,12,6,4,0,105
78841,915783,1,13,1,1,0,106
78842,915783,1,13,2,2,0,108
78843,915783,1,13,3,1,0,109
78844,915783,1,13,4,1,0,110
78845,915783,1,13,5,4,0,114
78846,915783,1,13,6,4,0,118
78847,915783,1,14,1,4,0,122
78848,915783,1,14,2,2,0,124
78849,915783,1,14,3,0,0,124
78850,915783,1,14,4,1,0,125
78851,915783,1,14,5,1,0,126
78852,915783,1,14,6,1,0,127
78853,915783,1,15,1,0,0,127
78854,915783,1,15,2,2,0,129
78855,915783,1,15,3,1,0,130
78856,915783,1,15,4,0,0,130
78857,915783,1,15,5,1,0,131
78858,915783,1,15,6,0,0,131
78859,915783,1,16,1,4,0,135
78860,915783,1,16,2,1,0,136
78861,915783,1,16,3,1,0,137
78862,915783,1,16,4,6,0,143
78863,915783,1,16,5,5,0,148
78864,915783,1,16,6,6,0,154
78865,915783,1,17,1,1,0,155
78866,915783,1,17,2,0,1,155
78867,915783,1,17,3,4,0,159
78868,915783,1,17,4,0,0,159
78869,915783,1,17,5,6,0,165
78870,915783,1,17,6,1,0,166
78871,915783,1,18,1,6,0,172
78872,915783,1,18,2,2,0,174
78873,915783,1,18,3,1,0,175
78874,915783,1,18,4,6,0,181
78875,915783,1,18,5,6,0,187
78876,915783,1,18,6,1,0,188
78877,915783,1,19,1,2,0,190
78878,915783,1,19,2,1,0,191
78879,915783,1,19,3,1,0,192
78880,915783,1,19,4,0,0,192
78881,915783,1,19,5,6,0,198
78882,915783,1,19,6,1,0,199
78883,915783,1,20,1,1,0,200
78884,915783,1,20,2,1,0,201
78885,915783,1,20,3,6,0,207
78886,915783,1,20,4,0,0,207
78887,915783,1,20,5,4,0,211
78888,915783,1,20,6,4,0,215
79008,915785,1,1,1,0,0,0
79009,915785,1,1,2,0,0,0
79010,915785,1,1,3,0,0,0
79011,915785,1,1,4,0,0,0
79012,915785,1,1,5,0,0,0
79013,915785,1,1,6,1,0,1
79014,915785,1,2,1,2,0,3
79015,915785,1,2,2,0,0,3
79016,915785,1,2,3,0,0,3
79017,915785,1,2,4,2,0,5
79018,915785,1,2,5,0,0,5
79019,915785,1,2,6,4,0,9
79020,915785,1,3,1,0,0,9
79021,915785,1,3,2,1,0,10
79022,915785,1,3,3,3,0,13
79023,915785,1,3,4,1,0,14
79024,915785,1,3,5,0,0,14
79025,915785,1,3,6,1,0,15
79026,915785,1,4,1,0,0,15
79027,915785,1,4,2,0,0,15
79028,915785,1,4,3,0,0,15
79029,915785,1,4,4,1,0,16
79030,915785,1,4,5,0,0,16
79031,915785,1,4,6,1,0,17
79032,915785,1,5,1,0,0,17
79033,915785,1,5,2,0,0,17
79034,915785,1,5,3,6,0,23
79035,915785,1,5,4,6,0,29
79036,915785,1,5,5,6,0,35
79037,915785,1,5,6,4,0,39
79038,915785,1,6,1,4,0,43
79039,915785,1,6,2,4,0,47
79040,915785,1,6,3,2,0,49
79041,915785,1,6,4,1,0,50
79042,915785,1,6,5,4,0,54
79043,915785,1,6,6,7,0,61
79044,915785,1,7,1,1,0,62
79045,915785,1,7,2,0,1,62
79046,915785,1,7,3,1,0,63
79047,915785,1,7,4,2,1,65
79048,915785,1,7,5,0,0,65
79049,915785,1,7,6,1,0,66
79050,915785,1,8,1,1,0,67
79051,915785,1,8,2,1,0,68
79052,915785,1,8,3,2,0,70
79053,915785,1,8,4,0,0,70
79054,915785,1,8,5,1,0,71
79055,915785,1,8,6,1,0,72
79056,915785,1,9,1,0,0,72
79057,915785,1,9,2,1,0,73
79058,915785,1,9,3,1,0,74
79059,915785,1,9,4,1,0,75
79060,915785,1,9,5,0,0,75
79061,915785,1,9,6,0,1,75
79062,915785,1,10,1,2,0,77
79063,915785,1,10,2,1,0,78
79064,915785,1,10,3,0,0,78
79065,915785,1,10,4,1,0,79
79066,915785,1,10,5,1,0,80
79067,915785,1,10,6,1,0,81
79068,915785,1,11,1,0,0,81
79069,915785,1,11,2,0,0,81
79070,915785,1,11,3,0,0,81
79071,915785,1,11,4,1,0,82
79072,915785,1,11,5,2,0,84
79073,915785,1,11,6,6,0,90
79074,915785,1,12,1,0,0,90
79075,915785,1,12,2,6,0,96
79076,915785,1,12,3,1,0,97
79077,915785,1,12,4,0,1,97
79078,915785,1,12,5,0,0,97
79079,915785,1,12,6,0,0,97
79080,915785,1,13,1,1,0,98
79081,915785,1,13,2,1,0,99
79082,915785,1,13,3,2,0,101
79083,915785,1,13,4,1,0,102
79084,915785,1,13,5,0,0,102
79085,915785,1,13,6,1,0,103
79086,915785,1,14,1,1,0,104
79087,915785,1,14,2,1,0,105
79088,915785,1,14,3,0,0,105
79089,915785,1,14,4,1,0,106
79090,915785,1,14,5,6,0,112
79091,915785,1,14,6,6,0,118
79092,915785,1,15,1,2,0,120
79093,915785,1,15,2,1,0,121
79094,915785,1,15,3,4,0,125
79095,915785,1,15,4,1,0,126
79096,915785,1,15,5,1,0,127
79097,915785,1,15,6,1,0,128
79098,915785,1,16,1,1,0,129
79099,915785,1,16,2,1,0,130
79100,915785,1,16,3,2,0,132
79101,915785,1,16,4,1,0,133
79102,915785,1,16,5,1,0,134
79103,915785,1,16,6,0,0,134
79104,915785,1,17,1,2,0,136
79105,915785,1,17,2,1,0,137
79106,915785,1,17,3,1,0,138
79107,915785,1,17,4,0,0,138
79108,915785,1,17,5,0,1,138
79109,915785,1,17,6,1,0,139
79110,915785,1,18,1,1,0,140
79111,915785,1,18,2,1,0,141
79112,915785,1,18,3,0,0,141
79113,915785,1,18,4,1,0,142
79114,915785,1,18,5,2,0,144
79115,915785,1,18,6,2,0,146
79116,915785,1,19,1,1,0,147
79117,915785,1,19,2,0,1,147
79118,915785,1,19,3,1,0,148
79119,915785,1,19,4,1,0,149
79120,915785,1,19,5,1,0,150
79121,915785,1,19,6,1,0,151
79122,915785,1,20,1,1,0,152
79123,915785,1,20,2,2,0,154
79124,915785,1,20,3,4,0,158
79125,915785,1,20,4,0,0,158
79126,915785,1,20,5,2,0,160
79127,915785,1,20,6,2,0,162
79248,919603,1,1,1,0,0,0
79249,919603,1,1,2,4,0,4
79250,919603,1,1,3,0,0,4
79251,919603,1,1,4,0,0,4
79252,919603,1,1,5,0,0,4
79253,919603,1,1,6,2,0,6
79254,919603,1,2,1,1,0,7
79255,919603,1,2,2,1,0,8
79256,919603,1,2,3,2,0,10
79257,919603,1,2,4,1,0,11
79258,919603,1,2,5,4,0,15
79259,919603,1,2,6,1,0,16
79260,919603,1,3,1,0,0,16
79261,919603,1,3,2,0,0,16
79262,919603,1,3,3,4,0,20
79263,919603,1,3,4,0,0,20
79264,919603,1,3,5,0,0,20
79265,919603,1,3,6,1,0,21
79266,919603,1,4,1,0,0,21
79267,919603,1,4,2,0,0,21
79268,919603,1,4,3,0,0,21
79269,919603,1,4,4,0,1,21
79270,919603,1,4,5,3,0,24
79271,919603,1,4,6,1,1,25
79272,919603,1,5,1,2,0,27
79273,919603,1,5,2,1,0,28
79274,919603,1,5,3,0,0,28
79275,919603,1,5,4,0,0,28
79276,919603,1,5,5,0,0,28
79277,919603,1,5,6,1,0,29
79278,919603,1,6,1,0,0,29
79279,919603,1,6,2,0,0,29
79280,919603,1,6,3,0,1,29
79281,919603,1,6,4,4,0,33
79282,919603,1,6,5,0,0,33
79283,919603,1,6,6,0,0,33
79284,919603,1,7,1,1,0,34
79285,919603,1,7,2,3,0,37
79286,919603,1,7,3,0,0,37
79287,919603,1,7,4,4,0,41
79288,919603,1,7,5,1,0,42
79289,919603,1,7,6,0,0,42
79290,919603,1,8,1,2,0,44
79291,919603,1,8,2,0,0,44
79292,919603,1,8,3,1,0,45
79293,919603,1,8,4,0,0,45
79294,919603,1,8,5,1,0,46
79295,919603,1,8,6,1,0,47
79296,919603,1,9,1,1,0,48
79297,919603,1,9,2,1,0,49
79298,919603,1,9,3,1,0,50
79299,919603,1,9,4,1,0,51
79300,919603,1,9,5,4,0,55
79301,919603,1,9,6,1,0,56
79302,919603,1,10,1,6,0,62
79303,919603,1,10,2,1,0,63
79304,919603,1,10,3,2,0,65
79305,919603,1,10,4,0,0,65
79306,919603,1,10,5,1,0,66
79307,919603,1,10,6,1,0,67
79308,919603,1,11,1,1,0,68
79309,919603,1,11,2,0,0,68
79310,919603,1,11,3,1,0,69
79311,919603,1,11,4,1,0,70
79312,919603,1,11,5,1,0,71
79313,919603,1,11,6,0,0,71
79314,919603,1,12,1,0,0,71
79315,919603,1,12,2,0,1,71
79316,919603,1,12,3,0,0,71
79317,919603,1,12,4,2,0,73
79318,919603,1,12,5,0,0,73
79319,919603,1,12,6,0,0,73
79320,919603,1,13,1,1,0,74
79321,919603,1,13,2,0,0,74
79322,919603,1,13,3,0,0,74
79323,919603,1,13,4,1,0,75
79324,919603,1,13,5,1,0,76
79325,919603,1,13,6,4,0,80
79326,919603,1,14,1,1,0,81
79327,919603,1,14,2,1,0,82
79328,919603,1,14,3,1,0,83
79329,919603,1,14,4,0,0,83
79330,919603,1,14,5,0,0,83
79331,919603,1,14,6,0,0,83
79332,919603,1,15,1,4,0,87
79333,919603,1,15,2,0,1,87
79334,919603,1,15,3,1,0,88
79335,919603,1,15,4,2,0,90
79336,919603,1,15,5,1,0,91
79337,919603,1,15,6,0,0,91
79338,919603,1,16,1,0,0,91
79339,919603,1,16,2,2,0,93
79340,919603,1,16,3,2,0,95
79341,919603,1,16,4,0,0,95
79342,919603,1,16,5,2,0,97
79343,919603,1,16,6,2,0,99
79344,919603,1,17,1,2,0,101
79345,919603,1,17,2,0,0,101
79346,919603,1,17,3,6,0,107
79347,919603,1,17,4,2,0,109
79348,919603,1,17,5,1,0,110
79349,919603,1,17,6,1,0,111
79350,919603,1,18,1,3,0,114
79351,919603,1,18,2,1,0,115
79352,919603,1,18,3,1,0,116
79353,919603,1,18,4,1,0,117
79354,919603,1,18,5,6,0,123
79355,919603,1,18,6,4,0,127
79356,919603,1,19,1,1,0,128
79357,919603,1,19,2,2,0,130
79358,919603,1,19,3,1,0,131
79359,919603,1,19,4,1,0,132
79360,919603,1,19,5,1,0,133
79361,919603,1,19,6,0,1,133
79362,919603,1,20,1,0,0,133
79363,919603,1,20,2,1,0,134
79364,919603,1,20,3,0,0,134
79365,919603,1,20,4,2,0,136
79366,919603,1,20,5,0,1,136
79367,919603,1,20,6,0,1,136
79488,919605,1,1,1,1,0,1
79489,919605,1,1,2,0,0,1
79490,919605,1,1,3,0,0,1
79491,919605,1,1,4,1,0,2
79492,919605,1,1,5,0,0,2
79493,919605,1,1,6,4,0,6
79494,919605,1,2,1,0,0,6
79495,919605,1,2,2,1,0,7
79496,919605,1,2,3,0,0,7
79497,919605,1,2,4,0,0,7
79498,919605,1,2,5,4,0,11
79499,919605,1,2,6,0,0,11
79500,919605,1,3,1,1,0,12
79501,919605,1,3,2,0,0,12
79502,919605,1,3,3,4,0,16
79503,919605,1,3,4,0,0,16
79504,919605,1,3,5,2,0,18
79505,919605,1,3,6,1,0,19
79506,919605,1,4,1,0,0,19
79507,919605,1,4,2,1,0,20
79508,919605,1,4,3,0,0,20
79509,919605,1,4,4,4,0,24
79510,919605,1,4,5,0,1,24
79511,919605,1,4,6,0,0,24
79512,919605,1,5,1,1,0,25
79513,919605,1,5,2,0,0,25
79514,919605,1,5,3,0,0,25
79515,919605,1,5,4,0,0,25
79516,919605,1,5,5,0,0,25
79517,919605,1,5,6,1,0,26
79518,919605,1,6,1,0,0,26
79519,919605,1,6,2,4,0,30
79520,919605,1,6,3,0,0,30
79521,919605,1,6,4,3,0,33
79522,919605,1,6,5,0,0,33
79523,919605,1,6,6,0,0,33
79524,919605,1,7,1,1,0,34
79525,919605,1,7,2,0,1,34
79526,919605,1,7,3,0,0,34
79527,919605,1,7,4,1,0,35
79528,919605,1,7,5,4,0,39
79529,919605,1,7,6,1,0,40
79530,919605,1,8,1,0,0,40
79531,919605,1,8,2,4,0,44
79532,919605,1,8,3,0,0,44
79533,919605,1,8,4,0,0,44
79534,919605,1,8,5,1,0,45
79535,919605,1,8,6,1,0,46
79536,919605,1,9,1,1,0,47
79537,919605,1,9,2,0,0,47
79538,919605,1,9,3,0,0,47
79539,919605,1,9,4,3,0,50
79540,919605,1,9,5,4,0,54
79541,919605,1,9,6,0,0,54
79542,919605,1,10,1,1,0,55
79543,919605,1,10,2,0,0,55
79544,919605,1,10,3,2,0,57
79545,919605,1,10,4,0,0,57
79546,919605,1,10,5,4,0,61
79547,919605,1,10,6,2,0,63
79548,919605,1,11,1,1,0,64
79549,919605,1,11,2,0,0,64
79550,919605,1,11,3,0,1,64
79551,919605,1,11,4,4,0,68
79552,919605,1,11,5,1,0,69
79553,919605,1,11,6,2,0,71
79554,919605,1,12,1,1,0,72
79555,919605,1,12,2,0,1,72
79556,919605,1,12,3,4,0,76
79557,919605,1,12,4,4,0,80
79558,919605,1,12,5,0,0,80
79559,919605,1,12,6,2,0,82
79560,919605,1,13,1,1,0,83
79561,919605,1,13,2,1,0,84
79562,919605,1,13,3,1,0,85
79563,919605,1,13,4,1,0,86
79564,919605,1,13,5,0,0,86
79565,919605,1,13,6,0,0,86
79566,919605,1,14,1,1,0,87
79567,919605,1,14,2,1,0,88
79568,919605,1,14,3,2,0,90
79569,919605,1,14,4,1,0,91
79570,919605,1,14,5,1,0,92
79571,919605,1,14,6,1,0,93
79572,919605,1,15,1,0,0,93
79573,919605,1,15,2,0,0,93
79574,919605,1,15,3,2,0,95
79575,919605,1,15,4,2,0,97
79576,919605,1,15,5,0,0,97
79577,919605,1,15,6,1,0,98
79578,919605,1,16,1,1,0,99
79579,919605,1,16,2,2,0,101
79580,919605,1,16,3,1,0,102
79581,919605,1,16,4,1,0,103
79582,919605,1,16,5,1,0,104
79583,919605,1,16,6,0,0,104
79584,919605,1,17,1,0,0,104
79585,919605,1,17,2,0,0,104
79586,919605,1,17,3,2,0,106
79587,919605,1,17,4,0,1,106
79588,919605,1,17,5,1,0,107
79589,919605,1,17,6,2,0,109
79590,919605,1,18,1,0,0,109
79591,919605,1,18,2,1,0,110
79592,919605,1,18,3,1,1,111
79593,919605,1,18,4,1,0,112
79594,919605,1,18,5,0,0,112
79595,919605,1,18,6,0,0,112
79596,919605,1,19,1,1,0,113
79597,919605,1,19,2,4,0,117
79598,919605,1,19,3,1,0,118
79599,919605,1,19,4,1,0,119
79600,919605,1,19,5,1,0,120
79601,919605,1,19,6,2,0,122
79602,919605,1,20,1,4,0,126
79603,919605,1,20,2,0,0,126
79604,919605,1,20,3,2,0,128
79605,919605,1,20,4,1,0,129
79606,919605,1,20,5,6,0,135
79607,919605,1,20,6,1,0,136
79728,924637,1,1,1,0,0,0
79729,924637,1,1,2,0,0,0
79730,924637,1,1,3,4,0,4
79731,924637,1,1,4,1,0,5
79732,924637,1,1,5,1,0,6
79733,924637,1,1,6,6,0,12
79734,924637,1,2,1,1,0,13
79735,924637,1,2,2,1,0,14
79736,924637,1,2,3,4,0,18
79737,924637,1,2,4,0,0,18
79738,924637,1,2,5,3,0,21
79739,924637,1,2,6,1,0,22
79740,924637,1,3,1,4,0,26
79741,924637,1,3,2,0,0,26
79742,924637,1,3,3,0,0,26
79743,924637,1,3,4,0,0,26
79744,924637,1,3,5,0,0,26
79745,924637,1,3,6,0,0,26
79746,924637,1,4,1,4,0,30
79747,924637,1,4,2,0,0,30
79748,924637,1,4,3,0,0,30
79749,924637,1,4,4,1,0,31
79750,924637,1,4,5,3,0,34
79751,924637,1,4,6,2,0,36
79752,924637,1,5,1,0,0,36
79753,924637,1,5,2,2,0,38
79754,924637,1,5,3,4,0,42
79755,924637,1,5,4,4,0,46
79756,924637,1,5,5,2,0,48
79757,924637,1,5,6,0,0,48
79758,924637,1,6,1,0,0,48
79759,924637,1,6,2,0,0,48
79760,924637,1,6,3,4,0,52
79761,924637,1,6,4,4,0,56
79762,924637,1,6,5,1,0,57
79763,924637,1,6,6,1,0,58
79764,924637,1,7,1,0,0,58
79765,924637,1,7,2,2,0,60
79766,924637,1,7,3,2,0,62
79767,924637,1,7,4,1,0,63
79768,924637,1,7,5,0,0,63
79769,924637,1,7,6,0,0,63
79770,924637,1,8,1,1,0,64
79771,924637,1,8,2,2,0,66
79772,924637,1,8,3,1,0,67
79773,924637,1,8,4,4,0,71
79774,924637,1,8,5,3,0,74
79775,924637,1,8,6,0,0,74
79776,924637,1,9,1,2,0,76
79777,924637,1,9,2,1,0,77
79778,924637,1,9,3,2,0,79
79779,924637,1,9,4,0,0,79
79780,924637,1,9,5,0,0,79
79781,924637,1,9,6,1,0,80
79782,924637,1,10,1,0,0,80
79783,924637,1,10,2,1,0,81
79784,924637,1,10,3,1,0,82
79785,924637,1,10,4,0,0,82
79786,924637,1,10,5,1,0,83
79787,924637,1,10,6,1,0,84
79788,924637,1,11,1,1,0,85
79789,924637,1,11,2,0,0,85
79790,924637,1,11,3,1,0,86
79791,924637,1,11,4,1,0,87
79792,924637,1,11,5,1,0,88
79793,924637,1,11,6,1,0,89
79794,924637,1,12,1,1,0,90
79795,924637,1,12,2,1,0,91
79796,924637,1,12,3,1,0,92
79797,924637,1,12,4,4,0,96
79798,924637,1,12,5,1,0,97
79799,924637,1,12,6,1,0,98
79800,924637,1,13,1,2,0,100
79801,924637,1,13,2,0,0,100
79802,924637,1,13,3,0,1,100
79803,924637,1,13,4,0,0,100
79804,924637,1,13,5,2,0,102
79805,924637,1,13,6,0,0,102
79806,924637,1,14,1,0,0,102
79807,924637,1,14,2,1,0,103
79808,924637,1,14,3,1,0,104
79809,924637,1,14,4,1,0,105
79810,924637,1,14,5,2,0,107
79811,924637,1,14,6,1,0,108
79812,924637,1,15,1,1,0,109
79813,924637,1,15,2,1,0,110
79814,924637,1,15,3,0,0,110
79815,924637,1,15,4,1,0,111
79816,924637,1,15,5,1,0,112
79817,924637,1,15,6,0,0,112
79818,924637,1,16,1,4,0,116
79819,924637,1,16,2,0,0,116
79820,924637,1,16,3,1,0,117
79821,924637,1,16,4,1,0,118
79822,924637,1,16,5,1,0,119
79823,924637,1,16,6,2,0,121
79824,924637,1,17,1,0,0,121
79825,924637,1,17,2,1,0,122
79826,924637,1,17,3,0,0,122
79827,924637,1,17,4,1,0,123
79828,924637,1,17,5,2,0,125
79829,924637,1,17,6,0,1,125
79830,924637,1,18,1,1,0,126
79831,924637,1,18,2,6,0,132
79832,924637,1,18,3,0,0,132
79833,924637,1,18,4,2,0,134
79834,924637,1,18,5,2,0,136
79835,924637,1,18,6,1,0,137
79836,924637,1,19,1,1,0,138
79837,924637,1,19,2,0,0,138
79838,924637,1,19,3,4,0,142
79839,924637,1,19,4,0,1,142
79840,924637,1,19,5,0,1,142
79841,924637,1,19,6,4,0,146
79842,924637,1,20,1,0,1,146
79843,924637,1,20,2,1,0,147
79844,924637,1,20,3,0,0,147
79845,924637,1,20,4,0,0,147
79846,924637,1,20,5,0,0,147
79847,924637,1,20,6,6,0,153
79963,924639,1,1,1,0,0,0
79964,924639,1,1,2,0,1,0
79965,924639,1,1,3,0,0,0
79966,924639,1,1,4,0,0,0
79967,924639,1,1,5,0,0,0
79968,924639,1,1,6,0,0,0
79969,924639,1,2,1,0,0,0
79970,924639,1,2,2,0,0,0
79971,924639,1,2,3,1,0,1
79972,924639,1,2,4,0,0,1
79973,924639,1,2,5,4,0,5
79974,924639,1,2,6,4,0,9
79975,924639,1,3,1,2,0,11
79976,924639,1,3,2,0,0,11
79977,924639,1,3,3,0,0,11
79978,924639,1,3,4,0,0,11
79979,924639,1,3,5,4,0,15
79980,924639,1,3,6,4,0,19
79981,924639,1,4,1,1,0,20
79982,924639,1,4,2,6,0,26
79983,924639,1,4,3,0,0,26
79984,924639,1,4,4,4,0,30
79985,924639,1,4,5,0,1,30
79986,924639,1,4,6,2,0,32
79987,924639,1,5,1,1,0,33
79988,924639,1,5,2,4,0,37
79989,924639,1,5,3,4,0,41
79990,924639,1,5,4,4,0,45
79991,924639,1,5,5,6,0,51
79992,924639,1,5,6,1,0,52
79993,924639,1,6,1,4,0,56
79994,924639,1,6,2,6,0,62
79995,924639,1,6,3,0,0,62
79996,924639,1,6,4,1,0,63
79997,924639,1,6,5,1,0,64
79998,924639,1,6,6,4,0,68
79999,924639,1,7,1,0,0,68
80000,924639,1,7,2,1,0,69
80001,924639,1,7,3,4,0,73
80002,924639,1,7,4,1,0,74
80003,924639,1,7,5,4,0,78
80004,924639,1,7,6,1,0,79
80005,924639,1,8,1,1,0,80
80006,924639,1,8,2,2,0,82
80007,924639,1,8,3,0,0,82
80008,924639,1,8,4,1,0,83
80009,924639,1,8,5,1,0,84
80010,924639,1,8,6,1,0,85
80011,924639,1,9,1,0,1,85
80012,924639,1,9,2,2,0,87
80013,924639,1,9,3,5,0,92
80014,924639,1,9,4,1,0,93
80015,924639,1,9,5,1,0,94
80016,924639,1,9,6,1,0,95
80017,924639,1,10,1,1,0,96
80018,924639,1,10,2,0,0,96
80019,924639,1,10,3,1,0,97
80020,924639,1,10,4,2,0,99
80021,924639,1,10,5,1,0,100
80022,924639,1,10,6,0,0,100
80023,924639,1,11,1,1,0,101
80024,924639,1,11,2,2,0,103
80025,924639,1,11,3,0,0,103
80026,924639,1,11,4,1,0,104
80027,924639,1,11,5,6,0,110
80028,924639,1,11,6,0,0,110
80029,924639,1,12,1,2,0,112
80030,924639,1,12,2,1,0,113
80031,924639,1,12,3,1,0,114
80032,924639,1,12,4,2,0,116
80033,924639,1,12,5,1,0,117
80034,924639,1,12,6,1,0,118
80035,924639,1,13,1,1,0,119
80036,924639,1,13,2,1,0,120
80037,924639,1,13,3,0,0,120
80038,924639,1,13,4,6,0,126
80039,924639,1,13,5,1,0,127
80040,924639,1,13,6,4,0,131
80041,924639,1,14,1,0,0,131
80042,924639,1,14,2,1,0,132
80043,924639,1,14,3,1,0,133
80044,924639,1,14,4,1,0,134
80045,924639,1,14,5,1,0,135
80046,924639,1,14,6,4,0,139
80047,924639,1,15,1,2,0,141
80048,924639,1,15,2,1,0,142
80049,924639,1,15,3,1,0,143
80050,924639,1,15,4,2,0,145
80051,924639,1,15,5,0,1,145
80052,924639,1,15,6,0,0,145
80053,924639,1,16,1,4,0,149
80054,924639,1,16,2,0,0,149
80055,924639,1,16,3,0,0,149
80056,924639,1,16,4,2,0,151
80057,924639,1,16,5,2,0,153
80058,924639,1,16,6,0,0,153
80059,924639,1,17,1,4,0,157
80060,924639,1,17,2,0,1,157
80061,924639,1,17,3,0,0,157
80062,924639,1,17,4,2,0,159
80063,924639,1,17,5,1,0,160
80064,924639,1,17,6,1,0,161
80065,924639,1,18,1,1,0,162
80066,924639,1,18,2,1,0,163
80067,924639,1,18,3,1,0,164
80068,924639,1,18,4,1,0,165
80069,924639,1,18,5,1,0,166
80070,924639,1,18,6,0,1,166
80071,924639,1,19,1,0,0,166
80072,924639,1,19,2,3,0,169
80073,924639,1,19,3,1,0,170
80074,924639,1,19,4,1,0,171
80075,924639,1,19,5,0,0,171
80076,924639,1,19,6,1,0,172
80077,924639,1,20,1,6,0,178
80078,924639,1,20,2,0,1,178
80079,924639,1,20,3,2,0,180
80080,924639,1,20,4,0,0,180
80081,924639,1,20,5,2,0,182
80082,924639,1,20,6,8,0,190
80202,931396,1,1,1,0,0,0
80203,931396,1,1,2,0,0,0
80204,931396,1,1,3,0,0,0
80205,931396,1,1,4,4,0,4
80206,931396,1,1,5,0,1,4
80207,931396,1,1,6,0,0,4
80208,931396,1,2,1,0,0,4
80209,931396,1,2,2,4,0,8
80210,931396,1,2,3,0,1,8
80211,931396,1,2,4,0,0,8
80212,931396,1,2,5,0,0,8
80213,931396,1,2,6,1,0,9
80214,931396,1,3,1,0,0,9
80215,931396,1,3,2,1,0,10
80216,931396,1,3,3,0,1,10
80217,931396,1,3,4,0,0,10
80218,931396,1,3,5,0,0,10
80219,931396,1,3,6,1,0,11
80220,931396,1,4,1,0,0,11
80221,931396,1,4,2,1,0,12
80222,931396,1,4,3,1,0,13
80223,931396,1,4,4,0,0,13
80224,931396,1,4,5,4,0,17
80225,931396,1,4,6,0,0,17
80226,931396,1,5,1,0,0,17
80227,931396,1,5,2,1,0,18
80228,931396,1,5,3,0,0,18
80229,931396,1,5,4,0,0,18
80230,931396,1,5,5,2,0,20
80231,931396,1,5,6,0,0,20
80232,931396,1,6,1,1,0,21
80233,931396,1,6,2,0,0,21
80234,931396,1,6,3,0,0,21
80235,931396,1,6,4,2,0,23
80236,931396,1,6,5,0,0,23
80237,931396,1,6,6,0,0,23
80238,931396,1,7,1,1,0,24
80239,931396,1,7,2,4,0,28
80240,931396,1,7,3,1,0,29
80241,931396,1,7,4,0,0,29
80242,931396,1,7,5,1,0,30
80243,931396,1,7,6,0,0,30
80244,931396,1,8,1,1,0,31
80245,931396,1,8,2,2,0,33
80246,931396,1,8,3,1,0,34
80247,931396,1,8,4,1,0,35
80248,931396,1,8,5,1,0,36
80249,931396,1,8,6,0,0,36
80250,931396,1,9,1,0,0,36
80251,931396,1,9,2,1,0,37
80252,931396,1,9,3,1,0,38
80253,931396,1,9,4,0,1,38
80254,931396,1,9,5,1,0,39
80255,931396,1,9,6,0,0,39
80256,931396,1,10,1,0,0,39
80257,931396,1,10,2,4,0,43
80258,931396,1,10,3,6,0,49
80259,931396,1,10,4,6,0,55
80260,931396,1,10,5,1,0,56
80261,931396,1,10,6,0,0,56
80262,931396,1,11,1,6,0,62
80263,931396,1,11,2,4,0,66
80264,931396,1,11,3,4,0,70
80265,931396,1,11,4,0,0,70
80266,931396,1,11,5,0,0,70
80267,931396,1,11,6,6,0,76
80268,931396,1,12,1,1,0,77
80269,931396,1,12,2,2,0,79
80270,931396,1,12,3,0,0,79
80271,931396,1,12,4,0,0,79
80272,931396,1,12,5,2,0,81
80273,931396,1,12,6,1,0,82
80274,931396,1,13,1,0,0,82
80275,931396,1,13,2,6,0,88
80276,931396,1,13,3,1,0,89
80277,931396,1,13,4,1,0,90
80278,931396,1,13,5,2,0,92
80279,931396,1,13,6,2,0,94
80280,931396,1,14,1,4,0,98
80281,931396,1,14,2,1,0,99
80282,931396,1,14,3,4,0,103
80283,931396,1,14,4,1,0,104
80284,931396,1,14,5,1,0,105
80285,931396,1,14,6,0,0,105
80286,931396,1,15,1,0,0,105
80287,931396,1,15,2,0,1,105
80288,931396,1,15,3,0,0,105
80289,931396,1,15,4,0,0,105
80290,931396,1,15,5,0,0,105
80291,931396,1,15,6,0,0,105
80292,931396,1,16,1,1,0,106
80293,931396,1,16,2,0,1,106
80294,931396,1,16,3,0,0,106
80295,931396,1,16,4,1,0,107
80296,931396,1,16,5,1,0,108
80297,931396,1,16,6,0,1,108
80298,931396,1,17,1,1,0,109
80299,931396,1,17,2,6,0,115
80300,931396,1,17,3,1,0,116
80301,931396,1,17,4,0,0,116
80302,931396,1,17,5,2,0,118
80303,931396,1,17,6,1,0,119
80304,931396,1,18,1,0,0,119
80305,931396,1,18,2,0,0,119
80306,931396,1,18,3,1,0,120
80307,931396,1,18,4,1,0,121
80308,931396,1,18,5,1,0,122
80309,931396,1,18,6,0,1,122
80310,931396,1,19,1,2,0,124
80311,931396,1,19,2,1,0,125
80312,931396,1,19,3,1,0,126
80313,931396,1,19,4,0,0,126
80314,931396,1,19,5,0,1,126
80315,931396,1,19,6,0,0,126
80316,931396,1,20,1,1,0,127
80317,931396,1,20,2,4,0,131
80318,931396,1,20,3,0,1,131
80425,931398,1,1,1,0,0,0
80426,931398,1,1,2,0,0,0
80427,931398,1,1,3,1,0,1
80428,931398,1,1,4,0,0,1
80429,931398,1,1,5,0,0,1
80430,931398,1,1,6,4,0,5
80431,931398,1,2,1,0,0,5
80432,931398,1,2,2,0,0,5
80433,931398,1,2,3,1,0,6
80434,931398,1,2,4,0,0,6
80435,931398,1,2,5,0,0,6
80436,931398,1,2,6,8,0,14
80437,931398,1,3,1,1,0,15
80438,931398,1,3,2,1,0,16
80439,931398,1,3,3,4,0,20
80440,931398,1,3,4,1,0,21
80441,931398,1,3,5,1,0,22
80442,931398,1,3,6,4,0,26
80443,931398,1,4,1,6,0,32
80444,931398,1,4,2,0,0,32
80445,931398,1,4,3,2,0,34
80446,931398,1,4,4,0,1,34
80447,931398,1,4,5,0,0,34
80448,931398,1,4,6,0,0,34
80449,931398,1,5,1,0,0,34
80450,931398,1,5,2,0,0,34
80451,931398,1,5,3,0,0,34
80452,931398,1,5,4,1,0,35
80453,931398,1,5,5,0,1,35
80454,931398,1,5,6,0,0,35
80455,931398,1,6,1,0,0,35
80456,931398,1,6,2,2,0,37
80457,931398,1,6,3,0,0,37
80458,931398,1,6,4,0,0,37
80459,931398,1,6,5,0,0,37
80460,931398,1,6,6,1,0,38
80461,931398,1,7,1,0,0,38
80462,931398,1,7,2,1,0,39
80463,931398,1,7,3,1,0,40
80464,931398,1,7,4,1,0,41
80465,931398,1,7,5,6,0,47
80466,931398,1,7,6,0,0,47
80467,931398,1,8,1,1,0,48
80468,931398,1,8,2,1,0,49
80469,931398,1,8,3,4,0,53
80470,931398,1,8,4,0,0,53
80471,931398,1,8,5,4,0,57
80472,931398,1,8,6,2,0,59
80473,931398,1,9,1,0,1,59
80474,931398,1,9,2,1,0,60
80475,931398,1,9,3,1,0,61
80476,931398,1,9,4,1,0,62
80477,931398,1,9,5,1,0,63
80478,931398,1,9,6,0,0,63
80479,931398,1,10,1,1,0,64
80480,931398,1,10,2,0,0,64
80481,931398,1,10,3,1,0,65
80482,931398,1,10,4,1,0,66
80483,931398,1,10,5,1,0,67
80484,931398,1,10,6,2,0,69
80485,931398,1,11,1,1,0,70
80486,931398,1,11,2,0,0,70
80487,931398,1,11,3,4,0,74
80488,931398,1,11,4,0,0,74
80489,931398,1,11,5,1,0,75
80490,931398,1,11,6,1,0,76
80491,931398,1,12,1,1,0,77
80492,931398,1,12,2,1,0,78
80493,931398,1,12,3,1,0,79
80494,931398,1,12,4,1,0,80
80495,931398,1,12,5,1,0,81
80496,931398,1,12,6,1,0,82
80497,931398,1,13,1,1,0,83
80498,931398,1,13,2,2,0,85
80499,931398,1,13,3,1,0,86
80500,931398,1,13,4,0,0,86
80501,931398,1,13,5,1,0,87
80502,931398,1,13,6,1,0,88
80503,931398,1,14,1,2,0,90
80504,931398,1,14,2,1,0,91
80505,931398,1,14,3,1,0,92
80506,931398,1,14,4,0,0,92
80507,931398,1,14,5,2,0,94
80508,931398,1,14,6,4,0,98
80509,931398,1,15,1,0,0,98
80510,931398,1,15,2,0,1,98
80511,931398,1,15,3,1,0,99
80512,931398,1,15,4,0,0,99
80513,931398,1,15,5,2,0,101
80514,931398,1,15,6,1,0,102
80515,931398,1,16,1,1,0,103
80516,931398,1,16,2,0,0,103
80517,931398,1,16,3,4,0,107
80518,931398,1,16,4,1,0,108
80519,931398,1,16,5,1,0,109
80520,931398,1,16,6,4,0,113
80521,931398,1,17,1,0,0,113
80522,931398,1,17,2,0,1,113
80523,931398,1,17,3,4,0,117
80524,931398,1,17,4,0,0,117
80525,931398,1,17,5,4,0,121
80526,931398,1,17,6,0,1,121
80527,931398,1,18,1,0,0,121
80528,931398,1,18,2,1,0,122
80529,931398,1,18,3,0,1,122
80530,931398,1,18,4,1,0,123
80531,931398,1,18,5,1,0,124
80532,931398,1,18,6,1,0,125
80533,931398,1,19,1,0,0,125
80534,931398,1,19,2,0,0,125
80535,931398,1,19,3,2,0,127
80536,931398,1,19,4,2,0,129
80537,931398,1,19,5,1,0,130
80538,931398,1,19,6,0,1,130
80539,931398,1,20,1,1,0,131
80540,931398,1,20,2,0,0,131
80541,931398,1,20,3,2,0,133
80542,931398,1,20,4,1,1,134
80543,931398,1,20,5,0,0,134
80544,931398,1,20,6,1,0,135
80664,936153,1,1,1,1,0,1
80665,936153,1,1,2,4,0,5
80666,936153,1,1,3,1,0,6
80667,936153,1,1,4,1,0,7
80668,936153,1,1,5,1,0,8
80669,936153,1,1,6,2,0,10
80670,936153,1,2,1,1,0,11
80671,936153,1,2,2,0,0,11
80672,936153,1,2,3,4,0,15
80673,936153,1,2,4,0,1,15
80674,936153,1,2,5,4,0,19
80675,936153,1,2,6,0,0,19
80676,936153,1,3,1,4,0,23
80677,936153,1,3,2,1,0,24
80678,936153,1,3,3,6,0,30
80679,936153,1,3,4,0,1,30
80680,936153,1,3,5,6,0,36
80681,936153,1,3,6,1,0,37
80682,936153,1,4,1,1,0,38
80683,936153,1,4,2,1,0,39
80684,936153,1,4,3,1,0,40
80685,936153,1,4,4,1,0,41
80686,936153,1,4,5,1,0,42
80687,936153,1,4,6,0,0,42
80688,936153,1,5,1,4,0,46
80689,936153,1,5,2,1,0,47
80690,936153,1,5,3,6,0,53
80691,936153,1,5,4,1,0,54
80692,936153,1,5,5,0,1,54
80693,936153,1,5,6,2,0,56
80694,936153,1,6,1,1,0,57
80695,936153,1,6,2,2,0,59
80696,936153,1,6,3,2,0,61
80697,936153,1,6,4,0,0,61
80698,936153,1,6,5,1,0,62
80699,936153,1,6,6,1,0,63
80700,936153,1,7,1,1,0,64
80701,936153,1,7,2,4,0,68
80702,936153,1,7,3,0,0,68
80703,936153,1,7,4,1,0,69
80704,936153,1,7,5,1,0,70
80705,936153,1,7,6,4,0,74
80706,936153,1,8,1,1,0,75
80707,936153,1,8,2,1,0,76
80708,936153,1,8,3,6,0,82
80709,936153,1,8,4,3,0,85
80710,936153,1,8,5,4,0,89
80711,936153,1,8,6,4,0,93
80712,936153,1,9,1,1,0,94
80713,936153,1,9,2,5,0,99
80714,936153,1,9,3,6,0,105
80715,936153,1,9,4,0,1,105
80716,936153,1,9,5,1,0,106
80717,936153,1,9,6,6,0,112
80718,936153,1,10,1,0,0,112
80719,936153,1,10,2,4,0,116
80720,936153,1,10,3,6,0,122
80721,936153,1,10,4,2,0,124
80722,936153,1,10,5,1,1,125
80723,936153,1,10,6,1,0,126
80784,936155,1,1,1,0,0,0
80785,936155,1,1,2,0,0,0
80786,936155,1,1,3,4,0,4
80787,936155,1,1,4,0,0,4
80788,936155,1,1,5,0,0,4
80789,936155,1,1,6,0,0,4
80790,936155,1,2,1,0,0,4
80791,936155,1,2,2,0,0,4
80792,936155,1,2,3,1,0,5
80793,936155,1,2,4,0,0,5
80794,936155,1,2,5,0,1,5
80795,936155,1,2,6,1,0,6
80796,936155,1,3,1,1,0,7
80797,936155,1,3,2,0,0,7
80798,936155,1,3,3,1,0,8
80799,936155,1,3,4,0,0,8
80800,936155,1,3,5,4,0,12
80801,936155,1,3,6,1,0,13
80802,936155,1,4,1,0,1,13
80803,936155,1,4,2,3,0,16
80804,936155,1,4,3,0,0,16
80805,936155,1,4,4,0,0,16
80806,936155,1,4,5,4,0,20
80807,936155,1,4,6,0,0,20
80808,936155,1,5,1,0,0,20
80809,936155,1,5,2,1,0,21
80810,936155,1,5,3,4,0,25
80811,936155,1,5,4,0,0,25
80812,936155,1,5,5,1,0,26
80813,936155,1,5,6,0,0,26
80814,936155,1,6,1,1,0,27
80815,936155,1,6,2,6,0,33
80816,936155,1,6,3,2,0,35
80817,936155,1,6,4,4,0,39
80818,936155,1,6,5,1,0,40
80819,936155,1,6,6,1,0,41
80820,936155,1,7,1,0,1,41
80821,936155,1,7,2,2,0,43
80822,936155,1,7,3,0,0,43
80823,936155,1,7,4,1,0,44
80824,936155,1,7,5,1,0,45
80825,936155,1,7,6,1,0,46
80826,936155,1,8,1,1,0,47
80827,936155,1,8,2,1,0,48
80828,936155,1,8,3,1,0,49
80829,936155,1,8,4,1,0,50
80830,936155,1,8,5,1,0,51
80831,936155,1,8,6,0,0,51
80832,936155,1,9,1,0,0,51
80833,936155,1,9,2,6,0,57
80834,936155,1,9,3,0,1,57
80835,936155,1,9,4,1,0,58
80836,936155,1,9,5,4,0,62
80837,936155,1,9,6,1,0,63
80838,936155,1,10,1,1,0,64
80839,936155,1,10,2,1,0,65
80840,936155,1,10,3,0,0,65
80841,936155,1,10,4,1,0,66
80842,936155,1,10,5,1,0,67
80843,936155,1,10,6,1,0,68
80844,936155,1,11,1,0,1,68
80845,936155,1,11,2,0,0,68
80846,936155,1,11,3,0,0,68
80847,936155,1,11,4,1,0,69
80848,936155,1,11,5,1,0,70
80849,936155,1,11,6,1,0,71
80850,936155,1,12,1,2,0,73
80851,936155,1,12,2,1,0,74
80852,936155,1,12,3,0,0,74
80853,936155,1,12,4,0,1,74
80854,936155,1,12,5,0,0,74
80855,936155,1,12,6,0,1,74
80856,936155,1,13,1,0,0,74
80857,936155,1,13,2,1,0,75
80858,936155,1,13,3,0,0,75
80859,936155,1,13,4,1,0,76
80860,936155,1,13,5,1,0,77
80861,936155,1,13,6,0,0,77
80862,936155,1,14,1,1,0,78
80863,936155,1,14,2,1,0,79
80864,936155,1,14,3,1,0,80
80865,936155,1,14,4,0,0,80
80866,936155,1,14,5,1,0,81
80867,936155,1,14,6,1,0,82
80868,936155,1,15,1,4,0,86
80869,936155,1,15,2,4,0,90
80870,936155,1,15,3,1,0,91
80871,936155,1,15,4,0,0,91
80872,936155,1,15,5,0,0,91
80873,936155,1,15,6,0,0,91
80874,936155,1,16,1,0,0,91
80875,936155,1,16,2,2,0,93
80876,936155,1,16,3,1,0,94
80877,936155,1,16,4,1,0,95
80878,936155,1,16,5,1,0,96
80879,936155,1,16,6,1,0,97
80880,936155,1,17,1,4,0,101
80881,936155,1,17,2,1,0,102
80882,936155,1,17,3,1,0,103
80883,936155,1,17,4,0,0,103
80884,936155,1,17,5,1,0,104
80885,936155,1,17,6,1,0,105
80886,936155,1,18,1,2,0,107
80887,936155,1,18,2,0,1,107
80888,936155,1,18,3,0,0,107
80889,936155,1,18,4,0,0,107
80890,936155,1,18,5,2,0,109
80891,936155,1,18,6,0,0,109
80892,936155,1,19,1,0,0,109
80893,936155,1,19,2,0,0,109
80894,936155,1,19,3,0,1,109
80895,936155,1,19,4,0,0,109
80896,936155,1,19,5,1,0,110
80897,936155,1,19,6,1,0,111
80898,936155,1,20,1,1,0,112
80899,936155,1,20,2,1,0,113
80900,936155,1,20,3,0,1,113
81019,936157,1,1,1,1,0,1
81020,936157,1,1,2,1,0,2
81021,936157,1,1,3,0,0,2
81022,936157,1,1,4,4,0,6
81023,936157,1,1,5,4,0,10
81024,936157,1,1,6,0,0,10
81025,936157,1,2,1,4,0,14
81026,936157,1,2,2,1,0,15
81027,936157,1,2,3,2,0,17
81028,936157,1,2,4,1,0,18
81029,936157,1,2,5,0,0,18
81030,936157,1,2,6,4,0,22
81031,936157,1,3,1,0,0,22
81032,936157,1,3,2,1,0,23
81033,936157,1,3,3,1,0,24
81034,936157,1,3,4,1,0,25
81035,936157,1,3,5,2,0,27
81036,936157,1,3,6,0,0,27
81037,936157,1,4,1,4,0,31
81038,936157,1,4,2,1,0,32
81039,936157,1,4,3,1,0,33
81040,936157,1,4,4,1,0,34
81041,936157,1,4,5,0,0,34
81042,936157,1,4,6,1,0,35
81043,936157,1,5,1,1,0,36
81044,936157,1,5,2,0,1,36
81045,936157,1,5,3,0,0,36
81046,936157,1,5,4,0,0,36
81047,936157,1,5,5,0,0,36
81048,936157,1,5,6,0,0,36
81049,936157,1,6,1,1,0,37
81050,936157,1,6,2,1,0,38
81051,936157,1,6,3,4,0,42
81052,936157,1,6,4,1,0,43
81053,936157,1,6,5,1,0,44
81054,936157,1,6,6,4,0,48
81055,936157,1,7,1,1,0,49
81056,936157,1,7,2,2,0,51
81057,936157,1,7,3,1,0,52
81058,936157,1,7,4,1,0,53
81059,936157,1,7,5,1,0,54
81060,936157,1,7,6,1,0,55
81061,936157,1,8,1,1,0,56
81062,936157,1,8,2,1,0,57
81063,936157,1,8,3,2,0,59
81064,936157,1,8,4,0,0,59
81065,936157,1,8,5,1,0,60
81066,936157,1,8,6,0,0,60
81067,936157,1,9,1,1,0,61
81068,936157,1,9,2,1,0,62
81069,936157,1,9,3,3,0,65
81070,936157,1,9,4,4,0,69
81071,936157,1,9,5,2,0,71
81072,936157,1,9,6,2,0,73
81073,936157,1,10,1,1,0,74
81074,936157,1,10,2,1,0,75
81075,936157,1,10,3,1,0,76
81076,936157,1,10,4,1,0,77
81077,936157,1,10,5,1,0,78
81078,936157,1,10,6,1,0,79
81079,936157,1,11,1,2,0,81
81080,936157,1,11,2,0,0,81
81081,936157,1,11,3,1,0,82
81082,936157,1,11,4,1,0,83
81083,936157,1,11,5,3,0,86
81084,936157,1,11,6,2,0,88
81085,936157,1,12,1,1,0,89
81086,936157,1,12,2,1,0,90
81087,936157,1,12,3,1,0,91
81088,936157,1,12,4,1,0,92
81089,936157,1,12,5,6,0,98
81090,936157,1,12,6,0,0,98
81091,936157,1,13,1,0,0,98
81092,936157,1,13,2,1,0,99
81093,936157,1,13,3,6,0,105
81094,936157,1,13,4,1,0,106
81095,936157,1,13,5,1,0,107
81096,936157,1,13,6,0,0,107
81097,936157,1,14,1,0,0,107
81098,936157,1,14,2,0,1,107
81099,936157,1,14,3,0,0,107
81100,936157,1,14,4,1,0,108
81101,936157,1,14,5,1,0,109
81102,936157,1,14,6,0,0,109
81103,936157,1,15,1,2,0,111
81104,936157,1,15,2,4,0,115
81105,936157,1,15,3,2,0,117
81106,936157,1,15,4,0,1,117
81107,936157,1,15,5,1,0,118
81108,936157,1,15,6,1,0,119
81109,936157,1,16,1,1,0,120
81110,936157,1,16,2,1,0,121
81111,936157,1,16,3,1,0,122
81112,936157,1,16,4,1,0,123
81113,936157,1,16,5,1,0,124
81114,936157,1,16,6,0,0,124
81115,936157,1,17,1,1,0,125
81116,936157,1,17,2,6,0,131
81117,936157,1,17,3,1,0,132
81118,936157,1,17,4,1,1,133
81119,936157,1,17,5,1,0,134
81120,936157,1,17,6,1,0,135
81121,936157,1,18,1,0,1,135
81122,936157,1,18,2,1,0,136
81123,936157,1,18,3,2,0,138
81124,936157,1,18,4,1,0,139
81125,936157,1,18,5,1,0,140
81126,936157,1,18,6,1,0,141
81127,936157,1,19,1,0,0,141
81128,936157,1,19,2,4,0,145
81129,936157,1,19,3,0,0,145
81130,936157,1,19,4,1,0,146
81131,936157,1,19,5,1,0,147
81132,936157,1,19,6,1,0,148
81133,936157,1,20,1,6,0,154
81134,936157,1,20,2,0,0,154
81135,936157,1,20,3,6,0,160
81136,936157,1,20,4,6,0,166
81137,936157,1,20,5,2,0,168
81138,936157,1,20,6,1,0,169
81258,951309,1,1,1,1,0,1
81259,951309,1,1,2,0,0,1
81260,951309,1,1,3,0,0,1
81261,951309,1,1,4,2,0,3
81262,951309,1,1,5,4,0,7
81263,951309,1,1,6,1,0,8
81264,951309,1,2,1,0,0,8
81265,951309,1,2,2,4,0,12
81266,951309,1,2,3,0,0,12
81267,951309,1,2,4,0,0,12
81268,951309,1,2,5,1,0,13
81269,951309,1,2,6,1,0,14
81270,951309,1,3,1,0,0,14
81271,951309,1,3,2,0,0,14
81272,951309,1,3,3,1,0,15
81273,951309,1,3,4,2,0,17
81274,951309,1,3,5,1,0,18
81275,951309,1,3,6,0,0,18
81276,951309,1,4,1,0,1,18
81277,951309,1,4,2,1,0,19
81278,951309,1,4,3,0,0,19
81279,951309,1,4,4,0,0,19
81280,951309,1,4,5,2,0,21
81281,951309,1,4,6,2,0,23
81282,951309,1,5,1,1,0,24
81283,951309,1,5,2,1,0,25
81284,951309,1,5,3,0,0,25
81285,951309,1,5,4,0,0,25
81286,951309,1,5,5,0,0,25
81287,951309,1,5,6,1,0,26
81288,951309,1,6,1,2,0,28
81289,951309,1,6,2,4,0,32
81290,951309,1,6,3,0,0,32
81291,951309,1,6,4,0,0,32
81292,951309,1,6,5,1,0,33
81293,951309,1,6,6,0,0,33
81294,951309,1,7,1,1,0,34
81295,951309,1,7,2,0,0,34
81296,951309,1,7,3,1,0,35
81297,951309,1,7,4,0,0,35
81298,951309,1,7,5,0,0,35
81299,951309,1,7,6,6,0,41
81300,951309,1,8,1,1,0,42
81301,951309,1,8,2,4,0,46
81302,951309,1,8,3,1,0,47
81303,951309,1,8,4,4,0,51
81304,951309,1,8,5,1,0,52
81305,951309,1,8,6,1,0,53
81306,951309,1,9,1,1,0,54
81307,951309,1,9,2,6,0,60
81308,951309,1,9,3,0,1,60
81309,951309,1,9,4,1,0,61
81310,951309,1,9,5,1,0,62
81311,951309,1,9,6,0,0,62
81312,951309,1,10,1,3,0,65
81313,951309,1,10,2,1,0,66
81314,951309,1,10,3,1,0,67
81315,951309,1,10,4,1,0,68
81316,951309,1,10,5,1,0,69
81317,951309,1,10,6,1,0,70
81318,951309,1,11,1,1,0,71
81319,951309,1,11,2,2,0,73
81320,951309,1,11,3,4,0,77
81321,951309,1,11,4,1,0,78
81322,951309,1,11,5,0,1,78
81323,951309,1,11,6,1,0,79
81324,951309,1,12,1,0,0,79
81325,951309,1,12,2,4,0,83
81326,951309,1,12,3,0,0,83
81327,951309,1,12,4,2,0,85
81328,951309,1,12,5,1,0,86
81329,951309,1,12,6,1,0,87
81330,951309,1,13,1,6,0,93
81331,951309,1,13,2,0,0,93
81332,951309,1,13,3,3,0,96
81333,951309,1,13,4,0,0,96
81334,951309,1,13,5,2,0,98
81335,951309,1,13,6,1,0,99
81336,951309,1,14,1,4,0,103
81337,951309,1,14,2,0,0,103
81338,951309,1,14,3,0,0,103
81339,951309,1,14,4,4,0,107
81340,951309,1,14,5,1,0,108
81341,951309,1,14,6,1,0,109
81342,951309,1,15,1,1,0,110
81343,951309,1,15,2,1,0,111
81344,951309,1,15,3,0,1,111
81345,951309,1,15,4,0,0,111
81346,951309,1,15,5,1,1,112
81347,951309,1,15,6,0,0,112
81348,951309,1,16,1,0,0,112
81349,951309,1,16,2,1,0,113
81350,951309,1,16,3,0,0,113
81351,951309,1,16,4,0,0,113
81352,951309,1,16,5,1,0,114
81353,951309,1,16,6,1,0,115
81354,951309,1,17,1,4,0,119
81355,951309,1,17,2,0,0,119
81356,951309,1,17,3,2,0,121
81357,951309,1,17,4,1,0,122
81358,951309,1,17,5,1,0,123
81359,951309,1,17,6,2,0,125
81360,951309,1,18,1,1,0,126
81361,951309,1,18,2,0,0,126
81362,951309,1,18,3,1,0,127
81363,951309,1,18,4,0,1,127
81364,951309,1,18,5,1,0,128
81365,951309,1,18,6,1,0,129
81366,951309,1,19,1,1,0,130
81367,951309,1,19,2,1,0,131
81368,951309,1,19,3,0,0,131
81369,951309,1,19,4,6,0,137
81370,951309,1,19,5,0,1,137
81371,951309,1,19,6,1,0,138
81372,951309,1,20,1,6,0,144
81373,951309,1,20,2,1,0,145
81374,951309,1,20,3,0,0,145
81375,951309,1,20,4,0,0,145
81376,951309,1,20,5,6,0,151
81377,951309,1,20,6,2,0,153
81498,951321,1,1,1,2,0,2
81499,951321,1,1,2,0,0,2
81500,951321,1,1,3,0,0,2
81501,951321,1,1,4,0,0,2
81502,951321,1,1,5,2,0,4
81503,951321,1,1,6,0,0,4
81504,951321,1,2,1,1,0,5
81505,951321,1,2,2,0,0,5
81506,951321,1,2,3,4,0,9
81507,951321,1,2,4,4,0,13
81508,951321,1,2,5,4,0,17
81509,951321,1,2,6,4,0,21
81510,951321,1,3,1,1,0,22
81511,951321,1,3,2,0,0,22
81512,951321,1,3,3,0,0,22
81513,951321,1,3,4,0,0,22
81514,951321,1,3,5,0,0,22
81515,951321,1,3,6,0,0,22
81516,951321,1,4,1,0,0,22
81517,951321,1,4,2,2,0,24
81518,951321,1,4,3,4,0,28
81519,951321,1,4,4,4,0,32
81520,951321,1,4,5,4,0,36
81521,951321,1,4,6,1,0,37
81522,951321,1,5,1,6,0,43
81523,951321,1,5,2,1,0,44
81524,951321,1,5,3,4,0,48
81525,951321,1,5,4,1,0,49
81526,951321,1,5,5,0,1,49
81527,951321,1,5,6,0,0,49
81528,951321,1,6,1,0,0,49
81529,951321,1,6,2,1,0,50
81530,951321,1,6,3,0,1,50
81531,951321,1,6,4,0,0,50
81532,951321,1,6,5,4,0,54
81533,951321,1,6,6,1,0,55
81534,951321,1,7,1,1,0,56
81535,951321,1,7,2,0,0,56
81536,951321,1,7,3,0,0,56
81537,951321,1,7,4,2,0,58
81538,951321,1,7,5,0,0,58
81539,951321,1,7,6,0,0,58
81540,951321,1,8,1,0,0,58
81541,951321,1,8,2,2,0,60
81542,951321,1,8,3,0,1,60
81543,951321,1,8,4,2,0,62
81544,951321,1,8,5,1,0,63
81545,951321,1,8,6,0,1,63
81546,951321,1,9,1,1,0,64
81547,951321,1,9,2,1,0,65
81548,951321,1,9,3,1,0,66
81549,951321,1,9,4,0,0,66
81550,951321,1,9,5,0,0,66
81551,951321,1,9,6,0,0,66
81552,951321,1,10,1,1,0,67
81553,951321,1,10,2,1,0,68
81554,951321,1,10,3,1,0,69
81555,951321,1,10,4,2,0,71
81556,951321,1,10,5,1,0,72
81557,951321,1,10,6,1,0,73
81558,951321,1,11,1,4,0,77
81559,951321,1,11,2,0,0,77
81560,951321,1,11,3,1,0,78
81561,951321,1,11,4,1,0,79
81562,951321,1,11,5,1,0,80
81563,951321,1,11,6,0,0,80
81564,951321,1,12,1,1,0,81
81565,951321,1,12,2,0,0,81
81566,951321,1,12,3,1,0,82
81567,951321,1,12,4,2,0,84
81568,951321,1,12,5,1,0,85
81569,951321,1,12,6,1,0,86
81570,951321,1,13,1,2,0,88
81571,951321,1,13,2,1,0,89
81572,951321,1,13,3,0,0,89
81573,951321,1,13,4,1,0,90
81574,951321,1,13,5,0,0,90
81575,951321,1,13,6,1,0,91
81576,951321,1,14,1,0,0,91
81577,951321,1,14,2,1,0,92
81578,951321,1,14,3,4,0,96
81579,951321,1,14,4,0,0,96
81580,951321,1,14,5,1,0,97
81581,951321,1,14,6,1,0,98
81582,951321,1,15,1,0,0,98
81583,951321,1,15,2,4,0,102
81584,951321,1,15,3,4,0,106
81585,951321,1,15,4,1,0,107
81586,951321,1,15,5,1,0,108
81587,951321,1,15,6,1,0,109
81588,951321,1,16,1,6,0,115
81589,951321,1,16,2,1,0,116
81590,951321,1,16,3,4,0,120
81591,951321,1,16,4,1,0,121
81592,951321,1,16,5,6,0,127
81593,951321,1,16,6,3,0,130
81594,951321,1,17,1,2,0,132
81595,951321,1,17,2,3,0,135
81596,951321,1,17,3,4,0,139
81597,951321,1,17,4,1,0,140
81598,951321,1,17,5,2,0,142
81599,951321,1,17,6,1,0,143
81600,951321,1,18,1,1,0,144
81601,951321,1,18,2,0,0,144
81602,951321,1,18,3,0,0,144
81603,951321,1,18,4,4,0,148
81604,951321,1,18,5,4,0,152
81605,951321,1,18,6,6,0,158
81606,951321,1,19,1,1,0,159
81607,951321,1,19,2,1,0,160
81608,951321,1,19,3,1,0,161
81609,951321,1,19,4,0,1,161
81610,951321,1,19,5,10,0,171
81611,951321,1,19,6,2,0,173
81612,951321,1,20,1,6,0,179
81613,951321,1,20,2,1,0,180
81614,951321,1,20,3,1,0,181
81615,951321,1,20,4,3,0,184
81616,951321,1,20,5,0,1,184
81617,951321,1,20,6,2,0,186
81736,951325,1,1,1,0,0,0
81737,951325,1,1,2,0,0,0
81738,951325,1,1,3,0,0,0
81739,951325,1,1,4,4,0,4
81740,951325,1,1,5,4,0,8
81741,951325,1,1,6,1,0,9
81742,951325,1,2,1,1,0,10
81743,951325,1,2,2,0,0,10
81744,951325,1,2,3,0,1,10
81745,951325,1,2,4,2,0,12
81746,951325,1,2,5,0,1,12
81747,951325,1,2,6,1,0,13
81748,951325,1,3,1,1,0,14
81749,951325,1,3,2,2,0,16
81750,951325,1,3,3,1,0,17
81751,951325,1,3,4,6,0,23
81752,951325,1,3,5,6,0,29
81753,951325,1,3,6,4,0,33
81754,951325,1,4,1,0,0,33
81755,951325,1,4,2,0,1,33
81756,951325,1,4,3,4,0,37
81757,951325,1,4,4,0,0,37
81758,951325,1,4,5,0,0,37
81759,951325,1,4,6,1,0,38
81760,951325,1,5,1,4,0,42
81761,951325,1,5,2,1,0,43
81762,951325,1,5,3,2,0,45
81763,951325,1,5,4,1,0,46
81764,951325,1,5,5,0,0,46
81765,951325,1,5,6,4,0,50
81766,951325,1,6,1,4,0,54
81767,951325,1,6,2,0,0,54
81768,951325,1,6,3,4,0,58
81769,951325,1,6,4,0,0,58
81770,951325,1,6,5,0,1,58
81771,951325,1,6,6,1,1,59
81808,951329,1,1,1,6,0,6
81809,951329,1,1,2,0,1,6
81810,951329,1,1,3,0,0,6
81811,951329,1,1,4,6,0,12
81812,951329,1,1,5,1,0,13
81813,951329,1,1,6,0,0,13
81814,951329,1,2,1,0,0,13
81815,951329,1,2,2,0,0,13
81816,951329,1,2,3,0,1,13
81817,951329,1,2,4,0,0,13
81818,951329,1,2,5,1,0,14
81819,951329,1,2,6,0,0,14
81820,951329,1,3,1,0,0,14
81821,951329,1,3,2,0,0,14
81822,951329,1,3,3,1,0,15
81823,951329,1,3,4,0,0,15
81824,951329,1,3,5,1,0,16
81825,951329,1,3,6,1,0,17
81826,951329,1,4,1,0,0,17
81827,951329,1,4,2,0,0,17
81828,951329,1,4,3,0,0,17
81829,951329,1,4,4,1,0,18
81830,951329,1,4,5,0,0,18
81831,951329,1,4,6,4,0,22
81832,951329,1,5,1,0,0,22
81833,951329,1,5,2,4,0,26
81834,951329,1,5,3,1,0,27
81835,951329,1,5,4,0,0,27
81836,951329,1,5,5,1,0,28
81837,951329,1,5,6,4,0,32
81838,951329,1,6,1,0,0,32
81839,951329,1,6,2,0,0,32
81840,951329,1,6,3,0,0,32
81841,951329,1,6,4,0,0,32
81842,951329,1,6,5,1,0,33
81843,951329,1,6,6,0,0,33
81844,951329,1,7,1,0,0,33
81845,951329,1,7,2,1,0,34
81846,951329,1,7,3,0,0,34
81847,951329,1,7,4,1,0,35
81848,951329,1,7,5,0,1,35
81849,951329,1,7,6,0,0,35
81850,951329,1,8,1,4,0,39
81851,951329,1,8,2,1,0,40
81852,951329,1,8,3,0,0,40
81853,951329,1,8,4,0,0,40
81854,951329,1,8,5,1,0,41
81855,951329,1,8,6,1,0,42
81856,951329,1,9,1,2,0,44
81857,951329,1,9,2,1,0,45
81858,951329,1,9,3,1,0,46
81859,951329,1,9,4,2,0,48
81860,951329,1,9,5,0,0,48
81861,951329,1,9,6,1,0,49
81862,951329,1,10,1,1,0,50
81863,951329,1,10,2,0,0,50
81864,951329,1,10,3,0,0,50
81865,951329,1,10,4,4,0,54
81866,951329,1,10,5,1,0,55
81867,951329,1,10,6,0,0,55
81868,951329,1,11,1,0,0,55
81869,951329,1,11,2,1,0,56
81870,951329,1,11,3,1,0,57
81871,951329,1,11,4,1,0,58
81872,951329,1,11,5,1,0,59
81873,951329,1,11,6,0,0,59
81874,951329,1,12,1,1,0,60
81875,951329,1,12,2,1,0,61
81876,951329,1,12,3,0,1,61
81877,951329,1,12,4,1,0,62
81878,951329,1,12,5,1,0,63
81879,951329,1,12,6,0,0,63
81880,951329,1,13,1,4,0,67
81881,951329,1,13,2,1,0,68
81882,951329,1,13,3,3,0,71
81883,951329,1,13,4,1,0,72
81884,951329,1,13,5,0,0,72
81885,951329,1,13,6,3,0,75
81886,951329,1,14,1,0,0,75
81887,951329,1,14,2,1,0,76
81888,951329,1,14,3,1,0,77
81889,951329,1,14,4,1,0,78
81890,951329,1,14,5,0,0,78
81891,951329,1,14,6,0,0,78
81892,951329,1,15,1,0,0,78
81893,951329,1,15,2,5,0,83
81894,951329,1,15,3,1,0,84
81895,951329,1,15,4,1,0,85
81896,951329,1,15,5,2,0,87
81897,951329,1,15,6,1,0,88
81898,951329,1,16,1,1,0,89
81899,951329,1,16,2,0,0,89
81900,951329,1,16,3,0,0,89
81901,951329,1,16,4,0,1,89
81902,951329,1,16,5,0,0,89
81903,951329,1,16,6,1,0,90
81904,951329,1,17,1,1,0,91
81905,951329,1,17,2,2,0,93
81906,951329,1,17,3,5,0,98
81907,951329,1,17,4,0,1,98
81908,951329,1,17,5,0,0,98
81909,951329,1,17,6,0,0,98
81910,951329,1,18,1,0,0,98
81911,951329,1,18,2,2,0,100
81912,951329,1,18,3,1,0,101
81913,951329,1,18,4,1,0,102
81914,951329,1,18,5,0,0,102
81915,951329,1,18,6,1,0,103
81916,951329,1,19,1,0,0,103
81917,951329,1,19,2,1,0,104
81918,951329,1,19,3,4,0,108
81919,951329,1,19,4,1,0,109
81920,951329,1,19,5,1,0,110
81921,951329,1,19,6,1,0,111
81922,951329,1,20,1,1,0,112
81923,951329,1,20,2,1,0,113
81924,951329,1,20,3,1,1,114
81925,951329,1,20,4,4,0,118
81926,951329,1,20,5,6,0,124
81927,951329,1,20,6,2,0,126
82037,951331,1,1,1,0,0,0
82038,951331,1,1,2,1,0,1
82039,951331,1,1,3,0,0,1
82040,951331,1,1,4,0,0,1
82041,951331,1,1,5,0,0,1
82042,951331,1,1,6,0,0,1
82043,951331,1,2,1,1,0,2
82044,951331,1,2,2,1,0,3
82045,951331,1,2,3,1,0,4
82046,951331,1,2,4,0,0,4
82047,951331,1,2,5,0,0,4
82048,951331,1,2,6,1,0,5
82049,951331,1,3,1,4,0,9
82050,951331,1,3,2,2,0,11
82051,951331,1,3,3,1,0,12
82052,951331,1,3,4,2,0,14
82053,951331,1,3,5,5,0,19
82054,951331,1,3,6,4,0,23
82055,951331,1,4,1,0,0,23
82056,951331,1,4,2,4,0,27
82057,951331,1,4,3,4,0,31
82058,951331,1,4,4,4,0,35
82059,951331,1,4,5,0,0,35
82060,951331,1,4,6,1,0,36
82061,951331,1,5,1,1,0,37
82062,951331,1,5,2,0,0,37
82063,951331,1,5,3,0,1,37
82064,951331,1,5,4,0,0,37
82065,951331,1,5,5,4,0,41
82066,951331,1,5,6,1,0,42
82067,951331,1,6,1,3,0,45
82068,951331,1,6,2,1,0,46
82069,951331,1,6,3,0,0,46
82070,951331,1,6,4,1,0,47
82071,951331,1,6,5,2,0,49
82072,951331,1,6,6,0,0,49
82073,951331,1,7,1,0,0,49
82074,951331,1,7,2,0,0,49
82075,951331,1,7,3,2,0,51
82076,951331,1,7,4,0,0,51
82077,951331,1,7,5,6,0,57
82078,951331,1,7,6,1,0,58
82079,951331,1,8,1,1,0,59
82080,951331,1,8,2,1,0,60
82081,951331,1,8,3,1,0,61
82082,951331,1,8,4,0,0,61
82083,951331,1,8,5,1,0,62
82084,951331,1,8,6,1,0,63
82085,951331,1,9,1,1,0,64
82086,951331,1,9,2,0,0,64
82087,951331,1,9,3,1,0,65
82088,951331,1,9,4,4,0,69
82089,951331,1,9,5,1,0,70
82090,951331,1,9,6,4,0,74
82091,951331,1,10,1,1,0,75
82092,951331,1,10,2,1,0,76
82093,951331,1,10,3,2,0,78
82094,951331,1,10,4,1,0,79
82095,951331,1,10,5,1,0,80
82096,951331,1,10,6,1,0,81
82097,951331,1,11,1,7,0,88
82098,951331,1,11,2,0,0,88
82099,951331,1,11,3,2,0,90
82100,951331,1,11,4,1,0,91
82101,951331,1,11,5,1,0,92
82102,951331,1,11,6,0,0,92
82103,951331,1,12,1,0,1,92
82104,951331,1,12,2,0,0,92
82105,951331,1,12,3,1,0,93
82106,951331,1,12,4,1,0,94
82107,951331,1,12,5,1,0,95
82108,951331,1,12,6,1,0,96
82109,951331,1,13,1,0,0,96
82110,951331,1,13,2,4,0,100
82111,951331,1,13,3,1,0,101
82112,951331,1,13,4,1,0,102
82113,951331,1,13,5,1,0,103
82114,951331,1,13,6,0,0,103
82115,951331,1,14,1,1,0,104
82116,951331,1,14,2,1,0,105
82117,951331,1,14,3,1,0,106
82118,951331,1,14,4,6,0,112
82119,951331,1,14,5,2,0,114
82120,951331,1,14,6,0,0,114
82121,951331,1,15,1,0,0,114
82122,951331,1,15,2,0,1,114
82123,951331,1,15,3,1,0,115
82124,951331,1,15,4,1,0,116
82125,951331,1,15,5,6,0,122
82126,951331,1,15,6,1,0,123
82127,951331,1,16,1,1,0,124
82128,951331,1,16,2,1,0,125
82129,951331,1,16,3,1,0,126
82130,951331,1,16,4,1,0,127
82131,951331,1,16,5,1,0,128
82132,951331,1,16,6,0,0,128
82133,951331,1,17,1,1,0,129
82134,951331,1,17,2,6,0,135
82135,951331,1,17,3,0,0,135
82136,951331,1,17,4,1,0,136
82137,951331,1,17,5,2,0,138
82138,951331,1,17,6,4,0,142
82139,951331,1,18,1,1,0,143
82140,951331,1,18,2,1,0,144
82141,951331,1,18,3,6,0,150
82142,951331,1,18,4,2,0,152
82143,951331,1,18,5,0,1,152
82144,951331,1,18,6,0,0,152
82145,951331,1,19,1,4,0,156
82146,951331,1,19,2,0,0,156
82147,951331,1,19,3,6,0,162
82148,951331,1,19,4,1,0,163
82149,951331,1,19,5,1,0,164
82150,951331,1,19,6,0,0,164
82151,951331,1,20,1,6,0,170
82152,951331,1,20,2,1,0,171
82153,951331,1,20,3,4,0,175
82154,951331,1,20,4,0,1,175
82155,951331,1,20,5,6,0,181
82156,951331,1,20,6,1,1,182
82266,951333,1,1,1,0,0,0
82267,951333,1,1,2,1,0,1
82268,951333,1,1,3,0,0,1
82269,951333,1,1,4,4,0,5
82270,951333,1,1,5,1,0,6
82271,951333,1,1,6,1,0,7
82272,951333,1,2,1,6,0,13
82273,951333,1,2,2,0,0,13
82274,951333,1,2,3,6,0,19
82275,951333,1,2,4,1,0,20
82276,951333,1,2,5,1,0,21
82277,951333,1,2,6,4,0,25
82278,951333,1,3,1,1,0,26
82279,951333,1,3,2,0,0,26
82280,951333,1,3,3,0,1,26
82281,951333,1,3,4,0,0,26
82282,951333,1,3,5,6,0,32
82283,951333,1,3,6,0,0,32
82284,951333,1,4,1,4,0,36
82285,951333,1,4,2,0,0,36
82286,951333,1,4,3,0,0,36
82287,951333,1,4,4,0,0,36
82288,951333,1,4,5,1,0,37
82289,951333,1,4,6,1,0,38
82290,951333,1,5,1,1,0,39
82291,951333,1,5,2,0,0,39
82292,951333,1,5,3,4,0,43
82293,951333,1,5,4,1,0,44
82294,951333,1,5,5,0,0,44
82295,951333,1,5,6,0,0,44
82296,951333,1,6,1,0,0,44
82297,951333,1,6,2,1,0,45
82298,951333,1,6,3,4,0,49
82299,951333,1,6,4,1,0,50
82300,951333,1,6,5,4,0,54
82301,951333,1,6,6,1,0,55
82302,951333,1,7,1,1,0,56
82303,951333,1,7,2,1,0,57
82304,951333,1,7,3,0,0,57
82305,951333,1,7,4,1,0,58
82306,951333,1,7,5,1,0,59
82307,951333,1,7,6,6,0,65
82308,951333,1,8,1,1,0,66
82309,951333,1,8,2,1,0,67
82310,951333,1,8,3,4,0,71
82311,951333,1,8,4,1,0,72
82312,951333,1,8,5,1,0,73
82313,951333,1,8,6,4,0,77
82314,951333,1,9,1,1,0,78
82315,951333,1,9,2,1,0,79
82316,951333,1,9,3,1,0,80
82317,951333,1,9,4,1,0,81
82318,951333,1,9,5,1,0,82
82319,951333,1,9,6,1,0,83
82320,951333,1,10,1,4,0,87
82321,951333,1,10,2,0,0,87
82322,951333,1,10,3,1,0,88
82323,951333,1,10,4,0,0,88
82324,951333,1,10,5,0,0,88
82325,951333,1,10,6,2,0,90
82326,951333,1,11,1,0,0,90
82327,951333,1,11,2,1,0,91
82328,951333,1,11,3,2,0,93
82329,951333,1,11,4,4,0,97
82330,951333,1,11,5,0,0,97
82331,951333,1,11,6,2,0,99
82332,951333,1,12,1,0,0,99
82333,951333,1,12,2,4,0,103
82334,951333,1,12,3,1,0,104
82335,951333,1,12,4,0,0,104
82336,951333,1,12,5,1,0,105
82337,951333,1,12,6,1,0,106
82338,951333,1,13,1,4,0,110
82339,951333,1,13,2,1,0,111
82340,951333,1,13,3,0,0,111
82341,951333,1,13,4,4,0,115
82342,951333,1,13,5,1,0,116
82343,951333,1,13,6,1,0,117
82344,951333,1,14,1,1,0,118
82345,951333,1,14,2,2,0,120
82346,951333,1,14,3,1,0,121
82347,951333,1,14,4,0,0,121
82348,951333,1,14,5,0,1,121
82349,951333,1,14,6,0,0,121
82350,951333,1,15,1,1,0,122
82351,951333,1,15,2,1,0,123
82352,951333,1,15,3,4,0,127
82353,951333,1,15,4,4,0,131
82354,951333,1,15,5,7,0,138
82355,951333,1,15,6,1,0,139
82356,951333,1,16,1,2,0,141
82357,951333,1,16,2,1,0,142
82358,951333,1,16,3,4,0,146
82359,951333,1,16,4,4,0,150
82360,951333,1,16,5,1,0,151
82361,951333,1,16,6,6,0,157
82362,951333,1,17,1,1,0,158
82363,951333,1,17,2,1,0,159
82364,951333,1,17,3,4,0,163
82365,951333,1,17,4,0,1,163
82366,951333,1,17,5,4,0,167
82367,951333,1,17,6,1,0,168
82368,951333,1,18,1,6,0,174
82369,951333,1,18,2,0,0,174
82370,951333,1,18,3,1,0,175
82371,951333,1,18,4,0,0,175
82372,951333,1,18,5,0,1,175
82373,951333,1,18,6,1,0,176
82374,951333,1,19,1,1,0,177
82375,951333,1,19,2,4,0,181
82376,951333,1,19,3,1,0,182
82377,951333,1,19,4,0,0,182
82378,951333,1,19,5,1,0,183
82379,951333,1,19,6,6,0,189
82380,951333,1,20,1,4,0,193
82381,951333,1,20,2,4,0,197
82382,951333,1,20,3,1,0,198
82383,951333,1,20,4,0,1,198
82384,951333,1,20,5,2,0,200
82385,951333,1,20,6,1,0,201
82506,951335,1,1,1,1,0,1
82507,951335,1,1,2,0,0,1
82508,951335,1,1,3,0,0,1
82509,951335,1,1,4,0,0,1
82510,951335,1,1,5,1,0,2
82511,951335,1,1,6,1,0,3
82512,951335,1,2,1,3,0,6
82513,951335,1,2,2,0,0,6
82514,951335,1,2,3,0,0,6
82515,951335,1,2,4,0,0,6
82516,951335,1,2,5,0,0,6
82517,951335,1,2,6,0,0,6
82518,951335,1,3,1,1,0,7
82519,951335,1,3,2,1,0,8
82520,951335,1,3,3,0,0,8
82521,951335,1,3,4,4,0,12
82522,951335,1,3,5,0,1,12
82523,951335,1,3,6,0,0,12
82524,951335,1,4,1,0,0,12
82525,951335,1,4,2,4,0,16
82526,951335,1,4,3,4,0,20
82527,951335,1,4,4,0,0,20
82528,951335,1,4,5,0,0,20
82529,951335,1,4,6,2,0,22
82530,951335,1,5,1,1,0,23
82531,951335,1,5,2,4,0,27
82532,951335,1,5,3,1,0,28
82533,951335,1,5,4,1,0,29
82534,951335,1,5,5,1,0,30
82535,951335,1,5,6,0,0,30
82536,951335,1,6,1,2,0,32
82537,951335,1,6,2,1,0,33
82538,951335,1,6,3,1,0,34
82539,951335,1,6,4,1,0,35
82540,951335,1,6,5,0,0,35
82541,951335,1,6,6,1,0,36
82542,951335,1,7,1,1,0,37
82543,951335,1,7,2,4,0,41
82544,951335,1,7,3,0,0,41
82545,951335,1,7,4,0,0,41
82546,951335,1,7,5,0,0,41
82547,951335,1,7,6,1,0,42
82548,951335,1,8,1,0,0,42
82549,951335,1,8,2,1,0,43
82550,951335,1,8,3,0,0,43
82551,951335,1,8,4,0,0,43
82552,951335,1,8,5,1,0,44
82553,951335,1,8,6,0,0,44
82554,951335,1,9,1,0,1,44
82555,951335,1,9,2,1,0,45
82556,951335,1,9,3,0,0,45
82557,951335,1,9,4,0,0,45
82558,951335,1,9,5,0,0,45
82559,951335,1,9,6,0,0,45
82560,951335,1,10,1,1,0,46
82561,951335,1,10,2,0,0,46
82562,951335,1,10,3,0,1,46
82563,951335,1,10,4,1,0,47
82564,951335,1,10,5,0,0,47
82565,951335,1,10,6,0,0,47
82566,951335,1,11,1,1,0,48
82567,951335,1,11,2,1,0,49
82568,951335,1,11,3,1,0,50
82569,951335,1,11,4,0,0,50
82570,951335,1,11,5,1,0,51
82571,951335,1,11,6,0,1,51
82572,951335,1,12,1,0,0,51
82573,951335,1,12,2,1,0,52
82574,951335,1,12,3,1,0,53
82575,951335,1,12,4,1,0,54
82576,951335,1,12,5,4,0,58
82577,951335,1,12,6,1,0,59
82578,951335,1,13,1,1,0,60
82579,951335,1,13,2,1,0,61
82580,951335,1,13,3,1,0,62
82581,951335,1,13,4,6,0,68
82582,951335,1,13,5,6,0,74
82583,951335,1,13,6,1,0,75
82584,951335,1,14,1,1,0,76
82585,951335,1,14,2,1,0,77
82586,951335,1,14,3,0,0,77
82587,951335,1,14,4,2,0,79
82588,951335,1,14,5,1,0,80
82589,951335,1,14,6,1,0,81
82590,951335,1,15,1,0,0,81
82591,951335,1,15,2,0,0,81
82592,951335,1,15,3,6,0,87
82593,951335,1,15,4,1,0,88
82594,951335,1,15,5,6,0,94
82595,951335,1,15,6,0,0,94
82596,951335,1,16,1,1,0,95
82597,951335,1,16,2,1,0,96
82598,951335,1,16,3,0,0,96
82599,951335,1,16,4,1,0,97
82600,951335,1,16,5,4,0,101
82601,951335,1,16,6,4,0,105
82602,951335,1,17,1,1,0,106
82603,951335,1,17,2,6,0,112
82604,951335,1,17,3,0,1,112
82605,951335,1,17,4,1,0,113
82606,951335,1,17,5,1,0,114
82607,951335,1,17,6,4,0,118
82608,951335,1,18,1,0,0,118
82609,951335,1,18,2,1,0,119
82610,951335,1,18,3,1,0,120
82611,951335,1,18,4,2,0,122
82612,951335,1,18,5,1,0,123
82613,951335,1,18,6,1,0,124
82614,951335,1,19,1,1,0,125
82615,951335,1,19,2,6,0,131
82616,951335,1,19,3,1,0,132
82617,951335,1,19,4,0,1,132
82618,951335,1,19,5,4,0,136
82619,951335,1,19,6,0,1,136
82620,951335,1,20,1,2,0,138
82621,951335,1,20,2,2,0,140
82622,951335,1,20,3,1,0,141
82623,951335,1,20,4,6,0,147
82624,951335,1,20,5,4,0,151
82625,951335,1,20,6,2,0,153
82739,951337,1,1,1,0,0,0
82740,951337,1,1,2,0,0,0
82741,951337,1,1,3,4,0,4
82742,951337,1,1,4,4,0,8
82743,951337,1,1,5,1,0,9
82744,951337,1,1,6,0,0,9
82745,951337,1,2,1,0,0,9
82746,951337,1,2,2,0,0,9
82747,951337,1,2,3,0,0,9
82748,951337,1,2,4,1,0,10
82749,951337,1,2,5,4,0,14
82750,951337,1,2,6,0,0,14
82751,951337,1,3,1,6,0,20
82752,951337,1,3,2,6,0,26
82753,951337,1,3,3,0,0,26
82754,951337,1,3,4,0,0,26
82755,951337,1,3,5,0,0,26
82756,951337,1,3,6,6,0,32
82757,951337,1,4,1,1,0,33
82758,951337,1,4,2,0,0,33
82759,951337,1,4,3,0,0,33
82760,951337,1,4,4,0,0,33
82761,951337,1,4,5,1,0,34
82762,951337,1,4,6,1,0,35
82763,951337,1,5,1,0,0,35
82764,951337,1,5,2,0,0,35
82765,951337,1,5,3,0,0,35
82766,951337,1,5,4,4,0,39
82767,951337,1,5,5,4,0,43
82768,951337,1,5,6,1,0,44
82769,951337,1,6,1,1,0,45
82770,951337,1,6,2,1,0,46
82771,951337,1,6,3,1,0,47
82772,951337,1,6,4,6,0,53
82773,951337,1,6,5,1,0,54
82774,951337,1,6,6,4,0,58
82775,951337,1,7,1,1,0,59
82776,951337,1,7,2,1,0,60
82777,951337,1,7,3,0,0,60
82778,951337,1,7,4,0,0,60
82779,951337,1,7,5,1,0,61
82780,951337,1,7,6,0,0,61
82781,951337,1,8,1,0,1,61
82782,951337,1,8,2,1,0,62
82783,951337,1,8,3,1,0,63
82784,951337,1,8,4,0,0,63
82785,951337,1,8,5,1,0,64
82786,951337,1,8,6,1,0,65
82787,951337,1,9,1,1,0,66
82788,951337,1,9,2,0,1,66
82789,951337,1,9,3,1,0,67
82790,951337,1,9,4,0,0,67
82791,951337,1,9,5,1,0,68
82792,951337,1,9,6,1,0,69
82793,951337,1,10,1,2,0,71
82794,951337,1,10,2,1,0,72
82795,951337,1,10,3,1,0,73
82796,951337,1,10,4,0,0,73
82797,951337,1,10,5,1,0,74
82798,951337,1,10,6,1,0,75
82799,951337,1,11,1,1,0,76
82800,951337,1,11,2,0,1,76
82801,951337,1,11,3,0,0,76
82802,951337,1,11,4,2,0,78
82803,951337,1,11,5,1,0,79
82804,951337,1,11,6,0,0,79
82805,951337,1,12,1,0,0,79
82806,951337,1,12,2,0,0,79
82807,951337,1,12,3,0,0,79
82808,951337,1,12,4,1,0,80
82809,951337,1,12,5,1,0,81
82810,951337,1,12,6,1,0,82
82811,951337,1,13,1,4,0,86
82812,951337,1,13,2,1,0,87
82813,951337,1,13,3,1,0,88
82814,951337,1,13,4,0,0,88
82815,951337,1,13,5,4,0,92
82816,951337,1,13,6,4,0,96
82817,951337,1,14,1,0,0,96
82818,951337,1,14,2,1,0,97
82819,951337,1,14,3,0,0,97
82820,951337,1,14,4,0,0,97
82821,951337,1,14,5,0,0,97
82822,951337,1,14,6,0,1,97
82823,951337,1,15,1,0,0,97
82824,951337,1,15,2,1,0,98
82825,951337,1,15,3,0,0,98
82826,951337,1,15,4,1,0,99
82827,951337,1,15,5,0,0,99
82828,951337,1,15,6,0,0,99
82829,951337,1,16,1,0,0,99
82830,951337,1,16,2,1,0,100
82831,951337,1,16,3,4,0,104
82832,951337,1,16,4,0,0,104
82833,951337,1,16,5,2,0,106
82834,951337,1,16,6,1,0,107
82835,951337,1,17,1,2,0,109
82836,951337,1,17,2,1,0,110
82837,951337,1,17,3,7,0,117
82838,951337,1,17,4,0,1,117
82839,951337,1,17,5,0,0,117
82840,951337,1,17,6,1,0,118
82841,951337,1,18,1,1,0,119
82842,951337,1,18,2,4,0,123
82843,951337,1,18,3,0,0,123
82844,951337,1,18,4,1,0,124
82845,951337,1,18,5,1,0,125
82846,951337,1,18,6,4,0,129
82847,951337,1,19,1,1,0,130
82848,951337,1,19,2,0,0,130
82849,951337,1,19,3,1,0,131
82850,951337,1,19,4,2,0,133
82851,951337,1,19,5,0,1,133
82852,951337,1,19,6,1,0,134
82853,951337,1,20,1,2,0,136
82854,951337,1,20,2,2,0,138
82855,951337,1,20,3,1,0,139
82856,951337,1,20,4,1,1,140
82857,951337,1,20,5,2,0,142
82858,951337,1,20,6,0,1,142
82979,951339,1,1,1,0,0,0
82980,951339,1,1,2,1,0,1
82981,951339,1,1,3,0,0,1
82982,951339,1,1,4,0,0,1
82983,951339,1,1,5,0,0,1
82984,951339,1,1,6,1,0,2
82985,951339,1,2,1,6,0,8
82986,951339,1,2,2,0,0,8
82987,951339,1,2,3,4,0,12
82988,951339,1,2,4,4,0,16
82989,951339,1,2,5,1,0,17
82990,951339,1,2,6,0,0,17
82991,951339,1,3,1,0,0,17
82992,951339,1,3,2,0,0,17
82993,951339,1,3,3,6,0,23
82994,951339,1,3,4,4,0,27
82995,951339,1,3,5,4,0,31
82996,951339,1,3,6,6,0,37
82997,951339,1,4,1,4,0,41
82998,951339,1,4,2,0,0,41
82999,951339,1,4,3,4,0,45
83000,951339,1,4,4,1,0,46
83001,951339,1,4,5,4,0,50
83002,951339,1,4,6,0,0,50
83003,951339,1,5,1,4,0,54
83004,951339,1,5,2,4,0,58
83005,951339,1,5,3,4,0,62
83006,951339,1,5,4,6,0,68
83007,951339,1,5,5,4,0,72
83008,951339,1,5,6,0,0,72
83009,951339,1,6,1,1,0,73
83010,951339,1,6,2,0,0,73
83011,951339,1,6,3,4,0,77
83012,951339,1,6,4,1,0,78
83013,951339,1,6,5,4,0,82
83014,951339,1,6,6,1,0,83
83015,951339,1,7,1,4,0,87
83016,951339,1,7,2,1,0,88
83017,951339,1,7,3,0,0,88
83018,951339,1,7,4,1,0,89
83019,951339,1,7,5,1,0,90
83020,951339,1,7,6,6,0,96
83021,951339,1,8,1,0,1,96
83022,951339,1,8,2,1,0,97
83023,951339,1,8,3,1,0,98
83024,951339,1,8,4,0,0,98
83025,951339,1,8,5,1,0,99
83026,951339,1,8,6,1,0,100
83027,951339,1,9,1,2,0,102
83028,951339,1,9,2,0,0,102
83029,951339,1,9,3,6,0,108
83030,951339,1,9,4,6,0,114
83031,951339,1,9,5,0,0,114
83032,951339,1,9,6,0,1,114
83033,951339,1,10,1,1,0,115
83034,951339,1,10,2,1,0,116
83035,951339,1,10,3,1,0,117
83036,951339,1,10,4,1,0,118
83037,951339,1,10,5,1,0,119
83038,951339,1,10,6,6,0,125
83039,951339,1,11,1,1,0,126
83040,951339,1,11,2,1,0,127
83041,951339,1,11,3,0,0,127
83042,951339,1,11,4,1,0,128
83043,951339,1,11,5,0,0,128
83044,951339,1,11,6,0,0,128
83045,951339,1,12,1,1,0,129
83046,951339,1,12,2,2,0,131
83047,951339,1,12,3,1,0,132
83048,951339,1,12,4,1,0,133
83049,951339,1,12,5,0,1,133
83050,951339,1,12,6,1,0,134
83051,951339,1,13,1,1,0,135
83052,951339,1,13,2,1,0,136
83053,951339,1,13,3,1,0,137
83054,951339,1,13,4,0,0,137
83055,951339,1,13,5,1,0,138
83056,951339,1,13,6,1,0,139
83057,951339,1,14,1,2,0,141
83058,951339,1,14,2,1,0,142
83059,951339,1,14,3,1,0,143
83060,951339,1,14,4,4,0,147
83061,951339,1,14,5,4,0,151
83062,951339,1,14,6,1,0,152
83063,951339,1,15,1,1,0,153
83064,951339,1,15,2,4,0,157
83065,951339,1,15,3,2,0,159
83066,951339,1,15,4,1,0,160
83067,951339,1,15,5,4,0,164
83068,951339,1,15,6,2,0,166
83069,951339,1,16,1,1,0,167
83070,951339,1,16,2,2,0,169
83071,951339,1,16,3,0,1,169
83072,951339,1,16,4,2,0,171
83073,951339,1,16,5,1,0,172
83074,951339,1,16,6,1,0,173
83075,951339,1,17,1,1,0,174
83076,951339,1,17,2,4,0,178
83077,951339,1,17,3,1,0,179
83078,951339,1,17,4,1,0,180
83079,951339,1,17,5,1,0,181
83080,951339,1,17,6,1,0,182
83081,951339,1,18,1,1,0,183
83082,951339,1,18,2,1,0,184
83083,951339,1,18,3,1,0,185
83084,951339,1,18,4,6,0,191
83085,951339,1,18,5,1,0,192
83086,951339,1,18,6,1,0,193
83087,951339,1,19,1,6,0,199
83088,951339,1,19,2,6,0,205
83089,951339,1,19,3,1,0,206
83090,951339,1,19,4,1,0,207
83091,951339,1,19,5,3,0,210
83092,951339,1,19,6,1,0,211
83093,951339,1,20,1,1,0,212
83094,951339,1,20,2,6,0,218
83095,951339,1,20,3,0,0,218
83096,951339,1,20,4,1,0,219
83097,951339,1,20,5,6,0,225
83098,951339,1,20,6,4,0,229
83217,951341,1,1,1,1,0,1
83218,951341,1,1,2,1,0,2
83219,951341,1,1,3,0,0,2
83220,951341,1,1,4,1,0,3
83221,951341,1,1,5,0,0,3
83222,951341,1,1,6,0,0,3
83223,951341,1,2,1,0,0,3
83224,951341,1,2,2,0,0,3
83225,951341,1,2,3,0,0,3
83226,951341,1,2,4,0,0,3
83227,951341,1,2,5,1,0,4
83228,951341,1,2,6,1,0,5
83229,951341,1,3,1,1,0,6
83230,951341,1,3,2,1,0,7
83231,951341,1,3,3,0,0,7
83232,951341,1,3,4,0,0,7
83233,951341,1,3,5,1,0,8
83234,951341,1,3,6,4,0,12
83235,951341,1,4,1,1,0,13
83236,951341,1,4,2,0,0,13
83237,951341,1,4,3,1,0,14
83238,951341,1,4,4,4,0,18
83239,951341,1,4,5,0,0,18
83240,951341,1,4,6,1,0,19
83241,951341,1,5,1,1,0,20
83242,951341,1,5,2,0,0,20
83243,951341,1,5,3,0,0,20
83244,951341,1,5,4,0,0,20
83245,951341,1,5,5,0,0,20
83246,951341,1,5,6,4,0,24
83247,951341,1,6,1,0,0,24
83248,951341,1,6,2,1,0,25
83249,951341,1,6,3,1,0,26
83250,951341,1,6,4,1,0,27
83251,951341,1,6,5,0,0,27
83252,951341,1,6,6,1,0,28
83253,951341,1,7,1,1,0,29
83254,951341,1,7,2,1,0,30
83255,951341,1,7,3,0,0,30
83256,951341,1,7,4,4,0,34
83257,951341,1,7,5,0,0,34
83258,951341,1,7,6,0,0,34
83259,951341,1,8,1,1,0,35
83260,951341,1,8,2,2,0,37
83261,951341,1,8,3,1,0,38
83262,951341,1,8,4,0,1,38
83263,951341,1,8,5,0,0,38
83264,951341,1,8,6,1,0,39
83265,951341,1,9,1,1,0,40
83266,951341,1,9,2,0,0,40
83267,951341,1,9,3,0,0,40
83268,951341,1,9,4,1,0,41
83269,951341,1,9,5,1,0,42
83270,951341,1,9,6,0,0,42
83271,951341,1,10,1,4,0,46
83272,951341,1,10,2,0,1,46
83273,951341,1,10,3,4,0,50
83274,951341,1,10,4,0,0,50
83275,951341,1,10,5,0,0,50
83276,951341,1,10,6,1,0,51
83277,951341,1,11,1,0,0,51
83278,951341,1,11,2,1,0,52
83279,951341,1,11,3,0,0,52
83280,951341,1,11,4,0,0,52
83281,951341,1,11,5,1,0,53
83282,951341,1,11,6,1,0,54
83283,951341,1,12,1,1,0,55
83284,951341,1,12,2,4,0,59
83285,951341,1,12,3,1,0,60
83286,951341,1,12,4,0,0,60
83287,951341,1,12,5,0,1,60
83288,951341,1,12,6,5,0,65
83289,951341,1,13,1,0,0,65
83290,951341,1,13,2,0,0,65
83291,951341,1,13,3,1,0,66
83292,951341,1,13,4,0,0,66
83293,951341,1,13,5,0,0,66
83294,951341,1,13,6,1,0,67
83295,951341,1,14,1,1,0,68
83296,951341,1,14,2,1,0,69
83297,951341,1,14,3,0,0,69
83298,951341,1,14,4,6,0,75
83299,951341,1,14,5,1,0,76
83300,951341,1,14,6,6,0,82
83301,951341,1,15,1,1,0,83
83302,951341,1,15,2,3,0,86
83303,951341,1,15,3,1,0,87
83304,951341,1,15,4,4,0,91
83305,951341,1,15,5,4,0,95
83306,951341,1,15,6,0,0,95
83307,951341,1,16,1,0,0,95
83308,951341,1,16,2,1,0,96
83309,951341,1,16,3,4,0,100
83310,951341,1,16,4,1,0,101
83311,951341,1,16,5,0,1,101
83312,951341,1,16,6,2,0,103
83313,951341,1,17,1,2,0,105
83314,951341,1,17,2,0,1,105
83315,951341,1,17,3,1,0,106
83316,951341,1,17,4,1,0,107
83317,951341,1,17,5,4,0,111
83318,951341,1,17,6,0,0,111
83319,951341,1,18,1,1,0,112
83320,951341,1,18,2,1,0,113
83321,951341,1,18,3,2,0,115
83322,951341,1,18,4,1,0,116
83323,951341,1,18,5,1,0,117
83324,951341,1,18,6,1,0,118
83420,951343,1,1,1,0,0,0
83421,951343,1,1,2,4,0,4
83422,951343,1,1,3,4,0,8
83423,951343,1,1,4,0,0,8
83424,951343,1,1,5,4,0,12
83425,951343,1,1,6,0,0,12
83426,951343,1,2,1,1,0,13
83427,951343,1,2,2,4,0,17
83428,951343,1,2,3,0,0,17
83429,951343,1,2,4,0,0,17
83430,951343,1,2,5,0,0,17
83431,951343,1,2,6,4,0,21
83432,951343,1,3,1,0,0,21
83433,951343,1,3,2,0,0,21
83434,951343,1,3,3,4,0,25
83435,951343,1,3,4,0,1,25
83436,951343,1,3,5,4,0,29
83437,951343,1,3,6,1,0,30
83438,951343,1,4,1,0,0,30
83439,951343,1,4,2,0,0,30
83440,951343,1,4,3,0,0,30
83441,951343,1,4,4,4,0,34
83442,951343,1,4,5,0,0,34
83443,951343,1,4,6,4,0,38
83444,951343,1,5,1,1,0,39
83445,951343,1,5,2,1,0,40
83446,951343,1,5,3,4,0,44
83447,951343,1,5,4,0,0,44
83448,951343,1,5,5,1,0,45
83449,951343,1,5,6,4,0,49
83450,951343,1,6,1,6,0,55
83451,951343,1,6,2,6,0,61
83452,951343,1,6,3,1,0,62
83453,951343,1,6,4,4,0,66
83454,951343,1,6,5,0,0,66
83455,951343,1,6,6,0,0,66
83456,951343,1,7,1,0,0,66
83457,951343,1,7,2,0,0,66
83458,951343,1,7,3,1,0,67
83459,951343,1,7,4,0,0,67
83460,951343,1,7,5,0,0,67
83461,951343,1,7,6,1,0,68
83462,951343,1,8,1,1,0,69
83463,951343,1,8,2,1,0,70
83464,951343,1,8,3,6,0,76
83465,951343,1,8,4,0,0,76
83466,951343,1,8,5,0,0,76
83467,951343,1,8,6,0,0,76
83468,951343,1,9,1,1,0,77
83469,951343,1,9,2,4,0,81
83470,951343,1,9,3,1,0,82
83471,951343,1,9,4,0,0,82
83472,951343,1,9,5,1,0,83
83473,951343,1,9,6,1,0,84
83474,951343,1,10,1,1,0,85
83475,951343,1,10,2,1,0,86
83476,951343,1,10,3,4,0,90
83477,951343,1,10,4,0,1,90
83478,951343,1,10,5,1,0,91
83479,951343,1,10,6,1,0,92
83480,951343,1,11,1,1,0,93
83481,951343,1,11,2,0,0,93
83482,951343,1,11,3,0,0,93
83483,951343,1,11,4,1,0,94
83484,951343,1,11,5,0,0,94
83485,951343,1,11,6,0,0,94
83486,951343,1,12,1,0,0,94
83487,951343,1,12,2,2,0,96
83488,951343,1,12,3,1,0,97
83489,951343,1,12,4,0,1,97
83490,951343,1,12,5,1,0,98
83491,951343,1,12,6,1,0,99
83492,951343,1,13,1,4,0,103
83493,951343,1,13,2,1,0,104
83494,951343,1,13,3,1,0,105
83495,951343,1,13,4,2,0,107
83496,951343,1,13,5,1,0,108
83497,951343,1,13,6,2,0,110
83498,951343,1,14,1,1,0,111
83499,951343,1,14,2,1,0,112
83500,951343,1,14,3,1,0,113
83501,951343,1,14,4,4,0,117
83502,951343,1,14,5,1,0,118
83503,951343,1,14,6,4,0,122
83504,951343,1,15,1,0,0,122
83505,951343,1,15,2,1,0,123
83506,951343,1,15,3,2,0,125
83507,951343,1,15,4,4,0,129
83508,951343,1,15,5,1,0,130
83509,951343,1,15,6,1,0,131
83510,951343,1,16,1,0,0,131
83511,951343,1,16,2,1,0,132
83512,951343,1,16,3,4,0,136
83513,951343,1,16,4,1,0,137
83514,951343,1,16,5,1,0,138
83515,951343,1,16,6,0,0,138
83516,951343,1,17,1,6,0,144
83517,951343,1,17,2,4,0,148
83518,951343,1,17,3,6,0,154
83519,951343,1,17,4,6,0,160
83520,951343,1,17,5,6,0,166
83521,951343,1,17,6,1,0,167
83522,951343,1,18,1,6,0,173
83523,951343,1,18,2,0,0,173
83524,951343,1,18,3,0,1,173
83525,951343,1,18,4,4,0,177
83526,951343,1,18,5,1,0,178
83527,951343,1,18,6,1,0,179
83528,951343,1,19,1,1,0,180
83529,951343,1,19,2,1,0,181
83530,951343,1,19,3,1,0,182
83531,951343,1,19,4,1,0,183
83532,951343,1,19,5,2,0,185
83533,951343,1,19,6,4,0,189
83534,951343,1,20,1,3,0,192
83535,951343,1,20,2,1,0,193
83536,951343,1,20,3,6,0,199
83537,951343,1,20,4,4,0,203
83538,951343,1,20,5,0,1,203
83539,951343,1,20,6,6,0,209
83660,951345,1,1,1,1,0,1
83661,951345,1,1,2,6,0,7
83662,951345,1,1,3,4,0,11
83663,951345,1,1,4,1,0,12
83664,951345,1,1,5,1,0,13
83665,951345,1,1,6,0,0,13
83666,951345,1,2,1,0,0,13
83667,951345,1,2,2,0,0,13
83668,951345,1,2,3,0,0,13
83669,951345,1,2,4,1,0,14
83670,951345,1,2,5,1,0,15
83671,951345,1,2,6,4,0,19
83672,951345,1,3,1,0,0,19
83673,951345,1,3,2,0,0,19
83674,951345,1,3,3,0,0,19
83675,951345,1,3,4,1,0,20
83676,951345,1,3,5,0,0,20
83677,951345,1,3,6,0,0,20
83678,951345,1,4,1,0,1,20
83679,951345,1,4,2,1,0,21
83680,951345,1,4,3,1,0,22
83681,951345,1,4,4,1,0,23
83682,951345,1,4,5,6,0,29
83683,951345,1,4,6,1,0,30
83684,951345,1,5,1,0,0,30
83685,951345,1,5,2,2,0,32
83686,951345,1,5,3,0,0,32
83687,951345,1,5,4,0,0,32
83688,951345,1,5,5,0,0,32
83689,951345,1,5,6,0,1,32
83690,951345,1,6,1,0,0,32
83691,951345,1,6,2,0,0,32
83692,951345,1,6,3,4,0,36
83693,951345,1,6,4,1,0,37
83694,951345,1,6,5,0,0,37
83695,951345,1,6,6,4,0,41
83696,951345,1,7,1,0,1,41
83697,951345,1,7,2,0,0,41
83698,951345,1,7,3,1,0,42
83699,951345,1,7,4,0,0,42
83700,951345,1,7,5,0,0,42
83701,951345,1,7,6,1,0,43
83702,951345,1,8,1,0,0,43
83703,951345,1,8,2,0,0,43
83704,951345,1,8,3,1,0,44
83705,951345,1,8,4,1,0,45
83706,951345,1,8,5,2,0,47
83707,951345,1,8,6,0,0,47
83708,951345,1,9,1,0,1,47
83709,951345,1,9,2,0,0,47
83710,951345,1,9,3,0,0,47
83711,951345,1,9,4,0,1,47
83712,951345,1,9,5,1,0,48
83713,951345,1,9,6,1,0,49
83714,951345,1,10,1,0,0,49
83715,951345,1,10,2,1,0,50
83716,951345,1,10,3,1,0,51
83717,951345,1,10,4,0,0,51
83718,951345,1,10,5,2,0,53
83719,951345,1,10,6,1,0,54
83720,951345,1,11,1,1,0,55
83721,951345,1,11,2,1,0,56
83722,951345,1,11,3,0,0,56
83723,951345,1,11,4,0,0,56
83724,951345,1,11,5,0,0,56
83725,951345,1,11,6,1,0,57
83726,951345,1,12,1,1,0,58
83727,951345,1,12,2,2,0,60
83728,951345,1,12,3,1,0,61
83729,951345,1,12,4,1,0,62
83730,951345,1,12,5,2,0,64
83731,951345,1,12,6,1,0,65
83732,951345,1,13,1,0,0,65
83733,951345,1,13,2,0,0,65
83734,951345,1,13,3,0,0,65
83735,951345,1,13,4,0,0,65
83736,951345,1,13,5,1,0,66
83737,951345,1,13,6,1,0,67
83738,951345,1,14,1,0,0,67
83739,951345,1,14,2,4,0,71
83740,951345,1,14,3,0,0,71
83741,951345,1,14,4,1,0,72
83742,951345,1,14,5,1,0,73
83743,951345,1,14,6,0,0,73
83744,951345,1,15,1,0,0,73
83745,951345,1,15,2,1,0,74
83746,951345,1,15,3,4,0,78
83747,951345,1,15,4,1,0,79
83748,951345,1,15,5,1,0,80
83749,951345,1,15,6,1,0,81
83750,951345,1,16,1,0,0,81
83751,951345,1,16,2,6,0,87
83752,951345,1,16,3,1,0,88
83753,951345,1,16,4,0,0,88
83754,951345,1,16,5,1,0,89
83755,951345,1,16,6,1,0,90
83756,951345,1,17,1,1,1,91
83757,951345,1,17,2,0,0,91
83758,951345,1,17,3,1,0,92
83759,951345,1,17,4,1,0,93
83760,951345,1,17,5,1,0,94
83761,951345,1,17,6,0,0,94
83762,951345,1,18,1,2,0,96
83763,951345,1,18,2,4,0,100
83764,951345,1,18,3,6,0,106
83765,951345,1,18,4,1,0,107
83766,951345,1,18,5,2,0,109
83767,951345,1,18,6,1,0,110
83768,951345,1,19,1,1,0,111
83769,951345,1,19,2,4,0,115
83770,951345,1,19,3,0,0,115
83771,951345,1,19,4,1,0,116
83772,951345,1,19,5,0,1,116
83773,951345,1,19,6,2,0,118
83774,951345,1,20,1,1,0,119
83775,951345,1,20,2,1,0,120
83776,951345,1,20,3,1,0,121
83777,951345,1,20,4,0,1,121
83778,951345,1,20,5,0,1,121
83779,951345,1,20,6,1,0,122
83890,951347,1,1,1,1,0,1
83891,951347,1,1,2,0,0,1
83892,951347,1,1,3,0,0,1
83893,951347,1,1,4,0,0,1
83894,951347,1,1,5,1,0,2
83895,951347,1,1,6,0,0,2
83896,951347,1,2,1,0,0,2
83897,951347,1,2,2,0,1,2
83898,951347,1,2,3,2,0,4
83899,951347,1,2,4,1,0,5
83900,951347,1,2,5,0,0,5
83901,951347,1,2,6,0,0,5
83902,951347,1,3,1,1,0,6
83903,951347,1,3,2,0,0,6
83904,951347,1,3,3,0,0,6
83905,951347,1,3,4,2,0,8
83906,951347,1,3,5,1,0,9
83907,951347,1,3,6,1,0,10
83908,951347,1,4,1,1,0,11
83909,951347,1,4,2,4,0,15
83910,951347,1,4,3,0,0,15
83911,951347,1,4,4,4,0,19
83912,951347,1,4,5,0,0,19
83913,951347,1,4,6,0,0,19
83914,951347,1,5,1,1,0,20
83915,951347,1,5,2,0,0,20
83916,951347,1,5,3,1,0,21
83917,951347,1,5,4,1,0,22
83918,951347,1,5,5,2,0,24
83919,951347,1,5,6,1,0,25
83920,951347,1,6,1,0,1,25
83921,951347,1,6,2,0,0,25
83922,951347,1,6,3,2,0,27
83923,951347,1,6,4,4,0,31
83924,951347,1,6,5,1,0,32
83925,951347,1,6,6,1,0,33
83926,951347,1,7,1,4,0,37
83927,951347,1,7,2,0,0,37
83928,951347,1,7,3,0,0,37
83929,951347,1,7,4,1,0,38
83930,951347,1,7,5,1,0,39
83931,951347,1,7,6,6,0,45
83932,951347,1,8,1,0,0,45
83933,951347,1,8,2,1,0,46
83934,951347,1,8,3,0,0,46
83935,951347,1,8,4,0,0,46
83936,951347,1,8,5,2,0,48
83937,951347,1,8,6,1,0,49
83938,951347,1,9,1,1,0,50
83939,951347,1,9,2,0,0,50
83940,951347,1,9,3,0,0,50
83941,951347,1,9,4,4,0,54
83942,951347,1,9,5,6,0,60
83943,951347,1,9,6,1,0,61
83944,951347,1,10,1,1,0,62
83945,951347,1,10,2,0,1,62
83946,951347,1,10,3,0,0,62
83947,951347,1,10,4,1,0,63
83948,951347,1,10,5,1,0,64
83949,951347,1,10,6,0,0,64
83950,951347,1,11,1,1,0,65
83951,951347,1,11,2,0,0,65
83952,951347,1,11,3,0,0,65
83953,951347,1,11,4,1,0,66
83954,951347,1,11,5,1,0,67
83955,951347,1,11,6,1,0,68
83956,951347,1,12,1,6,0,74
83957,951347,1,12,2,4,0,78
83958,951347,1,12,3,0,1,78
83959,951347,1,12,4,1,0,79
83960,951347,1,12,5,1,0,80
83961,951347,1,12,6,0,0,80
83962,951347,1,13,1,1,0,81
83963,951347,1,13,2,0,0,81
83964,951347,1,13,3,4,0,85
83965,951347,1,13,4,6,0,91
83966,951347,1,13,5,0,0,91
83967,951347,1,13,6,0,0,91
83968,951347,1,14,1,1,0,92
83969,951347,1,14,2,1,0,93
83970,951347,1,14,3,1,0,94
83971,951347,1,14,4,1,0,95
83972,951347,1,14,5,0,0,95
83973,951347,1,14,6,1,0,96
83974,951347,1,15,1,1,0,97
83975,951347,1,15,2,1,0,98
83976,951347,1,15,3,4,0,102
83977,951347,1,15,4,0,0,102
83978,951347,1,15,5,1,0,103
83979,951347,1,15,6,1,0,104
83980,951347,1,16,1,1,0,105
83981,951347,1,16,2,0,1,105
83982,951347,1,16,3,1,0,106
83983,951347,1,16,4,1,0,107
83984,951347,1,16,5,0,0,107
83985,951347,1,16,6,1,0,108
83986,951347,1,17,1,1,0,109
83987,951347,1,17,2,1,0,110
83988,951347,1,17,3,1,0,111
83989,951347,1,17,4,0,0,111
83990,951347,1,17,5,1,0,112
83991,951347,1,17,6,0,0,112
83992,951347,1,18,1,4,0,116
83993,951347,1,18,2,4,0,120
83994,951347,1,18,3,1,0,121
83995,951347,1,18,4,4,0,125
83996,951347,1,18,5,1,0,126
83997,951347,1,18,6,1,0,127
83998,951347,1,19,1,2,0,129
83999,951347,1,19,2,5,0,134
84000,951347,1,19,3,1,0,135
84001,951347,1,19,4,4,0,139
84002,951347,1,19,5,1,0,140
84003,951347,1,19,6,4,0,144
84004,951347,1,20,1,1,0,145
84005,951347,1,20,2,4,0,149
84006,951347,1,20,3,4,0,153
84007,951347,1,20,4,2,0,155
84008,951347,1,20,5,0,0,155
84009,951347,1,20,6,1,0,156
84121,951349,1,1,1,0,0,0
84122,951349,1,1,2,0,0,0
84123,951349,1,1,3,0,0,0
84124,951349,1,1,4,0,0,0
84125,951349,1,1,5,1,0,1
84126,951349,1,1,6,0,0,1
84127,951349,1,2,1,0,0,1
84128,951349,1,2,2,6,0,7
84129,951349,1,2,3,1,0,8
84130,951349,1,2,4,2,0,10
84131,951349,1,2,5,4,0,14
84132,951349,1,2,6,0,0,14
84133,951349,1,3,1,4,0,18
84134,951349,1,3,2,0,0,18
84135,951349,1,3,3,0,0,18
84136,951349,1,3,4,5,0,23
84137,951349,1,3,5,4,0,27
84138,951349,1,3,6,0,0,27
84139,951349,1,4,1,0,0,27
84140,951349,1,4,2,1,0,28
84141,951349,1,4,3,2,0,30
84142,951349,1,4,4,4,0,34
84143,951349,1,4,5,1,0,35
84144,951349,1,4,6,0,0,35
84145,951349,1,5,1,0,0,35
84146,951349,1,5,2,1,0,36
84147,951349,1,5,3,1,0,37
84148,951349,1,5,4,0,0,37
84149,951349,1,5,5,1,0,38
84150,951349,1,5,6,6,0,44
84151,951349,1,6,1,0,0,44
84152,951349,1,6,2,1,0,45
84153,951349,1,6,3,0,0,45
84154,951349,1,6,4,6,0,51
84155,951349,1,6,5,4,0,55
84156,951349,1,6,6,0,0,55
84157,951349,1,7,1,1,0,56
84158,951349,1,7,2,1,0,57
84159,951349,1,7,3,0,0,57
84160,951349,1,7,4,2,0,59
84161,951349,1,7,5,0,0,59
84162,951349,1,7,6,1,0,60
84163,951349,1,8,1,2,0,62
84164,951349,1,8,2,0,1,62
84165,951349,1,8,3,1,0,63
84166,951349,1,8,4,4,0,67
84167,951349,1,8,5,1,0,68
84168,951349,1,8,6,1,0,69
84169,951349,1,9,1,0,0,69
84170,951349,1,9,2,4,0,73
84171,951349,1,9,3,1,0,74
84172,951349,1,9,4,1,0,75
84173,951349,1,9,5,0,1,75
84174,951349,1,9,6,1,0,76
84175,951349,1,10,1,1,0,77
84176,951349,1,10,2,1,0,78
84177,951349,1,10,3,0,0,78
84178,951349,1,10,4,1,0,79
84179,951349,1,10,5,1,0,80
84180,951349,1,10,6,1,0,81
84181,951349,1,11,1,0,0,81
84182,951349,1,11,2,2,0,83
84183,951349,1,11,3,4,0,87
84184,951349,1,11,4,0,0,87
84185,951349,1,11,5,4,0,91
84186,951349,1,11,6,2,0,93
84187,951349,1,12,1,2,0,95
84188,951349,1,12,2,1,0,96
84189,951349,1,12,3,1,0,97
84190,951349,1,12,4,2,0,99
84191,951349,1,12,5,0,0,99
84192,951349,1,12,6,1,0,100
84193,951349,1,13,1,0,0,100
84194,951349,1,13,2,4,0,104
84195,951349,1,13,3,1,0,105
84196,951349,1,13,4,1,0,106
84197,951349,1,13,5,0,0,106
84198,951349,1,13,6,4,0,110
84199,951349,1,14,1,4,0,114
84200,951349,1,14,2,2,0,116
84201,951349,1,14,3,0,0,116
84202,951349,1,14,4,4,0,120
84203,951349,1,14,5,2,0,122
84204,951349,1,14,6,1,0,123
84205,951349,1,15,1,4,0,127
84206,951349,1,15,2,0,0,127
84207,951349,1,15,3,0,1,127
84208,951349,1,15,4,0,0,127
84209,951349,1,15,5,0,0,127
84210,951349,1,15,6,0,0,127
84211,951349,1,16,1,5,0,132
84212,951349,1,16,2,0,1,132
84213,951349,1,16,3,0,0,132
84214,951349,1,16,4,1,0,133
84215,951349,1,16,5,1,0,134
84216,951349,1,16,6,1,0,135
84217,951349,1,17,1,4,0,139
84218,951349,1,17,2,2,0,141
84219,951349,1,17,3,2,0,143
84220,951349,1,17,4,1,0,144
84221,951349,1,17,5,1,0,145
84222,951349,1,17,6,1,0,146
84223,951349,1,18,1,1,0,147
84224,951349,1,18,2,1,0,148
84225,951349,1,18,3,3,0,151
84226,951349,1,18,4,6,0,157
84227,951349,1,18,5,1,0,158
84228,951349,1,18,6,2,0,160
84229,951349,1,19,1,1,0,161
84230,951349,1,19,2,0,0,161
84231,951349,1,19,3,2,0,163
84232,951349,1,19,4,0,0,163
84233,951349,1,19,5,1,0,164
84234,951349,1,19,6,0,1,164
84235,951349,1,20,1,6,0,170
84236,951349,1,20,2,1,0,171
84237,951349,1,20,3,1,0,172
84238,951349,1,20,4,2,0,174
84239,951349,1,20,5,4,0,178
84240,951349,1,20,6,2,0,180
84361,951351,1,1,1,1,0,1
84362,951351,1,1,2,0,0,1
84363,951351,1,1,3,0,0,1
84364,951351,1,1,4,0,0,1
84365,951351,1,1,5,1,0,2
84366,951351,1,1,6,0,0,2
84367,951351,1,2,1,1,0,3
84368,951351,1,2,2,0,0,3
84369,951351,1,2,3,3,0,6
84370,951351,1,2,4,1,0,7
84371,951351,1,2,5,4,0,11
84372,951351,1,2,6,0,0,11
84373,951351,1,3,1,4,0,15
84374,951351,1,3,2,0,0,15
84375,951351,1,3,3,0,0,15
84376,951351,1,3,4,0,0,15
84377,951351,1,3,5,1,0,16
84378,951351,1,3,6,0,1,16
84379,951351,1,4,1,4,0,20
84380,951351,1,4,2,1,0,21
84381,951351,1,4,3,0,0,21
84382,951351,1,4,4,0,0,21
84383,951351,1,4,5,0,0,21
84384,951351,1,4,6,6,0,27
84385,951351,1,5,1,4,0,31
84386,951351,1,5,2,1,0,32
84387,951351,1,5,3,4,0,36
84388,951351,1,5,4,0,0,36
84389,951351,1,5,5,1,0,37
84390,951351,1,5,6,4,0,41
84391,951351,1,6,1,1,0,42
84392,951351,1,6,2,0,0,42
84393,951351,1,6,3,0,1,42
84394,951351,1,6,4,0,1,42
84395,951351,1,6,5,0,0,42
84396,951351,1,6,6,0,1,42
84397,951351,1,7,1,1,0,43
84398,951351,1,7,2,1,0,44
84399,951351,1,7,3,4,0,48
84400,951351,1,7,4,0,0,48
84401,951351,1,7,5,0,0,48
84402,951351,1,7,6,0,0,48
84403,951351,1,8,1,1,0,49
84404,951351,1,8,2,0,0,49
84405,951351,1,8,3,0,0,49
84406,951351,1,8,4,0,0,49
84407,951351,1,8,5,1,0,50
84408,951351,1,8,6,0,0,50
84409,951351,1,9,1,0,1,50
84410,951351,1,9,2,1,0,51
84411,951351,1,9,3,0,0,51
84412,951351,1,9,4,0,0,51
84413,951351,1,9,5,1,0,52
84414,951351,1,9,6,1,0,53
84415,951351,1,10,1,4,0,57
84416,951351,1,10,2,0,1,57
84417,951351,1,10,3,0,0,57
84418,951351,1,10,4,1,0,58
84419,951351,1,10,5,1,0,59
84420,951351,1,10,6,0,0,59
84421,951351,1,11,1,1,0,60
84422,951351,1,11,2,1,0,61
84423,951351,1,11,3,1,0,62
84424,951351,1,11,4,1,0,63
84425,951351,1,11,5,0,0,63
84426,951351,1,11,6,1,0,64
84427,951351,1,12,1,0,0,64
84428,951351,1,12,2,1,0,65
84429,951351,1,12,3,0,0,65
84430,951351,1,12,4,0,0,65
84431,951351,1,12,5,0,0,65
84432,951351,1,12,6,0,0,65
84433,951351,1,13,1,0,0,65
84434,951351,1,13,2,1,0,66
84435,951351,1,13,3,6,0,72
84436,951351,1,13,4,0,0,72
84437,951351,1,13,5,1,0,73
84438,951351,1,13,6,1,0,74
84439,951351,1,14,1,0,0,74
84440,951351,1,14,2,1,0,75
84441,951351,1,14,3,1,0,76
84442,951351,1,14,4,4,0,80
84443,951351,1,14,5,1,0,81
84444,951351,1,14,6,0,0,81
84445,951351,1,15,1,4,0,85
84446,951351,1,15,2,0,0,85
84447,951351,1,15,3,0,1,85
84448,951351,1,15,4,0,0,85
84449,951351,1,15,5,1,0,86
84450,951351,1,15,6,1,0,87
84451,951351,1,16,1,1,0,88
84452,951351,1,16,2,4,0,92
84453,951351,1,16,3,1,0,93
84454,951351,1,16,4,0,0,93
84455,951351,1,16,5,0,0,93
84456,951351,1,16,6,1,0,94
84457,951351,1,17,1,0,0,94
84458,951351,1,17,2,1,0,95
84459,951351,1,17,3,1,0,96
84460,951351,1,17,4,1,0,97
84461,951351,1,17,5,1,0,98
84462,951351,1,17,6,0,0,98
84463,951351,1,18,1,4,0,102
84464,951351,1,18,2,1,0,103
84465,951351,1,18,3,1,0,104
84466,951351,1,18,4,1,0,105
84467,951351,1,18,5,1,0,106
84468,951351,1,18,6,1,0,107
84469,951351,1,19,1,2,0,109
84470,951351,1,19,2,6,0,115
84471,951351,1,19,3,4,0,119
84472,951351,1,19,4,1,0,120
84473,951351,1,19,5,6,0,126
84474,951351,1,19,6,6,0,132
84475,951351,1,20,1,2,0,134
84476,951351,1,20,2,1,0,135
84477,951351,1,20,3,4,0,139
84478,951351,1,20,4,1,0,140
84479,951351,1,20,5,1,0,141
84480,951351,1,20,6,1,0,142
84601,951353,1,1,1,1,0,1
84602,951353,1,1,2,1,0,2
84603,951353,1,1,3,1,0,3
84604,951353,1,1,4,1,0,4
84605,951353,1,1,5,1,0,5
84606,951353,1,1,6,0,0,5
84607,951353,1,2,1,0,0,5
84608,951353,1,2,2,0,0,5
84609,951353,1,2,3,0,0,5
84610,951353,1,2,4,4,0,9
84611,951353,1,2,5,0,0,9
84612,951353,1,2,6,0,0,9
84613,951353,1,3,1,4,0,13
84614,951353,1,3,2,1,0,14
84615,951353,1,3,3,1,0,15
84616,951353,1,3,4,1,0,16
84617,951353,1,3,5,1,0,17
84618,951353,1,3,6,0,0,17
84619,951353,1,4,1,0,0,17
84620,951353,1,4,2,0,0,17
84621,951353,1,4,3,1,0,18
84622,951353,1,4,4,1,0,19
84623,951353,1,4,5,0,0,19
84624,951353,1,4,6,4,0,23
84625,951353,1,5,1,0,0,23
84626,951353,1,5,2,1,0,24
84627,951353,1,5,3,1,0,25
84628,951353,1,5,4,0,0,25
84629,951353,1,5,5,1,0,26
84630,951353,1,5,6,1,0,27
84631,951353,1,6,1,1,0,28
84632,951353,1,6,2,6,0,34
84633,951353,1,6,3,1,0,35
84634,951353,1,6,4,6,0,41
84635,951353,1,6,5,1,0,42
84636,951353,1,6,6,0,1,42
84637,951353,1,7,1,0,0,42
84638,951353,1,7,2,0,0,42
84639,951353,1,7,3,1,0,43
84640,951353,1,7,4,1,0,44
84641,951353,1,7,5,1,0,45
84642,951353,1,7,6,0,1,45
84643,951353,1,8,1,2,0,47
84644,951353,1,8,2,1,0,48
84645,951353,1,8,3,0,0,48
84646,951353,1,8,4,0,0,48
84647,951353,1,8,5,0,0,48
84648,951353,1,8,6,1,0,49
84649,951353,1,9,1,1,0,50
84650,951353,1,9,2,0,0,50
84651,951353,1,9,3,2,0,52
84652,951353,1,9,4,0,0,52
84653,951353,1,9,5,0,0,52
84654,951353,1,9,6,0,0,52
84655,951353,1,10,1,1,0,53
84656,951353,1,10,2,1,0,54
84657,951353,1,10,3,1,0,55
84658,951353,1,10,4,2,0,57
84659,951353,1,10,5,1,0,58
84660,951353,1,10,6,1,0,59
84661,951353,1,11,1,1,0,60
84662,951353,1,11,2,1,0,61
84663,951353,1,11,3,0,0,61
84664,951353,1,11,4,6,0,67
84665,951353,1,11,5,6,0,73
84666,951353,1,11,6,0,0,73
84667,951353,1,12,1,0,0,73
84668,951353,1,12,2,2,0,75
84669,951353,1,12,3,1,0,76
84670,951353,1,12,4,1,0,77
84671,951353,1,12,5,1,0,78
84672,951353,1,12,6,1,0,79
84673,951353,1,13,1,1,0,80
84674,951353,1,13,2,1,0,81
84675,951353,1,13,3,1,0,82
84676,951353,1,13,4,0,0,82
84677,951353,1,13,5,1,0,83
84678,951353,1,13,6,1,0,84
84679,951353,1,14,1,4,0,88
84680,951353,1,14,2,1,0,89
84681,951353,1,14,3,6,0,95
84682,951353,1,14,4,0,1,95
84683,951353,1,14,5,0,0,95
84684,951353,1,14,6,6,0,101
84685,951353,1,15,1,1,0,102
84686,951353,1,15,2,1,0,103
84687,951353,1,15,3,1,0,104
84688,951353,1,15,4,0,0,104
84689,951353,1,15,5,4,0,108
84690,951353,1,15,6,4,0,112
84691,951353,1,16,1,0,1,112
84692,951353,1,16,2,0,1,112
84693,951353,1,16,3,2,0,114
84694,951353,1,16,4,0,0,114
84695,951353,1,16,5,0,0,114
84696,951353,1,16,6,0,0,114
84697,951353,1,17,1,1,0,115
84698,951353,1,17,2,1,0,116
84699,951353,1,17,3,0,0,116
84700,951353,1,17,4,1,0,117
84701,951353,1,17,5,0,1,117
84702,951353,1,17,6,1,0,118
84703,951353,1,18,1,1,0,119
84704,951353,1,18,2,2,0,121
84705,951353,1,18,3,0,0,121
84706,951353,1,18,4,1,0,122
84707,951353,1,18,5,1,0,123
84708,951353,1,18,6,0,0,123
84709,951353,1,19,1,0,0,123
84710,951353,1,19,2,4,0,127
84711,951353,1,19,3,1,0,128
84712,951353,1,19,4,4,0,132
84713,951353,1,19,5,4,0,136
84714,951353,1,19,6,1,0,137
84715,951353,1,20,1,0,1,137
84716,951353,1,20,2,4,0,141
84717,951353,1,20,3,1,0,142
84718,951353,1,20,4,2,0,144
84719,951353,1,20,5,0,0,144
84720,951353,1,20,6,2,0,146
84841,951355,1,1,1,0,0,0
84842,951355,1,1,2,0,0,0
84843,951355,1,1,3,0,0,0
84844,951355,1,1,4,4,0,4
84845,951355,1,1,5,1,0,5
84846,951355,1,1,6,0,0,5
84847,951355,1,2,1,4,0,9
84848,951355,1,2,2,0,0,9
84849,951355,1,2,3,1,0,10
84850,951355,1,2,4,1,0,11
84851,951355,1,2,5,1,0,12
84852,951355,1,2,6,4,0,16
84853,951355,1,3,1,1,0,17
84854,951355,1,3,2,0,0,17
84855,951355,1,3,3,1,0,18
84856,951355,1,3,4,0,0,18
84857,951355,1,3,5,3,0,21
84858,951355,1,3,6,0,0,21
84859,951355,1,4,1,1,0,22
84860,951355,1,4,2,6,0,28
84861,951355,1,4,3,0,0,28
84862,951355,1,4,4,0,1,28
84863,951355,1,4,5,0,0,28
84864,951355,1,4,6,4,0,32
84865,951355,1,5,1,4,0,36
84866,951355,1,5,2,0,0,36
84867,951355,1,5,3,1,0,37
84868,951355,1,5,4,4,0,41
84869,951355,1,5,5,0,0,41
84870,951355,1,5,6,1,0,42
84871,951355,1,6,1,0,1,42
84872,951355,1,6,2,1,0,43
84873,951355,1,6,3,1,0,44
84874,951355,1,6,4,0,0,44
84875,951355,1,6,5,4,0,48
84876,951355,1,6,6,4,0,52
84877,951355,1,7,1,1,0,53
84878,951355,1,7,2,1,0,54
84879,951355,1,7,3,1,0,55
84880,951355,1,7,4,1,0,56
84881,951355,1,7,5,0,0,56
84882,951355,1,7,6,1,0,57
84883,951355,1,8,1,0,0,57
84884,951355,1,8,2,0,1,57
84885,951355,1,8,3,1,0,58
84886,951355,1,8,4,4,0,62
84887,951355,1,8,5,1,0,63
84888,951355,1,8,6,1,0,64
84889,951355,1,9,1,0,0,64
84890,951355,1,9,2,1,0,65
84891,951355,1,9,3,1,0,66
84892,951355,1,9,4,1,0,67
84893,951355,1,9,5,2,0,69
84894,951355,1,9,6,1,0,70
84895,951355,1,10,1,0,0,70
84896,951355,1,10,2,2,0,72
84897,951355,1,10,3,1,0,73
84898,951355,1,10,4,2,0,75
84899,951355,1,10,5,1,0,76
84900,951355,1,10,6,1,0,77
84901,951355,1,11,1,1,0,78
84902,951355,1,11,2,4,0,82
84903,951355,1,11,3,1,0,83
84904,951355,1,11,4,1,0,84
84905,951355,1,11,5,2,0,86
84906,951355,1,11,6,4,0,90
84907,951355,1,12,1,0,0,90
84908,951355,1,12,2,1,0,91
84909,951355,1,12,3,1,0,92
84910,951355,1,12,4,1,0,93
84911,951355,1,12,5,1,0,94
84912,951355,1,12,6,1,0,95
84913,951355,1,13,1,5,0,100
84914,951355,1,13,2,1,0,101
84915,951355,1,13,3,0,0,101
84916,951355,1,13,4,1,0,102
84917,951355,1,13,5,4,0,106
84918,951355,1,13,6,6,0,112
84919,951355,1,14,1,4,0,116
84920,951355,1,14,2,2,0,118
84921,951355,1,14,3,1,0,119
84922,951355,1,14,4,0,1,119
84923,951355,1,14,5,1,0,120
84924,951355,1,14,6,4,0,124
84925,951355,1,15,1,0,0,124
84926,951355,1,15,2,0,0,124
84927,951355,1,15,3,1,0,125
84928,951355,1,15,4,1,0,126
84929,951355,1,15,5,0,0,126
84930,951355,1,15,6,1,0,127
84931,951355,1,16,1,1,0,128
84932,951355,1,16,2,0,0,128
84933,951355,1,16,3,1,0,129
84934,951355,1,16,4,4,0,133
84935,951355,1,16,5,1,0,134
84936,951355,1,16,6,1,0,135
84937,951355,1,17,1,1,0,136
84938,951355,1,17,2,1,0,137
84939,951355,1,17,3,4,0,141
84940,951355,1,17,4,1,0,142
84941,951355,1,17,5,6,0,148
84942,951355,1,17,6,4,0,152
84943,951355,1,18,1,2,0,154
84944,951355,1,18,2,1,0,155
84945,951355,1,18,3,6,0,161
84946,951355,1,18,4,1,0,162
84947,951355,1,18,5,4,0,166
84948,951355,1,18,6,1,0,167
84949,951355,1,19,1,1,0,168
84950,951355,1,19,2,0,0,168
84951,951355,1,19,3,4,0,172
84952,951355,1,19,4,2,0,174
84953,951355,1,19,5,1,0,175
84954,951355,1,19,6,4,0,179
84955,951355,1,20,1,2,0,181
84956,951355,1,20,2,0,0,181
84957,951355,1,20,3,1,0,182
84958,951355,1,20,4,4,0,186
84959,951355,1,20,5,6,0,192
84960,951355,1,20,6,1,0,193
85081,951357,1,1,1,1,0,1
85082,951357,1,1,2,0,0,1
85083,951357,1,1,3,0,1,1
85084,951357,1,1,4,1,0,2
85085,951357,1,1,5,2,0,4
85086,951357,1,1,6,0,0,4
85087,951357,1,2,1,0,0,4
85088,951357,1,2,2,0,0,4
85089,951357,1,2,3,0,0,4
85090,951357,1,2,4,6,0,10
85091,951357,1,2,5,2,0,12
85092,951357,1,2,6,1,1,13
85093,951357,1,3,1,2,0,15
85094,951357,1,3,2,0,0,15
85095,951357,1,3,3,4,0,19
85096,951357,1,3,4,1,0,20
85097,951357,1,3,5,0,0,20
85098,951357,1,3,6,0,1,20
85099,951357,1,4,1,0,0,20
85100,951357,1,4,2,0,0,20
85101,951357,1,4,3,2,0,22
85102,951357,1,4,4,1,0,23
85103,951357,1,4,5,5,0,28
85104,951357,1,4,6,0,0,28
85105,951357,1,5,1,0,0,28
85106,951357,1,5,2,0,0,28
85107,951357,1,5,3,0,0,28
85108,951357,1,5,4,6,0,34
85109,951357,1,5,5,0,0,34
85110,951357,1,5,6,2,0,36
85111,951357,1,6,1,0,0,36
85112,951357,1,6,2,0,0,36
85113,951357,1,6,3,0,0,36
85114,951357,1,6,4,1,0,37
85115,951357,1,6,5,1,0,38
85116,951357,1,6,6,1,0,39
85117,951357,1,7,1,0,0,39
85118,951357,1,7,2,2,0,41
85119,951357,1,7,3,1,0,42
85120,951357,1,7,4,0,0,42
85121,951357,1,7,5,0,0,42
85122,951357,1,7,6,2,0,44
85123,951357,1,8,1,1,0,45
85124,951357,1,8,2,0,0,45
85125,951357,1,8,3,1,0,46
85126,951357,1,8,4,0,1,46
85127,951357,1,8,5,0,0,46
85128,951357,1,8,6,1,0,47
85129,951357,1,9,1,0,0,47
85130,951357,1,9,2,0,1,47
85131,951357,1,9,3,1,0,48
85132,951357,1,9,4,1,0,49
85133,951357,1,9,5,0,0,49
85134,951357,1,9,6,1,0,50
85135,951357,1,10,1,0,0,50
85136,951357,1,10,2,1,0,51
85137,951357,1,10,3,0,0,51
85138,951357,1,10,4,0,0,51
85139,951357,1,10,5,2,0,53
85140,951357,1,10,6,4,0,57
85141,951357,1,11,1,0,0,57
85142,951357,1,11,2,1,0,58
85143,951357,1,11,3,1,0,59
85144,951357,1,11,4,4,0,63
85145,951357,1,11,5,2,0,65
85146,951357,1,11,6,1,0,66
85147,951357,1,12,1,2,0,68
85148,951357,1,12,2,2,0,70
85149,951357,1,12,3,1,0,71
85150,951357,1,12,4,1,0,72
85151,951357,1,12,5,1,0,73
85152,951357,1,12,6,1,0,74
85153,951357,1,13,1,0,0,74
85154,951357,1,13,2,1,0,75
85155,951357,1,13,3,1,0,76
85156,951357,1,13,4,1,0,77
85157,951357,1,13,5,1,0,78
85158,951357,1,13,6,0,0,78
85159,951357,1,14,1,4,0,82
85160,951357,1,14,2,0,0,82
85161,951357,1,14,3,1,0,83
85162,951357,1,14,4,0,0,83
85163,951357,1,14,5,2,0,85
85164,951357,1,14,6,0,0,85
85165,951357,1,15,1,1,0,86
85166,951357,1,15,2,2,0,88
85167,951357,1,15,3,0,0,88
85168,951357,1,15,4,1,0,89
85169,951357,1,15,5,1,0,90
85170,951357,1,15,6,1,0,91
85171,951357,1,16,1,4,0,95
85172,951357,1,16,2,1,0,96
85173,951357,1,16,3,1,0,97
85174,951357,1,16,4,0,1,97
85175,951357,1,16,5,1,0,98
85176,951357,1,16,6,0,0,98
85177,951357,1,17,1,0,0,98
85178,951357,1,17,2,4,0,102
85179,951357,1,17,3,4,0,106
85180,951357,1,17,4,0,0,106
85181,951357,1,17,5,1,0,107
85182,951357,1,17,6,1,0,108
85183,951357,1,18,1,4,0,112
85184,951357,1,18,2,0,1,112
85185,951357,1,18,3,0,0,112
85186,951357,1,18,4,0,0,112
85187,951357,1,18,5,1,0,113
85188,951357,1,18,6,1,0,114
85189,951357,1,19,1,1,0,115
85190,951357,1,19,2,1,0,116
85191,951357,1,19,3,0,0,116
85192,951357,1,19,4,1,0,117
85193,951357,1,19,5,0,0,117
85194,951357,1,19,6,1,0,118
85195,951357,1,20,1,2,0,120
85196,951357,1,20,2,0,0,120
85197,951357,1,20,3,1,0,121
85198,951357,1,20,4,1,0,122
85199,951357,1,20,5,0,0,122
85200,951357,1,20,6,0,1,122
85319,951359,1,1,1,0,0,0
85320,951359,1,1,2,1,0,1
85321,951359,1,1,3,0,0,1
85322,951359,1,1,4,0,0,1
85323,951359,1,1,5,4,0,5
85324,951359,1,1,6,4,0,9
85325,951359,1,2,1,0,0,9
85326,951359,1,2,2,0,0,9
85327,951359,1,2,3,4,0,13
85328,951359,1,2,4,0,0,13
85329,951359,1,2,5,1,0,14
85330,951359,1,2,6,1,0,15
85331,951359,1,3,1,4,0,19
85332,951359,1,3,2,0,0,19
85333,951359,1,3,3,2,0,21
85334,951359,1,3,4,0,0,21
85335,951359,1,3,5,2,0,23
85336,951359,1,3,6,0,0,23
85337,951359,1,4,1,0,0,23
85338,951359,1,4,2,0,0,23
85339,951359,1,4,3,1,0,24
85340,951359,1,4,4,0,0,24
85341,951359,1,4,5,1,0,25
85342,951359,1,4,6,0,1,25
85343,951359,1,5,1,0,0,25
85344,951359,1,5,2,4,0,29
85345,951359,1,5,3,0,0,29
85346,951359,1,5,4,0,0,29
85347,951359,1,5,5,6,0,35
85348,951359,1,5,6,0,0,35
85349,951359,1,6,1,0,0,35
85350,951359,1,6,2,0,0,35
85351,951359,1,6,3,0,0,35
85352,951359,1,6,4,1,0,36
85353,951359,1,6,5,1,0,37
85354,951359,1,6,6,2,0,39
85355,951359,1,7,1,0,0,39
85356,951359,1,7,2,1,0,40
85357,951359,1,7,3,1,0,41
85358,951359,1,7,4,1,0,42
85359,951359,1,7,5,1,0,43
85360,951359,1,7,6,1,0,44
85361,951359,1,8,1,1,0,45
85362,951359,1,8,2,1,0,46
85363,951359,1,8,3,1,0,47
85364,951359,1,8,4,1,0,48
85365,951359,1,8,5,2,0,50
85366,951359,1,8,6,2,0,52
85367,951359,1,9,1,0,0,52
85368,951359,1,9,2,1,0,53
85369,951359,1,9,3,4,0,57
85370,951359,1,9,4,0,0,57
85371,951359,1,9,5,0,0,57
85372,951359,1,9,6,0,1,57
85373,951359,1,10,1,0,0,57
85374,951359,1,10,2,0,0,57
85375,951359,1,10,3,0,0,57
85376,951359,1,10,4,0,0,57
85377,951359,1,10,5,1,0,58
85378,951359,1,10,6,1,0,59
85379,951359,1,11,1,1,0,60
85380,951359,1,11,2,1,0,61
85381,951359,1,11,3,1,0,62
85382,951359,1,11,4,1,0,63
85383,951359,1,11,5,1,0,64
85384,951359,1,11,6,1,0,65
85385,951359,1,12,1,1,0,66
85386,951359,1,12,2,1,0,67
85387,951359,1,12,3,1,0,68
85388,951359,1,12,4,0,0,68
85389,951359,1,12,5,1,0,69
85390,951359,1,12,6,1,0,70
85391,951359,1,13,1,1,0,71
85392,951359,1,13,2,1,0,72
85393,951359,1,13,3,1,0,73
85394,951359,1,13,4,1,0,74
85395,951359,1,13,5,0,0,74
85396,951359,1,13,6,4,0,78
85397,951359,1,14,1,4,0,82
85398,951359,1,14,2,1,0,83
85399,951359,1,14,3,1,0,84
85400,951359,1,14,4,0,0,84
85401,951359,1,14,5,6,0,90
85402,951359,1,14,6,1,0,91
85403,951359,1,15,1,0,0,91
85404,951359,1,15,2,6,0,97
85405,951359,1,15,3,1,0,98
85406,951359,1,15,4,1,0,99
85407,951359,1,15,5,0,1,99
85408,951359,1,15,6,0,0,99
85409,951359,1,16,1,0,0,99
85410,951359,1,16,2,1,0,100
85411,951359,1,16,3,0,0,100
85412,951359,1,16,4,0,1,100
85413,951359,1,16,5,1,0,101
85414,951359,1,16,6,4,0,105
85415,951359,1,17,1,1,0,106
85416,951359,1,17,2,6,0,112
85417,951359,1,17,3,1,0,113
85418,951359,1,17,4,4,0,117
85419,951359,1,17,5,1,0,118
85420,951359,1,17,6,0,0,118
85421,951359,1,18,1,1,0,119
85422,951359,1,18,2,1,0,120
85423,951359,1,18,3,1,0,121
85424,951359,1,18,4,1,0,122
85425,951359,1,18,5,0,1,122
85426,951359,1,18,6,1,0,123
85427,951359,1,19,1,4,0,127
85428,951359,1,19,2,0,1,127
85429,951359,1,19,3,0,0,127
85430,951359,1,19,4,4,0,131
85431,951359,1,19,5,2,0,133
85432,951359,1,19,6,2,0,135
85433,951359,1,20,1,1,0,136
85434,951359,1,20,2,1,0,137
85435,951359,1,20,3,2,0,139
85436,951359,1,20,4,0,1,139
85437,951359,1,20,5,0,1,139
85438,951359,1,20,6,6,0,145
85533,951361,1,1,1,2,0,2
85534,951361,1,1,2,0,0,2
85535,951361,1,1,3,0,0,2
85536,951361,1,1,4,2,0,4
85537,951361,1,1,5,0,0,4
85538,951361,1,1,6,0,0,4
85539,951361,1,2,1,0,0,4
85540,951361,1,2,2,0,0,4
85541,951361,1,2,3,0,0,4
85542,951361,1,2,4,0,1,4
85543,951361,1,2,5,0,0,4
85544,951361,1,2,6,0,0,4
85545,951361,1,3,1,1,0,5
85546,951361,1,3,2,1,0,6
85547,951361,1,3,3,1,0,7
85548,951361,1,3,4,1,0,8
85549,951361,1,3,5,0,0,8
85550,951361,1,3,6,0,0,8
85551,951361,1,4,1,1,0,9
85552,951361,1,4,2,4,0,13
85553,951361,1,4,3,1,0,14
85554,951361,1,4,4,0,0,14
85555,951361,1,4,5,4,0,18
85556,951361,1,4,6,1,0,19
85557,951361,1,5,1,4,0,23
85558,951361,1,5,2,0,0,23
85559,951361,1,5,3,1,0,24
85560,951361,1,5,4,0,0,24
85561,951361,1,5,5,4,0,28
85562,951361,1,5,6,1,0,29
85563,951361,1,6,1,0,0,29
85564,951361,1,6,2,0,0,29
85565,951361,1,6,3,4,0,33
85566,951361,1,6,4,1,0,34
85567,951361,1,6,5,0,0,34
85568,951361,1,6,6,4,0,38
85569,951361,1,7,1,1,0,39
85570,951361,1,7,2,1,0,40
85571,951361,1,7,3,6,0,46
85572,951361,1,7,4,0,0,46
85573,951361,1,7,5,0,0,46
85574,951361,1,7,6,1,0,47
85575,951361,1,8,1,0,0,47
85576,951361,1,8,2,0,0,47
85577,951361,1,8,3,1,0,48
85578,951361,1,8,4,1,0,49
85579,951361,1,8,5,0,0,49
85580,951361,1,8,6,1,0,50
85581,951361,1,9,1,1,0,51
85582,951361,1,9,2,0,0,51
85583,951361,1,9,3,1,0,52
85584,951361,1,9,4,6,0,58
85585,951361,1,9,5,1,0,59
85586,951361,1,9,6,1,0,60
85587,951361,1,10,1,0,0,60
85588,951361,1,10,2,4,0,64
85589,951361,1,10,3,0,0,64
85590,951361,1,10,4,0,0,64
85591,951361,1,10,5,1,0,65
85592,951361,1,10,6,0,0,65
85593,951361,1,11,1,0,1,65
85594,951361,1,11,2,1,0,66
85595,951361,1,11,3,2,0,68
85596,951361,1,11,4,1,0,69
85597,951361,1,11,5,0,0,69
85598,951361,1,11,6,4,0,73
85599,951361,1,12,1,1,0,74
85600,951361,1,12,2,1,0,75
85601,951361,1,12,3,1,0,76
85602,951361,1,12,4,4,0,80
85603,951361,1,12,5,0,0,80
85604,951361,1,12,6,1,0,81
85605,951361,1,13,1,4,0,85
85606,951361,1,13,2,1,0,86
85607,951361,1,13,3,1,0,87
85608,951361,1,13,4,1,0,88
85609,951361,1,13,5,0,1,88
85610,951361,1,13,6,0,0,88
85611,951361,1,14,1,1,0,89
85612,951361,1,14,2,1,0,90
85613,951361,1,14,3,1,0,91
85614,951361,1,14,4,0,0,91
85615,951361,1,14,5,1,0,92
85616,951361,1,14,6,1,0,93
85617,951361,1,15,1,1,0,94
85618,951361,1,15,2,1,0,95
85619,951361,1,15,3,1,0,96
85620,951361,1,15,4,1,0,97
85621,951361,1,15,5,1,0,98
85622,951361,1,15,6,1,0,99
85623,951361,1,16,1,3,0,102
85624,951361,1,16,2,4,0,106
85625,951361,1,16,3,6,0,112
85626,951361,1,16,4,3,0,115
85627,951361,1,16,5,1,0,116
85628,951361,1,16,6,1,0,117
85629,951361,1,17,1,0,0,117
85630,951361,1,17,2,0,0,117
85631,951361,1,17,3,4,0,121
85632,951361,1,17,4,4,0,125
85633,951361,1,17,5,0,0,125
85634,951361,1,17,6,6,0,131
85635,951361,1,18,1,2,0,133
85636,951361,1,18,2,4,0,137
85637,951361,1,18,3,2,0,139
85638,951361,1,18,4,6,0,145
85639,951361,1,18,5,1,0,146
85640,951361,1,18,6,0,0,146
85641,951361,1,19,1,5,0,151
85642,951361,1,19,2,6,0,157
85643,951361,1,19,3,1,0,158
85644,951361,1,19,4,1,0,159
85645,951361,1,19,5,1,0,160
85646,951361,1,19,6,1,0,161
85647,951361,1,20,1,1,0,162
85648,951361,1,20,2,0,1,162
85649,951361,1,20,3,2,0,164
85650,951361,1,20,4,0,0,164
85651,951361,1,20,5,1,0,165
85652,951361,1,20,6,6,0,171
85773,951363,1,1,1,4,0,4
85774,951363,1,1,2,0,0,4
85775,951363,1,1,3,0,0,4
85776,951363,1,1,4,0,0,4
85777,951363,1,1,5,0,0,4
85778,951363,1,1,6,0,0,4
85779,951363,1,2,1,1,0,5
85780,951363,1,2,2,4,0,9
85781,951363,1,2,3,4,0,13
85782,951363,1,2,4,4,0,17
85783,951363,1,2,5,0,0,17
85784,951363,1,2,6,4,0,21
85785,951363,1,3,1,0,0,21
85786,951363,1,3,2,4,0,25
85787,951363,1,3,3,1,0,26
85788,951363,1,3,4,4,0,30
85789,951363,1,3,5,0,0,30
85790,951363,1,3,6,1,0,31
85791,951363,1,4,1,1,0,32
85792,951363,1,4,2,0,0,32
85793,951363,1,4,3,6,0,38
85794,951363,1,4,4,6,0,44
85795,951363,1,4,5,8,0,52
85796,951363,1,4,6,1,0,53
85797,951363,1,5,1,1,0,54
85798,951363,1,5,2,0,1,54
85799,951363,1,5,3,0,0,54
85800,951363,1,5,4,1,0,55
85801,951363,1,5,5,0,0,55
85802,951363,1,5,6,0,0,55
85803,951363,1,6,1,1,0,56
85804,951363,1,6,2,0,0,56
85805,951363,1,6,3,0,0,56
85806,951363,1,6,4,1,0,57
85807,951363,1,6,5,1,0,58
85808,951363,1,6,6,1,0,59
85809,951363,1,7,1,1,0,60
85810,951363,1,7,2,2,0,62
85811,951363,1,7,3,0,0,62
85812,951363,1,7,4,1,0,63
85813,951363,1,7,5,0,0,63
85814,951363,1,7,6,1,0,64
85815,951363,1,8,1,2,0,66
85816,951363,1,8,2,1,0,67
85817,951363,1,8,3,4,0,71
85818,951363,1,8,4,1,0,72
85819,951363,1,8,5,0,1,72
85820,951363,1,8,6,1,0,73
85821,951363,1,9,1,0,0,73
85822,951363,1,9,2,0,0,73
85823,951363,1,9,3,0,0,73
85824,951363,1,9,4,1,0,74
85825,951363,1,9,5,0,0,74
85826,951363,1,9,6,0,0,74
85827,951363,1,10,1,0,1,74
85828,951363,1,10,2,1,0,75
85829,951363,1,10,3,2,0,77
85830,951363,1,10,4,1,0,78
85831,951363,1,10,5,2,0,80
85832,951363,1,10,6,1,0,81
85833,951363,1,11,1,0,0,81
85834,951363,1,11,2,0,0,81
85835,951363,1,11,3,2,0,83
85836,951363,1,11,4,0,0,83
85837,951363,1,11,5,1,0,84
85838,951363,1,11,6,1,0,85
85839,951363,1,12,1,1,0,86
85840,951363,1,12,2,2,0,88
85841,951363,1,12,3,2,0,90
85842,951363,1,12,4,1,0,91
85843,951363,1,12,5,1,0,92
85844,951363,1,12,6,1,0,93
85845,951363,1,13,1,1,0,94
85846,951363,1,13,2,0,0,94
85847,951363,1,13,3,2,0,96
85848,951363,1,13,4,0,0,96
85849,951363,1,13,5,4,0,100
85850,951363,1,13,6,0,1,100
85851,951363,1,14,1,1,0,101
85852,951363,1,14,2,2,0,103
85853,951363,1,14,3,0,0,103
85854,951363,1,14,4,0,0,103
85855,951363,1,14,5,1,0,104
85856,951363,1,14,6,0,0,104
85857,951363,1,15,1,1,0,105
85858,951363,1,15,2,5,0,110
85859,951363,1,15,3,1,0,111
85860,951363,1,15,4,1,0,112
85861,951363,1,15,5,1,0,113
85862,951363,1,15,6,1,0,114
85863,951363,1,16,1,1,0,115
85864,951363,1,16,2,1,0,116
85865,951363,1,16,3,1,0,117
85866,951363,1,16,4,2,0,119
85867,951363,1,16,5,4,0,123
85868,951363,1,16,6,6,0,129
85869,951363,1,17,1,1,0,130
85870,951363,1,17,2,0,0,130
85871,951363,1,17,3,0,1,130
85872,951363,1,17,4,1,0,131
85873,951363,1,17,5,0,0,131
85874,951363,1,17,6,1,0,132
85875,951363,1,18,1,1,0,133
85876,951363,1,18,2,1,0,134
85877,951363,1,18,3,1,0,135
85878,951363,1,18,4,0,0,135
85879,951363,1,18,5,0,0,135
85880,951363,1,18,6,1,0,136
85881,951363,1,19,1,4,0,140
85882,951363,1,19,2,1,0,141
85883,951363,1,19,3,1,0,142
85884,951363,1,19,4,1,0,143
85885,951363,1,19,5,1,0,144
85886,951363,1,19,6,1,0,145
85887,951363,1,20,1,0,1,145
85888,951363,1,20,2,0,0,145
85889,951363,1,20,3,4,0,149
85890,951363,1,20,4,1,0,150
85891,951363,1,20,5,4,0,154
85892,951363,1,20,6,6,0,160
86008,951365,1,1,1,1,0,1
86009,951365,1,1,2,0,0,1
86010,951365,1,1,3,0,0,1
86011,951365,1,1,4,0,0,1
86012,951365,1,1,5,4,0,5
86013,951365,1,1,6,0,0,5
86014,951365,1,2,1,0,0,5
86015,951365,1,2,2,0,0,5
86016,951365,1,2,3,2,0,7
86017,951365,1,2,4,1,0,8
86018,951365,1,2,5,0,1,8
86019,951365,1,2,6,0,0,8
86020,951365,1,3,1,1,0,9
86021,951365,1,3,2,1,0,10
86022,951365,1,3,3,4,0,14
86023,951365,1,3,4,0,0,14
86024,951365,1,3,5,4,0,18
86025,951365,1,3,6,1,0,19
86026,951365,1,4,1,0,0,19
86027,951365,1,4,2,0,0,19
86028,951365,1,4,3,0,0,19
86029,951365,1,4,4,1,0,20
86030,951365,1,4,5,1,0,21
86031,951365,1,4,6,6,0,27
86032,951365,1,5,1,1,0,28
86033,951365,1,5,2,0,0,28
86034,951365,1,5,3,2,0,30
86035,951365,1,5,4,1,0,31
86036,951365,1,5,5,0,0,31
86037,951365,1,5,6,1,0,32
86038,951365,1,6,1,0,0,32
86039,951365,1,6,2,1,0,33
86040,951365,1,6,3,0,0,33
86041,951365,1,6,4,0,0,33
86042,951365,1,6,5,0,0,33
86043,951365,1,6,6,0,1,33
86044,951365,1,7,1,0,0,33
86045,951365,1,7,2,1,0,34
86046,951365,1,7,3,1,0,35
86047,951365,1,7,4,1,0,36
86048,951365,1,7,5,0,0,36
86049,951365,1,7,6,2,0,38
86050,951365,1,8,1,0,0,38
86051,951365,1,8,2,0,0,38
86052,951365,1,8,3,0,0,38
86053,951365,1,8,4,1,0,39
86054,951365,1,8,5,0,0,39
86055,951365,1,8,6,1,0,40
86056,951365,1,9,1,1,0,41
86057,951365,1,9,2,1,0,42
86058,951365,1,9,3,1,0,43
86059,951365,1,9,4,0,0,43
86060,951365,1,9,5,0,0,43
86061,951365,1,9,6,1,0,44
86062,951365,1,10,1,0,0,44
86063,951365,1,10,2,6,0,50
86064,951365,1,10,3,0,1,50
86065,951365,1,10,4,0,0,50
86066,951365,1,10,5,1,0,51
86067,951365,1,10,6,1,0,52
86068,951365,1,11,1,0,0,52
86069,951365,1,11,2,0,1,52
86070,951365,1,11,3,1,0,53
86071,951365,1,11,4,0,0,53
86072,951365,1,11,5,0,0,53
86073,951365,1,11,6,0,0,53
86074,951365,1,12,1,1,0,54
86075,951365,1,12,2,1,0,55
86076,951365,1,12,3,0,0,55
86077,951365,1,12,4,1,0,56
86078,951365,1,12,5,0,1,56
86079,951365,1,12,6,1,0,57
86080,951365,1,13,1,0,0,57
86081,951365,1,13,2,0,0,57
86082,951365,1,13,3,0,0,57
86083,951365,1,13,4,0,0,57
86084,951365,1,13,5,4,0,61
86085,951365,1,13,6,1,0,62
86086,951365,1,14,1,2,0,64
86087,951365,1,14,2,1,0,65
86088,951365,1,14,3,0,0,65
86089,951365,1,14,4,1,0,66
86090,951365,1,14,5,0,0,66
86091,951365,1,14,6,0,0,66
86092,951365,1,15,1,1,0,67
86093,951365,1,15,2,0,0,67
86094,951365,1,15,3,2,0,69
86095,951365,1,15,4,2,0,71
86096,951365,1,15,5,1,0,72
86097,951365,1,15,6,4,0,76
86098,951365,1,16,1,2,0,78
86099,951365,1,16,2,6,0,84
86100,951365,1,16,3,1,0,85
86101,951365,1,16,4,1,0,86
86102,951365,1,16,5,1,0,87
86103,951365,1,16,6,2,0,89
86104,951365,1,17,1,1,0,90
86105,951365,1,17,2,0,0,90
86106,951365,1,17,3,0,1,90
86107,951365,1,17,4,2,0,92
86108,951365,1,17,5,0,0,92
86109,951365,1,17,6,1,0,93
86110,951365,1,18,1,0,0,93
86111,951365,1,18,2,4,0,97
86112,951365,1,18,3,2,0,99
86113,951365,1,18,4,1,0,100
86114,951365,1,18,5,2,0,102
86115,951365,1,18,6,1,0,103
86116,951365,1,19,1,0,1,103
86117,951365,1,19,2,2,0,105
86118,951365,1,19,3,0,0,105
86119,951365,1,19,4,0,0,105
86120,951365,1,19,5,1,0,106
86121,951365,1,19,6,6,0,112
86122,951365,1,20,1,4,0,116
86123,951365,1,20,2,0,0,116
86124,951365,1,20,3,2,0,118
86125,951365,1,20,4,0,0,118
86126,951365,1,20,5,4,0,122
86127,951365,1,20,6,1,0,123
86248,951367,1,1,1,0,0,0
86249,951367,1,1,2,0,0,0
86250,951367,1,1,3,0,0,0
86251,951367,1,1,4,0,0,0
86252,951367,1,1,5,4,0,4
86253,951367,1,1,6,1,0,5
86254,951367,1,2,1,2,0,7
86255,951367,1,2,2,1,0,8
86256,951367,1,2,3,0,0,8
86257,951367,1,2,4,2,0,10
86258,951367,1,2,5,0,0,10
86259,951367,1,2,6,4,0,14
86260,951367,1,3,1,4,0,18
86261,951367,1,3,2,1,0,19
86262,951367,1,3,3,0,0,19
86263,951367,1,3,4,6,0,25
86264,951367,1,3,5,4,0,29
86265,951367,1,3,6,1,0,30
86266,951367,1,4,1,1,0,31
86267,951367,1,4,2,0,0,31
86268,951367,1,4,3,1,0,32
86269,951367,1,4,4,1,0,33
86270,951367,1,4,5,1,0,34
86271,951367,1,4,6,0,0,34
86272,951367,1,5,1,4,0,38
86273,951367,1,5,2,6,0,44
86274,951367,1,5,3,0,0,44
86275,951367,1,5,4,1,0,45
86276,951367,1,5,5,0,1,45
86277,951367,1,5,6,0,1,45
86278,951367,1,6,1,0,0,45
86279,951367,1,6,2,0,0,45
86280,951367,1,6,3,0,0,45
86281,951367,1,6,4,0,0,45
86282,951367,1,6,5,1,0,46
86283,951367,1,6,6,1,0,47
86284,951367,1,7,1,1,0,48
86285,951367,1,7,2,1,0,49
86286,951367,1,7,3,1,0,50
86287,951367,1,7,4,0,0,50
86288,951367,1,7,5,4,0,54
86289,951367,1,7,6,0,0,54
86290,951367,1,8,1,4,0,58
86291,951367,1,8,2,1,0,59
86292,951367,1,8,3,0,0,59
86293,951367,1,8,4,1,0,60
86294,951367,1,8,5,1,0,61
86295,951367,1,8,6,1,0,62
86296,951367,1,9,1,1,0,63
86297,951367,1,9,2,6,0,69
86298,951367,1,9,3,0,0,69
86299,951367,1,9,4,1,0,70
86300,951367,1,9,5,1,0,71
86301,951367,1,9,6,0,0,71
86302,951367,1,10,1,4,0,75
86303,951367,1,10,2,0,1,75
86304,951367,1,10,3,1,0,76
86305,951367,1,10,4,0,0,76
86306,951367,1,10,5,0,0,76
86307,951367,1,10,6,1,0,77
86308,951367,1,11,1,1,0,78
86309,951367,1,11,2,0,0,78
86310,951367,1,11,3,0,1,78
86311,951367,1,11,4,1,0,79
86312,951367,1,11,5,1,0,80
86313,951367,1,11,6,0,0,80
86314,951367,1,12,1,0,0,80
86315,951367,1,12,2,0,0,80
86316,951367,1,12,3,0,0,80
86317,951367,1,12,4,1,0,81
86318,951367,1,12,5,1,0,82
86319,951367,1,12,6,0,0,82
86320,951367,1,13,1,1,0,83
86321,951367,1,13,2,1,0,84
86322,951367,1,13,3,1,0,85
86323,951367,1,13,4,0,0,85
86324,951367,1,13,5,0,1,85
86325,951367,1,13,6,0,0,85
86326,951367,1,14,1,0,0,85
86327,951367,1,14,2,0,1,85
86328,951367,1,14,3,1,0,86
86329,951367,1,14,4,0,0,86
86330,951367,1,14,5,2,0,88
86331,951367,1,14,6,1,0,89
86332,951367,1,15,1,4,0,93
86333,951367,1,15,2,1,0,94
86334,951367,1,15,3,0,0,94
86335,951367,1,15,4,0,0,94
86336,951367,1,15,5,2,0,96
86337,951367,1,15,6,0,1,96
86338,951367,1,16,1,1,0,97
86339,951367,1,16,2,0,0,97
86340,951367,1,16,3,1,0,98
86341,951367,1,16,4,0,0,98
86342,951367,1,16,5,1,0,99
86343,951367,1,16,6,0,0,99
86344,951367,1,17,1,0,0,99
86345,951367,1,17,2,6,0,105
86346,951367,1,17,3,1,0,106
86347,951367,1,17,4,1,0,107
86348,951367,1,17,5,0,0,107
86349,951367,1,17,6,1,0,108
86350,951367,1,18,1,1,0,109
86351,951367,1,18,2,0,1,109
86352,951367,1,18,3,0,0,109
86353,951367,1,18,4,1,0,110
86354,951367,1,18,5,2,0,112
86355,951367,1,18,6,1,0,113
86356,951367,1,19,1,0,0,113
86357,951367,1,19,2,1,0,114
86358,951367,1,19,3,4,0,118
86359,951367,1,19,4,0,0,118
86360,951367,1,19,5,1,0,119
86361,951367,1,19,6,0,0,119
86362,951367,1,20,1,1,0,120
86363,951367,1,20,2,0,1,120
86364,951367,1,20,3,0,1,120
86471,951369,1,1,1,4,0,4
86472,951369,1,1,2,0,0,4
86473,951369,1,1,3,1,0,5
86474,951369,1,1,4,1,0,6
86475,951369,1,1,5,4,0,10
86476,951369,1,1,6,1,0,11
86477,951369,1,2,1,0,0,11
86478,951369,1,2,2,0,0,11
86479,951369,1,2,3,0,0,11
86480,951369,1,2,4,1,0,12
86481,951369,1,2,5,4,0,16
86482,951369,1,2,6,1,0,17
86483,951369,1,3,1,0,1,17
86484,951369,1,3,2,1,0,18
86485,951369,1,3,3,1,0,19
86486,951369,1,3,4,0,0,19
86487,951369,1,3,5,4,0,23
86488,951369,1,3,6,0,0,23
86489,951369,1,4,1,1,0,24
86490,951369,1,4,2,1,0,25
86491,951369,1,4,3,0,0,25
86492,951369,1,4,4,4,0,29
86493,951369,1,4,5,0,0,29
86494,951369,1,4,6,2,0,31
86495,951369,1,5,1,0,0,31
86496,951369,1,5,2,1,0,32
86497,951369,1,5,3,1,0,33
86498,951369,1,5,4,4,0,37
86499,951369,1,5,5,0,0,37
86500,951369,1,5,6,1,0,38
86501,951369,1,6,1,1,0,39
86502,951369,1,6,2,4,0,43
86503,951369,1,6,3,4,0,47
86504,951369,1,6,4,4,0,51
86505,951369,1,6,5,0,0,51
86506,951369,1,6,6,0,0,51
86507,951369,1,7,1,0,0,51
86508,951369,1,7,2,1,0,52
86509,951369,1,7,3,1,0,53
86510,951369,1,7,4,0,0,53
86511,951369,1,7,5,1,0,54
86512,951369,1,7,6,1,0,55
86513,951369,1,8,1,1,0,56
86514,951369,1,8,2,1,0,57
86515,951369,1,8,3,6,0,63
86516,951369,1,8,4,1,0,64
86517,951369,1,8,5,1,0,65
86518,951369,1,8,6,1,0,66
86519,951369,1,9,1,1,0,67
86520,951369,1,9,2,6,0,73
86521,951369,1,9,3,1,0,74
86522,951369,1,9,4,4,0,78
86523,951369,1,9,5,0,0,78
86524,951369,1,9,6,0,0,78
86525,951369,1,10,1,4,0,82
86526,951369,1,10,2,1,0,83
86527,951369,1,10,3,1,0,84
86528,951369,1,10,4,0,0,84
86529,951369,1,10,5,4,0,88
86530,951369,1,10,6,1,0,89
86531,951369,1,11,1,1,0,90
86532,951369,1,11,2,1,0,91
86533,951369,1,11,3,0,1,91
86534,951369,1,11,4,1,0,92
86535,951369,1,11,5,0,0,92
86536,951369,1,11,6,0,0,92
86537,951369,1,12,1,4,0,96
86538,951369,1,12,2,1,0,97
86539,951369,1,12,3,0,0,97
86540,951369,1,12,4,0,0,97
86541,951369,1,12,5,1,0,98
86542,951369,1,12,6,1,0,99
86543,951369,1,13,1,0,0,99
86544,951369,1,13,2,1,0,100
86545,951369,1,13,3,4,0,104
86546,951369,1,13,4,0,0,104
86547,951369,1,13,5,1,0,105
86548,951369,1,13,6,1,0,106
86549,951369,1,14,1,1,0,107
86550,951369,1,14,2,0,1,107
86551,951369,1,14,3,0,0,107
86552,951369,1,14,4,2,0,109
86553,951369,1,14,5,1,0,110
86554,951369,1,14,6,1,0,111
86555,951369,1,15,1,2,0,113
86556,951369,1,15,2,2,0,115
86557,951369,1,15,3,1,0,116
86558,951369,1,15,4,0,0,116
86559,951369,1,15,5,1,0,117
86560,951369,1,15,6,4,0,121
86561,951369,1,16,1,0,0,121
86562,951369,1,16,2,3,0,124
86563,951369,1,16,3,0,0,124
86564,951369,1,16,4,2,0,126
86565,951369,1,16,5,6,0,132
86566,951369,1,16,6,1,0,133
86567,951369,1,17,1,1,0,134
86568,951369,1,17,2,0,0,134
86569,951369,1,17,3,0,1,134
86570,951369,1,17,4,1,0,135
86571,951369,1,17,5,0,0,135
86572,951369,1,17,6,1,0,136
86573,951369,1,18,1,1,0,137
86574,951369,1,18,2,2,0,139
86575,951369,1,18,3,0,1,139
86576,951369,1,18,4,0,1,139
86577,951369,1,18,5,1,0,140
86578,951369,1,18,6,1,0,141
86579,951369,1,19,1,1,0,142
86580,951369,1,19,2,0,0,142
86581,951369,1,19,3,2,0,144
86582,951369,1,19,4,1,0,145
86583,951369,1,19,5,4,0,149
86584,951369,1,19,6,1,0,150
86585,951369,1,20,1,0,0,150
86586,951369,1,20,2,0,1,150
86587,951369,1,20,3,1,0,151
86588,951369,1,20,4,1,0,152
86589,951369,1,20,5,1,0,153
86590,951369,1,20,6,0,1,153
86694,951371,1,1,1,0,0,0
86695,951371,1,1,2,0,0,0
86696,951371,1,1,3,0,0,0
86697,951371,1,1,4,1,0,1
86698,951371,1,1,5,1,0,2
86699,951371,1,1,6,0,0,2
86700,951371,1,2,1,1,0,3
86701,951371,1,2,2,1,0,4
86702,951371,1,2,3,0,0,4
86703,951371,1,2,4,0,0,4
86704,951371,1,2,5,1,0,5
86705,951371,1,2,6,1,0,6
86706,951371,1,3,1,6,0,12
86707,951371,1,3,2,0,0,12
86708,951371,1,3,3,1,0,13
86709,951371,1,3,4,1,0,14
86710,951371,1,3,5,0,0,14
86711,951371,1,3,6,1,0,15
86712,951371,1,4,1,2,0,17
86713,951371,1,4,2,0,0,17
86714,951371,1,4,3,0,0,17
86715,951371,1,4,4,4,0,21
86716,951371,1,4,5,4,0,25
86717,951371,1,4,6,1,0,26
86718,951371,1,5,1,1,0,27
86719,951371,1,5,2,0,0,27
86720,951371,1,5,3,4,0,31
86721,951371,1,5,4,2,0,33
86722,951371,1,5,5,1,0,34
86723,951371,1,5,6,1,0,35
86724,951371,1,6,1,0,0,35
86725,951371,1,6,2,13,0,48
86726,951371,1,6,3,1,0,49
86727,951371,1,6,4,1,0,50
86728,951371,1,6,5,4,0,54
86729,951371,1,6,6,1,0,55
86730,951371,1,7,1,0,0,55
86731,951371,1,7,2,1,0,56
86732,951371,1,7,3,1,0,57
86733,951371,1,7,4,1,0,58
86734,951371,1,7,5,2,0,60
86735,951371,1,7,6,2,0,62
86736,951371,1,8,1,0,0,62
86737,951371,1,8,2,0,1,62
86738,951371,1,8,3,1,0,63
86739,951371,1,8,4,0,0,63
86740,951371,1,8,5,2,0,65
86741,951371,1,8,6,1,0,66
86742,951371,1,9,1,1,0,67
86743,951371,1,9,2,0,0,67
86744,951371,1,9,3,1,0,68
86745,951371,1,9,4,2,0,70
86746,951371,1,9,5,4,0,74
86747,951371,1,9,6,2,0,76
86748,951371,1,10,1,3,0,79
86749,951371,1,10,2,0,0,79
86750,951371,1,10,3,1,0,80
86751,951371,1,10,4,1,0,81
86752,951371,1,10,5,4,0,85
86753,951371,1,10,6,1,0,86
86754,951371,1,11,1,1,0,87
86755,951371,1,11,2,1,0,88
86756,951371,1,11,3,1,0,89
86757,951371,1,11,4,0,0,89
86758,951371,1,11,5,1,0,90
86759,951371,1,11,6,1,0,91
86760,951371,1,12,1,1,0,92
86761,951371,1,12,2,2,0,94
86762,951371,1,12,3,1,0,95
86763,951371,1,12,4,1,0,96
86764,951371,1,12,5,1,0,97
86765,951371,1,12,6,1,0,98
86766,951371,1,13,1,1,0,99
86767,951371,1,13,2,1,0,100
86768,951371,1,13,3,2,0,102
86769,951371,1,13,4,4,0,106
86770,951371,1,13,5,2,0,108
86771,951371,1,13,6,1,0,109
86772,951371,1,14,1,4,0,113
86773,951371,1,14,2,1,0,114
86774,951371,1,14,3,2,0,116
86775,951371,1,14,4,1,0,117
86776,951371,1,14,5,2,0,119
86777,951371,1,14,6,1,0,120
86778,951371,1,15,1,1,0,121
86779,951371,1,15,2,1,0,122
86780,951371,1,15,3,0,0,122
86781,951371,1,15,4,4,0,126
86782,951371,1,15,5,1,0,127
86783,951371,1,15,6,0,0,127
86784,951371,1,16,1,0,0,127
86785,951371,1,16,2,1,0,128
86786,951371,1,16,3,0,1,128
86787,951371,1,16,4,2,0,130
86788,951371,1,16,5,1,0,131
86789,951371,1,16,6,2,0,133
86790,951371,1,17,1,4,0,137
86791,951371,1,17,2,2,0,139
86792,951371,1,17,3,1,0,140
86793,951371,1,17,4,4,0,144
86794,951371,1,17,5,2,0,146
86795,951371,1,17,6,4,0,150
86796,951371,1,18,1,1,0,151
86797,951371,1,18,2,1,0,152
86798,951371,1,18,3,1,0,153
86799,951371,1,18,4,4,0,157
86800,951371,1,18,5,0,0,157
86801,951371,1,18,6,4,0,161
86802,951371,1,19,1,1,0,162
86803,951371,1,19,2,2,0,164
86804,951371,1,19,3,6,0,170
86805,951371,1,19,4,2,0,172
86806,951371,1,19,5,4,0,176
86807,951371,1,19,6,4,0,180
86808,951371,1,20,1,1,0,181
86809,951371,1,20,2,2,0,183
86810,951371,1,20,3,1,0,184
86811,951371,1,20,4,3,0,187
86812,951371,1,20,5,4,0,191
86813,951371,1,20,6,1,0,192
86932,951373,1,1,1,0,0,0
86933,951373,1,1,2,0,1,0
86934,951373,1,1,3,1,0,1
86935,951373,1,1,4,1,0,2
86936,951373,1,1,5,4,0,6
86937,951373,1,1,6,1,0,7
86938,951373,1,2,1,0,0,7
86939,951373,1,2,2,0,0,7
86940,951373,1,2,3,1,0,8
86941,951373,1,2,4,0,0,8
86942,951373,1,2,5,0,1,8
86943,951373,1,2,6,0,0,8
86944,951373,1,3,1,1,0,9
86945,951373,1,3,2,0,0,9
86946,951373,1,3,3,0,0,9
86947,951373,1,3,4,0,0,9
86948,951373,1,3,5,0,0,9
86949,951373,1,3,6,0,0,9
86950,951373,1,4,1,0,0,9
86951,951373,1,4,2,4,0,13
86952,951373,1,4,3,1,0,14
86953,951373,1,4,4,4,0,18
86954,951373,1,4,5,1,0,19
86955,951373,1,4,6,4,0,23
86956,951373,1,5,1,0,0,23
86957,951373,1,5,2,0,0,23
86958,951373,1,5,3,0,0,23
86959,951373,1,5,4,0,1,23
86960,951373,1,5,5,0,0,23
86961,951373,1,5,6,0,0,23
86962,951373,1,6,1,1,0,24
86963,951373,1,6,2,4,0,28
86964,951373,1,6,3,2,0,30
86965,951373,1,6,4,1,0,31
86966,951373,1,6,5,0,0,31
86967,951373,1,6,6,2,0,33
86968,951373,1,7,1,0,0,33
86969,951373,1,7,2,1,0,34
86970,951373,1,7,3,1,0,35
86971,951373,1,7,4,1,0,36
86972,951373,1,7,5,4,0,40
86973,951373,1,7,6,1,0,41
86974,951373,1,8,1,2,0,43
86975,951373,1,8,2,1,0,44
86976,951373,1,8,3,1,0,45
86977,951373,1,8,4,0,0,45
86978,951373,1,8,5,1,0,46
86979,951373,1,8,6,1,0,47
86980,951373,1,9,1,0,0,47
86981,951373,1,9,2,1,0,48
86982,951373,1,9,3,1,0,49
86983,951373,1,9,4,6,0,55
86984,951373,1,9,5,2,0,57
86985,951373,1,9,6,0,0,57
86986,951373,1,10,1,2,0,59
86987,951373,1,10,2,1,0,60
86988,951373,1,10,3,1,0,61
86989,951373,1,10,4,4,0,65
86990,951373,1,10,5,1,0,66
86991,951373,1,10,6,1,0,67
86992,951373,1,11,1,6,0,73
86993,951373,1,11,2,6,0,79
86994,951373,1,11,3,1,0,80
86995,951373,1,11,4,1,0,81
86996,951373,1,11,5,1,0,82
86997,951373,1,11,6,1,0,83
86998,951373,1,12,1,1,0,84
86999,951373,1,12,2,0,1,84
87000,951373,1,12,3,2,0,86
87001,951373,1,12,4,1,0,87
87002,951373,1,12,5,1,0,88
87003,951373,1,12,6,1,0,89
87004,951373,1,13,1,1,0,90
87005,951373,1,13,2,2,0,92
87006,951373,1,13,3,4,0,96
87007,951373,1,13,4,1,0,97
87008,951373,1,13,5,4,0,101
87009,951373,1,13,6,2,0,103
87010,951373,1,14,1,4,0,107
87011,951373,1,14,2,1,0,108
87012,951373,1,14,3,2,0,110
87013,951373,1,14,4,0,1,110
87014,951373,1,14,5,0,0,110
87015,951373,1,14,6,0,1,110
87016,951373,1,15,1,1,1,111
87017,951373,1,15,2,2,0,113
87018,951373,1,15,3,0,0,113
87019,951373,1,15,4,1,0,114
87020,951373,1,15,5,0,0,114
87021,951373,1,15,6,1,0,115
87022,951373,1,16,1,1,0,116
87023,951373,1,16,2,0,0,116
87024,951373,1,16,3,0,0,116
87025,951373,1,16,4,0,0,116
87026,951373,1,16,5,1,0,117
87027,951373,1,16,6,0,0,117
87028,951373,1,17,1,0,0,117
87029,951373,1,17,2,6,0,123
87030,951373,1,17,3,0,0,123
87031,951373,1,17,4,1,0,124
87032,951373,1,17,5,1,0,125
87033,951373,1,17,6,6,0,131
87034,951373,1,18,1,1,0,132
87035,951373,1,18,2,4,0,136
87036,951373,1,18,3,0,1,136
87037,951373,1,18,4,1,0,137
87038,951373,1,18,5,1,0,138
87039,951373,1,18,6,0,0,138
87040,951373,1,19,1,2,0,140
87041,951373,1,19,2,2,0,142
87042,951373,1,19,3,0,1,142
87043,951373,1,19,4,1,0,143
87044,951373,1,19,5,1,0,144
87045,951373,1,19,6,1,0,145
87046,951373,1,20,1,1,0,146
87047,951373,1,20,2,0,0,146
87048,951373,1,20,3,4,0,150
87049,951373,1,20,4,2,0,152
87050,951373,1,20,5,1,0,153
87051,951373,1,20,6,2,0,155
87170,953345,1,1,1,0,0,0
87171,953345,1,1,2,0,0,0
87172,953345,1,1,3,4,0,4
87173,953345,1,1,4,0,0,4
87174,953345,1,1,5,2,0,6
87175,953345,1,1,6,0,0,6
87176,953345,1,2,1,6,0,12
87177,953345,1,2,2,1,0,13
87178,953345,1,2,3,0,0,13
87179,953345,1,2,4,0,0,13
87180,953345,1,2,5,0,0,13
87181,953345,1,2,6,0,0,13
87182,953345,1,3,1,0,0,13
87183,953345,1,3,2,4,0,17
87184,953345,1,3,3,1,0,18
87185,953345,1,3,4,2,0,20
87186,953345,1,3,5,2,0,22
87187,953345,1,3,6,0,0,22
87188,953345,1,4,1,1,0,23
87189,953345,1,4,2,0,0,23
87190,953345,1,4,3,2,0,25
87191,953345,1,4,4,6,0,31
87192,953345,1,4,5,1,0,32
87193,953345,1,4,6,6,0,38
87194,953345,1,5,1,4,0,42
87195,953345,1,5,2,1,0,43
87196,953345,1,5,3,6,0,49
87197,953345,1,5,4,1,0,50
87198,953345,1,5,5,0,0,50
87199,953345,1,5,6,1,0,51
87200,953345,1,6,1,4,0,55
87201,953345,1,6,2,1,0,56
87202,953345,1,6,3,1,0,57
87203,953345,1,6,4,4,0,61
87204,953345,1,6,5,0,0,61
87205,953345,1,6,6,1,0,62
87206,953345,1,7,1,0,0,62
87207,953345,1,7,2,1,0,63
87208,953345,1,7,3,0,1,63
87209,953345,1,7,4,0,0,63
87210,953345,1,7,5,0,0,63
87211,953345,1,7,6,0,0,63
87212,953345,1,8,1,0,0,63
87213,953345,1,8,2,2,0,65
87214,953345,1,8,3,1,0,66
87215,953345,1,8,4,1,0,67
87216,953345,1,8,5,1,0,68
87217,953345,1,8,6,1,0,69
87218,953345,1,9,1,0,0,69
87219,953345,1,9,2,6,0,75
87220,953345,1,9,3,0,1,75
87221,953345,1,9,4,1,0,76
87222,953345,1,9,5,0,0,76
87223,953345,1,9,6,1,0,77
87224,953345,1,10,1,1,0,78
87225,953345,1,10,2,4,0,82
87226,953345,1,10,3,1,0,83
87227,953345,1,10,4,0,0,83
87228,953345,1,10,5,1,0,84
87229,953345,1,10,6,1,0,85
87230,953345,1,11,1,0,0,85
87231,953345,1,11,2,1,0,86
87232,953345,1,11,3,1,0,87
87233,953345,1,11,4,4,0,91
87234,953345,1,11,5,0,0,91
87235,953345,1,11,6,0,0,91
87236,953345,1,12,1,0,0,91
87237,953345,1,12,2,1,0,92
87238,953345,1,12,3,1,0,93
87239,953345,1,12,4,4,0,97
87240,953345,1,12,5,1,0,98
87241,953345,1,12,6,1,0,99
87242,953345,1,13,1,0,0,99
87243,953345,1,13,2,0,0,99
87244,953345,1,13,3,4,0,103
87245,953345,1,13,4,1,0,104
87246,953345,1,13,5,0,1,104
87247,953345,1,13,6,1,0,105
87248,953345,1,14,1,0,0,105
87249,953345,1,14,2,0,1,105
87250,953345,1,14,3,0,0,105
87251,953345,1,14,4,1,0,106
87252,953345,1,14,5,0,0,106
87253,953345,1,14,6,0,0,106
87254,953345,1,15,1,1,0,107
87255,953345,1,15,2,1,0,108
87256,953345,1,15,3,6,0,114
87257,953345,1,15,4,0,0,114
87258,953345,1,15,5,1,0,115
87259,953345,1,15,6,6,0,121
87260,953345,1,16,1,4,0,125
87261,953345,1,16,2,0,0,125
87262,953345,1,16,3,2,0,127
87263,953345,1,16,4,1,0,128
87264,953345,1,16,5,0,0,128
87265,953345,1,16,6,2,0,130
87266,953345,1,17,1,6,0,136
87267,953345,1,17,2,1,0,137
87268,953345,1,17,3,1,0,138
87269,953345,1,17,4,0,0,138
87270,953345,1,17,5,1,0,139
87271,953345,1,17,6,4,0,143
87272,953345,1,18,1,0,0,143
87273,953345,1,18,2,2,0,145
87274,953345,1,18,3,6,0,151
87275,953345,1,18,4,6,0,157
87276,953345,1,18,5,0,1,157
87277,953345,1,18,6,2,0,159
87278,953345,1,19,1,1,0,160
87279,953345,1,19,2,2,1,162
87280,953345,1,19,3,1,0,163
87281,953345,1,19,4,4,0,167
87282,953345,1,19,5,0,0,167
87283,953345,1,19,6,6,0,173
87284,953345,1,20,1,0,1,173
87285,953345,1,20,2,0,0,173
87286,953345,1,20,3,4,0,177
87287,953345,1,20,4,2,0,179
87288,953345,1,20,5,6,0,185
87289,953345,1,20,6,2,0,187
87410,953347,1,1,1,0,0,0
87411,953347,1,1,2,0,0,0
87412,953347,1,1,3,0,0,0
87413,953347,1,1,4,1,0,1
87414,953347,1,1,5,1,0,2
87415,953347,1,1,6,1,0,3
87416,953347,1,2,1,0,0,3
87417,953347,1,2,2,0,0,3
87418,953347,1,2,3,6,0,9
87419,953347,1,2,4,1,0,10
87420,953347,1,2,5,0,0,10
87421,953347,1,2,6,0,0,10
87422,953347,1,3,1,4,0,14
87423,953347,1,3,2,2,0,16
87424,953347,1,3,3,0,0,16
87425,953347,1,3,4,1,0,17
87426,953347,1,3,5,0,0,17
87427,953347,1,3,6,2,0,19
87428,953347,1,4,1,0,0,19
87429,953347,1,4,2,4,0,23
87430,953347,1,4,3,0,0,23
87431,953347,1,4,4,1,0,24
87432,953347,1,4,5,0,0,24
87433,953347,1,4,6,0,0,24
87434,953347,1,5,1,0,0,24
87435,953347,1,5,2,1,0,25
87436,953347,1,5,3,0,0,25
87437,953347,1,5,4,1,0,26
87438,953347,1,5,5,4,0,30
87439,953347,1,5,6,0,0,30
87440,953347,1,6,1,2,0,32
87441,953347,1,6,2,1,0,33
87442,953347,1,6,3,4,0,37
87443,953347,1,6,4,1,0,38
87444,953347,1,6,5,1,0,39
87445,953347,1,6,6,4,0,43
87446,953347,1,7,1,0,1,43
87447,953347,1,7,2,0,0,43
87448,953347,1,7,3,1,0,44
87449,953347,1,7,4,0,0,44
87450,953347,1,7,5,0,0,44
87451,953347,1,7,6,1,0,45
87452,953347,1,8,1,6,0,51
87453,953347,1,8,2,4,0,55
87454,953347,1,8,3,4,0,59
87455,953347,1,8,4,1,0,60
87456,953347,1,8,5,1,0,61
87457,953347,1,8,6,1,0,62
87458,953347,1,9,1,0,0,62
87459,953347,1,9,2,1,0,63
87460,953347,1,9,3,6,0,69
87461,953347,1,9,4,1,0,70
87462,953347,1,9,5,0,0,70
87463,953347,1,9,6,6,0,76
87464,953347,1,10,1,1,0,77
87465,953347,1,10,2,1,0,78
87466,953347,1,10,3,1,0,79
87467,953347,1,10,4,7,0,86
87468,953347,1,10,5,6,0,92
87469,953347,1,10,6,1,0,93
87470,953347,1,11,1,7,0,100
87471,953347,1,11,2,4,0,104
87472,953347,1,11,3,1,0,105
87473,953347,1,11,4,0,0,105
87474,953347,1,11,5,4,0,109
87475,953347,1,11,6,4,0,113
87476,953347,1,12,1,0,0,113
87477,953347,1,12,2,1,0,114
87478,953347,1,12,3,2,0,116
87479,953347,1,12,4,0,1,116
87480,953347,1,12,5,2,0,118
87481,953347,1,12,6,5,0,123
87482,953347,1,13,1,6,0,129
87483,953347,1,13,2,0,0,129
87484,953347,1,13,3,6,0,135
87485,953347,1,13,4,1,0,136
87486,953347,1,13,5,2,0,138
87487,953347,1,13,6,4,0,142
87488,953347,1,14,1,2,0,144
87489,953347,1,14,2,1,0,145
87490,953347,1,14,3,0,1,145
87491,953347,1,14,4,0,0,145
87492,953347,1,14,5,0,0,145
87493,953347,1,14,6,1,0,146
87494,953347,1,15,1,6,0,152
87495,953347,1,15,2,1,0,153
87496,953347,1,15,3,1,0,154
87497,953347,1,15,4,0,1,154
87498,953347,1,15,5,0,0,154
87499,953347,1,15,6,0,0,154
87500,953347,1,16,1,1,0,155
87501,953347,1,16,2,4,0,159
87502,953347,1,16,3,1,0,160
87503,953347,1,16,4,1,0,161
87504,953347,1,16,5,2,0,163
87505,953347,1,16,6,4,0,167
87506,953347,1,17,1,0,0,167
87507,953347,1,17,2,1,0,168
87508,953347,1,17,3,6,0,174
87509,953347,1,17,4,2,0,176
87510,953347,1,17,5,1,0,177
87511,953347,1,17,6,4,0,181
87512,953347,1,18,1,1,0,182
87513,953347,1,18,2,2,0,184
87514,953347,1,18,3,1,0,185
87515,953347,1,18,4,0,0,185
87516,953347,1,18,5,0,0,185
87517,953347,1,18,6,4,0,189
87518,953347,1,19,1,2,0,191
87519,953347,1,19,2,3,0,194
87520,953347,1,19,3,1,0,195
87521,953347,1,19,4,6,0,201
87522,953347,1,19,5,0,1,201
87523,953347,1,19,6,1,0,202
87524,953347,1,20,1,6,0,208
87525,953347,1,20,2,2,0,210
87526,953347,1,20,3,1,0,211
87527,953347,1,20,4,1,0,212
87528,953347,1,20,5,2,0,214
87529,953347,1,20,6,1,1,215
87639,958415,1,1,1,0,0,0
87640,958415,1,1,2,0,0,0
87641,958415,1,1,3,0,0,0
87642,958415,1,1,4,0,0,0
87643,958415,1,1,5,2,0,2
87644,958415,1,1,6,0,0,2
87645,958415,1,2,1,0,0,2
87646,958415,1,2,2,1,0,3
87647,958415,1,2,3,0,0,3
87648,958415,1,2,4,0,0,3
87649,958415,1,2,5,4,0,7
87650,958415,1,2,6,0,0,7
87651,958415,1,3,1,4,0,11
87652,958415,1,3,2,4,0,15
87653,958415,1,3,3,0,0,15
87654,958415,1,3,4,1,0,16
87655,958415,1,3,5,1,0,17
87656,958415,1,3,6,4,0,21
87657,958415,1,4,1,0,0,21
87658,958415,1,4,2,0,0,21
87659,958415,1,4,3,0,0,21
87660,958415,1,4,4,4,0,25
87661,958415,1,4,5,0,0,25
87662,958415,1,4,6,1,0,26
87663,958415,1,5,1,1,0,27
87664,958415,1,5,2,0,0,27
87665,958415,1,5,3,4,0,31
87666,958415,1,5,4,3,0,34
87667,958415,1,5,5,1,0,35
87668,958415,1,5,6,6,0,41
87669,958415,1,6,1,0,0,41
87670,958415,1,6,2,4,0,45
87671,958415,1,6,3,0,0,45
87672,958415,1,6,4,1,0,46
87673,958415,1,6,5,1,0,47
87674,958415,1,6,6,0,0,47
87675,958415,1,7,1,1,0,48
87676,958415,1,7,2,1,0,49
87677,958415,1,7,3,1,0,50
87678,958415,1,7,4,3,0,53
87679,958415,1,7,5,1,0,54
87680,958415,1,7,6,1,0,55
87681,958415,1,8,1,1,0,56
87682,958415,1,8,2,1,0,57
87683,958415,1,8,3,2,0,59
87684,958415,1,8,4,1,0,60
87685,958415,1,8,5,0,0,60
87686,958415,1,8,6,1,0,61
87687,958415,1,9,1,4,0,65
87688,958415,1,9,2,1,0,66
87689,958415,1,9,3,1,0,67
87690,958415,1,9,4,0,0,67
87691,958415,1,9,5,1,0,68
87692,958415,1,9,6,1,0,69
87693,958415,1,10,1,0,0,69
87694,958415,1,10,2,1,0,70
87695,958415,1,10,3,0,0,70
87696,958415,1,10,4,1,0,71
87697,958415,1,10,5,0,0,71
87698,958415,1,10,6,4,0,75
87699,958415,1,11,1,6,0,81
87700,958415,1,11,2,1,0,82
87701,958415,1,11,3,1,0,83
87702,958415,1,11,4,4,0,87
87703,958415,1,11,5,0,0,87
87704,958415,1,11,6,1,0,88
87705,958415,1,12,1,1,0,89
87706,958415,1,12,2,1,0,90
87707,958415,1,12,3,1,0,91
87708,958415,1,12,4,4,0,95
87709,958415,1,12,5,6,0,101
87710,958415,1,12,6,0,1,101
87711,958415,1,13,1,1,0,102
87712,958415,1,13,2,1,0,103
87713,958415,1,13,3,1,0,104
87714,958415,1,13,4,4,0,108
87715,958415,1,13,5,2,0,110
87716,958415,1,13,6,2,0,112
87717,958415,1,14,1,4,0,116
87718,958415,1,14,2,0,0,116
87719,958415,1,14,3,1,0,117
87720,958415,1,14,4,0,0,117
87721,958415,1,14,5,1,0,118
87722,958415,1,14,6,4,0,122
87723,958415,1,15,1,1,0,123
87724,958415,1,15,2,2,0,125
87725,958415,1,15,3,1,0,126
87726,958415,1,15,4,1,1,127
87727,958415,1,15,5,1,0,128
87728,958415,1,15,6,4,0,132
87729,958415,1,16,1,1,0,133
87730,958415,1,16,2,0,0,133
87731,958415,1,16,3,1,0,134
87732,958415,1,16,4,1,0,135
87733,958415,1,16,5,6,0,141
87734,958415,1,16,6,1,0,142
87735,958415,1,17,1,0,0,142
87736,958415,1,17,2,0,0,142
87737,958415,1,17,3,2,0,144
87738,958415,1,17,4,1,0,145
87739,958415,1,17,5,1,0,146
87740,958415,1,17,6,1,0,147
87741,958415,1,18,1,1,0,148
87742,958415,1,18,2,1,0,149
87743,958415,1,18,3,1,0,150
87744,958415,1,18,4,0,1,150
87745,958415,1,18,5,2,0,152
87746,958415,1,18,6,1,0,153
87747,958415,1,19,1,0,1,153
87748,958415,1,19,2,0,1,153
87749,958415,1,19,3,0,0,153
87750,958415,1,19,4,1,0,154
87751,958415,1,19,5,1,0,155
87752,958415,1,19,6,0,0,155
87753,958415,1,20,1,0,1,155
87754,958415,1,20,2,0,0,155
87755,958415,1,20,3,1,0,156
87756,958415,1,20,4,6,0,162
87757,958415,1,20,5,1,0,163
87758,958415,1,20,6,0,1,163
87872,958417,1,1,1,0,0,0
87873,958417,1,1,2,1,0,1
87874,958417,1,1,3,0,0,1
87875,958417,1,1,4,0,0,1
87876,958417,1,1,5,0,0,1
87877,958417,1,1,6,0,0,1
87878,958417,1,2,1,1,0,2
87879,958417,1,2,2,4,0,6
87880,958417,1,2,3,0,0,6
87881,958417,1,2,4,0,0,6
87882,958417,1,2,5,0,0,6
87883,958417,1,2,6,1,0,7
87884,958417,1,3,1,0,0,7
87885,958417,1,3,2,4,0,11
87886,958417,1,3,3,4,0,15
87887,958417,1,3,4,1,0,16
87888,958417,1,3,5,0,0,16
87889,958417,1,3,6,1,0,17
87890,958417,1,4,1,4,0,21
87891,958417,1,4,2,0,0,21
87892,958417,1,4,3,0,0,21
87893,958417,1,4,4,1,0,22
87894,958417,1,4,5,6,0,28
87895,958417,1,4,6,0,0,28
87896,958417,1,5,1,4,0,32
87897,958417,1,5,2,0,0,32
87898,958417,1,5,3,1,0,33
87899,958417,1,5,4,0,0,33
87900,958417,1,5,5,1,0,34
87901,958417,1,5,6,6,0,40
87902,958417,1,6,1,1,0,41
87903,958417,1,6,2,0,0,41
87904,958417,1,6,3,4,0,45
87905,958417,1,6,4,0,0,45
87906,958417,1,6,5,0,1,45
87907,958417,1,6,6,1,0,46
87908,958417,1,7,1,0,0,46
87909,958417,1,7,2,1,0,47
87910,958417,1,7,3,1,0,48
87911,958417,1,7,4,1,0,49
87912,958417,1,7,5,1,0,50
87913,958417,1,7,6,1,0,51
87914,958417,1,8,1,1,0,52
87915,958417,1,8,2,0,0,52
87916,958417,1,8,3,0,0,52
87917,958417,1,8,4,6,0,58
87918,958417,1,8,5,0,0,58
87919,958417,1,8,6,1,0,59
87920,958417,1,9,1,1,0,60
87921,958417,1,9,2,1,0,61
87922,958417,1,9,3,6,0,67
87923,958417,1,9,4,4,0,71
87924,958417,1,9,5,0,0,71
87925,958417,1,9,6,2,0,73
87926,958417,1,10,1,0,0,73
87927,958417,1,10,2,1,0,74
87928,958417,1,10,3,1,0,75
87929,958417,1,10,4,0,1,75
87930,958417,1,10,5,0,0,75
87931,958417,1,10,6,1,0,76
87932,958417,1,11,1,0,1,76
87933,958417,1,11,2,0,0,76
87934,958417,1,11,3,0,0,76
87935,958417,1,11,4,1,0,77
87936,958417,1,11,5,1,0,78
87937,958417,1,11,6,1,0,79
87938,958417,1,12,1,2,0,81
87939,958417,1,12,2,1,0,82
87940,958417,1,12,3,0,0,82
87941,958417,1,12,4,0,0,82
87942,958417,1,12,5,2,0,84
87943,958417,1,12,6,2,0,86
87944,958417,1,13,1,1,0,87
87945,958417,1,13,2,0,0,87
87946,958417,1,13,3,1,0,88
87947,958417,1,13,4,4,0,92
87948,958417,1,13,5,2,0,94
87949,958417,1,13,6,1,0,95
87950,958417,1,14,1,2,0,97
87951,958417,1,14,2,1,0,98
87952,958417,1,14,3,0,0,98
87953,958417,1,14,4,6,0,104
87954,958417,1,14,5,1,0,105
87955,958417,1,14,6,2,0,107
87956,958417,1,15,1,1,0,108
87957,958417,1,15,2,1,0,109
87958,958417,1,15,3,6,0,115
87959,958417,1,15,4,1,0,116
87960,958417,1,15,5,0,0,116
87961,958417,1,15,6,1,0,117
87962,958417,1,16,1,0,0,117
87963,958417,1,16,2,1,0,118
87964,958417,1,16,3,6,0,124
87965,958417,1,16,4,1,0,125
87966,958417,1,16,5,2,0,127
87967,958417,1,16,6,1,1,128
87968,958417,1,17,1,2,0,130
87969,958417,1,17,2,2,0,132
87970,958417,1,17,3,1,0,133
87971,958417,1,17,4,1,0,134
87972,958417,1,17,5,1,0,135
87973,958417,1,17,6,4,0,139
87974,958417,1,18,1,2,0,141
87975,958417,1,18,2,1,0,142
87976,958417,1,18,3,4,0,146
87977,958417,1,18,4,1,0,147
87978,958417,1,18,5,2,0,149
87979,958417,1,18,6,0,0,149
87980,958417,1,19,1,1,0,150
87981,958417,1,19,2,1,0,151
87982,958417,1,19,3,0,0,151
87983,958417,1,19,4,4,0,155
87984,958417,1,19,5,2,0,157
87985,958417,1,19,6,1,0,158
87986,958417,1,20,1,0,0,158
87987,958417,1,20,2,0,0,158
87988,958417,1,20,3,0,0,158
87989,958417,1,20,4,6,0,164
87990,958417,1,20,5,1,0,165
87991,958417,1,20,6,2,0,167
88112,958419,1,1,1,0,0,0
88113,958419,1,1,2,1,0,1
88114,958419,1,1,3,4,0,5
88115,958419,1,1,4,2,0,7
88116,958419,1,1,5,0,0,7
88117,958419,1,1,6,0,0,7
88118,958419,1,2,1,0,0,7
88119,958419,1,2,2,0,0,7
88120,958419,1,2,3,0,0,7
88121,958419,1,2,4,4,0,11
88122,958419,1,2,5,0,0,11
88123,958419,1,2,6,0,0,11
88124,958419,1,3,1,0,0,11
88125,958419,1,3,2,4,0,15
88126,958419,1,3,3,6,0,21
88127,958419,1,3,4,4,0,25
88128,958419,1,3,5,4,0,29
88129,958419,1,3,6,0,0,29
88130,958419,1,4,1,0,0,29
88131,958419,1,4,2,4,0,33
88132,958419,1,4,3,4,0,37
88133,958419,1,4,4,4,0,41
88134,958419,1,4,5,4,0,45
88135,958419,1,4,6,0,1,45
88136,958419,1,5,1,4,0,49
88137,958419,1,5,2,0,0,49
88138,958419,1,5,3,1,0,50
88139,958419,1,5,4,0,0,50
88140,958419,1,5,5,1,0,51
88141,958419,1,5,6,1,0,52
88142,958419,1,6,1,1,0,53
88143,958419,1,6,2,0,0,53
88144,958419,1,6,3,1,0,54
88145,958419,1,6,4,4,0,58
88146,958419,1,6,5,1,0,59
88147,958419,1,6,6,0,0,59
88148,958419,1,7,1,0,0,59
88149,958419,1,7,2,1,0,60
88150,958419,1,7,3,4,0,64
88151,958419,1,7,4,1,0,65
88152,958419,1,7,5,1,0,66
88153,958419,1,7,6,6,0,72
88154,958419,1,8,1,0,0,72
88155,958419,1,8,2,1,0,73
88156,958419,1,8,3,6,0,79
88157,958419,1,8,4,0,0,79
88158,958419,1,8,5,0,0,79
88159,958419,1,8,6,1,0,80
88160,958419,1,9,1,0,0,80
88161,958419,1,9,2,0,1,80
88162,958419,1,9,3,1,0,81
88163,958419,1,9,4,0,0,81
88164,958419,1,9,5,0,0,81
88165,958419,1,9,6,1,0,82
88166,958419,1,10,1,1,0,83
88167,958419,1,10,2,1,0,84
88168,958419,1,10,3,1,0,85
88169,958419,1,10,4,1,0,86
88170,958419,1,10,5,0,0,86
88171,958419,1,10,6,1,0,87
88172,958419,1,11,1,0,0,87
88173,958419,1,11,2,0,0,87
88174,958419,1,11,3,1,0,88
88175,958419,1,11,4,1,0,89
88176,958419,1,11,5,0,1,89
88177,958419,1,11,6,1,0,90
88178,958419,1,12,1,1,0,91
88179,958419,1,12,2,1,0,92
88180,958419,1,12,3,1,0,93
88181,958419,1,12,4,0,0,93
88182,958419,1,12,5,1,0,94
88183,958419,1,12,6,2,0,96
88184,958419,1,13,1,0,0,96
88185,958419,1,13,2,1,0,97
88186,958419,1,13,3,4,0,101
88187,958419,1,13,4,0,0,101
88188,958419,1,13,5,1,0,102
88189,958419,1,13,6,0,0,102
88190,958419,1,14,1,4,0,106
88191,958419,1,14,2,1,0,107
88192,958419,1,14,3,0,0,107
88193,958419,1,14,4,2,0,109
88194,958419,1,14,5,2,0,111
88195,958419,1,14,6,1,0,112
88196,958419,1,15,1,1,0,113
88197,958419,1,15,2,9,0,122
88198,958419,1,15,3,1,0,123
88199,958419,1,15,4,1,0,124
88200,958419,1,15,5,1,0,125
88201,958419,1,15,6,4,0,129
88202,958419,1,16,1,6,0,135
88203,958419,1,16,2,2,0,137
88204,958419,1,16,3,2,0,139
88205,958419,1,16,4,1,0,140
88206,958419,1,16,5,1,0,141
88207,958419,1,16,6,0,0,141
88208,958419,1,17,1,1,0,142
88209,958419,1,17,2,1,0,143
88210,958419,1,17,3,4,0,147
88211,958419,1,17,4,1,0,148
88212,958419,1,17,5,6,0,154
88213,958419,1,17,6,1,0,155
88214,958419,1,18,1,1,0,156
88215,958419,1,18,2,0,0,156
88216,958419,1,18,3,1,0,157
88217,958419,1,18,4,6,0,163
88218,958419,1,18,5,0,1,163
88219,958419,1,18,6,6,0,169
88220,958419,1,19,1,0,0,169
88221,958419,1,19,2,4,0,173
88222,958419,1,19,3,0,0,173
88223,958419,1,19,4,1,0,174
88224,958419,1,19,5,1,0,175
88225,958419,1,19,6,2,0,177
88226,958419,1,20,1,0,1,177
88227,958419,1,20,2,2,0,179
88228,958419,1,20,3,6,0,185
88229,958419,1,20,4,1,0,186
88230,958419,1,20,5,0,1,186
88231,958419,1,20,6,1,0,187
88352,958421,1,1,1,0,0,0
88353,958421,1,1,2,0,0,0
88354,958421,1,1,3,0,0,0
88355,958421,1,1,4,4,0,4
88356,958421,1,1,5,0,1,4
88357,958421,1,1,6,2,0,6
88358,958421,1,2,1,2,0,8
88359,958421,1,2,2,0,0,8
88360,958421,1,2,3,4,0,12
88361,958421,1,2,4,4,0,16
88362,958421,1,2,5,1,0,17
88363,958421,1,2,6,0,0,17
88364,958421,1,3,1,0,0,17
88365,958421,1,3,2,0,0,17
88366,958421,1,3,3,1,0,18
88367,958421,1,3,4,4,0,22
88368,958421,1,3,5,4,0,26
88369,958421,1,3,6,1,0,27
88370,958421,1,4,1,0,0,27
88371,958421,1,4,2,0,0,27
88372,958421,1,4,3,4,0,31
88373,958421,1,4,4,6,0,37
88374,958421,1,4,5,0,0,37
88375,958421,1,4,6,1,0,38
88376,958421,1,5,1,0,0,38
88377,958421,1,5,2,6,0,44
88378,958421,1,5,3,4,0,48
88379,958421,1,5,4,1,0,49
88380,958421,1,5,5,1,0,50
88381,958421,1,5,6,2,0,52
88382,958421,1,6,1,4,0,56
88383,958421,1,6,2,0,0,56
88384,958421,1,6,3,0,0,56
88385,958421,1,6,4,2,0,58
88386,958421,1,6,5,2,0,60
88387,958421,1,6,6,2,0,62
88388,958421,1,7,1,0,0,62
88389,958421,1,7,2,1,0,63
88390,958421,1,7,3,0,0,63
88391,958421,1,7,4,1,0,64
88392,958421,1,7,5,1,0,65
88393,958421,1,7,6,4,0,69
88394,958421,1,8,1,0,0,69
88395,958421,1,8,2,0,0,69
88396,958421,1,8,3,1,0,70
88397,958421,1,8,4,0,0,70
88398,958421,1,8,5,0,0,70
88399,958421,1,8,6,1,0,71
88400,958421,1,9,1,0,0,71
88401,958421,1,9,2,0,0,71
88402,958421,1,9,3,1,0,72
88403,958421,1,9,4,1,0,73
88404,958421,1,9,5,1,0,74
88405,958421,1,9,6,1,0,75
88406,958421,1,10,1,6,0,81
88407,958421,1,10,2,1,0,82
88408,958421,1,10,3,0,0,82
88409,958421,1,10,4,0,0,82
88410,958421,1,10,5,2,0,84
88411,958421,1,10,6,0,0,84
88412,958421,1,11,1,0,1,84
88413,958421,1,11,2,1,0,85
88414,958421,1,11,3,1,0,86
88415,958421,1,11,4,2,0,88
88416,958421,1,11,5,1,0,89
88417,958421,1,11,6,2,0,91
88418,958421,1,12,1,1,0,92
88419,958421,1,12,2,1,0,93
88420,958421,1,12,3,6,0,99
88421,958421,1,12,4,1,0,100
88422,958421,1,12,5,1,0,101
88423,958421,1,12,6,1,0,102
88424,958421,1,13,1,1,0,103
88425,958421,1,13,2,4,0,107
88426,958421,1,13,3,1,0,108
88427,958421,1,13,4,6,0,114
88428,958421,1,13,5,1,0,115
88429,958421,1,13,6,1,0,116
88430,958421,1,14,1,6,0,122
88431,958421,1,14,2,1,0,123
88432,958421,1,14,3,6,0,129
88433,958421,1,14,4,2,0,131
88434,958421,1,14,5,1,0,132
88435,958421,1,14,6,4,0,136
88436,958421,1,15,1,1,0,137
88437,958421,1,15,2,1,0,138
88438,958421,1,15,3,1,0,139
88439,958421,1,15,4,1,0,140
88440,958421,1,15,5,4,0,144
88441,958421,1,15,6,1,0,145
88442,958421,1,16,1,0,1,145
88443,958421,1,16,2,0,0,145
88444,958421,1,16,3,1,0,146
88445,958421,1,16,4,0,0,146
88446,958421,1,16,5,1,0,147
88447,958421,1,16,6,2,0,149
88448,958421,1,17,1,0,0,149
88449,958421,1,17,2,0,1,149
88450,958421,1,17,3,1,0,150
88451,958421,1,17,4,1,0,151
88452,958421,1,17,5,1,0,152
88453,958421,1,17,6,1,0,153
88454,958421,1,18,1,1,0,154
88455,958421,1,18,2,2,0,156
88456,958421,1,18,3,2,0,158
88457,958421,1,18,4,6,0,164
88458,958421,1,18,5,4,0,168
88459,958421,1,18,6,0,0,168
88460,958421,1,19,1,1,0,169
88461,958421,1,19,2,1,0,170
88462,958421,1,19,3,0,0,170
88463,958421,1,19,4,0,0,170
88464,958421,1,19,5,0,0,170
88465,958421,1,19,6,0,0,170
88466,958421,1,20,1,1,0,171
88467,958421,1,20,2,1,0,172
88468,958421,1,20,3,0,0,172
88469,958421,1,20,4,6,0,178
88470,958421,1,20,5,2,0,180
88471,958421,1,20,6,0,0,180
88586,963697,1,1,1,0,0,0
88587,963697,1,1,2,0,1,0
88588,963697,1,1,3,0,0,0
88589,963697,1,1,4,0,0,0
88590,963697,1,1,5,5,0,5
88591,963697,1,1,6,0,1,5
88592,963697,1,2,1,0,0,5
88593,963697,1,2,2,0,0,5
88594,963697,1,2,3,0,0,5
88595,963697,1,2,4,0,0,5
88596,963697,1,2,5,0,0,5
88597,963697,1,2,6,0,0,5
88598,963697,1,3,1,1,0,6
88599,963697,1,3,2,0,0,6
88600,963697,1,3,3,1,0,7
88601,963697,1,3,4,1,0,8
88602,963697,1,3,5,2,0,10
88603,963697,1,3,6,0,0,10
88604,963697,1,4,1,6,0,16
88605,963697,1,4,2,0,0,16
88606,963697,1,4,3,1,0,17
88607,963697,1,4,4,1,0,18
88608,963697,1,4,5,1,0,19
88609,963697,1,4,6,0,0,19
88610,963697,1,5,1,0,0,19
88611,963697,1,5,2,4,0,23
88612,963697,1,5,3,6,0,29
88613,963697,1,5,4,1,0,30
88614,963697,1,5,5,2,0,32
88615,963697,1,5,6,0,1,32
88616,963697,1,6,1,0,0,32
88617,963697,1,6,2,6,0,38
88618,963697,1,6,3,0,0,38
88619,963697,1,6,4,1,0,39
88620,963697,1,6,5,0,0,39
88621,963697,1,6,6,1,0,40
88622,963697,1,7,1,0,0,40
88623,963697,1,7,2,0,0,40
88624,963697,1,7,3,0,0,40
88625,963697,1,7,4,1,0,41
88626,963697,1,7,5,2,0,43
88627,963697,1,7,6,0,0,43
88628,963697,1,8,1,2,0,45
88629,963697,1,8,2,1,0,46
88630,963697,1,8,3,0,0,46
88631,963697,1,8,4,0,0,46
88632,963697,1,8,5,1,0,47
88633,963697,1,8,6,0,0,47
88634,963697,1,9,1,2,0,49
88635,963697,1,9,2,0,1,49
88636,963697,1,9,3,2,0,51
88637,963697,1,9,4,0,1,51
88638,963697,1,9,5,0,0,51
88639,963697,1,9,6,0,0,51
88640,963697,1,10,1,1,0,52
88641,963697,1,10,2,1,0,53
88642,963697,1,10,3,0,0,53
88643,963697,1,10,4,0,1,53
88644,963697,1,10,5,0,0,53
88645,963697,1,10,6,1,0,54
88646,963697,1,11,1,1,0,55
88647,963697,1,11,2,2,0,57
88648,963697,1,11,3,0,0,57
88649,963697,1,11,4,1,0,58
88650,963697,1,11,5,0,0,58
88651,963697,1,11,6,0,1,58
88652,963697,1,12,1,1,0,59
88653,963697,1,12,2,4,0,63
88654,963697,1,12,3,0,0,63
88655,963697,1,12,4,0,0,63
88656,963697,1,12,5,0,0,63
88657,963697,1,12,6,1,0,64
88658,963697,1,13,1,4,0,68
88659,963697,1,13,2,1,0,69
88660,963697,1,13,3,1,0,70
88661,963697,1,13,4,1,0,71
88662,963697,1,13,5,1,0,72
88663,963697,1,13,6,0,0,72
88664,963697,1,14,1,0,1,72
88665,963697,1,14,2,0,0,72
88666,963697,1,14,3,1,0,73
88667,963697,1,14,4,0,0,73
88668,963697,1,14,5,4,0,77
88669,963697,1,14,6,1,0,78
88670,963697,1,15,1,1,0,79
88671,963697,1,15,2,0,0,79
88672,963697,1,15,3,0,0,79
88673,963697,1,15,4,0,0,79
88674,963697,1,15,5,0,0,79
88675,963697,1,15,6,1,0,80
88676,963697,1,16,1,0,0,80
88677,963697,1,16,2,1,0,81
88678,963697,1,16,3,1,0,82
88679,963697,1,16,4,0,0,82
88680,963697,1,16,5,1,0,83
88681,963697,1,16,6,1,0,84
88682,963697,1,17,1,1,0,85
88683,963697,1,17,2,0,0,85
88684,963697,1,17,3,0,0,85
88685,963697,1,17,4,1,0,86
88686,963697,1,17,5,0,0,86
88687,963697,1,17,6,4,0,90
88688,963697,1,18,1,0,0,90
88689,963697,1,18,2,1,0,91
88690,963697,1,18,3,0,0,91
88691,963697,1,18,4,1,0,92
88692,963697,1,18,5,4,0,96
88693,963697,1,18,6,1,0,97
88694,963697,1,19,1,1,0,98
88695,963697,1,19,2,0,0,98
88696,963697,1,19,3,2,0,100
88697,963697,1,19,4,0,1,100
88698,963697,1,19,5,1,1,101
88807,963699,1,1,1,4,0,4
88808,963699,1,1,2,2,0,6
88809,963699,1,1,3,0,0,6
88810,963699,1,1,4,1,0,7
88811,963699,1,1,5,0,0,7
88812,963699,1,1,6,0,0,7
88813,963699,1,2,1,1,0,8
88814,963699,1,2,2,2,0,10
88815,963699,1,2,3,1,0,11
88816,963699,1,2,4,0,0,11
88817,963699,1,2,5,1,0,12
88818,963699,1,2,6,6,0,18
88819,963699,1,3,1,1,0,19
88820,963699,1,3,2,0,0,19
88821,963699,1,3,3,0,0,19
88822,963699,1,3,4,6,0,25
88823,963699,1,3,5,1,0,26
88824,963699,1,3,6,1,0,27
88825,963699,1,4,1,4,0,31
88826,963699,1,4,2,1,0,32
88827,963699,1,4,3,0,0,32
88828,963699,1,4,4,4,0,36
88829,963699,1,4,5,4,0,40
88830,963699,1,4,6,4,0,44
88831,963699,1,5,1,1,0,45
88832,963699,1,5,2,1,0,46
88833,963699,1,5,3,1,0,47
88834,963699,1,5,4,4,0,51
88835,963699,1,5,5,4,0,55
88836,963699,1,5,6,0,0,55
88837,963699,1,6,1,1,0,56
88838,963699,1,6,2,2,0,58
88839,963699,1,6,3,1,0,59
88840,963699,1,6,4,2,0,61
88841,963699,1,6,5,5,0,66
88842,963699,1,6,6,4,0,70
88843,963699,1,7,1,1,0,71
88844,963699,1,7,2,2,0,73
88845,963699,1,7,3,1,0,74
88846,963699,1,7,4,1,0,75
88847,963699,1,7,5,0,0,75
88848,963699,1,7,6,0,1,75
88849,963699,1,8,1,1,0,76
88850,963699,1,8,2,1,0,77
88851,963699,1,8,3,1,0,78
88852,963699,1,8,4,1,0,79
88853,963699,1,8,5,1,0,80
88854,963699,1,8,6,0,0,80
88855,963699,1,9,1,0,0,80
88856,963699,1,9,2,2,0,82
88857,963699,1,9,3,0,0,82
88858,963699,1,9,4,1,0,83
88859,963699,1,9,5,4,0,87
88860,963699,1,9,6,0,0,87
88861,963699,1,10,1,1,0,88
88862,963699,1,10,2,1,0,89
88863,963699,1,10,3,1,0,90
88864,963699,1,10,4,1,0,91
88865,963699,1,10,5,1,0,92
88866,963699,1,10,6,1,0,93
88867,963699,1,11,1,0,0,93
88868,963699,1,11,2,1,0,94
88869,963699,1,11,3,2,0,96
88870,963699,1,11,4,1,0,97
88871,963699,1,11,5,2,0,99
88872,963699,1,11,6,1,0,100
88873,963699,1,12,1,1,0,101
88874,963699,1,12,2,1,0,102
88875,963699,1,12,3,1,0,103
88876,963699,1,12,4,1,0,104
88877,963699,1,12,5,0,0,104
88878,963699,1,12,6,6,0,110
88879,963699,1,13,1,0,0,110
88880,963699,1,13,2,1,0,111
88881,963699,1,13,3,1,0,112
88882,963699,1,13,4,4,0,116
88883,963699,1,13,5,4,0,120
88884,963699,1,13,6,2,0,122
88885,963699,1,14,1,0,1,122
88886,963699,1,14,2,1,0,123
88887,963699,1,14,3,1,0,124
88888,963699,1,14,4,1,0,125
88889,963699,1,14,5,0,0,125
88890,963699,1,14,6,2,0,127
88891,963699,1,15,1,0,0,127
88892,963699,1,15,2,0,1,127
88893,963699,1,15,3,0,0,127
88894,963699,1,15,4,1,0,128
88895,963699,1,15,5,2,0,130
88896,963699,1,15,6,1,0,131
88897,963699,1,16,1,4,0,135
88898,963699,1,16,2,1,0,136
88899,963699,1,16,3,2,0,138
88900,963699,1,16,4,2,0,140
88901,963699,1,16,5,1,0,141
88902,963699,1,16,6,4,0,145
88903,963699,1,17,1,6,0,151
88904,963699,1,17,2,6,0,157
88905,963699,1,17,3,1,0,158
88906,963699,1,17,4,1,0,159
88907,963699,1,17,5,1,0,160
88908,963699,1,17,6,1,0,161
88909,963699,1,18,1,4,0,165
88910,963699,1,18,2,4,0,169
88911,963699,1,18,3,5,0,174
88912,963699,1,18,4,0,0,174
88913,963699,1,18,5,4,0,178
88914,963699,1,18,6,1,0,179
88915,963699,1,19,1,1,0,180
88916,963699,1,19,2,3,0,183
88917,963699,1,19,3,2,0,185
88918,963699,1,19,4,1,1,186
88919,963699,1,19,5,0,1,186
88920,963699,1,19,6,0,1,186
88921,963699,1,20,1,1,0,187
88922,963699,1,20,2,1,0,188
88923,963699,1,20,3,0,0,188
88924,963699,1,20,4,2,0,190
88925,963699,1,20,5,2,0,192
88926,963699,1,20,6,4,0,196
89047,963701,1,1,1,1,0,1
89048,963701,1,1,2,1,0,2
89049,963701,1,1,3,0,1,2
89050,963701,1,1,4,0,0,2
89051,963701,1,1,5,1,0,3
89052,963701,1,1,6,0,1,3
89053,963701,1,2,1,0,0,3
89054,963701,1,2,2,0,0,3
89055,963701,1,2,3,4,0,7
89056,963701,1,2,4,0,0,7
89057,963701,1,2,5,4,0,11
89058,963701,1,2,6,1,0,12
89059,963701,1,3,1,0,1,12
89060,963701,1,3,2,0,0,12
89061,963701,1,3,3,0,0,12
89062,963701,1,3,4,0,0,12
89063,963701,1,3,5,2,0,14
89064,963701,1,3,6,1,0,15
89065,963701,1,4,1,0,0,15
89066,963701,1,4,2,0,0,15
89067,963701,1,4,3,0,0,15
89068,963701,1,4,4,0,0,15
89069,963701,1,4,5,1,0,16
89070,963701,1,4,6,4,0,20
89071,963701,1,5,1,0,0,20
89072,963701,1,5,2,0,1,20
89073,963701,1,5,3,0,0,20
89074,963701,1,5,4,0,0,20
89075,963701,1,5,5,0,0,20
89076,963701,1,5,6,0,0,20
89077,963701,1,6,1,1,1,21
89078,963701,1,6,2,0,0,21
89079,963701,1,6,3,0,0,21
89080,963701,1,6,4,4,0,25
89081,963701,1,6,5,0,0,25
89082,963701,1,6,6,4,0,29
89083,963701,1,7,1,0,0,29
89084,963701,1,7,2,4,0,33
89085,963701,1,7,3,0,0,33
89086,963701,1,7,4,0,0,33
89087,963701,1,7,5,0,0,33
89088,963701,1,7,6,0,0,33
89089,963701,1,8,1,1,0,34
89090,963701,1,8,2,0,0,34
89091,963701,1,8,3,13,0,47
89092,963701,1,8,4,1,0,48
89093,963701,1,8,5,0,1,48
89094,963701,1,8,6,0,0,48
89095,963701,1,9,1,0,0,48
89096,963701,1,9,2,2,0,50
89097,963701,1,9,3,0,0,50
89098,963701,1,9,4,0,0,50
89099,963701,1,9,5,0,0,50
89100,963701,1,9,6,0,0,50
89101,963701,1,10,1,1,0,51
89102,963701,1,10,2,1,0,52
89103,963701,1,10,3,1,0,53
89104,963701,1,10,4,1,0,54
89105,963701,1,10,5,0,0,54
89106,963701,1,10,6,0,0,54
89107,963701,1,11,1,0,0,54
89108,963701,1,11,2,0,0,54
89109,963701,1,11,3,0,1,54
89110,963701,1,11,4,0,0,54
89111,963701,1,11,5,0,0,54
89112,963701,1,11,6,0,0,54
89113,963701,1,12,1,1,0,55
89114,963701,1,12,2,1,0,56
89115,963701,1,12,3,4,0,60
89116,963701,1,12,4,1,0,61
89117,963701,1,12,5,1,0,62
89118,963701,1,12,6,1,0,63
89119,963701,1,13,1,0,0,63
89120,963701,1,13,2,0,0,63
89121,963701,1,13,3,2,0,65
89122,963701,1,13,4,0,0,65
89123,963701,1,13,5,1,0,66
89124,963701,1,13,6,0,0,66
89125,963701,1,14,1,1,0,67
89126,963701,1,14,2,0,0,67
89127,963701,1,14,3,1,0,68
89128,963701,1,14,4,1,0,69
89129,963701,1,14,5,0,0,69
89130,963701,1,14,6,0,0,69
89131,963701,1,15,1,1,0,70
89132,963701,1,15,2,0,0,70
89133,963701,1,15,3,0,0,70
89134,963701,1,15,4,0,0,70
89135,963701,1,15,5,1,0,71
89136,963701,1,15,6,0,0,71
89137,963701,1,16,1,1,0,72
89138,963701,1,16,2,0,1,72
89139,963701,1,16,3,1,0,73
89140,963701,1,16,4,0,1,73
89141,963701,1,16,5,1,0,74
89142,963701,1,16,6,0,0,74
89143,963701,1,17,1,0,0,74
89144,963701,1,17,2,0,0,74
89145,963701,1,17,3,0,0,74
89146,963701,1,17,4,4,0,78
89147,963701,1,17,5,1,0,79
89148,963701,1,17,6,0,0,79
89149,963701,1,18,1,1,0,80
89150,963701,1,18,2,0,0,80
89151,963701,1,18,3,0,0,80
89152,963701,1,18,4,1,0,81
89153,963701,1,18,5,1,0,82
89154,963701,1,18,6,0,1,82
89238,966745,1,1,1,0,0,0
89239,966745,1,1,2,1,0,1
89240,966745,1,1,3,1,0,2
89241,966745,1,1,4,0,0,2
89242,966745,1,1,5,0,0,2
89243,966745,1,1,6,0,0,2
89244,966745,1,2,1,2,0,4
89245,966745,1,2,2,0,0,4
89246,966745,1,2,3,0,1,4
89247,966745,1,2,4,1,0,5
89248,966745,1,2,5,0,0,5
89249,966745,1,2,6,4,0,9
89250,966745,1,3,1,0,0,9
89251,966745,1,3,2,0,0,9
89252,966745,1,3,3,4,0,13
89253,966745,1,3,4,1,0,14
89254,966745,1,3,5,0,0,14
89255,966745,1,3,6,2,0,16
89256,966745,1,4,1,1,0,17
89257,966745,1,4,2,0,0,17
89258,966745,1,4,3,0,0,17
89259,966745,1,4,4,2,0,19
89260,966745,1,4,5,0,0,19
89261,966745,1,4,6,0,0,19
89262,966745,1,5,1,2,0,21
89263,966745,1,5,2,1,0,22
89264,966745,1,5,3,0,1,22
89265,966745,1,5,4,0,0,22
89266,966745,1,5,5,0,0,22
89267,966745,1,5,6,1,0,23
89268,966745,1,6,1,0,0,23
89269,966745,1,6,2,4,0,27
89270,966745,1,6,3,0,0,27
89271,966745,1,6,4,0,0,27
89272,966745,1,6,5,4,0,31
89273,966745,1,6,6,0,0,31
89274,966745,1,7,1,0,0,31
89275,966745,1,7,2,2,0,33
89276,966745,1,7,3,1,0,34
89277,966745,1,7,4,3,0,37
89278,966745,1,7,5,1,0,38
89279,966745,1,7,6,1,0,39
89280,966745,1,8,1,0,0,39
89281,966745,1,8,2,1,0,40
89282,966745,1,8,3,1,0,41
89283,966745,1,8,4,1,0,42
89284,966745,1,8,5,0,1,42
89285,966745,1,8,6,1,0,43
89286,966745,1,9,1,1,0,44
89287,966745,1,9,2,0,0,44
89288,966745,1,9,3,0,0,44
89289,966745,1,9,4,1,0,45
89290,966745,1,9,5,1,0,46
89291,966745,1,9,6,1,0,47
89292,966745,1,10,1,1,0,48
89293,966745,1,10,2,0,0,48
89294,966745,1,10,3,1,0,49
89295,966745,1,10,4,1,0,50
89296,966745,1,10,5,1,0,51
89297,966745,1,10,6,1,0,52
89298,966745,1,11,1,0,0,52
89299,966745,1,11,2,0,0,52
89300,966745,1,11,3,0,0,52
89301,966745,1,11,4,4,0,56
89302,966745,1,11,5,6,0,62
89303,966745,1,11,6,4,0,66
89304,966745,1,12,1,1,0,67
89305,966745,1,12,2,2,0,69
89306,966745,1,12,3,4,0,73
89307,966745,1,12,4,1,0,74
89308,966745,1,12,5,1,0,75
89309,966745,1,12,6,1,0,76
89310,966745,1,13,1,1,0,77
89311,966745,1,13,2,1,0,78
89312,966745,1,13,3,1,0,79
89313,966745,1,13,4,0,0,79
89314,966745,1,13,5,1,0,80
89315,966745,1,13,6,1,0,81
89316,966745,1,14,1,1,0,82
89317,966745,1,14,2,4,0,86
89318,966745,1,14,3,1,0,87
89319,966745,1,14,4,1,0,88
89320,966745,1,14,5,1,0,89
89321,966745,1,14,6,1,0,90
89322,966745,1,15,1,1,0,91
89323,966745,1,15,2,1,0,92
89324,966745,1,15,3,4,0,96
89325,966745,1,15,4,1,0,97
89326,966745,1,15,5,0,1,97
89327,966745,1,15,6,0,0,97
89328,966745,1,16,1,1,0,98
89329,966745,1,16,2,1,0,99
89330,966745,1,16,3,2,0,101
89331,966745,1,16,4,6,0,107
89332,966745,1,16,5,4,0,111
89333,966745,1,16,6,4,0,115
89334,966745,1,17,1,4,0,119
89335,966745,1,17,2,1,0,120
89336,966745,1,17,3,6,0,126
89337,966745,1,17,4,1,0,127
89338,966745,1,17,5,2,0,129
89339,966745,1,17,6,7,0,136
89340,966745,1,18,1,2,0,138
89341,966745,1,18,2,1,0,139
89342,966745,1,18,3,4,0,143
89343,966745,1,18,4,4,0,147
89344,966745,1,18,5,0,0,147
89345,966745,1,18,6,2,0,149
89346,966745,1,19,1,1,0,150
89347,966745,1,19,2,4,0,154
89348,966745,1,19,3,0,0,154
89349,966745,1,19,4,0,0,154
89350,966745,1,19,5,2,0,156
89351,966745,1,19,6,1,0,157
89352,966745,1,20,1,1,0,158
89353,966745,1,20,2,0,1,158
89354,966745,1,20,3,0,0,158
89355,966745,1,20,4,0,1,158
89356,966745,1,20,5,2,0,160
89357,966745,1,20,6,6,0,166
89478,966751,1,1,1,0,0,0
89479,966751,1,1,2,4,0,4
89480,966751,1,1,3,0,0,4
89481,966751,1,1,4,0,1,4
89482,966751,1,1,5,0,0,4
89483,966751,1,1,6,1,0,5
89484,966751,1,2,1,0,0,5
89485,966751,1,2,2,0,0,5
89486,966751,1,2,3,0,0,5
89487,966751,1,2,4,0,0,5
89488,966751,1,2,5,0,0,5
89489,966751,1,2,6,0,0,5
89490,966751,1,3,1,6,0,11
89491,966751,1,3,2,3,0,14
89492,966751,1,3,3,0,0,14
89493,966751,1,3,4,3,0,17
89494,966751,1,3,5,1,0,18
89495,966751,1,3,6,0,0,18
89496,966751,1,4,1,4,0,22
89497,966751,1,4,2,0,0,22
89498,966751,1,4,3,0,1,22
89499,966751,1,4,4,0,0,22
89500,966751,1,4,5,4,0,26
89501,966751,1,4,6,0,0,26
89502,966751,1,5,1,0,0,26
89503,966751,1,5,2,0,0,26
89504,966751,1,5,3,2,0,28
89505,966751,1,5,4,0,0,28
89506,966751,1,5,5,0,0,28
89507,966751,1,5,6,0,0,28
89508,966751,1,6,1,4,0,32
89509,966751,1,6,2,0,0,32
89510,966751,1,6,3,0,0,32
89511,966751,1,6,4,0,0,32
89512,966751,1,6,5,0,1,32
89513,966751,1,6,6,0,0,32
89514,966751,1,7,1,2,0,34
89515,966751,1,7,2,0,0,34
89516,966751,1,7,3,1,0,35
89517,966751,1,7,4,0,0,35
89518,966751,1,7,5,0,0,35
89519,966751,1,7,6,0,1,35
89520,966751,1,8,1,0,1,35
89521,966751,1,8,2,1,0,36
89522,966751,1,8,3,0,0,36
89523,966751,1,8,4,4,0,40
89524,966751,1,8,5,1,0,41
89525,966751,1,8,6,1,1,42
89526,966751,1,9,1,0,0,42
89527,966751,1,9,2,0,0,42
89528,966751,1,9,3,0,0,42
89529,966751,1,9,4,1,0,43
89530,966751,1,9,5,0,0,43
89531,966751,1,9,6,0,0,43
89532,966751,1,10,1,1,0,44
89533,966751,1,10,2,1,0,45
89534,966751,1,10,3,1,0,46
89535,966751,1,10,4,0,0,46
89536,966751,1,10,5,0,0,46
89537,966751,1,10,6,1,0,47
89538,966751,1,11,1,1,0,48
89539,966751,1,11,2,0,0,48
89540,966751,1,11,3,1,0,49
89541,966751,1,11,4,1,0,50
89542,966751,1,11,5,1,0,51
89543,966751,1,11,6,0,0,51
89544,966751,1,12,1,1,0,52
89545,966751,1,12,2,0,0,52
89546,966751,1,12,3,0,0,52
89547,966751,1,12,4,0,1,52
89548,966751,1,12,5,2,0,54
89549,966751,1,12,6,2,0,56
89550,966751,1,13,1,0,0,56
89551,966751,1,13,2,1,0,57
89552,966751,1,13,3,1,0,58
89553,966751,1,13,4,0,0,58
89554,966751,1,13,5,0,0,58
89555,966751,1,13,6,0,0,58
89556,966751,1,14,1,0,0,58
89557,966751,1,14,2,4,0,62
89558,966751,1,14,3,1,0,63
89559,966751,1,14,4,0,0,63
89560,966751,1,14,5,0,0,63
89561,966751,1,14,6,0,0,63
89562,966751,1,15,1,4,0,67
89563,966751,1,15,2,1,0,68
89564,966751,1,15,3,0,0,68
89565,966751,1,15,4,1,0,69
89566,966751,1,15,5,0,0,69
89567,966751,1,15,6,1,0,70
89568,966751,1,16,1,0,1,70
89569,966751,1,16,2,1,0,71
89570,966751,1,16,3,0,0,71
89571,966751,1,16,4,0,0,71
89572,966751,1,16,5,0,0,71
89573,966751,1,16,6,0,0,71
89574,966751,1,17,1,4,0,75
89575,966751,1,17,2,6,0,81
89576,966751,1,17,3,0,0,81
89577,966751,1,17,4,1,0,82
89578,966751,1,17,5,0,0,82
89579,966751,1,17,6,1,0,83
89580,966751,1,18,1,0,0,83
89581,966751,1,18,2,0,1,83
89582,966751,1,18,3,0,1,83
89676,966753,1,1,1,0,0,0
89677,966753,1,1,2,0,1,0
89678,966753,1,1,3,0,0,0
89679,966753,1,1,4,0,0,0
89680,966753,1,1,5,1,0,1
89681,966753,1,1,6,0,0,1
89682,966753,1,2,1,1,0,2
89683,966753,1,2,2,0,0,2
89684,966753,1,2,3,0,1,2
89685,966753,1,2,4,0,0,2
89686,966753,1,2,5,0,0,2
89687,966753,1,2,6,0,0,2
89688,966753,1,3,1,0,0,2
89689,966753,1,3,2,0,0,2
89690,966753,1,3,3,0,0,2
89691,966753,1,3,4,1,0,3
89692,966753,1,3,5,1,0,4
89693,966753,1,3,6,2,0,6
89694,966753,1,4,1,4,0,10
89695,966753,1,4,2,6,0,16
89696,966753,1,4,3,4,0,20
89697,966753,1,4,4,4,0,24
89698,966753,1,4,5,0,0,24
89699,966753,1,4,6,0,0,24
89700,966753,1,5,1,1,0,25
89701,966753,1,5,2,1,0,26
89702,966753,1,5,3,0,0,26
89703,966753,1,5,4,0,0,26
89704,966753,1,5,5,0,1,26
89705,966753,1,5,6,1,0,27
89706,966753,1,6,1,0,0,27
89707,966753,1,6,2,1,0,28
89708,966753,1,6,3,4,0,32
89709,966753,1,6,4,4,0,36
89710,966753,1,6,5,4,0,40
89711,966753,1,6,6,1,0,41
89712,966753,1,7,1,1,0,42
89713,966753,1,7,2,1,0,43
89714,966753,1,7,3,1,0,44
89715,966753,1,7,4,0,0,44
89716,966753,1,7,5,0,0,44
89717,966753,1,7,6,0,0,44
89718,966753,1,8,1,1,0,45
89719,966753,1,8,2,1,0,46
89720,966753,1,8,3,0,0,46
89721,966753,1,8,4,1,0,47
89722,966753,1,8,5,4,0,51
89723,966753,1,8,6,1,0,52
89724,966753,1,9,1,0,0,52
89725,966753,1,9,2,1,0,53
89726,966753,1,9,3,0,0,53
89727,966753,1,9,4,0,0,53
89728,966753,1,9,5,0,0,53
89729,966753,1,9,6,0,0,53
89730,966753,1,10,1,0,0,53
89731,966753,1,10,2,1,0,54
89732,966753,1,10,3,0,0,54
89733,966753,1,10,4,1,0,55
89734,966753,1,10,5,1,0,56
89735,966753,1,10,6,1,0,57
89736,966753,1,11,1,1,0,58
89737,966753,1,11,2,2,0,60
89738,966753,1,11,3,1,0,61
89739,966753,1,11,4,1,0,62
89740,966753,1,11,5,0,0,62
89741,966753,1,11,6,0,0,62
89742,966753,1,12,1,1,0,63
89743,966753,1,12,2,1,0,64
89744,966753,1,12,3,0,0,64
89745,966753,1,12,4,1,0,65
89746,966753,1,12,5,1,0,66
89747,966753,1,12,6,1,0,67
89748,966753,1,13,1,6,0,73
89749,966753,1,13,2,4,0,77
89750,966753,1,13,3,4,0,81
89751,966753,1,13,4,2,0,83
89752,966753,1,13,5,1,0,84
89753,966753,1,13,6,0,0,84
89754,966753,1,14,1,4,0,88
89755,966753,1,14,2,0,0,88
89756,966753,1,14,3,1,0,89
89757,966753,1,14,4,1,0,90
89758,966753,1,14,5,0,0,90
89759,966753,1,14,6,0,0,90
89760,966753,1,15,1,1,0,91
89761,966753,1,15,2,1,0,92
89762,966753,1,15,3,0,0,92
89763,966753,1,15,4,1,0,93
89764,966753,1,15,5,0,0,93
89765,966753,1,15,6,4,0,97
89766,966753,1,16,1,1,0,98
89767,966753,1,16,2,2,0,100
89768,966753,1,16,3,1,0,101
89769,966753,1,16,4,0,0,101
89770,966753,1,16,5,7,0,108
89771,966753,1,16,6,0,1,108
89772,966753,1,17,1,4,0,112
89773,966753,1,17,2,1,0,113
89774,966753,1,17,3,1,0,114
89775,966753,1,17,4,1,0,115
89776,966753,1,17,5,4,0,119
89777,966753,1,17,6,0,0,119
89778,966753,1,18,1,4,0,123
89779,966753,1,18,2,0,1,123
89780,966753,1,18,3,0,0,123
89781,966753,1,18,4,1,0,124
89782,966753,1,18,5,0,0,124
89783,966753,1,18,6,1,0,125
89784,966753,1,19,1,1,0,126
89785,966753,1,19,2,4,0,130
89786,966753,1,19,3,2,0,132
89787,966753,1,19,4,6,0,138
89788,966753,1,19,5,1,0,139
89789,966753,1,19,6,0,0,139
89790,966753,1,20,1,1,0,140
89791,966753,1,20,2,0,1,140
89792,966753,1,20,3,2,0,142
89793,966753,1,20,4,2,0,144
89794,966753,1,20,5,1,0,145
89795,966753,1,20,6,2,1,147
89916,966757,1,1,1,0,0,0
89917,966757,1,1,2,4,0,4
89918,966757,1,1,3,0,0,4
89919,966757,1,1,4,0,0,4
89920,966757,1,1,5,0,0,4
89921,966757,1,1,6,0,0,4
89922,966757,1,2,1,0,0,4
89923,966757,1,2,2,1,0,5
89924,966757,1,2,3,0,0,5
89925,966757,1,2,4,0,0,5
89926,966757,1,2,5,0,0,5
89927,966757,1,2,6,0,0,5
89928,966757,1,3,1,1,0,6
89929,966757,1,3,2,0,1,6
89930,966757,1,3,3,1,0,7
89931,966757,1,3,4,1,0,8
89932,966757,1,3,5,0,0,8
89933,966757,1,3,6,1,0,9
89934,966757,1,4,1,1,0,10
89935,966757,1,4,2,4,0,14
89936,966757,1,4,3,1,0,15
89937,966757,1,4,4,0,1,15
89938,966757,1,4,5,0,0,15
89939,966757,1,4,6,0,0,15
89940,966757,1,5,1,0,0,15
89941,966757,1,5,2,1,0,16
89942,966757,1,5,3,1,0,17
89943,966757,1,5,4,1,0,18
89944,966757,1,5,5,3,0,21
89945,966757,1,5,6,1,0,22
89946,966757,1,6,1,4,0,26
89947,966757,1,6,2,2,0,28
89948,966757,1,6,3,1,0,29
89949,966757,1,6,4,1,0,30
89950,966757,1,6,5,1,0,31
89951,966757,1,6,6,0,0,31
89952,966757,1,7,1,0,1,31
89953,966757,1,7,2,0,0,31
89954,966757,1,7,3,0,0,31
89955,966757,1,7,4,0,0,31
89956,966757,1,7,5,0,0,31
89957,966757,1,7,6,1,0,32
89958,966757,1,8,1,0,0,32
89959,966757,1,8,2,1,0,33
89960,966757,1,8,3,0,0,33
89961,966757,1,8,4,1,0,34
89962,966757,1,8,5,1,0,35
89963,966757,1,8,6,0,0,35
89964,966757,1,9,1,1,0,36
89965,966757,1,9,2,4,0,40
89966,966757,1,9,3,0,0,40
89967,966757,1,9,4,1,0,41
89968,966757,1,9,5,0,0,41
89969,966757,1,9,6,0,0,41
89970,966757,1,10,1,1,0,42
89971,966757,1,10,2,0,0,42
89972,966757,1,10,3,0,0,42
89973,966757,1,10,4,4,0,46
89974,966757,1,10,5,1,0,47
89975,966757,1,10,6,0,0,47
89976,966757,1,11,1,4,0,51
89977,966757,1,11,2,1,0,52
89978,966757,1,11,3,0,0,52
89979,966757,1,11,4,1,0,53
89980,966757,1,11,5,4,0,57
89981,966757,1,11,6,0,1,57
89982,966757,1,12,1,1,0,58
89983,966757,1,12,2,1,0,59
89984,966757,1,12,3,0,0,59
89985,966757,1,12,4,2,0,61
89986,966757,1,12,5,1,0,62
89987,966757,1,12,6,0,0,62
89988,966757,1,13,1,0,0,62
89989,966757,1,13,2,6,0,68
89990,966757,1,13,3,4,0,72
89991,966757,1,13,4,1,0,73
89992,966757,1,13,5,1,0,74
89993,966757,1,13,6,1,0,75
89994,966757,1,14,1,1,0,76
89995,966757,1,14,2,4,0,80
89996,966757,1,14,3,1,0,81
89997,966757,1,14,4,0,0,81
89998,966757,1,14,5,1,0,82
89999,966757,1,14,6,2,0,84
90000,966757,1,15,1,0,0,84
90001,966757,1,15,2,2,0,86
90002,966757,1,15,3,1,0,87
90003,966757,1,15,4,4,0,91
90004,966757,1,15,5,0,0,91
90005,966757,1,15,6,0,0,91
90006,966757,1,16,1,1,0,92
90007,966757,1,16,2,2,0,94
90008,966757,1,16,3,1,0,95
90009,966757,1,16,4,2,0,97
90010,966757,1,16,5,1,0,98
90011,966757,1,16,6,2,0,100
90012,966757,1,17,1,0,1,100
90013,966757,1,17,2,1,0,101
90014,966757,1,17,3,0,0,101
90015,966757,1,17,4,1,0,102
90016,966757,1,17,5,1,0,103
90017,966757,1,17,6,1,1,104
90018,966757,1,18,1,1,0,105
90019,966757,1,18,2,0,1,105
90020,966757,1,18,3,4,0,109
90021,966757,1,18,4,4,0,113
90022,966757,1,18,5,1,0,114
90023,966757,1,18,6,1,0,115
90024,966757,1,19,1,1,0,116
90025,966757,1,19,2,6,0,122
90026,966757,1,19,3,1,0,123
90027,966757,1,19,4,1,0,124
90028,966757,1,19,5,2,1,126
90029,966757,1,19,6,1,0,127
90030,966757,1,20,1,1,0,128
90031,966757,1,20,2,1,0,129
90032,966757,1,20,3,4,0,133
90033,966757,1,20,4,4,0,137
90034,966757,1,20,5,0,0,137
90035,966757,1,20,6,1,1,138
90152,966759,1,1,1,0,0,0
90153,966759,1,1,2,0,0,0
90154,966759,1,1,3,0,0,0
90155,966759,1,1,4,0,0,0
90156,966759,1,1,5,0,0,0
90157,966759,1,1,6,1,0,1
90158,966759,1,2,1,0,1,1
90159,966759,1,2,2,0,0,1
90160,966759,1,2,3,1,0,2
90161,966759,1,2,4,0,0,2
90162,966759,1,2,5,6,0,8
90163,966759,1,2,6,0,0,8
90164,966759,1,3,1,0,0,8
90165,966759,1,3,2,0,0,8
90166,966759,1,3,3,0,0,8
90167,966759,1,3,4,0,0,8
90168,966759,1,3,5,0,0,8
90169,966759,1,3,6,0,0,8
90170,966759,1,4,1,0,0,8
90171,966759,1,4,2,4,0,12
90172,966759,1,4,3,0,0,12
90173,966759,1,4,4,0,0,12
90174,966759,1,4,5,0,1,12
90175,966759,1,4,6,4,0,16
90176,966759,1,5,1,1,0,17
90177,966759,1,5,2,0,0,17
90178,966759,1,5,3,1,0,18
90179,966759,1,5,4,0,0,18
90180,966759,1,5,5,0,1,18
90181,966759,1,5,6,0,0,18
90182,966759,1,6,1,0,0,18
90183,966759,1,6,2,1,0,19
90184,966759,1,6,3,0,0,19
90185,966759,1,6,4,1,0,20
90186,966759,1,6,5,0,0,20
90187,966759,1,6,6,0,0,20
90188,966759,1,7,1,0,0,20
90189,966759,1,7,2,0,0,20
90190,966759,1,7,3,0,0,20
90191,966759,1,7,4,1,0,21
90192,966759,1,7,5,4,0,25
90193,966759,1,7,6,0,0,25
90194,966759,1,8,1,1,0,26
90195,966759,1,8,2,0,0,26
90196,966759,1,8,3,1,0,27
90197,966759,1,8,4,1,0,28
90198,966759,1,8,5,0,0,28
90199,966759,1,8,6,0,0,28
90200,966759,1,9,1,0,0,28
90201,966759,1,9,2,0,1,28
90202,966759,1,9,3,0,0,28
90203,966759,1,9,4,0,0,28
90204,966759,1,9,5,0,0,28
90205,966759,1,9,6,1,0,29
90206,966759,1,10,1,0,0,29
90207,966759,1,10,2,1,0,30
90208,966759,1,10,3,0,0,30
90209,966759,1,10,4,0,0,30
90210,966759,1,10,5,0,0,30
90211,966759,1,10,6,4,0,34
90212,966759,1,11,1,0,0,34
90213,966759,1,11,2,0,0,34
90214,966759,1,11,3,0,0,34
90215,966759,1,11,4,1,0,35
90216,966759,1,11,5,1,0,36
90217,966759,1,11,6,4,0,40
90218,966759,1,12,1,2,0,42
90219,966759,1,12,2,0,0,42
90220,966759,1,12,3,1,0,43
90221,966759,1,12,4,0,0,43
90222,966759,1,12,5,2,0,45
90223,966759,1,12,6,1,0,46
90224,966759,1,13,1,1,0,47
90225,966759,1,13,2,1,0,48
90226,966759,1,13,3,4,0,52
90227,966759,1,13,4,0,0,52
90228,966759,1,13,5,2,0,54
90229,966759,1,13,6,0,0,54
90230,966759,1,14,1,1,0,55
90231,966759,1,14,2,1,0,56
90232,966759,1,14,3,1,0,57
90233,966759,1,14,4,1,0,58
90234,966759,1,14,5,1,0,59
90235,966759,1,14,6,6,0,65
90236,966759,1,15,1,4,0,69
90237,966759,1,15,2,2,0,71
90238,966759,1,15,3,1,0,72
90239,966759,1,15,4,1,0,73
90240,966759,1,15,5,0,0,73
90241,966759,1,15,6,6,0,79
90242,966759,1,16,1,0,0,79
90243,966759,1,16,2,1,0,80
90244,966759,1,16,3,2,0,82
90245,966759,1,16,4,1,0,83
90246,966759,1,16,5,4,0,87
90247,966759,1,16,6,4,0,91
90248,966759,1,17,1,1,0,92
90249,966759,1,17,2,2,0,94
90250,966759,1,17,3,4,0,98
90251,966759,1,17,4,0,1,98
90252,966759,1,17,5,2,0,100
90253,966759,1,17,6,1,0,101
90254,966759,1,18,1,1,0,102
90255,966759,1,18,2,0,0,102
90256,966759,1,18,3,0,1,102
90257,966759,1,18,4,1,0,103
90258,966759,1,18,5,0,0,103
90259,966759,1,18,6,2,0,105
90260,966759,1,19,1,1,0,106
90261,966759,1,19,2,1,0,107
90262,966759,1,19,3,1,0,108
90263,966759,1,19,4,4,0,112
90264,966759,1,19,5,1,0,113
90265,966759,1,19,6,4,0,117
90266,966759,1,20,1,1,0,118
90267,966759,1,20,2,6,0,124
90268,966759,1,20,3,1,0,125
90269,966759,1,20,4,2,0,127
90270,966759,1,20,5,2,0,129
90271,966759,1,20,6,0,1,129
90387,966763,1,1,1,0,0,0
90388,966763,1,1,2,0,0,0
90389,966763,1,1,3,0,0,0
90390,966763,1,1,4,1,0,1
90391,966763,1,1,5,1,0,2
90392,966763,1,1,6,4,0,6
90393,966763,1,2,1,1,0,7
90394,966763,1,2,2,0,0,7
90395,966763,1,2,3,1,0,8
90396,966763,1,2,4,0,0,8
90397,966763,1,2,5,0,0,8
90398,966763,1,2,6,1,0,9
90399,966763,1,3,1,0,0,9
90400,966763,1,3,2,0,0,9
90401,966763,1,3,3,0,0,9
90402,966763,1,3,4,4,0,13
90403,966763,1,3,5,0,0,13
90404,966763,1,3,6,0,0,13
90405,966763,1,4,1,0,0,13
90406,966763,1,4,2,0,0,13
90407,966763,1,4,3,1,0,14
90408,966763,1,4,4,1,0,15
90409,966763,1,4,5,0,0,15
90410,966763,1,4,6,4,0,19
90411,966763,1,5,1,1,0,20
90412,966763,1,5,2,1,0,21
90413,966763,1,5,3,0,0,21
90414,966763,1,5,4,1,0,22
90415,966763,1,5,5,4,0,26
90416,966763,1,5,6,0,0,26
90417,966763,1,6,1,4,0,30
90418,966763,1,6,2,6,0,36
90419,966763,1,6,3,4,0,40
90420,966763,1,6,4,0,0,40
90421,966763,1,6,5,0,0,40
90422,966763,1,6,6,4,0,44
90423,966763,1,7,1,0,0,44
90424,966763,1,7,2,1,0,45
90425,966763,1,7,3,1,0,46
90426,966763,1,7,4,2,0,48
90427,966763,1,7,5,0,0,48
90428,966763,1,7,6,1,0,49
90429,966763,1,8,1,2,0,51
90430,966763,1,8,2,4,0,55
90431,966763,1,8,3,1,0,56
90432,966763,1,8,4,0,0,56
90433,966763,1,8,5,0,0,56
90434,966763,1,8,6,0,0,56
90435,966763,1,9,1,0,0,56
90436,966763,1,9,2,2,0,58
90437,966763,1,9,3,0,0,58
90438,966763,1,9,4,0,0,58
90439,966763,1,9,5,0,0,58
90440,966763,1,9,6,1,0,59
90441,966763,1,10,1,4,0,63
90442,966763,1,10,2,1,0,64
90443,966763,1,10,3,1,0,65
90444,966763,1,10,4,0,0,65
90445,966763,1,10,5,1,0,66
90446,966763,1,10,6,0,0,66
90447,966763,1,11,1,0,0,66
90448,966763,1,11,2,4,0,70
90449,966763,1,11,3,4,0,74
90450,966763,1,11,4,1,0,75
90451,966763,1,11,5,2,0,77
90452,966763,1,11,6,4,0,81
90453,966763,1,12,1,4,0,85
90454,966763,1,12,2,1,0,86
90455,966763,1,12,3,1,0,87
90456,966763,1,12,4,0,0,87
90457,966763,1,12,5,2,0,89
90458,966763,1,12,6,1,0,90
90459,966763,1,13,1,1,0,91
90460,966763,1,13,2,1,0,92
90461,966763,1,13,3,0,0,92
90462,966763,1,13,4,0,0,92
90463,966763,1,13,5,1,0,93
90464,966763,1,13,6,4,0,97
90465,966763,1,14,1,6,0,103
90466,966763,1,14,2,1,0,104
90467,966763,1,14,3,2,0,106
90468,966763,1,14,4,0,0,106
90469,966763,1,14,5,0,0,106
90470,966763,1,14,6,4,0,110
90471,966763,1,15,1,0,1,110
90472,966763,1,15,2,1,0,111
90473,966763,1,15,3,1,0,112
90474,966763,1,15,4,1,0,113
90475,966763,1,15,5,0,0,113
90476,966763,1,15,6,0,0,113
90477,966763,1,16,1,1,0,114
90478,966763,1,16,2,1,0,115
90479,966763,1,16,3,1,0,116
90480,966763,1,16,4,1,0,117
90481,966763,1,16,5,0,0,117
90482,966763,1,16,6,0,1,117
90483,966763,1,17,1,1,0,118
90484,966763,1,17,2,1,0,119
90485,966763,1,17,3,0,0,119
90486,966763,1,17,4,4,0,123
90487,966763,1,17,5,1,0,124
90488,966763,1,17,6,1,0,125
90489,966763,1,18,1,0,1,125
90490,966763,1,18,2,0,0,125
90491,966763,1,18,3,0,1,125
90492,966763,1,18,4,1,0,126
90493,966763,1,18,5,1,0,127
90494,966763,1,18,6,0,0,127
90495,966763,1,19,1,4,0,131
90496,966763,1,19,2,2,0,133
90497,966763,1,19,3,2,0,135
90498,966763,1,19,4,3,0,138
90499,966763,1,19,5,2,0,140
90500,966763,1,19,6,1,0,141
90501,966763,1,20,1,0,0,141
90502,966763,1,20,2,4,0,145
90503,966763,1,20,3,1,0,146
90504,966763,1,20,4,1,0,147
90505,966763,1,20,5,1,0,148
90506,966763,1,20,6,2,0,150
90623,966765,1,1,1,0,0,0
90624,966765,1,1,2,0,0,0
90625,966765,1,1,3,0,0,0
90626,966765,1,1,4,0,0,0
90627,966765,1,1,5,1,0,1
90628,966765,1,1,6,4,0,5
90629,966765,1,2,1,4,0,9
90630,966765,1,2,2,1,0,10
90631,966765,1,2,3,0,0,10
90632,966765,1,2,4,0,0,10
90633,966765,1,2,5,1,0,11
90634,966765,1,2,6,0,0,11
90635,966765,1,3,1,0,0,11
90636,966765,1,3,2,1,0,12
90637,966765,1,3,3,0,0,12
90638,966765,1,3,4,0,0,12
90639,966765,1,3,5,2,0,14
90640,966765,1,3,6,0,0,14
90641,966765,1,4,1,0,0,14
90642,966765,1,4,2,4,0,18
90643,966765,1,4,3,1,0,19
90644,966765,1,4,4,4,0,23
90645,966765,1,4,5,4,0,27
90646,966765,1,4,6,0,1,27
90647,966765,1,5,1,1,0,28
90648,966765,1,5,2,1,0,29
90649,966765,1,5,3,1,0,30
90650,966765,1,5,4,0,1,30
90651,966765,1,5,5,0,0,30
90652,966765,1,5,6,0,0,30
90653,966765,1,6,1,1,0,31
90654,966765,1,6,2,0,0,31
90655,966765,1,6,3,1,0,32
90656,966765,1,6,4,1,0,33
90657,966765,1,6,5,1,0,34
90658,966765,1,6,6,1,0,35
90659,966765,1,7,1,1,0,36
90660,966765,1,7,2,1,0,37
90661,966765,1,7,3,4,0,41
90662,966765,1,7,4,1,0,42
90663,966765,1,7,5,4,0,46
90664,966765,1,7,6,1,0,47
90665,966765,1,8,1,1,0,48
90666,966765,1,8,2,1,0,49
90667,966765,1,8,3,1,0,50
90668,966765,1,8,4,4,0,54
90669,966765,1,8,5,0,0,54
90670,966765,1,8,6,4,0,58
90671,966765,1,9,1,1,0,59
90672,966765,1,9,2,2,0,61
90673,966765,1,9,3,1,0,62
90674,966765,1,9,4,1,0,63
90675,966765,1,9,5,1,0,64
90676,966765,1,9,6,0,0,64
90677,966765,1,10,1,0,1,64
90678,966765,1,10,2,1,0,65
90679,966765,1,10,3,0,0,65
90680,966765,1,10,4,1,0,66
90681,966765,1,10,5,1,0,67
90682,966765,1,10,6,1,0,68
90683,966765,1,11,1,0,0,68
90684,966765,1,11,2,1,0,69
90685,966765,1,11,3,1,0,70
90686,966765,1,11,4,0,0,70
90687,966765,1,11,5,1,0,71
90688,966765,1,11,6,0,0,71
90689,966765,1,12,1,2,0,73
90690,966765,1,12,2,1,0,74
90691,966765,1,12,3,1,1,75
90692,966765,1,12,4,0,1,75
90693,966765,1,12,5,2,0,77
90694,966765,1,12,6,1,0,78
90695,966765,1,13,1,4,0,82
90696,966765,1,13,2,1,0,83
90697,966765,1,13,3,2,0,85
90698,966765,1,13,4,2,0,87
90699,966765,1,13,5,4,0,91
90700,966765,1,13,6,1,0,92
90701,966765,1,14,1,4,0,96
90702,966765,1,14,2,6,0,102
90703,966765,1,14,3,2,0,104
90704,966765,1,14,4,6,0,110
90705,966765,1,14,5,2,0,112
90706,966765,1,14,6,1,0,113
90707,966765,1,15,1,1,0,114
90708,966765,1,15,2,2,0,116
90709,966765,1,15,3,0,0,116
90710,966765,1,15,4,2,0,118
90711,966765,1,15,5,1,0,119
90712,966765,1,15,6,1,0,120
90796,995467,1,1,1,0,0,0
90797,995467,1,1,2,0,0,0
90798,995467,1,1,3,0,0,0
90799,995467,1,1,4,1,0,1
90800,995467,1,1,5,2,0,3
90801,995467,1,1,6,0,0,3
90802,995467,1,2,1,1,0,4
90803,995467,1,2,2,0,0,4
90804,995467,1,2,3,1,0,5
90805,995467,1,2,4,4,0,9
90806,995467,1,2,5,1,0,10
90807,995467,1,2,6,4,0,14
90808,995467,1,3,1,2,0,16
90809,995467,1,3,2,4,0,20
90810,995467,1,3,3,4,0,24
90811,995467,1,3,4,4,0,28
90812,995467,1,3,5,4,0,32
90813,995467,1,3,6,1,0,33
90814,995467,1,4,1,1,0,34
90815,995467,1,4,2,4,0,38
90816,995467,1,4,3,2,0,40
90817,995467,1,4,4,2,0,42
90818,995467,1,4,5,0,0,42
90819,995467,1,4,6,4,0,46
90820,995467,1,5,1,6,0,52
90821,995467,1,5,2,4,0,56
90822,995467,1,5,3,1,0,57
90823,995467,1,5,4,0,0,57
90824,995467,1,5,5,0,1,57
90825,995467,1,5,6,1,0,58
90826,995467,1,6,1,1,0,59
90827,995467,1,6,2,4,0,63
90828,995467,1,6,3,4,0,67
90829,995467,1,6,4,0,0,67
90830,995467,1,6,5,4,0,71
90831,995467,1,6,6,2,0,73
90832,995467,1,7,1,1,0,74
90833,995467,1,7,2,1,0,75
90834,995467,1,7,3,1,0,76
90835,995467,1,7,4,0,0,76
90836,995467,1,7,5,4,0,80
90837,995467,1,7,6,1,0,81
90838,995467,1,8,1,1,0,82
90839,995467,1,8,2,1,0,83
90840,995467,1,8,3,0,0,83
90841,995467,1,8,4,1,0,84
90842,995467,1,8,5,0,0,84
90843,995467,1,8,6,1,0,85
90844,995467,1,9,1,1,0,86
90845,995467,1,9,2,0,0,86
90846,995467,1,9,3,6,0,92
90847,995467,1,9,4,6,0,98
90848,995467,1,9,5,0,0,98
90849,995467,1,9,6,0,0,98
90850,995467,1,10,1,0,0,98
90851,995467,1,10,2,1,0,99
90852,995467,1,10,3,2,0,101
90853,995467,1,10,4,1,0,102
90854,995467,1,10,5,6,0,108
90855,995467,1,10,6,2,0,110
90856,995467,1,11,1,1,0,111
90857,995467,1,11,2,1,0,112
90858,995467,1,11,3,6,0,118
90859,995467,1,11,4,1,0,119
90860,995467,1,11,5,1,0,120
90861,995467,1,11,6,1,0,121
90862,995467,1,12,1,1,0,122
90863,995467,1,12,2,2,0,124
90864,995467,1,12,3,1,0,125
90865,995467,1,12,4,4,0,129
90866,995467,1,12,5,1,0,130
90867,995467,1,12,6,4,0,134
90868,995467,1,13,1,2,0,136
90869,995467,1,13,2,6,0,142
90870,995467,1,13,3,1,0,143
90871,995467,1,13,4,0,0,143
90872,995467,1,13,5,6,0,149
90873,995467,1,13,6,1,0,150
90874,995467,1,14,1,4,0,154
90875,995467,1,14,2,0,1,154
90876,995467,1,14,3,1,0,155
90877,995467,1,14,4,4,0,159
90878,995467,1,14,5,1,0,160
90879,995467,1,14,6,6,0,166
90880,995467,1,15,1,1,0,167
90881,995467,1,15,2,0,0,167
90882,995467,1,15,3,1,0,168
90883,995467,1,15,4,4,0,172
90884,995467,1,15,5,2,0,174
90885,995467,1,15,6,4,0,178
90886,995467,1,16,1,1,0,179
90887,995467,1,16,2,4,0,183
90888,995467,1,16,3,1,0,184
90889,995467,1,16,4,4,0,188
90890,995467,1,16,5,6,0,194
90891,995467,1,16,6,1,0,195
90892,995467,1,17,1,4,0,199
90893,995467,1,17,2,0,0,199
90894,995467,1,17,3,6,0,205
90895,995467,1,17,4,6,0,211
90896,995467,1,17,5,6,0,217
90897,995467,1,17,6,1,0,218
90898,995467,1,18,1,1,0,219
90899,995467,1,18,2,2,0,221
90900,995467,1,18,3,4,0,225
90901,995467,1,18,4,1,0,226
90902,995467,1,18,5,2,0,228
90903,995467,1,18,6,4,0,232
90904,995467,1,19,1,2,0,234
90905,995467,1,19,2,4,0,238
90906,995467,1,19,3,6,0,244
90907,995467,1,19,4,1,0,245
90908,995467,1,19,5,2,0,247
90909,995467,1,19,6,0,0,247
90910,995467,1,20,1,1,0,248
90911,995467,1,20,2,1,0,249
90912,995467,1,20,3,4,0,253
90913,995467,1,20,4,4,0,257
90914,995467,1,20,5,6,0,263
90915,995467,1,20,6,0,1,263
91036,995469,1,1,1,0,0,0
91037,995469,1,1,2,5,0,5
91038,995469,1,1,3,1,0,6
91039,995469,1,1,4,1,0,7
91040,995469,1,1,5,2,0,9
91041,995469,1,1,6,0,0,9
91042,995469,1,2,1,0,0,9
91043,995469,1,2,2,0,1,9
91044,995469,1,2,3,0,0,9
91045,995469,1,2,4,0,0,9
91046,995469,1,2,5,1,0,10
91047,995469,1,2,6,0,0,10
91048,995469,1,3,1,4,0,14
91049,995469,1,3,2,0,0,14
91050,995469,1,3,3,3,0,17
91051,995469,1,3,4,0,0,17
91052,995469,1,3,5,4,0,21
91053,995469,1,3,6,0,0,21
91054,995469,1,4,1,3,0,24
91055,995469,1,4,2,1,0,25
91056,995469,1,4,3,1,0,26
91057,995469,1,4,4,0,0,26
91058,995469,1,4,5,0,0,26
91059,995469,1,4,6,1,0,27
91060,995469,1,5,1,4,0,31
91061,995469,1,5,2,1,0,32
91062,995469,1,5,3,2,0,34
91063,995469,1,5,4,4,0,38
91064,995469,1,5,5,1,0,39
91065,995469,1,5,6,4,0,43
91066,995469,1,6,1,0,0,43
91067,995469,1,6,2,1,0,44
91068,995469,1,6,3,0,0,44
91069,995469,1,6,4,0,1,44
91070,995469,1,6,5,1,0,45
91071,995469,1,6,6,1,0,46
91072,995469,1,7,1,1,0,47
91073,995469,1,7,2,0,0,47
91074,995469,1,7,3,1,0,48
91075,995469,1,7,4,1,0,49
91076,995469,1,7,5,1,0,50
91077,995469,1,7,6,1,0,51
91078,995469,1,8,1,0,1,51
91079,995469,1,8,2,1,0,52
91080,995469,1,8,3,0,0,52
91081,995469,1,8,4,1,0,53
91082,995469,1,8,5,0,0,53
91083,995469,1,8,6,0,0,53
91084,995469,1,9,1,1,0,54
91085,995469,1,9,2,4,0,58
91086,995469,1,9,3,0,0,58
91087,995469,1,9,4,0,0,58
91088,995469,1,9,5,0,1,58
91089,995469,1,9,6,0,0,58
91090,995469,1,10,1,1,0,59
91091,995469,1,10,2,2,0,61
91092,995469,1,10,3,0,0,61
91093,995469,1,10,4,1,0,62
91094,995469,1,10,5,1,0,63
91095,995469,1,10,6,1,0,64
91096,995469,1,11,1,0,0,64
91097,995469,1,11,2,0,0,64
91098,995469,1,11,3,1,0,65
91099,995469,1,11,4,1,0,66
91100,995469,1,11,5,1,0,67
91101,995469,1,11,6,1,0,68
91102,995469,1,12,1,4,0,72
91103,995469,1,12,2,1,0,73
91104,995469,1,12,3,1,0,74
91105,995469,1,12,4,0,0,74
91106,995469,1,12,5,0,0,74
91107,995469,1,12,6,1,0,75
91108,995469,1,13,1,1,0,76
91109,995469,1,13,2,0,0,76
91110,995469,1,13,3,0,1,76
91111,995469,1,13,4,0,0,76
91112,995469,1,13,5,0,1,76
91113,995469,1,13,6,1,0,77
91114,995469,1,14,1,1,0,78
91115,995469,1,14,2,2,0,80
91116,995469,1,14,3,1,0,81
91117,995469,1,14,4,0,0,81
91118,995469,1,14,5,4,0,85
91119,995469,1,14,6,1,0,86
91120,995469,1,15,1,0,1,86
91121,995469,1,15,2,1,0,87
91122,995469,1,15,3,1,0,88
91123,995469,1,15,4,0,0,88
91124,995469,1,15,5,1,0,89
91125,995469,1,15,6,4,0,93
91126,995469,1,16,1,0,0,93
91127,995469,1,16,2,0,0,93
91128,995469,1,16,3,1,0,94
91129,995469,1,16,4,2,0,96
91130,995469,1,16,5,2,0,98
91131,995469,1,16,6,1,0,99
91132,995469,1,17,1,1,0,100
91133,995469,1,17,2,1,0,101
91134,995469,1,17,3,1,0,102
91135,995469,1,17,4,2,0,104
91136,995469,1,17,5,1,0,105
91137,995469,1,17,6,1,0,106
91138,995469,1,18,1,1,0,107
91139,995469,1,18,2,4,0,111
91140,995469,1,18,3,1,0,112
91141,995469,1,18,4,1,0,113
91142,995469,1,18,5,1,0,114
91143,995469,1,18,6,0,1,114
91144,995469,1,19,1,1,0,115
91145,995469,1,19,2,2,0,117
91146,995469,1,19,3,1,0,118
91147,995469,1,19,4,2,0,120
91148,995469,1,19,5,1,0,121
91149,995469,1,19,6,2,0,123
91150,995469,1,20,1,1,0,124
91151,995469,1,20,2,1,0,125
91152,995469,1,20,3,0,0,125
91153,995469,1,20,4,0,1,125
91154,995469,1,20,5,2,0,127
91155,995469,1,20,6,1,0,128
91263,1001349,1,1,1,0,0,0
91264,1001349,1,1,2,0,0,0
91265,1001349,1,1,3,1,0,1
91266,1001349,1,1,4,2,0,3
91267,1001349,1,1,5,0,0,3
91268,1001349,1,1,6,3,0,6
91269,1001349,1,2,1,0,0,6
91270,1001349,1,2,2,1,0,7
91271,1001349,1,2,3,0,0,7
91272,1001349,1,2,4,0,0,7
91273,1001349,1,2,5,4,0,11
91274,1001349,1,2,6,2,0,13
91275,1001349,1,3,1,1,0,14
91276,1001349,1,3,2,1,0,15
91277,1001349,1,3,3,0,0,15
91278,1001349,1,3,4,0,0,15
91279,1001349,1,3,5,4,0,19
91280,1001349,1,3,6,0,0,19
91281,1001349,1,4,1,0,0,19
91282,1001349,1,4,2,1,0,20
91283,1001349,1,4,3,1,0,21
91284,1001349,1,4,4,1,0,22
91285,1001349,1,4,5,4,0,26
91286,1001349,1,4,6,1,0,27
91287,1001349,1,5,1,3,0,30
91288,1001349,1,5,2,3,0,33
91289,1001349,1,5,3,4,0,37
91290,1001349,1,5,4,4,0,41
91291,1001349,1,5,5,1,0,42
91292,1001349,1,5,6,1,0,43
91293,1001349,1,6,1,1,0,44
91294,1001349,1,6,2,1,0,45
91295,1001349,1,6,3,0,0,45
91296,1001349,1,6,4,1,0,46
91297,1001349,1,6,5,1,0,47
91298,1001349,1,6,6,0,0,47
91299,1001349,1,7,1,1,0,48
91300,1001349,1,7,2,1,0,49
91301,1001349,1,7,3,0,0,49
91302,1001349,1,7,4,1,0,50
91303,1001349,1,7,5,1,0,51
91304,1001349,1,7,6,2,0,53
91305,1001349,1,8,1,0,0,53
91306,1001349,1,8,2,1,0,54
91307,1001349,1,8,3,1,0,55
91308,1001349,1,8,4,1,0,56
91309,1001349,1,8,5,4,0,60
91310,1001349,1,8,6,1,0,61
91311,1001349,1,9,1,1,0,62
91312,1001349,1,9,2,3,0,65
91313,1001349,1,9,3,1,0,66
91314,1001349,1,9,4,0,0,66
91315,1001349,1,9,5,0,0,66
91316,1001349,1,9,6,1,0,67
91317,1001349,1,10,1,1,0,68
91318,1001349,1,10,2,0,0,68
91319,1001349,1,10,3,0,0,68
91320,1001349,1,10,4,0,0,68
91321,1001349,1,10,5,6,0,74
91322,1001349,1,10,6,1,0,75
91323,1001349,1,11,1,0,0,75
91324,1001349,1,11,2,1,0,76
91325,1001349,1,11,3,0,1,76
91326,1001349,1,11,4,2,0,78
91327,1001349,1,11,5,0,0,78
91328,1001349,1,11,6,0,0,78
91329,1001349,1,12,1,6,0,84
91330,1001349,1,12,2,2,0,86
91331,1001349,1,12,3,0,1,86
91332,1001349,1,12,4,1,0,87
91333,1001349,1,12,5,1,0,88
91334,1001349,1,12,6,1,0,89
91335,1001349,1,13,1,0,0,89
91336,1001349,1,13,2,1,0,90
91337,1001349,1,13,3,1,0,91
91338,1001349,1,13,4,0,0,91
91339,1001349,1,13,5,1,0,92
91340,1001349,1,13,6,1,0,93
91341,1001349,1,14,1,0,0,93
91342,1001349,1,14,2,2,0,95
91343,1001349,1,14,3,2,0,97
91344,1001349,1,14,4,1,0,98
91345,1001349,1,14,5,1,0,99
91346,1001349,1,14,6,1,0,100
91347,1001349,1,15,1,1,0,101
91348,1001349,1,15,2,3,0,104
91349,1001349,1,15,3,1,0,105
91350,1001349,1,15,4,6,0,111
91351,1001349,1,15,5,3,0,114
91352,1001349,1,15,6,2,0,116
91353,1001349,1,16,1,0,1,116
91354,1001349,1,16,2,1,0,117
91355,1001349,1,16,3,2,0,119
91356,1001349,1,16,4,1,0,120
91357,1001349,1,16,5,2,0,122
91358,1001349,1,16,6,7,0,129
91359,1001349,1,17,1,2,0,131
91360,1001349,1,17,2,4,0,135
91361,1001349,1,17,3,1,0,136
91362,1001349,1,17,4,1,0,137
91363,1001349,1,17,5,1,0,138
91364,1001349,1,17,6,1,0,139
91365,1001349,1,18,1,1,0,140
91366,1001349,1,18,2,2,0,142
91367,1001349,1,18,3,2,0,144
91368,1001349,1,18,4,1,0,145
91369,1001349,1,18,5,1,0,146
91370,1001349,1,18,6,2,0,148
91371,1001349,1,19,1,2,0,150
91372,1001349,1,19,2,1,0,151
91373,1001349,1,19,3,2,0,153
91374,1001349,1,19,4,0,1,153
91375,1001349,1,19,5,0,1,153
91376,1001349,1,19,6,1,0,154
91377,1001349,1,20,1,4,0,158
91378,1001349,1,20,2,0,0,158
91379,1001349,1,20,3,2,0,160
91380,1001349,1,20,4,2,1,162
91381,1001349,1,20,5,2,0,164
91382,1001349,1,20,6,4,0,168
91503,1001351,1,1,1,0,0,0
91504,1001351,1,1,2,1,0,1
91505,1001351,1,1,3,0,0,1
91506,1001351,1,1,4,4,0,5
91507,1001351,1,1,5,1,0,6
91508,1001351,1,1,6,1,0,7
91509,1001351,1,2,1,2,0,9
91510,1001351,1,2,2,2,0,11
91511,1001351,1,2,3,2,0,13
91512,1001351,1,2,4,4,0,17
91513,1001351,1,2,5,0,0,17
91514,1001351,1,2,6,0,0,17
91515,1001351,1,3,1,0,0,17
91516,1001351,1,3,2,1,0,18
91517,1001351,1,3,3,0,0,18
91518,1001351,1,3,4,0,1,18
91519,1001351,1,3,5,0,0,18
91520,1001351,1,3,6,0,0,18
91521,1001351,1,4,1,3,0,21
91522,1001351,1,4,2,0,0,21
91523,1001351,1,4,3,4,0,25
91524,1001351,1,4,4,1,0,26
91525,1001351,1,4,5,4,0,30
91526,1001351,1,4,6,0,0,30
91527,1001351,1,5,1,0,0,30
91528,1001351,1,5,2,0,0,30
91529,1001351,1,5,3,1,0,31
91530,1001351,1,5,4,4,0,35
91531,1001351,1,5,5,1,0,36
91532,1001351,1,5,6,2,0,38
91533,1001351,1,6,1,4,0,42
91534,1001351,1,6,2,0,0,42
91535,1001351,1,6,3,6,0,48
91536,1001351,1,6,4,6,0,54
91537,1001351,1,6,5,0,0,54
91538,1001351,1,6,6,6,0,60
91539,1001351,1,7,1,1,0,61
91540,1001351,1,7,2,1,0,62
91541,1001351,1,7,3,1,0,63
91542,1001351,1,7,4,0,1,63
91543,1001351,1,7,5,1,0,64
91544,1001351,1,7,6,0,0,64
91545,1001351,1,8,1,1,0,65
91546,1001351,1,8,2,0,0,65
91547,1001351,1,8,3,0,0,65
91548,1001351,1,8,4,1,0,66
91549,1001351,1,8,5,1,0,67
91550,1001351,1,8,6,0,0,67
91551,1001351,1,9,1,1,0,68
91552,1001351,1,9,2,2,0,70
91553,1001351,1,9,3,1,0,71
91554,1001351,1,9,4,1,0,72
91555,1001351,1,9,5,1,0,73
91556,1001351,1,9,6,1,0,74
91557,1001351,1,10,1,0,0,74
91558,1001351,1,10,2,2,0,76
91559,1001351,1,10,3,0,0,76
91560,1001351,1,10,4,1,0,77
91561,1001351,1,10,5,2,0,79
91562,1001351,1,10,6,1,0,80
91563,1001351,1,11,1,6,0,86
91564,1001351,1,11,2,1,0,87
91565,1001351,1,11,3,0,0,87
91566,1001351,1,11,4,1,0,88
91567,1001351,1,11,5,1,0,89
91568,1001351,1,11,6,6,0,95
91569,1001351,1,12,1,2,0,97
91570,1001351,1,12,2,4,0,101
91571,1001351,1,12,3,0,0,101
91572,1001351,1,12,4,1,0,102
91573,1001351,1,12,5,0,0,102
91574,1001351,1,12,6,1,0,103
91575,1001351,1,13,1,0,0,103
91576,1001351,1,13,2,1,0,104
91577,1001351,1,13,3,1,0,105
91578,1001351,1,13,4,1,0,106
91579,1001351,1,13,5,1,0,107
91580,1001351,1,13,6,4,0,111
91581,1001351,1,14,1,2,0,113
91582,1001351,1,14,2,0,1,113
91583,1001351,1,14,3,1,0,114
91584,1001351,1,14,4,1,0,115
91585,1001351,1,14,5,1,0,116
91586,1001351,1,14,6,3,0,119
91587,1001351,1,15,1,2,0,121
91588,1001351,1,15,2,0,1,121
91589,1001351,1,15,3,1,0,122
91590,1001351,1,15,4,1,0,123
91591,1001351,1,15,5,1,0,124
91592,1001351,1,15,6,1,0,125
91593,1001351,1,16,1,1,0,126
91594,1001351,1,16,2,2,0,128
91595,1001351,1,16,3,2,0,130
91596,1001351,1,16,4,1,0,131
91597,1001351,1,16,5,3,0,134
91598,1001351,1,16,6,0,1,134
91599,1001351,1,17,1,1,0,135
91600,1001351,1,17,2,2,0,137
91601,1001351,1,17,3,4,0,141
91602,1001351,1,17,4,2,0,143
91603,1001351,1,17,5,1,0,144
91604,1001351,1,17,6,0,1,144
91605,1001351,1,18,1,6,0,150
91606,1001351,1,18,2,1,0,151
91607,1001351,1,18,3,4,0,155
91608,1001351,1,18,4,1,0,156
91609,1001351,1,18,5,1,0,157
91610,1001351,1,18,6,2,0,159
91611,1001351,1,19,1,2,0,161
91612,1001351,1,19,2,1,0,162
91613,1001351,1,19,3,0,1,162
91614,1001351,1,19,4,1,0,163
91615,1001351,1,19,5,1,0,164
91616,1001351,1,19,6,2,0,166
91617,1001351,1,20,1,2,0,168
91618,1001351,1,20,2,1,0,169
91619,1001351,1,20,3,0,1,169
91620,1001351,1,20,4,4,0,173
91621,1001351,1,20,5,0,1,173
91622,1001351,1,20,6,0,1,173
91743,1001353,1,1,1,0,0,0
91744,1001353,1,1,2,0,0,0
91745,1001353,1,1,3,0,0,0
91746,1001353,1,1,4,0,0,0
91747,1001353,1,1,5,1,0,1
91748,1001353,1,1,6,0,0,1
91749,1001353,1,2,1,7,0,8
91750,1001353,1,2,2,1,0,9
91751,1001353,1,2,3,0,0,9
91752,1001353,1,2,4,4,0,13
91753,1001353,1,2,5,1,0,14
91754,1001353,1,2,6,1,0,15
91755,1001353,1,3,1,0,0,15
91756,1001353,1,3,2,4,0,19
91757,1001353,1,3,3,2,0,21
91758,1001353,1,3,4,0,0,21
91759,1001353,1,3,5,4,0,25
91760,1001353,1,3,6,1,0,26
91761,1001353,1,4,1,1,0,27
91762,1001353,1,4,2,4,0,31
91763,1001353,1,4,3,0,0,31
91764,1001353,1,4,4,0,0,31
91765,1001353,1,4,5,4,0,35
91766,1001353,1,4,6,0,0,35
91767,1001353,1,5,1,4,0,39
91768,1001353,1,5,2,1,0,40
91769,1001353,1,5,3,4,0,44
91770,1001353,1,5,4,2,0,46
91771,1001353,1,5,5,6,0,52
91772,1001353,1,5,6,1,0,53
91773,1001353,1,6,1,4,0,57
91774,1001353,1,6,2,1,0,58
91775,1001353,1,6,3,2,0,60
91776,1001353,1,6,4,0,0,60
91777,1001353,1,6,5,1,0,61
91778,1001353,1,6,6,1,0,62
91779,1001353,1,7,1,1,0,63
91780,1001353,1,7,2,0,0,63
91781,1001353,1,7,3,1,0,64
91782,1001353,1,7,4,0,0,64
91783,1001353,1,7,5,1,0,65
91784,1001353,1,7,6,1,0,66
91785,1001353,1,8,1,2,0,68
91786,1001353,1,8,2,2,0,70
91787,1001353,1,8,3,0,0,70
91788,1001353,1,8,4,1,0,71
91789,1001353,1,8,5,1,0,72
91790,1001353,1,8,6,6,0,78
91791,1001353,1,9,1,1,0,79
91792,1001353,1,9,2,0,0,79
91793,1001353,1,9,3,0,1,79
91794,1001353,1,9,4,0,0,79
91795,1001353,1,9,5,1,0,80
91796,1001353,1,9,6,1,0,81
91797,1001353,1,10,1,3,0,84
91798,1001353,1,10,2,1,0,85
91799,1001353,1,10,3,6,0,91
91800,1001353,1,10,4,1,0,92
91801,1001353,1,10,5,1,0,93
91802,1001353,1,10,6,0,0,93
91803,1001353,1,11,1,6,0,99
91804,1001353,1,11,2,0,0,99
91805,1001353,1,11,3,0,0,99
91806,1001353,1,11,4,0,0,99
91807,1001353,1,11,5,0,0,99
91808,1001353,1,11,6,1,0,100
91809,1001353,1,12,1,1,0,101
91810,1001353,1,12,2,2,0,103
91811,1001353,1,12,3,2,0,105
91812,1001353,1,12,4,0,0,105
91813,1001353,1,12,5,1,0,106
91814,1001353,1,12,6,1,0,107
91815,1001353,1,13,1,1,0,108
91816,1001353,1,13,2,1,0,109
91817,1001353,1,13,3,4,0,113
91818,1001353,1,13,4,6,0,119
91819,1001353,1,13,5,1,0,120
91820,1001353,1,13,6,4,0,124
91821,1001353,1,14,1,0,0,124
91822,1001353,1,14,2,4,0,128
91823,1001353,1,14,3,0,0,128
91824,1001353,1,14,4,0,0,128
91825,1001353,1,14,5,0,0,128
91826,1001353,1,14,6,0,1,128
91827,1001353,1,15,1,1,0,129
91828,1001353,1,15,2,1,0,130
91829,1001353,1,15,3,1,0,131
91830,1001353,1,15,4,2,0,133
91831,1001353,1,15,5,1,0,134
91832,1001353,1,15,6,1,0,135
91833,1001353,1,16,1,1,0,136
91834,1001353,1,16,2,1,0,137
91835,1001353,1,16,3,1,0,138
91836,1001353,1,16,4,4,0,142
91837,1001353,1,16,5,3,0,145
91838,1001353,1,16,6,2,0,147
91839,1001353,1,17,1,2,0,149
91840,1001353,1,17,2,6,0,155
91841,1001353,1,17,3,6,0,161
91842,1001353,1,17,4,2,0,163
91843,1001353,1,17,5,4,0,167
91844,1001353,1,17,6,0,0,167
91845,1001353,1,18,1,1,0,168
91846,1001353,1,18,2,0,0,168
91847,1001353,1,18,3,2,0,170
91848,1001353,1,18,4,1,0,171
91849,1001353,1,18,5,4,0,175
91850,1001353,1,18,6,2,0,177
91851,1001353,1,19,1,2,0,179
91852,1001353,1,19,2,0,1,179
91853,1001353,1,19,3,1,1,180
91854,1001353,1,19,4,1,0,181
91855,1001353,1,19,5,1,0,182
91856,1001353,1,19,6,0,1,182
91857,1001353,1,20,1,2,0,184
91858,1001353,1,20,2,0,1,184
91859,1001353,1,20,3,1,0,185
91860,1001353,1,20,4,0,0,185
91861,1001353,1,20,5,1,0,186
91862,1001353,1,20,6,1,0,187
91971,1007655,1,1,1,0,0,0
91972,1007655,1,1,2,0,0,0
91973,1007655,1,1,3,0,0,0
91974,1007655,1,1,4,1,0,1
91975,1007655,1,1,5,0,0,1
91976,1007655,1,1,6,1,0,2
91977,1007655,1,2,1,0,0,2
91978,1007655,1,2,2,6,0,8
91979,1007655,1,2,3,0,0,8
91980,1007655,1,2,4,1,0,9
91981,1007655,1,2,5,1,0,10
91982,1007655,1,2,6,4,0,14
91983,1007655,1,3,1,0,0,14
91984,1007655,1,3,2,4,0,18
91985,1007655,1,3,3,0,0,18
91986,1007655,1,3,4,0,0,18
91987,1007655,1,3,5,1,0,19
91988,1007655,1,3,6,1,0,20
91989,1007655,1,4,1,6,0,26
91990,1007655,1,4,2,0,0,26
91991,1007655,1,4,3,6,0,32
91992,1007655,1,4,4,1,0,33
91993,1007655,1,4,5,0,0,33
91994,1007655,1,4,6,0,0,33
91995,1007655,1,5,1,0,0,33
91996,1007655,1,5,2,0,0,33
91997,1007655,1,5,3,0,1,33
91998,1007655,1,5,4,0,0,33
91999,1007655,1,5,5,0,0,33
92000,1007655,1,5,6,0,0,33
92001,1007655,1,6,1,1,0,34
92002,1007655,1,6,2,0,1,34
92003,1007655,1,6,3,1,0,35
92004,1007655,1,6,4,1,0,36
92005,1007655,1,6,5,1,0,37
92006,1007655,1,6,6,4,0,41
92007,1007655,1,7,1,1,0,42
92008,1007655,1,7,2,1,0,43
92009,1007655,1,7,3,1,0,44
92010,1007655,1,7,4,4,0,48
92011,1007655,1,7,5,2,0,50
92012,1007655,1,7,6,0,1,50
92013,1007655,1,8,1,1,0,51
92014,1007655,1,8,2,4,0,55
92015,1007655,1,8,3,0,0,55
92016,1007655,1,8,4,1,0,56
92017,1007655,1,8,5,1,0,57
92018,1007655,1,8,6,0,0,57
92019,1007655,1,9,1,4,0,61
92020,1007655,1,9,2,0,0,61
92021,1007655,1,9,3,1,0,62
92022,1007655,1,9,4,0,0,62
92023,1007655,1,9,5,1,0,63
92024,1007655,1,9,6,4,0,67
92025,1007655,1,10,1,1,0,68
92026,1007655,1,10,2,0,0,68
92027,1007655,1,10,3,1,0,69
92028,1007655,1,10,4,0,0,69
92029,1007655,1,10,5,2,0,71
92030,1007655,1,10,6,1,0,72
92031,1007655,1,11,1,1,0,73
92032,1007655,1,11,2,1,0,74
92033,1007655,1,11,3,1,0,75
92034,1007655,1,11,4,1,0,76
92035,1007655,1,11,5,2,0,78
92036,1007655,1,11,6,2,0,80
92037,1007655,1,12,1,1,0,81
92038,1007655,1,12,2,4,0,85
92039,1007655,1,12,3,1,0,86
92040,1007655,1,12,4,4,0,90
92041,1007655,1,12,5,1,0,91
92042,1007655,1,12,6,0,0,91
92043,1007655,1,13,1,4,0,95
92044,1007655,1,13,2,1,0,96
92045,1007655,1,13,3,1,0,97
92046,1007655,1,13,4,0,1,97
92047,1007655,1,13,5,1,0,98
92048,1007655,1,13,6,0,0,98
92049,1007655,1,14,1,0,1,98
92050,1007655,1,14,2,0,0,98
92051,1007655,1,14,3,1,0,99
92052,1007655,1,14,4,0,0,99
92053,1007655,1,14,5,0,0,99
92054,1007655,1,14,6,1,0,100
92055,1007655,1,15,1,1,0,101
92056,1007655,1,15,2,0,0,101
92057,1007655,1,15,3,1,0,102
92058,1007655,1,15,4,1,0,103
92059,1007655,1,15,5,8,0,111
92060,1007655,1,15,6,0,0,111
92061,1007655,1,16,1,0,1,111
92062,1007655,1,16,2,1,0,112
92063,1007655,1,16,3,1,0,113
92064,1007655,1,16,4,1,0,114
92065,1007655,1,16,5,1,0,115
92066,1007655,1,16,6,0,0,115
92067,1007655,1,17,1,1,0,116
92068,1007655,1,17,2,6,0,122
92069,1007655,1,17,3,1,0,123
92070,1007655,1,17,4,1,0,124
92071,1007655,1,17,5,6,0,130
92072,1007655,1,17,6,0,0,130
92073,1007655,1,18,1,0,1,130
92074,1007655,1,18,2,0,0,130
92075,1007655,1,18,3,1,0,131
92076,1007655,1,18,4,1,0,132
92077,1007655,1,18,5,1,0,133
92078,1007655,1,18,6,1,0,134
92079,1007655,1,19,1,1,0,135
92080,1007655,1,19,2,4,0,139
92081,1007655,1,19,3,6,0,145
92082,1007655,1,19,4,2,0,147
92083,1007655,1,19,5,8,0,155
92084,1007655,1,19,6,0,0,155
92085,1007655,1,20,1,1,0,156
92086,1007655,1,20,2,6,0,162
92087,1007655,1,20,3,1,0,163
92088,1007655,1,20,4,1,0,164
92089,1007655,1,20,5,6,0,170
92090,1007655,1,20,6,0,0,170
92211,1007657,1,1,1,0,0,0
92212,1007657,1,1,2,0,0,0
92213,1007657,1,1,3,4,0,4
92214,1007657,1,1,4,1,0,5
92215,1007657,1,1,5,0,0,5
92216,1007657,1,1,6,0,0,5
92217,1007657,1,2,1,4,0,9
92218,1007657,1,2,2,0,0,9
92219,1007657,1,2,3,1,0,10
92220,1007657,1,2,4,0,0,10
92221,1007657,1,2,5,0,0,10
92222,1007657,1,2,6,1,0,11
92223,1007657,1,3,1,0,0,11
92224,1007657,1,3,2,1,0,12
92225,1007657,1,3,3,2,0,14
92226,1007657,1,3,4,0,0,14
92227,1007657,1,3,5,0,1,14
92228,1007657,1,3,6,1,0,15
92229,1007657,1,4,1,0,0,15
92230,1007657,1,4,2,4,0,19
92231,1007657,1,4,3,1,0,20
92232,1007657,1,4,4,0,0,20
92233,1007657,1,4,5,1,0,21
92234,1007657,1,4,6,4,0,25
92235,1007657,1,5,1,1,0,26
92236,1007657,1,5,2,0,1,26
92237,1007657,1,5,3,1,0,27
92238,1007657,1,5,4,1,0,28
92239,1007657,1,5,5,0,1,28
92240,1007657,1,5,6,0,1,28
92241,1007657,1,6,1,4,0,32
92242,1007657,1,6,2,2,0,34
92243,1007657,1,6,3,1,0,35
92244,1007657,1,6,4,0,0,35
92245,1007657,1,6,5,0,0,35
92246,1007657,1,6,6,0,0,35
92247,1007657,1,7,1,0,0,35
92248,1007657,1,7,2,1,0,36
92249,1007657,1,7,3,0,0,36
92250,1007657,1,7,4,1,0,37
92251,1007657,1,7,5,0,0,37
92252,1007657,1,7,6,0,0,37
92253,1007657,1,8,1,2,0,39
92254,1007657,1,8,2,4,0,43
92255,1007657,1,8,3,0,0,43
92256,1007657,1,8,4,1,0,44
92257,1007657,1,8,5,1,0,45
92258,1007657,1,8,6,1,0,46
92259,1007657,1,9,1,0,0,46
92260,1007657,1,9,2,0,0,46
92261,1007657,1,9,3,1,0,47
92262,1007657,1,9,4,0,0,47
92263,1007657,1,9,5,0,0,47
92264,1007657,1,9,6,0,0,47
92265,1007657,1,10,1,1,0,48
92266,1007657,1,10,2,0,0,48
92267,1007657,1,10,3,0,0,48
92268,1007657,1,10,4,2,0,50
92269,1007657,1,10,5,1,0,51
92270,1007657,1,10,6,1,0,52
92271,1007657,1,11,1,1,0,53
92272,1007657,1,11,2,2,0,55
92273,1007657,1,11,3,1,0,56
92274,1007657,1,11,4,0,0,56
92275,1007657,1,11,5,0,0,56
92276,1007657,1,11,6,1,0,57
92277,1007657,1,12,1,0,1,57
92278,1007657,1,12,2,0,0,57
92279,1007657,1,12,3,0,0,57
92280,1007657,1,12,4,0,0,57
92281,1007657,1,12,5,0,0,57
92282,1007657,1,12,6,0,0,57
92283,1007657,1,13,1,6,0,63
92284,1007657,1,13,2,0,0,63
92285,1007657,1,13,3,4,0,67
92286,1007657,1,13,4,0,0,67
92287,1007657,1,13,5,0,0,67
92288,1007657,1,13,6,1,0,68
92289,1007657,1,14,1,1,0,69
92290,1007657,1,14,2,0,0,69
92291,1007657,1,14,3,1,0,70
92292,1007657,1,14,4,1,0,71
92293,1007657,1,14,5,1,0,72
92294,1007657,1,14,6,1,0,73
92295,1007657,1,15,1,0,0,73
92296,1007657,1,15,2,1,0,74
92297,1007657,1,15,3,1,0,75
92298,1007657,1,15,4,0,1,75
92299,1007657,1,15,5,1,0,76
92300,1007657,1,15,6,0,0,76
92301,1007657,1,16,1,0,0,76
92302,1007657,1,16,2,4,0,80
92303,1007657,1,16,3,0,0,80
92304,1007657,1,16,4,0,0,80
92305,1007657,1,16,5,0,0,80
92306,1007657,1,16,6,1,0,81
92307,1007657,1,17,1,0,1,81
92308,1007657,1,17,2,1,0,82
92309,1007657,1,17,3,1,0,83
92310,1007657,1,17,4,0,1,83
92311,1007657,1,17,5,0,0,83
92312,1007657,1,17,6,1,0,84
92313,1007657,1,18,1,0,0,84
92314,1007657,1,18,2,1,0,85
92315,1007657,1,18,3,1,0,86
92316,1007657,1,18,4,0,0,86
92317,1007657,1,18,5,0,0,86
92318,1007657,1,18,6,0,0,86
92319,1007657,1,19,1,1,0,87
92320,1007657,1,19,2,0,0,87
92321,1007657,1,19,3,0,0,87
92322,1007657,1,19,4,0,0,87
92323,1007657,1,19,5,1,0,88
92324,1007657,1,19,6,2,0,90
92325,1007657,1,20,1,1,0,91
92326,1007657,1,20,2,0,1,91
92327,1007657,1,20,3,7,0,98
92328,1007657,1,20,4,1,0,99
92329,1007657,1,20,5,0,0,99
92330,1007657,1,20,6,0,0,99
92410,1007659,1,1,1,0,0,0
92411,1007659,1,1,2,0,0,0
92412,1007659,1,1,3,0,0,0
92413,1007659,1,1,4,0,0,0
92414,1007659,1,1,5,0,0,0
92415,1007659,1,1,6,0,0,0
92416,1007659,1,2,1,0,0,0
92417,1007659,1,2,2,2,0,2
92418,1007659,1,2,3,1,0,3
92419,1007659,1,2,4,0,0,3
92420,1007659,1,2,5,1,0,4
92421,1007659,1,2,6,0,0,4
92422,1007659,1,3,1,0,0,4
92423,1007659,1,3,2,4,0,8
92424,1007659,1,3,3,6,0,14
92425,1007659,1,3,4,4,0,18
92426,1007659,1,3,5,1,0,19
92427,1007659,1,3,6,1,0,20
92428,1007659,1,4,1,0,1,20
92429,1007659,1,4,2,0,0,20
92430,1007659,1,4,3,0,0,20
92431,1007659,1,4,4,1,0,21
92432,1007659,1,4,5,1,0,22
92433,1007659,1,4,6,1,0,23
92434,1007659,1,5,1,0,0,23
92435,1007659,1,5,2,4,0,27
92436,1007659,1,5,3,0,1,27
92437,1007659,1,5,4,0,1,27
92438,1007659,1,5,5,0,0,27
92439,1007659,1,5,6,0,0,27
92440,1007659,1,6,1,1,0,28
92441,1007659,1,6,2,0,0,28
92442,1007659,1,6,3,0,0,28
92443,1007659,1,6,4,1,0,29
92444,1007659,1,6,5,0,0,29
92445,1007659,1,6,6,0,0,29
92446,1007659,1,7,1,1,0,30
92447,1007659,1,7,2,1,0,31
92448,1007659,1,7,3,1,0,32
92449,1007659,1,7,4,0,0,32
92450,1007659,1,7,5,0,0,32
92451,1007659,1,7,6,2,0,34
92452,1007659,1,8,1,0,0,34
92453,1007659,1,8,2,1,0,35
92454,1007659,1,8,3,0,0,35
92455,1007659,1,8,4,1,0,36
92456,1007659,1,8,5,1,0,37
92457,1007659,1,8,6,2,0,39
92458,1007659,1,9,1,0,0,39
92459,1007659,1,9,2,0,0,39
92460,1007659,1,9,3,4,0,43
92461,1007659,1,9,4,1,0,44
92462,1007659,1,9,5,1,0,45
92463,1007659,1,9,6,4,0,49
92464,1007659,1,10,1,1,0,50
92465,1007659,1,10,2,1,0,51
92466,1007659,1,10,3,2,0,53
92467,1007659,1,10,4,0,0,53
92468,1007659,1,10,5,0,0,53
92469,1007659,1,10,6,0,0,53
92470,1007659,1,11,1,0,0,53
92471,1007659,1,11,2,4,0,57
92472,1007659,1,11,3,1,0,58
92473,1007659,1,11,4,0,0,58
92474,1007659,1,11,5,2,0,60
92475,1007659,1,11,6,1,0,61
92476,1007659,1,12,1,0,0,61
92477,1007659,1,12,2,2,0,63
92478,1007659,1,12,3,4,0,67
92479,1007659,1,12,4,1,0,68
92480,1007659,1,12,5,1,0,69
92481,1007659,1,12,6,0,0,69
92482,1007659,1,13,1,0,0,69
92483,1007659,1,13,2,4,0,73
92484,1007659,1,13,3,2,0,75
92485,1007659,1,13,4,1,0,76
92486,1007659,1,13,5,0,1,76
92487,1007659,1,13,6,2,0,78
92488,1007659,1,14,1,1,0,79
92489,1007659,1,14,2,1,0,80
92490,1007659,1,14,3,0,0,80
92491,1007659,1,14,4,1,0,81
92492,1007659,1,14,5,0,0,81
92493,1007659,1,14,6,4,0,85
92494,1007659,1,15,1,1,0,86
92495,1007659,1,15,2,0,0,86
92496,1007659,1,15,3,0,0,86
92497,1007659,1,15,4,0,0,86
92498,1007659,1,15,5,0,0,86
92499,1007659,1,15,6,1,0,87
92500,1007659,1,16,1,0,0,87
92501,1007659,1,16,2,1,0,88
92502,1007659,1,16,3,2,0,90
92503,1007659,1,16,4,3,0,93
92504,1007659,1,16,5,0,0,93
92505,1007659,1,16,6,0,0,93
92506,1007659,1,17,1,0,0,93
92507,1007659,1,17,2,0,1,93
92508,1007659,1,17,3,0,0,93
92509,1007659,1,17,4,0,0,93
92510,1007659,1,17,5,1,0,94
92511,1007659,1,17,6,1,0,95
92512,1007659,1,18,1,6,0,101
92513,1007659,1,18,2,1,0,102
92514,1007659,1,18,3,1,0,103
92515,1007659,1,18,4,0,0,103
92516,1007659,1,18,5,4,0,107
92517,1007659,1,18,6,4,0,111
92518,1007659,1,19,1,1,0,112
92519,1007659,1,19,2,2,0,114
92520,1007659,1,19,3,1,0,115
92521,1007659,1,19,4,3,0,118
92522,1007659,1,19,5,4,0,122
92523,1007659,1,19,6,0,1,122
92524,1007659,1,20,1,2,0,124
92525,1007659,1,20,2,2,0,126
92526,1007659,1,20,3,2,0,128
92527,1007659,1,20,4,2,0,130
92528,1007659,1,20,5,6,0,136
92529,1007659,1,20,6,2,0,138
92650,1019979,1,1,1,0,0,0
92651,1019979,1,1,2,0,0,0
92652,1019979,1,1,3,0,0,0
92653,1019979,1,1,4,0,0,0
92654,1019979,1,1,5,3,0,3
92655,1019979,1,1,6,1,0,4
92656,1019979,1,2,1,1,0,5
92657,1019979,1,2,2,0,0,5
92658,1019979,1,2,3,0,1,5
92659,1019979,1,2,4,1,0,6
92660,1019979,1,2,5,4,0,10
92661,1019979,1,2,6,1,0,11
92662,1019979,1,3,1,0,0,11
92663,1019979,1,3,2,0,0,11
92664,1019979,1,3,3,0,0,11
92665,1019979,1,3,4,0,0,11
92666,1019979,1,3,5,0,0,11
92667,1019979,1,3,6,1,0,12
92668,1019979,1,4,1,6,0,18
92669,1019979,1,4,2,0,0,18
92670,1019979,1,4,3,1,0,19
92671,1019979,1,4,4,0,0,19
92672,1019979,1,4,5,1,0,20
92673,1019979,1,4,6,2,0,22
92674,1019979,1,5,1,2,0,24
92675,1019979,1,5,2,0,0,24
92676,1019979,1,5,3,4,0,28
92677,1019979,1,5,4,0,1,28
92678,1019979,1,5,5,1,0,29
92679,1019979,1,5,6,1,0,30
92680,1019979,1,6,1,0,1,30
92681,1019979,1,6,2,0,1,30
92682,1019979,1,6,3,0,0,30
92683,1019979,1,6,4,0,0,30
92684,1019979,1,6,5,0,0,30
92685,1019979,1,6,6,4,0,34
92686,1019979,1,7,1,0,0,34
92687,1019979,1,7,2,1,0,35
92688,1019979,1,7,3,1,0,36
92689,1019979,1,7,4,1,0,37
92690,1019979,1,7,5,0,0,37
92691,1019979,1,7,6,1,0,38
92692,1019979,1,8,1,0,0,38
92693,1019979,1,8,2,0,0,38
92694,1019979,1,8,3,1,0,39
92695,1019979,1,8,4,2,0,41
92696,1019979,1,8,5,5,0,46
92697,1019979,1,8,6,2,0,48
92698,1019979,1,9,1,6,0,54
92699,1019979,1,9,2,1,0,55
92700,1019979,1,9,3,1,0,56
92701,1019979,1,9,4,2,0,58
92702,1019979,1,9,5,1,0,59
92703,1019979,1,9,6,1,0,60
92704,1019979,1,10,1,1,0,61
92705,1019979,1,10,2,0,0,61
92706,1019979,1,10,3,1,0,62
92707,1019979,1,10,4,2,0,64
92708,1019979,1,10,5,1,0,65
92709,1019979,1,10,6,0,0,65
92710,1019979,1,11,1,1,0,66
92711,1019979,1,11,2,0,0,66
92712,1019979,1,11,3,1,0,67
92713,1019979,1,11,4,0,1,67
92714,1019979,1,11,5,0,0,67
92715,1019979,1,11,6,0,0,67
92716,1019979,1,12,1,1,0,68
92717,1019979,1,12,2,1,0,69
92718,1019979,1,12,3,1,0,70
92719,1019979,1,12,4,0,0,70
92720,1019979,1,12,5,0,0,70
92721,1019979,1,12,6,0,0,70
92722,1019979,1,13,1,1,0,71
92723,1019979,1,13,2,0,0,71
92724,1019979,1,13,3,2,0,73
92725,1019979,1,13,4,1,0,74
92726,1019979,1,13,5,0,0,74
92727,1019979,1,13,6,1,0,75
92728,1019979,1,14,1,1,0,76
92729,1019979,1,14,2,1,0,77
92730,1019979,1,14,3,0,0,77
92731,1019979,1,14,4,6,0,83
92732,1019979,1,14,5,1,0,84
92733,1019979,1,14,6,0,0,84
92734,1019979,1,15,1,0,0,84
92735,1019979,1,15,2,1,0,85
92736,1019979,1,15,3,6,0,91
92737,1019979,1,15,4,1,0,92
92738,1019979,1,15,5,3,0,95
92739,1019979,1,15,6,2,0,97
92740,1019979,1,16,1,1,0,98
92741,1019979,1,16,2,1,0,99
92742,1019979,1,16,3,0,1,99
92743,1019979,1,16,4,0,0,99
92744,1019979,1,16,5,1,0,100
92745,1019979,1,16,6,0,0,100
92746,1019979,1,17,1,5,0,105
92747,1019979,1,17,2,0,0,105
92748,1019979,1,17,3,6,0,111
92749,1019979,1,17,4,0,0,111
92750,1019979,1,17,5,1,0,112
92751,1019979,1,17,6,2,0,114
92752,1019979,1,18,1,0,1,114
92753,1019979,1,18,2,1,0,115
92754,1019979,1,18,3,1,0,116
92755,1019979,1,18,4,0,0,116
92756,1019979,1,18,5,6,0,122
92757,1019979,1,18,6,1,0,123
92758,1019979,1,19,1,6,0,129
92759,1019979,1,19,2,1,0,130
92760,1019979,1,19,3,1,0,131
92761,1019979,1,19,4,1,0,132
92762,1019979,1,19,5,0,0,132
92763,1019979,1,19,6,4,0,136
92764,1019979,1,20,1,2,0,138
92765,1019979,1,20,2,0,1,138
92766,1019979,1,20,3,1,0,139
92767,1019979,1,20,4,0,0,139
92768,1019979,1,20,5,1,0,140
92769,1019979,1,20,6,1,0,141
92878,1019981,1,1,1,0,1,0
92879,1019981,1,1,2,3,0,3
92880,1019981,1,1,3,1,0,4
92881,1019981,1,1,4,0,0,4
92882,1019981,1,1,5,0,0,4
92883,1019981,1,1,6,4,0,8
92884,1019981,1,2,1,1,0,9
92885,1019981,1,2,2,4,0,13
92886,1019981,1,2,3,4,0,17
92887,1019981,1,2,4,2,0,19
92888,1019981,1,2,5,1,0,20
92889,1019981,1,2,6,0,0,20
92890,1019981,1,3,1,0,0,20
92891,1019981,1,3,2,0,0,20
92892,1019981,1,3,3,0,0,20
92893,1019981,1,3,4,6,0,26
92894,1019981,1,3,5,0,0,26
92895,1019981,1,3,6,4,0,30
92896,1019981,1,4,1,5,0,35
92897,1019981,1,4,2,0,0,35
92898,1019981,1,4,3,0,0,35
92899,1019981,1,4,4,4,0,39
92900,1019981,1,4,5,1,0,40
92901,1019981,1,4,6,0,0,40
92902,1019981,1,5,1,1,0,41
92903,1019981,1,5,2,0,0,41
92904,1019981,1,5,3,1,0,42
92905,1019981,1,5,4,0,0,42
92906,1019981,1,5,5,0,0,42
92907,1019981,1,5,6,0,1,42
92908,1019981,1,6,1,4,0,46
92909,1019981,1,6,2,0,0,46
92910,1019981,1,6,3,0,1,46
92911,1019981,1,6,4,1,0,47
92912,1019981,1,6,5,1,0,48
92913,1019981,1,6,6,1,0,49
92914,1019981,1,7,1,1,0,50
92915,1019981,1,7,2,0,0,50
92916,1019981,1,7,3,2,0,52
92917,1019981,1,7,4,1,0,53
92918,1019981,1,7,5,1,0,54
92919,1019981,1,7,6,1,0,55
92920,1019981,1,8,1,1,0,56
92921,1019981,1,8,2,6,0,62
92922,1019981,1,8,3,1,0,63
92923,1019981,1,8,4,1,0,64
92924,1019981,1,8,5,6,0,70
92925,1019981,1,8,6,0,0,70
92926,1019981,1,9,1,1,0,71
92927,1019981,1,9,2,0,0,71
92928,1019981,1,9,3,1,0,72
92929,1019981,1,9,4,1,0,73
92930,1019981,1,9,5,1,0,74
92931,1019981,1,9,6,1,0,75
92932,1019981,1,10,1,1,0,76
92933,1019981,1,10,2,0,0,76
92934,1019981,1,10,3,1,0,77
92935,1019981,1,10,4,6,0,83
92936,1019981,1,10,5,2,0,85
92937,1019981,1,10,6,2,0,87
92938,1019981,1,11,1,1,0,88
92939,1019981,1,11,2,1,0,89
92940,1019981,1,11,3,0,0,89
92941,1019981,1,11,4,1,0,90
92942,1019981,1,11,5,1,0,91
92943,1019981,1,11,6,1,0,92
92944,1019981,1,12,1,0,0,92
92945,1019981,1,12,2,2,0,94
92946,1019981,1,12,3,6,0,100
92947,1019981,1,12,4,4,0,104
92948,1019981,1,12,5,1,0,105
92949,1019981,1,12,6,2,0,107
92950,1019981,1,13,1,6,0,113
92951,1019981,1,13,2,2,0,115
92952,1019981,1,13,3,6,0,121
92953,1019981,1,13,4,4,0,125
92954,1019981,1,13,5,4,0,129
92955,1019981,1,13,6,6,0,135
92956,1019981,1,14,1,4,0,139
92957,1019981,1,14,2,2,0,141
92958,1019981,1,14,3,1,0,142
92959,1019981,1,14,4,1,0,143
92960,1019981,1,14,5,1,0,144
92961,1019981,1,14,6,1,0,145
92962,1019981,1,15,1,1,0,146
92963,1019981,1,15,2,4,0,150
92964,1019981,1,15,3,0,0,150
92965,1019981,1,15,4,1,0,151
92966,1019981,1,15,5,1,0,152
92967,1019981,1,15,6,1,0,153
92968,1019981,1,16,1,1,0,154
92969,1019981,1,16,2,1,0,155
92970,1019981,1,16,3,4,0,159
92971,1019981,1,16,4,1,0,160
92972,1019981,1,16,5,2,0,162
92973,1019981,1,16,6,1,0,163
92974,1019981,1,17,1,1,0,164
92975,1019981,1,17,2,4,0,168
92976,1019981,1,17,3,1,0,169
92977,1019981,1,17,4,0,1,169
92978,1019981,1,17,5,2,0,171
92979,1019981,1,17,6,0,1,171
92980,1019981,1,18,1,1,0,172
92981,1019981,1,18,2,2,0,174
92982,1019981,1,18,3,1,0,175
92983,1019981,1,18,4,2,0,177
92984,1019981,1,18,5,1,0,178
92985,1019981,1,18,6,1,0,179
92986,1019981,1,19,1,1,0,180
92987,1019981,1,19,2,1,0,181
92988,1019981,1,19,3,1,0,182
92989,1019981,1,19,4,4,0,186
92990,1019981,1,19,5,2,0,188
92991,1019981,1,19,6,2,0,190
92992,1019981,1,20,1,0,1,190
92993,1019981,1,20,2,2,0,192
92994,1019981,1,20,3,0,0,192
92995,1019981,1,20,4,2,0,194
92996,1019981,1,20,5,0,1,194
92997,1019981,1,20,6,1,0,195
93107,1019983,1,1,1,0,0,0
93108,1019983,1,1,2,1,0,1
93109,1019983,1,1,3,4,0,5
93110,1019983,1,1,4,4,0,9
93111,1019983,1,1,5,0,0,9
93112,1019983,1,1,6,0,0,9
93113,1019983,1,2,1,1,0,10
93114,1019983,1,2,2,1,0,11
93115,1019983,1,2,3,0,0,11
93116,1019983,1,2,4,0,0,11
93117,1019983,1,2,5,1,0,12
93118,1019983,1,2,6,1,0,13
93119,1019983,1,3,1,0,0,13
93120,1019983,1,3,2,1,0,14
93121,1019983,1,3,3,0,0,14
93122,1019983,1,3,4,4,0,18
93123,1019983,1,3,5,1,0,19
93124,1019983,1,3,6,0,0,19
93125,1019983,1,4,1,1,0,20
93126,1019983,1,4,2,0,0,20
93127,1019983,1,4,3,0,0,20
93128,1019983,1,4,4,4,0,24
93129,1019983,1,4,5,4,0,28
93130,1019983,1,4,6,2,0,30
93131,1019983,1,5,1,4,0,34
93132,1019983,1,5,2,0,1,34
93133,1019983,1,5,3,1,0,35
93134,1019983,1,5,4,1,0,36
93135,1019983,1,5,5,0,0,36
93136,1019983,1,5,6,0,1,36
93137,1019983,1,6,1,0,0,36
93138,1019983,1,6,2,4,0,40
93139,1019983,1,6,3,1,0,41
93140,1019983,1,6,4,0,0,41
93141,1019983,1,6,5,0,0,41
93142,1019983,1,6,6,0,0,41
93143,1019983,1,7,1,0,1,41
93144,1019983,1,7,2,0,0,41
93145,1019983,1,7,3,0,0,41
93146,1019983,1,7,4,1,0,42
93147,1019983,1,7,5,1,0,43
93148,1019983,1,7,6,1,0,44
93149,1019983,1,8,1,1,0,45
93150,1019983,1,8,2,0,0,45
93151,1019983,1,8,3,0,0,45
93152,1019983,1,8,4,0,0,45
93153,1019983,1,8,5,1,0,46
93154,1019983,1,8,6,0,0,46
93155,1019983,1,9,1,0,0,46
93156,1019983,1,9,2,1,0,47
93157,1019983,1,9,3,1,0,48
93158,1019983,1,9,4,1,0,49
93159,1019983,1,9,5,0,0,49
93160,1019983,1,9,6,1,0,50
93161,1019983,1,10,1,1,0,51
93162,1019983,1,10,2,1,0,52
93163,1019983,1,10,3,1,0,53
93164,1019983,1,10,4,1,0,54
93165,1019983,1,10,5,0,0,54
93166,1019983,1,10,6,1,0,55
93167,1019983,1,11,1,0,0,55
93168,1019983,1,11,2,4,0,59
93169,1019983,1,11,3,2,0,61
93170,1019983,1,11,4,1,0,62
93171,1019983,1,11,5,4,0,66
93172,1019983,1,11,6,1,0,67
93173,1019983,1,12,1,1,0,68
93174,1019983,1,12,2,1,0,69
93175,1019983,1,12,3,6,0,75
93176,1019983,1,12,4,1,0,76
93177,1019983,1,12,5,1,0,77
93178,1019983,1,12,6,2,0,79
93179,1019983,1,13,1,4,0,83
93180,1019983,1,13,2,2,0,85
93181,1019983,1,13,3,4,0,89
93182,1019983,1,13,4,1,0,90
93183,1019983,1,13,5,1,0,91
93184,1019983,1,13,6,0,0,91
93185,1019983,1,14,1,1,0,92
93186,1019983,1,14,2,6,0,98
93187,1019983,1,14,3,4,0,102
93188,1019983,1,14,4,0,0,102
93189,1019983,1,14,5,0,0,102
93190,1019983,1,14,6,1,0,103
93191,1019983,1,15,1,4,0,107
93192,1019983,1,15,2,1,0,108
93193,1019983,1,15,3,4,0,112
93194,1019983,1,15,4,6,0,118
93195,1019983,1,15,5,6,0,124
93196,1019983,1,15,6,1,0,125
93197,1019983,1,16,1,1,0,126
93198,1019983,1,16,2,2,0,128
93199,1019983,1,16,3,0,0,128
93200,1019983,1,16,4,1,0,129
93201,1019983,1,16,5,0,0,129
93202,1019983,1,16,6,0,0,129
93203,1019983,1,17,1,1,0,130
93204,1019983,1,17,2,6,0,136
93205,1019983,1,17,3,6,0,142
93206,1019983,1,17,4,6,0,148
93207,1019983,1,17,5,2,0,150
93208,1019983,1,17,6,0,0,150
93209,1019983,1,18,1,1,0,151
93210,1019983,1,18,2,2,0,153
93211,1019983,1,18,3,1,0,154
93212,1019983,1,18,4,4,0,158
93213,1019983,1,18,5,1,0,159
93214,1019983,1,18,6,6,0,165
93215,1019983,1,19,1,0,1,165
93216,1019983,1,19,2,2,0,167
93217,1019983,1,19,3,1,0,168
93218,1019983,1,19,4,2,0,170
93219,1019983,1,19,5,6,0,176
93220,1019983,1,19,6,1,0,177
93221,1019983,1,20,1,7,0,184
93222,1019983,1,20,2,1,0,185
93223,1019983,1,20,3,1,0,186
93224,1019983,1,20,4,0,0,186
93225,1019983,1,20,5,6,0,192
93226,1019983,1,20,6,2,0,194
93347,1020029,1,1,1,0,0,0
93348,1020029,1,1,2,4,0,4
93349,1020029,1,1,3,0,0,4
93350,1020029,1,1,4,0,0,4
93351,1020029,1,1,5,1,0,5
93352,1020029,1,1,6,0,0,5
93353,1020029,1,2,1,0,0,5
93354,1020029,1,2,2,4,0,9
93355,1020029,1,2,3,4,0,13
93356,1020029,1,2,4,1,0,14
93357,1020029,1,2,5,0,0,14
93358,1020029,1,2,6,0,0,14
93359,1020029,1,3,1,0,0,14
93360,1020029,1,3,2,0,0,14
93361,1020029,1,3,3,1,0,15
93362,1020029,1,3,4,0,1,15
93363,1020029,1,3,5,0,0,15
93364,1020029,1,3,6,0,0,15
93365,1020029,1,4,1,2,0,17
93366,1020029,1,4,2,0,0,17
93367,1020029,1,4,3,2,0,19
93368,1020029,1,4,4,0,0,19
93369,1020029,1,4,5,0,0,19
93370,1020029,1,4,6,6,0,25
93371,1020029,1,5,1,4,0,29
93372,1020029,1,5,2,4,0,33
93373,1020029,1,5,3,4,0,37
93374,1020029,1,5,4,4,0,41
93375,1020029,1,5,5,0,0,41
93376,1020029,1,5,6,1,0,42
93377,1020029,1,6,1,1,0,43
93378,1020029,1,6,2,4,0,47
93379,1020029,1,6,3,1,0,48
93380,1020029,1,6,4,4,0,52
93381,1020029,1,6,5,4,0,56
93382,1020029,1,6,6,0,0,56
93383,1020029,1,7,1,1,0,57
93384,1020029,1,7,2,0,0,57
93385,1020029,1,7,3,1,0,58
93386,1020029,1,7,4,1,0,59
93387,1020029,1,7,5,1,0,60
93388,1020029,1,7,6,1,0,61
93389,1020029,1,8,1,2,0,63
93390,1020029,1,8,2,1,0,64
93391,1020029,1,8,3,1,0,65
93392,1020029,1,8,4,4,0,69
93393,1020029,1,8,5,1,0,70
93394,1020029,1,8,6,1,0,71
93395,1020029,1,9,1,1,0,72
93396,1020029,1,9,2,1,0,73
93397,1020029,1,9,3,6,0,79
93398,1020029,1,9,4,1,0,80
93399,1020029,1,9,5,1,0,81
93400,1020029,1,9,6,6,0,87
93401,1020029,1,10,1,4,0,91
93402,1020029,1,10,2,0,0,91
93403,1020029,1,10,3,6,0,97
93404,1020029,1,10,4,1,0,98
93405,1020029,1,10,5,0,0,98
93406,1020029,1,10,6,0,0,98
93407,1020029,1,11,1,1,0,99
93408,1020029,1,11,2,0,0,99
93409,1020029,1,11,3,1,0,100
93410,1020029,1,11,4,1,0,101
93411,1020029,1,11,5,1,0,102
93412,1020029,1,11,6,0,0,102
93413,1020029,1,12,1,0,1,102
93414,1020029,1,12,2,1,0,103
93415,1020029,1,12,3,1,0,104
93416,1020029,1,12,4,1,0,105
93417,1020029,1,12,5,1,0,106
93418,1020029,1,12,6,1,0,107
93419,1020029,1,13,1,0,0,107
93420,1020029,1,13,2,1,0,108
93421,1020029,1,13,3,4,0,112
93422,1020029,1,13,4,1,0,113
93423,1020029,1,13,5,4,0,117
93424,1020029,1,13,6,1,0,118
93425,1020029,1,14,1,0,0,118
93426,1020029,1,14,2,4,0,122
93427,1020029,1,14,3,1,0,123
93428,1020029,1,14,4,0,1,123
93429,1020029,1,14,5,4,0,127
93430,1020029,1,14,6,0,0,127
93431,1020029,1,15,1,2,0,129
93432,1020029,1,15,2,6,0,135
93433,1020029,1,15,3,1,0,136
93434,1020029,1,15,4,1,0,137
93435,1020029,1,15,5,1,0,138
93436,1020029,1,15,6,1,0,139
93437,1020029,1,16,1,0,0,139
93438,1020029,1,16,2,6,0,145
93439,1020029,1,16,3,0,1,145
93440,1020029,1,16,4,1,0,146
93441,1020029,1,16,5,0,0,146
93442,1020029,1,16,6,0,0,146
93443,1020029,1,17,1,0,0,146
93444,1020029,1,17,2,1,0,147
93445,1020029,1,17,3,1,0,148
93446,1020029,1,17,4,4,0,152
93447,1020029,1,17,5,4,0,156
93448,1020029,1,17,6,1,0,157
93449,1020029,1,18,1,0,0,157
93450,1020029,1,18,2,6,0,163
93451,1020029,1,18,3,1,0,164
93452,1020029,1,18,4,0,0,164
93453,1020029,1,18,5,6,0,170
93454,1020029,1,18,6,1,0,171
93455,1020029,1,19,1,0,1,171
93456,1020029,1,19,2,1,0,172
93457,1020029,1,19,3,0,0,172
93458,1020029,1,19,4,1,0,173
93459,1020029,1,19,5,0,0,173
93460,1020029,1,19,6,0,0,173
93461,1020029,1,20,1,6,0,179
93462,1020029,1,20,2,0,0,179
93463,1020029,1,20,3,0,0,179
93464,1020029,1,20,4,2,0,181
93465,1020029,1,20,5,0,1,181
93466,1020029,1,20,6,4,0,185
93556,1031431,1,1,1,0,1,0
93557,1031431,1,1,2,2,0,2
93558,1031431,1,1,3,3,0,5
93559,1031431,1,1,4,2,0,7
93560,1031431,1,1,5,0,0,7
93561,1031431,1,1,6,0,0,7
93562,1031431,1,2,1,0,1,7
93563,1031431,1,2,2,1,0,8
93564,1031431,1,2,3,4,0,12
93565,1031431,1,2,4,0,0,12
93566,1031431,1,2,5,2,0,14
93567,1031431,1,2,6,4,0,18
93568,1031431,1,3,1,6,0,24
93569,1031431,1,3,2,0,0,24
93570,1031431,1,3,3,1,0,25
93571,1031431,1,3,4,0,0,25
93572,1031431,1,3,5,1,0,26
93573,1031431,1,3,6,0,0,26
93574,1031431,1,4,1,1,0,27
93575,1031431,1,4,2,1,0,28
93576,1031431,1,4,3,0,0,28
93577,1031431,1,4,4,0,0,28
93578,1031431,1,4,5,0,0,28
93579,1031431,1,4,6,4,0,32
93580,1031431,1,5,1,0,1,32
93581,1031431,1,5,2,0,0,32
93582,1031431,1,5,3,0,0,32
93583,1031431,1,5,4,1,0,33
93584,1031431,1,5,5,0,0,33
93585,1031431,1,5,6,0,0,33
93586,1031431,1,6,1,4,0,37
93587,1031431,1,6,2,1,0,38
93588,1031431,1,6,3,1,0,39
93589,1031431,1,6,4,2,0,41
93590,1031431,1,6,5,1,0,42
93591,1031431,1,6,6,1,0,43
93592,1031431,1,7,1,0,0,43
93593,1031431,1,7,2,1,0,44
93594,1031431,1,7,3,0,0,44
93595,1031431,1,7,4,1,0,45
93596,1031431,1,7,5,1,0,46
93597,1031431,1,7,6,1,0,47
93598,1031431,1,8,1,0,0,47
93599,1031431,1,8,2,0,0,47
93600,1031431,1,8,3,4,0,51
93601,1031431,1,8,4,1,0,52
93602,1031431,1,8,5,1,0,53
93603,1031431,1,8,6,0,0,53
93604,1031431,1,9,1,1,0,54
93605,1031431,1,9,2,0,0,54
93606,1031431,1,9,3,1,0,55
93607,1031431,1,9,4,0,0,55
93608,1031431,1,9,5,0,0,55
93609,1031431,1,9,6,0,0,55
93610,1031431,1,10,1,1,0,56
93611,1031431,1,10,2,1,0,57
93612,1031431,1,10,3,2,0,59
93613,1031431,1,10,4,1,0,60
93614,1031431,1,10,5,1,0,61
93615,1031431,1,10,6,1,0,62
93616,1031431,1,11,1,1,0,63
93617,1031431,1,11,2,2,0,65
93618,1031431,1,11,3,0,0,65
93619,1031431,1,11,4,1,0,66
93620,1031431,1,11,5,1,0,67
93621,1031431,1,11,6,1,0,68
93622,1031431,1,12,1,0,0,68
93623,1031431,1,12,2,1,0,69
93624,1031431,1,12,3,1,0,70
93625,1031431,1,12,4,2,0,72
93626,1031431,1,12,5,1,0,73
93627,1031431,1,12,6,0,0,73
93628,1031431,1,13,1,2,0,75
93629,1031431,1,13,2,0,0,75
93630,1031431,1,13,3,1,0,76
93631,1031431,1,13,4,1,0,77
93632,1031431,1,13,5,1,0,78
93633,1031431,1,13,6,0,0,78
93634,1031431,1,14,1,0,0,78
93635,1031431,1,14,2,1,0,79
93636,1031431,1,14,3,0,0,79
93637,1031431,1,14,4,1,0,80
93638,1031431,1,14,5,0,0,80
93639,1031431,1,14,6,4,0,84
93640,1031431,1,15,1,2,0,86
93641,1031431,1,15,2,0,0,86
93642,1031431,1,15,3,4,0,90
93643,1031431,1,15,4,1,0,91
93644,1031431,1,15,5,1,0,92
93645,1031431,1,15,6,1,0,93
93646,1031431,1,16,1,0,0,93
93647,1031431,1,16,2,1,0,94
93648,1031431,1,16,3,1,0,95
93649,1031431,1,16,4,0,0,95
93650,1031431,1,16,5,6,0,101
93651,1031431,1,16,6,1,0,102
93652,1031431,1,17,1,1,0,103
93653,1031431,1,17,2,1,0,104
93654,1031431,1,17,3,0,0,104
93655,1031431,1,17,4,1,0,105
93656,1031431,1,17,5,6,0,111
93657,1031431,1,17,6,1,0,112
93658,1031431,1,18,1,0,0,112
93659,1031431,1,18,2,1,0,113
93660,1031431,1,18,3,1,0,114
93661,1031431,1,18,4,1,0,115
93662,1031431,1,18,5,0,0,115
93663,1031431,1,18,6,1,0,116
93664,1031431,1,19,1,2,0,118
93665,1031431,1,19,2,4,0,122
93666,1031431,1,19,3,6,0,128
93667,1031431,1,19,4,2,0,130
93668,1031431,1,19,5,1,0,131
93669,1031431,1,19,6,0,0,131
93670,1031431,1,20,1,1,0,132
93671,1031431,1,20,2,6,0,138
93672,1031431,1,20,3,0,0,138
93673,1031431,1,20,4,2,0,140
93674,1031431,1,20,5,1,0,141
93675,1031431,1,20,6,1,0,142
93763,1031433,1,1,1,0,0,0
93764,1031433,1,1,2,4,0,4
93765,1031433,1,1,3,0,0,4
93766,1031433,1,1,4,0,0,4
93767,1031433,1,1,5,4,0,8
93768,1031433,1,1,6,0,0,8
93769,1031433,1,2,1,0,0,8
93770,1031433,1,2,2,3,0,11
93771,1031433,1,2,3,1,0,12
93772,1031433,1,2,4,0,0,12
93773,1031433,1,2,5,1,0,13
93774,1031433,1,2,6,7,0,20
93775,1031433,1,3,1,0,0,20
93776,1031433,1,3,2,1,0,21
93777,1031433,1,3,3,0,0,21
93778,1031433,1,3,4,0,0,21
93779,1031433,1,3,5,1,0,22
93780,1031433,1,3,6,1,0,23
93781,1031433,1,4,1,2,0,25
93782,1031433,1,4,2,0,1,25
93783,1031433,1,4,3,1,0,26
93784,1031433,1,4,4,0,0,26
93785,1031433,1,4,5,0,0,26
93786,1031433,1,4,6,1,0,27
93787,1031433,1,5,1,0,0,27
93788,1031433,1,5,2,1,0,28
93789,1031433,1,5,3,0,0,28
93790,1031433,1,5,4,0,0,28
93791,1031433,1,5,5,1,0,29
93792,1031433,1,5,6,1,0,30
93793,1031433,1,6,1,4,0,34
93794,1031433,1,6,2,0,0,34
93795,1031433,1,6,3,1,0,35
93796,1031433,1,6,4,6,0,41
93797,1031433,1,6,5,4,0,45
93798,1031433,1,6,6,0,0,45
93799,1031433,1,7,1,1,0,46
93800,1031433,1,7,2,1,0,47
93801,1031433,1,7,3,6,0,53
93802,1031433,1,7,4,0,0,53
93803,1031433,1,7,5,1,0,54
93804,1031433,1,7,6,1,0,55
93805,1031433,1,8,1,0,0,55
93806,1031433,1,8,2,1,0,56
93807,1031433,1,8,3,1,0,57
93808,1031433,1,8,4,0,1,57
93809,1031433,1,8,5,2,0,59
93810,1031433,1,8,6,1,0,60
93811,1031433,1,9,1,1,0,61
93812,1031433,1,9,2,0,0,61
93813,1031433,1,9,3,1,0,62
93814,1031433,1,9,4,0,0,62
93815,1031433,1,9,5,1,0,63
93816,1031433,1,9,6,0,0,63
93817,1031433,1,10,1,4,0,67
93818,1031433,1,10,2,4,0,71
93819,1031433,1,10,3,1,0,72
93820,1031433,1,10,4,2,0,74
93821,1031433,1,10,5,4,0,78
93822,1031433,1,10,6,6,0,84
93823,1031433,1,11,1,0,0,84
93824,1031433,1,11,2,4,0,88
93825,1031433,1,11,3,6,0,94
93826,1031433,1,11,4,1,0,95
93827,1031433,1,11,5,1,0,96
93828,1031433,1,11,6,0,1,96
93829,1031433,1,12,1,1,0,97
93830,1031433,1,12,2,1,0,98
93831,1031433,1,12,3,1,0,99
93832,1031433,1,12,4,0,0,99
93833,1031433,1,12,5,0,0,99
93834,1031433,1,12,6,1,0,100
93835,1031433,1,13,1,1,0,101
93836,1031433,1,13,2,6,0,107
93837,1031433,1,13,3,1,0,108
93838,1031433,1,13,4,2,0,110
93839,1031433,1,13,5,2,0,112
93840,1031433,1,13,6,1,0,113
93841,1031433,1,14,1,0,0,113
93842,1031433,1,14,2,0,1,113
93843,1031433,1,14,3,1,0,114
93844,1031433,1,14,4,2,0,116
93845,1031433,1,14,5,4,0,120
93846,1031433,1,14,6,0,0,120
93847,1031433,1,15,1,1,0,121
93848,1031433,1,15,2,6,0,127
93849,1031433,1,15,3,0,1,127
93850,1031433,1,15,4,1,0,128
93851,1031433,1,15,5,1,0,129
93852,1031433,1,15,6,1,0,130
93853,1031433,1,16,1,1,0,131
93854,1031433,1,16,2,1,0,132
93855,1031433,1,16,3,1,0,133
93856,1031433,1,16,4,2,0,135
93857,1031433,1,16,5,1,0,136
93858,1031433,1,16,6,0,0,136
93859,1031433,1,17,1,0,0,136
93860,1031433,1,17,2,1,0,137
93861,1031433,1,17,3,1,0,138
93862,1031433,1,17,4,1,0,139
93863,1031433,1,17,5,4,0,143
93864,1031433,1,17,6,1,0,144
93865,1031433,1,18,1,4,0,148
93866,1031433,1,18,2,1,0,149
93867,1031433,1,18,3,4,0,153
93868,1031433,1,18,4,0,0,153
93869,1031433,1,18,5,2,0,155
93870,1031433,1,18,6,1,0,156
93871,1031433,1,19,1,1,0,157
93872,1031433,1,19,2,0,1,157
93873,1031433,1,19,3,6,0,163
93874,1031433,1,19,4,1,0,164
93875,1031433,1,19,5,0,1,164
93876,1031433,1,19,6,0,0,164
93877,1031433,1,20,1,0,0,164
93878,1031433,1,20,2,6,0,170
93879,1031433,1,20,3,0,0,170
93880,1031433,1,20,4,0,0,170
93881,1031433,1,20,5,0,1,170
93882,1031433,1,20,6,4,0,174
94003,1031435,1,1,1,0,0,0
94004,1031435,1,1,2,0,0,0
94005,1031435,1,1,3,2,0,2
94006,1031435,1,1,4,0,0,2
94007,1031435,1,1,5,0,0,2
94008,1031435,1,1,6,2,0,4
94009,1031435,1,2,1,0,0,4
94010,1031435,1,2,2,0,0,4
94011,1031435,1,2,3,4,0,8
94012,1031435,1,2,4,1,0,9
94013,1031435,1,2,5,4,0,13
94014,1031435,1,2,6,0,1,13
94015,1031435,1,3,1,1,0,14
94016,1031435,1,3,2,0,0,14
94017,1031435,1,3,3,6,0,20
94018,1031435,1,3,4,1,0,21
94019,1031435,1,3,5,0,0,21
94020,1031435,1,3,6,0,0,21
94021,1031435,1,4,1,2,0,23
94022,1031435,1,4,2,0,0,23
94023,1031435,1,4,3,2,0,25
94024,1031435,1,4,4,0,0,25
94025,1031435,1,4,5,0,0,25
94026,1031435,1,4,6,1,0,26
94027,1031435,1,5,1,4,0,30
94028,1031435,1,5,2,1,0,31
94029,1031435,1,5,3,1,0,32
94030,1031435,1,5,4,4,0,36
94031,1031435,1,5,5,1,0,37
94032,1031435,1,5,6,2,0,39
94033,1031435,1,6,1,1,0,40
94034,1031435,1,6,2,1,0,41
94035,1031435,1,6,3,0,0,41
94036,1031435,1,6,4,0,0,41
94037,1031435,1,6,5,1,0,42
94038,1031435,1,6,6,4,0,46
94039,1031435,1,7,1,1,0,47
94040,1031435,1,7,2,0,0,47
94041,1031435,1,7,3,0,0,47
94042,1031435,1,7,4,2,0,49
94043,1031435,1,7,5,1,0,50
94044,1031435,1,7,6,4,0,54
94045,1031435,1,8,1,1,0,55
94046,1031435,1,8,2,4,0,59
94047,1031435,1,8,3,0,0,59
94048,1031435,1,8,4,4,0,63
94049,1031435,1,8,5,1,0,64
94050,1031435,1,8,6,1,0,65
94051,1031435,1,9,1,1,0,66
94052,1031435,1,9,2,0,0,66
94053,1031435,1,9,3,0,0,66
94054,1031435,1,9,4,6,0,72
94055,1031435,1,9,5,1,0,73
94056,1031435,1,9,6,0,0,73
94057,1031435,1,10,1,6,0,79
94058,1031435,1,10,2,1,0,80
94059,1031435,1,10,3,0,0,80
94060,1031435,1,10,4,0,0,80
94061,1031435,1,10,5,4,0,84
94062,1031435,1,10,6,4,0,88
94063,1031435,1,11,1,1,0,89
94064,1031435,1,11,2,1,0,90
94065,1031435,1,11,3,4,0,94
94066,1031435,1,11,4,1,0,95
94067,1031435,1,11,5,0,0,95
94068,1031435,1,11,6,4,0,99
94069,1031435,1,12,1,1,0,100
94070,1031435,1,12,2,1,0,101
94071,1031435,1,12,3,6,0,107
94072,1031435,1,12,4,1,0,108
94073,1031435,1,12,5,4,0,112
94074,1031435,1,12,6,4,0,116
94075,1031435,1,13,1,1,0,117
94076,1031435,1,13,2,1,0,118
94077,1031435,1,13,3,0,1,118
94078,1031435,1,13,4,3,0,121
94079,1031435,1,13,5,1,0,122
94080,1031435,1,13,6,1,0,123
94081,1031435,1,14,1,4,0,127
94082,1031435,1,14,2,0,0,127
94083,1031435,1,14,3,0,1,127
94084,1031435,1,14,4,4,0,131
94085,1031435,1,14,5,1,0,132
94086,1031435,1,14,6,2,0,134
94087,1031435,1,15,1,1,0,135
94088,1031435,1,15,2,1,0,136
94089,1031435,1,15,3,1,0,137
94090,1031435,1,15,4,1,0,138
94091,1031435,1,15,5,0,0,138
94092,1031435,1,15,6,1,0,139
94093,1031435,1,16,1,4,0,143
94094,1031435,1,16,2,0,0,143
94095,1031435,1,16,3,2,0,145
94096,1031435,1,16,4,2,0,147
94097,1031435,1,16,5,1,0,148
94098,1031435,1,16,6,1,0,149
94099,1031435,1,17,1,0,0,149
94100,1031435,1,17,2,0,0,149
94101,1031435,1,17,3,1,0,150
94102,1031435,1,17,4,6,0,156
94103,1031435,1,17,5,4,0,160
94104,1031435,1,17,6,0,0,160
94105,1031435,1,18,1,0,0,160
94106,1031435,1,18,2,6,0,166
94107,1031435,1,18,3,0,0,166
94108,1031435,1,18,4,0,1,166
94109,1031435,1,18,5,0,1,166
94110,1031435,1,18,6,0,0,166
94111,1031435,1,19,1,2,0,168
94112,1031435,1,19,2,2,0,170
94113,1031435,1,19,3,2,0,172
94114,1031435,1,19,4,6,0,178
94115,1031435,1,19,5,1,0,179
94116,1031435,1,19,6,0,1,179
94117,1031435,1,20,1,1,0,180
94118,1031435,1,20,2,0,0,180
94119,1031435,1,20,3,0,1,180
94120,1031435,1,20,4,0,1,180
94121,1031435,1,20,5,0,0,180
94122,1031435,1,20,6,1,0,181
94243,1031665,1,1,1,4,0,4
94244,1031665,1,1,2,0,0,4
94245,1031665,1,1,3,1,0,5
94246,1031665,1,1,4,1,0,6
94247,1031665,1,1,5,1,0,7
94248,1031665,1,1,6,0,0,7
94249,1031665,1,2,1,0,0,7
94250,1031665,1,2,2,0,0,7
94251,1031665,1,2,3,0,0,7
94252,1031665,1,2,4,4,0,11
94253,1031665,1,2,5,0,0,11
94254,1031665,1,2,6,0,0,11
94255,1031665,1,3,1,0,0,11
94256,1031665,1,3,2,0,0,11
94257,1031665,1,3,3,6,0,17
94258,1031665,1,3,4,6,0,23
94259,1031665,1,3,5,0,0,23
94260,1031665,1,3,6,1,0,24
94261,1031665,1,4,1,0,0,24
94262,1031665,1,4,2,6,0,30
94263,1031665,1,4,3,0,0,30
94264,1031665,1,4,4,4,0,34
94265,1031665,1,4,5,1,0,35
94266,1031665,1,4,6,4,0,39
94267,1031665,1,5,1,1,0,40
94268,1031665,1,5,2,4,0,44
94269,1031665,1,5,3,1,0,45
94270,1031665,1,5,4,4,0,49
94271,1031665,1,5,5,0,0,49
94272,1031665,1,5,6,6,0,55
94273,1031665,1,6,1,6,0,61
94274,1031665,1,6,2,4,0,65
94275,1031665,1,6,3,6,0,71
94276,1031665,1,6,4,0,0,71
94277,1031665,1,6,5,1,0,72
94278,1031665,1,6,6,0,0,72
94279,1031665,1,7,1,4,0,76
94280,1031665,1,7,2,1,0,77
94281,1031665,1,7,3,0,1,77
94282,1031665,1,7,4,1,0,78
94283,1031665,1,7,5,0,0,78
94284,1031665,1,7,6,2,0,80
94285,1031665,1,8,1,0,0,80
94286,1031665,1,8,2,1,0,81
94287,1031665,1,8,3,4,0,85
94288,1031665,1,8,4,1,0,86
94289,1031665,1,8,5,1,0,87
94290,1031665,1,8,6,6,0,93
94291,1031665,1,9,1,0,0,93
94292,1031665,1,9,2,0,0,93
94293,1031665,1,9,3,0,0,93
94294,1031665,1,9,4,4,0,97
94295,1031665,1,9,5,1,0,98
94296,1031665,1,9,6,1,0,99
94297,1031665,1,10,1,0,0,99
94298,1031665,1,10,2,2,0,101
94299,1031665,1,10,3,1,0,102
94300,1031665,1,10,4,1,0,103
94301,1031665,1,10,5,1,0,104
94302,1031665,1,10,6,2,0,106
94303,1031665,1,11,1,0,1,106
94304,1031665,1,11,2,2,0,108
94305,1031665,1,11,3,6,0,114
94306,1031665,1,11,4,1,0,115
94307,1031665,1,11,5,0,1,115
94308,1031665,1,11,6,1,0,116
94309,1031665,1,12,1,0,0,116
94310,1031665,1,12,2,4,0,120
94311,1031665,1,12,3,1,0,121
94312,1031665,1,12,4,1,0,122
94313,1031665,1,12,5,0,0,122
94314,1031665,1,12,6,0,0,122
94315,1031665,1,13,1,1,0,123
94316,1031665,1,13,2,0,1,123
94317,1031665,1,13,3,0,0,123
94318,1031665,1,13,4,0,0,123
94319,1031665,1,13,5,1,0,124
94320,1031665,1,13,6,1,0,125
94321,1031665,1,14,1,1,0,126
94322,1031665,1,14,2,0,0,126
94323,1031665,1,14,3,1,0,127
94324,1031665,1,14,4,0,1,127
94325,1031665,1,14,5,1,0,128
94326,1031665,1,14,6,0,0,128
94327,1031665,1,15,1,2,0,130
94328,1031665,1,15,2,4,0,134
94329,1031665,1,15,3,1,0,135
94330,1031665,1,15,4,1,0,136
94331,1031665,1,15,5,1,0,137
94332,1031665,1,15,6,1,0,138
94333,1031665,1,16,1,0,1,138
94334,1031665,1,16,2,1,0,139
94335,1031665,1,16,3,1,0,140
94336,1031665,1,16,4,1,0,141
94337,1031665,1,16,5,1,0,142
94338,1031665,1,16,6,0,1,142
94339,1031665,1,17,1,1,0,143
94340,1031665,1,17,2,0,0,143
94341,1031665,1,17,3,1,0,144
94342,1031665,1,17,4,1,0,145
94343,1031665,1,17,5,1,0,146
94344,1031665,1,17,6,1,0,147
94345,1031665,1,18,1,2,0,149
94346,1031665,1,18,2,1,0,150
94347,1031665,1,18,3,6,0,156
94348,1031665,1,18,4,1,0,157
94349,1031665,1,18,5,0,0,157
94350,1031665,1,18,6,1,0,158
94351,1031665,1,19,1,1,0,159
94352,1031665,1,19,2,6,0,165
94353,1031665,1,19,3,0,1,165
94354,1031665,1,19,4,1,0,166
94355,1031665,1,19,5,1,0,167
94356,1031665,1,19,6,0,0,167
94357,1031665,1,20,1,0,0,167
94358,1031665,1,20,2,0,1,167
94359,1031665,1,20,3,1,0,168
94360,1031665,1,20,4,6,0,174
94361,1031665,1,20,5,1,0,175
94362,1031665,1,20,6,1,0,176
94480,1034825,1,1,1,0,0,0
94481,1034825,1,1,2,0,0,0
94482,1034825,1,1,3,4,0,4
94483,1034825,1,1,4,1,0,5
94484,1034825,1,1,5,0,0,5
94485,1034825,1,1,6,4,0,9
94486,1034825,1,2,1,1,0,10
94487,1034825,1,2,2,0,0,10
94488,1034825,1,2,3,1,0,11
94489,1034825,1,2,4,4,0,15
94490,1034825,1,2,5,0,0,15
94491,1034825,1,2,6,1,0,16
94492,1034825,1,3,1,1,0,17
94493,1034825,1,3,2,0,0,17
94494,1034825,1,3,3,2,0,19
94495,1034825,1,3,4,2,0,21
94496,1034825,1,3,5,1,0,22
94497,1034825,1,3,6,0,0,22
94498,1034825,1,4,1,4,0,26
94499,1034825,1,4,2,4,0,30
94500,1034825,1,4,3,0,0,30
94501,1034825,1,4,4,1,0,31
94502,1034825,1,4,5,1,0,32
94503,1034825,1,4,6,1,0,33
94504,1034825,1,5,1,1,0,34
94505,1034825,1,5,2,0,0,34
94506,1034825,1,5,3,0,1,34
94507,1034825,1,5,4,0,0,34
94508,1034825,1,5,5,1,0,35
94509,1034825,1,5,6,1,0,36
94510,1034825,1,6,1,1,0,37
94511,1034825,1,6,2,0,0,37
94512,1034825,1,6,3,4,0,41
94513,1034825,1,6,4,1,0,42
94514,1034825,1,6,5,1,0,43
94515,1034825,1,6,6,4,0,47
94516,1034825,1,7,1,1,0,48
94517,1034825,1,7,2,2,0,50
94518,1034825,1,7,3,2,0,52
94519,1034825,1,7,4,1,0,53
94520,1034825,1,7,5,1,0,54
94521,1034825,1,7,6,1,0,55
94522,1034825,1,8,1,0,1,55
94523,1034825,1,8,2,0,0,55
94524,1034825,1,8,3,0,0,55
94525,1034825,1,8,4,1,0,56
94526,1034825,1,8,5,1,0,57
94527,1034825,1,8,6,1,0,58
94528,1034825,1,9,1,1,0,59
94529,1034825,1,9,2,2,0,61
94530,1034825,1,9,3,0,0,61
94531,1034825,1,9,4,0,0,61
94532,1034825,1,9,5,3,0,64
94533,1034825,1,9,6,4,0,68
94534,1034825,1,10,1,1,0,69
94535,1034825,1,10,2,0,0,69
94536,1034825,1,10,3,1,0,70
94537,1034825,1,10,4,0,0,70
94538,1034825,1,10,5,4,0,74
94539,1034825,1,10,6,1,0,75
94540,1034825,1,11,1,0,1,75
94541,1034825,1,11,2,0,0,75
94542,1034825,1,11,3,1,0,76
94543,1034825,1,11,4,1,0,77
94544,1034825,1,11,5,4,0,81
94545,1034825,1,11,6,1,0,82
94546,1034825,1,12,1,1,0,83
94547,1034825,1,12,2,2,0,85
94548,1034825,1,12,3,1,0,86
94549,1034825,1,12,4,0,0,86
94550,1034825,1,12,5,1,0,87
94551,1034825,1,12,6,1,0,88
94552,1034825,1,13,1,1,0,89
94553,1034825,1,13,2,6,0,95
94554,1034825,1,13,3,0,1,95
94555,1034825,1,13,4,2,0,97
94556,1034825,1,13,5,0,0,97
94557,1034825,1,13,6,1,0,98
94558,1034825,1,14,1,0,0,98
94559,1034825,1,14,2,0,1,98
94560,1034825,1,14,3,0,0,98
94561,1034825,1,14,4,3,0,101
94562,1034825,1,14,5,1,0,102
94563,1034825,1,14,6,1,0,103
94564,1034825,1,15,1,0,0,103
94565,1034825,1,15,2,0,0,103
94566,1034825,1,15,3,0,0,103
94567,1034825,1,15,4,2,0,105
94568,1034825,1,15,5,1,0,106
94569,1034825,1,15,6,0,0,106
94570,1034825,1,16,1,2,0,108
94571,1034825,1,16,2,4,0,112
94572,1034825,1,16,3,2,0,114
94573,1034825,1,16,4,0,0,114
94574,1034825,1,16,5,2,0,116
94575,1034825,1,16,6,1,0,117
94576,1034825,1,17,1,1,0,118
94577,1034825,1,17,2,0,1,118
94578,1034825,1,17,3,1,0,119
94579,1034825,1,17,4,1,0,120
94580,1034825,1,17,5,1,0,121
94581,1034825,1,17,6,1,0,122
94582,1034825,1,18,1,1,0,123
94583,1034825,1,18,2,2,0,125
94584,1034825,1,18,3,0,0,125
94585,1034825,1,18,4,1,0,126
94586,1034825,1,18,5,1,0,127
94587,1034825,1,18,6,1,0,128
94588,1034825,1,19,1,1,0,129
94589,1034825,1,19,2,1,0,130
94590,1034825,1,19,3,2,0,132
94591,1034825,1,19,4,1,0,133
94592,1034825,1,19,5,1,0,134
94593,1034825,1,19,6,1,0,135
94594,1034825,1,20,1,2,0,137
94595,1034825,1,20,2,4,0,141
94596,1034825,1,20,3,4,0,145
94597,1034825,1,20,4,0,1,145
94598,1034825,1,20,5,0,0,145
94599,1034825,1,20,6,2,0,147
94709,1034827,1,1,1,1,0,1
94710,1034827,1,1,2,2,0,3
94711,1034827,1,1,3,0,0,3
94712,1034827,1,1,4,0,0,3
94713,1034827,1,1,5,1,0,4
94714,1034827,1,1,6,1,0,5
94715,1034827,1,2,1,0,0,5
94716,1034827,1,2,2,0,0,5
94717,1034827,1,2,3,4,0,9
94718,1034827,1,2,4,1,0,10
94719,1034827,1,2,5,0,0,10
94720,1034827,1,2,6,0,0,10
94721,1034827,1,3,1,0,0,10
94722,1034827,1,3,2,0,0,10
94723,1034827,1,3,3,1,0,11
94724,1034827,1,3,4,2,0,13
94725,1034827,1,3,5,2,0,15
94726,1034827,1,3,6,0,0,15
94727,1034827,1,4,1,0,0,15
94728,1034827,1,4,2,6,0,21
94729,1034827,1,4,3,4,0,25
94730,1034827,1,4,4,2,0,27
94731,1034827,1,4,5,1,0,28
94732,1034827,1,4,6,2,0,30
94733,1034827,1,5,1,0,1,30
94734,1034827,1,5,2,4,0,34
94735,1034827,1,5,3,1,0,35
94736,1034827,1,5,4,0,0,35
94737,1034827,1,5,5,1,0,36
94738,1034827,1,5,6,1,0,37
94739,1034827,1,6,1,2,0,39
94740,1034827,1,6,2,0,0,39
94741,1034827,1,6,3,1,0,40
94742,1034827,1,6,4,4,0,44
94743,1034827,1,6,5,1,0,45
94744,1034827,1,6,6,1,0,46
94745,1034827,1,7,1,1,0,47
94746,1034827,1,7,2,1,0,48
94747,1034827,1,7,3,1,0,49
94748,1034827,1,7,4,3,0,52
94749,1034827,1,7,5,2,0,54
94750,1034827,1,7,6,0,0,54
94751,1034827,1,8,1,1,0,55
94752,1034827,1,8,2,0,0,55
94753,1034827,1,8,3,1,0,56
94754,1034827,1,8,4,0,1,56
94755,1034827,1,8,5,0,0,56
94756,1034827,1,8,6,0,0,56
94757,1034827,1,9,1,0,0,56
94758,1034827,1,9,2,1,0,57
94759,1034827,1,9,3,0,0,57
94760,1034827,1,9,4,0,0,57
94761,1034827,1,9,5,0,0,57
94762,1034827,1,9,6,0,0,57
94763,1034827,1,10,1,1,0,58
94764,1034827,1,10,2,1,0,59
94765,1034827,1,10,3,6,0,65
94766,1034827,1,10,4,1,0,66
94767,1034827,1,10,5,0,0,66
94768,1034827,1,10,6,1,0,67
94769,1034827,1,11,1,0,0,67
94770,1034827,1,11,2,2,0,69
94771,1034827,1,11,3,0,1,69
94772,1034827,1,11,4,1,0,70
94773,1034827,1,11,5,1,0,71
94774,1034827,1,11,6,1,0,72
94775,1034827,1,12,1,1,0,73
94776,1034827,1,12,2,6,0,79
94777,1034827,1,12,3,2,0,81
94778,1034827,1,12,4,1,0,82
94779,1034827,1,12,5,1,0,83
94780,1034827,1,12,6,4,0,87
94781,1034827,1,13,1,1,0,88
94782,1034827,1,13,2,1,0,89
94783,1034827,1,13,3,1,0,90
94784,1034827,1,13,4,1,0,91
94785,1034827,1,13,5,1,0,92
94786,1034827,1,13,6,1,0,93
94787,1034827,1,14,1,4,0,97
94788,1034827,1,14,2,1,0,98
94789,1034827,1,14,3,1,0,99
94790,1034827,1,14,4,4,0,103
94791,1034827,1,14,5,1,0,104
94792,1034827,1,14,6,1,0,105
94793,1034827,1,15,1,0,0,105
94794,1034827,1,15,2,1,0,106
94795,1034827,1,15,3,0,0,106
94796,1034827,1,15,4,1,0,107
94797,1034827,1,15,5,0,0,107
94798,1034827,1,15,6,1,0,108
94799,1034827,1,16,1,1,0,109
94800,1034827,1,16,2,1,0,110
94801,1034827,1,16,3,1,0,111
94802,1034827,1,16,4,1,0,112
94803,1034827,1,16,5,1,0,113
94804,1034827,1,16,6,1,0,114
94805,1034827,1,17,1,1,0,115
94806,1034827,1,17,2,1,0,116
94807,1034827,1,17,3,1,0,117
94808,1034827,1,17,4,2,0,119
94809,1034827,1,17,5,1,0,120
94810,1034827,1,17,6,4,0,124
94811,1034827,1,18,1,1,0,125
94812,1034827,1,18,2,0,1,125
94813,1034827,1,18,3,1,0,126
94814,1034827,1,18,4,1,0,127
94815,1034827,1,18,5,1,0,128
94816,1034827,1,18,6,1,0,129
94817,1034827,1,19,1,1,0,130
94818,1034827,1,19,2,1,0,131
94819,1034827,1,19,3,6,0,137
94820,1034827,1,19,4,2,0,139
94821,1034827,1,19,5,0,1,139
94822,1034827,1,19,6,0,0,139
94823,1034827,1,20,1,1,0,140
94824,1034827,1,20,2,2,0,142
94825,1034827,1,20,3,1,1,143
94826,1034827,1,20,4,0,0,143
94827,1034827,1,20,5,1,1,144
94828,1034827,1,20,6,0,1,144
94949,1034829,1,1,1,0,0,0
94950,1034829,1,1,2,2,0,2
94951,1034829,1,1,3,0,0,2
94952,1034829,1,1,4,0,0,2
94953,1034829,1,1,5,1,0,3
94954,1034829,1,1,6,1,0,4
94955,1034829,1,2,1,0,1,4
94956,1034829,1,2,2,2,0,6
94957,1034829,1,2,3,0,0,6
94958,1034829,1,2,4,0,0,6
94959,1034829,1,2,5,1,0,7
94960,1034829,1,2,6,1,0,8
94961,1034829,1,3,1,0,0,8
94962,1034829,1,3,2,1,0,9
94963,1034829,1,3,3,1,0,10
94964,1034829,1,3,4,0,0,10
94965,1034829,1,3,5,1,0,11
94966,1034829,1,3,6,6,0,17
94967,1034829,1,4,1,4,0,21
94968,1034829,1,4,2,4,0,25
94969,1034829,1,4,3,1,0,26
94970,1034829,1,4,4,1,0,27
94971,1034829,1,4,5,1,0,28
94972,1034829,1,4,6,1,0,29
94973,1034829,1,5,1,2,0,31
94974,1034829,1,5,2,1,0,32
94975,1034829,1,5,3,1,0,33
94976,1034829,1,5,4,1,0,34
94977,1034829,1,5,5,4,0,38
94978,1034829,1,5,6,1,0,39
94979,1034829,1,6,1,1,0,40
94980,1034829,1,6,2,6,0,46
94981,1034829,1,6,3,0,0,46
94982,1034829,1,6,4,0,0,46
94983,1034829,1,6,5,6,0,52
94984,1034829,1,6,6,1,0,53
94985,1034829,1,7,1,0,0,53
94986,1034829,1,7,2,1,0,54
94987,1034829,1,7,3,6,0,60
94988,1034829,1,7,4,2,0,62
94989,1034829,1,7,5,1,0,63
94990,1034829,1,7,6,1,0,64
94991,1034829,1,8,1,1,0,65
94992,1034829,1,8,2,0,1,65
94993,1034829,1,8,3,1,0,66
94994,1034829,1,8,4,1,0,67
94995,1034829,1,8,5,0,0,67
94996,1034829,1,8,6,0,0,67
94997,1034829,1,9,1,1,0,68
94998,1034829,1,9,2,1,0,69
94999,1034829,1,9,3,0,0,69
95000,1034829,1,9,4,0,0,69
95001,1034829,1,9,5,0,0,69
95002,1034829,1,9,6,1,0,70
95003,1034829,1,10,1,1,0,71
95004,1034829,1,10,2,1,0,72
95005,1034829,1,10,3,4,0,76
95006,1034829,1,10,4,2,0,78
95007,1034829,1,10,5,0,0,78
95008,1034829,1,10,6,0,0,78
95009,1034829,1,11,1,1,0,79
95010,1034829,1,11,2,1,0,80
95011,1034829,1,11,3,1,0,81
95012,1034829,1,11,4,2,0,83
95013,1034829,1,11,5,1,0,84
95014,1034829,1,11,6,0,0,84
95015,1034829,1,12,1,0,0,84
95016,1034829,1,12,2,1,0,85
95017,1034829,1,12,3,6,0,91
95018,1034829,1,12,4,1,0,92
95019,1034829,1,12,5,6,0,98
95020,1034829,1,12,6,1,0,99
95021,1034829,1,13,1,6,0,105
95022,1034829,1,13,2,1,0,106
95023,1034829,1,13,3,1,0,107
95024,1034829,1,13,4,1,0,108
95025,1034829,1,13,5,1,0,109
95026,1034829,1,13,6,4,0,113
95027,1034829,1,14,1,6,0,119
95028,1034829,1,14,2,1,0,120
95029,1034829,1,14,3,0,1,120
95030,1034829,1,14,4,2,0,122
95031,1034829,1,14,5,2,0,124
95032,1034829,1,14,6,0,0,124
95033,1034829,1,15,1,1,0,125
95034,1034829,1,15,2,1,0,126
95035,1034829,1,15,3,1,0,127
95036,1034829,1,15,4,0,0,127
95037,1034829,1,15,5,4,0,131
95038,1034829,1,15,6,1,0,132
95039,1034829,1,16,1,4,0,136
95040,1034829,1,16,2,1,0,137
95041,1034829,1,16,3,1,0,138
95042,1034829,1,16,4,1,0,139
95043,1034829,1,16,5,2,0,141
95044,1034829,1,16,6,1,0,142
95045,1034829,1,17,1,4,0,146
95046,1034829,1,17,2,2,0,148
95047,1034829,1,17,3,0,0,148
95048,1034829,1,17,4,0,0,148
95049,1034829,1,17,5,4,0,152
95050,1034829,1,17,6,1,0,153
95051,1034829,1,18,1,1,0,154
95052,1034829,1,18,2,6,0,160
95053,1034829,1,18,3,6,0,166
95054,1034829,1,18,4,4,0,170
95055,1034829,1,18,5,6,0,176
95056,1034829,1,18,6,1,0,177
95057,1034829,1,19,1,0,1,177
95058,1034829,1,19,2,1,0,178
95059,1034829,1,19,3,1,0,179
95060,1034829,1,19,4,2,0,181
95061,1034829,1,19,5,1,0,182
95062,1034829,1,19,6,4,0,186
95063,1034829,1,20,1,5,0,191
95064,1034829,1,20,2,0,1,191
95065,1034829,1,20,3,2,0,193
95066,1034829,1,20,4,6,0,199
95067,1034829,1,20,5,2,0,201
95068,1034829,1,20,6,1,1,202
95168,1040485,1,1,1,0,0,0
95169,1040485,1,1,2,1,0,1
95170,1040485,1,1,3,0,0,1
95171,1040485,1,1,4,0,1,1
95172,1040485,1,1,5,0,0,1
95173,1040485,1,1,6,0,0,1
95174,1040485,1,2,1,4,0,5
95175,1040485,1,2,2,0,0,5
95176,1040485,1,2,3,3,0,8
95177,1040485,1,2,4,0,0,8
95178,1040485,1,2,5,4,0,12
95179,1040485,1,2,6,0,0,12
95180,1040485,1,3,1,0,0,12
95181,1040485,1,3,2,4,0,16
95182,1040485,1,3,3,0,0,16
95183,1040485,1,3,4,4,0,20
95184,1040485,1,3,5,0,0,20
95185,1040485,1,3,6,0,0,20
95186,1040485,1,4,1,1,0,21
95187,1040485,1,4,2,0,0,21
95188,1040485,1,4,3,1,0,22
95189,1040485,1,4,4,0,0,22
95190,1040485,1,4,5,1,0,23
95191,1040485,1,4,6,1,0,24
95192,1040485,1,5,1,0,0,24
95193,1040485,1,5,2,1,0,25
95194,1040485,1,5,3,0,0,25
95195,1040485,1,5,4,0,0,25
95196,1040485,1,5,5,0,0,25
95197,1040485,1,5,6,2,0,27
95198,1040485,1,6,1,4,0,31
95199,1040485,1,6,2,6,0,37
95200,1040485,1,6,3,1,0,38
95201,1040485,1,6,4,4,0,42
95202,1040485,1,6,5,4,0,46
95203,1040485,1,6,6,2,0,48
95204,1040485,1,7,1,4,0,52
95205,1040485,1,7,2,1,0,53
95206,1040485,1,7,3,1,0,54
95207,1040485,1,7,4,2,0,56
95208,1040485,1,7,5,4,0,60
95209,1040485,1,7,6,1,0,61
95210,1040485,1,8,1,1,0,62
95211,1040485,1,8,2,1,0,63
95212,1040485,1,8,3,0,0,63
95213,1040485,1,8,4,0,0,63
95214,1040485,1,8,5,2,0,65
95215,1040485,1,8,6,2,0,67
95216,1040485,1,9,1,1,0,68
95217,1040485,1,9,2,1,0,69
95218,1040485,1,9,3,1,0,70
95219,1040485,1,9,4,6,0,76
95220,1040485,1,9,5,0,0,76
95221,1040485,1,9,6,0,0,76
95222,1040485,1,10,1,4,0,80
95223,1040485,1,10,2,1,0,81
95224,1040485,1,10,3,2,0,83
95225,1040485,1,10,4,0,1,83
95226,1040485,1,10,5,1,0,84
95227,1040485,1,10,6,1,0,85
95228,1040485,1,11,1,0,0,85
95229,1040485,1,11,2,4,0,89
95230,1040485,1,11,3,1,0,90
95231,1040485,1,11,4,2,0,92
95232,1040485,1,11,5,0,0,92
95233,1040485,1,11,6,2,0,94
95234,1040485,1,12,1,1,0,95
95235,1040485,1,12,2,4,0,99
95236,1040485,1,12,3,0,0,99
95237,1040485,1,12,4,0,0,99
95238,1040485,1,12,5,1,0,100
95239,1040485,1,12,6,0,0,100
95240,1040485,1,13,1,2,1,102
95241,1040485,1,13,2,0,0,102
95242,1040485,1,13,3,0,0,102
95243,1040485,1,13,4,0,0,102
95244,1040485,1,13,5,1,0,103
95245,1040485,1,13,6,0,0,103
95246,1040485,1,14,1,1,0,104
95247,1040485,1,14,2,1,0,105
95248,1040485,1,14,3,1,0,106
95249,1040485,1,14,4,2,0,108
95250,1040485,1,14,5,1,0,109
95251,1040485,1,14,6,2,0,111
95252,1040485,1,15,1,0,0,111
95253,1040485,1,15,2,1,0,112
95254,1040485,1,15,3,0,1,112
95255,1040485,1,15,4,1,0,113
95256,1040485,1,15,5,1,0,114
95257,1040485,1,15,6,0,0,114
95258,1040485,1,16,1,4,0,118
95259,1040485,1,16,2,1,0,119
95260,1040485,1,16,3,2,0,121
95261,1040485,1,16,4,1,0,122
95262,1040485,1,16,5,1,0,123
95263,1040485,1,16,6,0,0,123
95264,1040485,1,17,1,1,0,124
95265,1040485,1,17,2,0,0,124
95266,1040485,1,17,3,1,0,125
95267,1040485,1,17,4,0,0,125
95268,1040485,1,17,5,0,0,125
95269,1040485,1,17,6,1,0,126
95270,1040485,1,18,1,4,0,130
95271,1040485,1,18,2,2,0,132
95272,1040485,1,18,3,1,0,133
95273,1040485,1,18,4,1,0,134
95274,1040485,1,18,5,1,0,135
95275,1040485,1,18,6,0,0,135
95276,1040485,1,19,1,4,0,139
95277,1040485,1,19,2,1,0,140
95278,1040485,1,19,3,4,0,144
95279,1040485,1,19,4,4,0,148
95280,1040485,1,19,5,4,0,152
95281,1040485,1,19,6,1,0,153
95282,1040485,1,20,1,0,0,153
95283,1040485,1,20,2,2,0,155
95284,1040485,1,20,3,1,0,156
95285,1040485,1,20,4,1,0,157
95286,1040485,1,20,5,6,0,163
95287,1040485,1,20,6,2,1,165
95396,1040487,1,1,1,0,0,0
95397,1040487,1,1,2,0,0,0
95398,1040487,1,1,3,4,0,4
95399,1040487,1,1,4,0,1,4
95400,1040487,1,1,5,0,0,4
95401,1040487,1,1,6,3,0,7
95402,1040487,1,2,1,4,0,11
95403,1040487,1,2,2,0,0,11
95404,1040487,1,2,3,0,0,11
95405,1040487,1,2,4,0,0,11
95406,1040487,1,2,5,0,0,11
95407,1040487,1,2,6,0,0,11
95408,1040487,1,3,1,0,0,11
95409,1040487,1,3,2,1,0,12
95410,1040487,1,3,3,0,1,12
95411,1040487,1,3,4,0,0,12
95412,1040487,1,3,5,0,0,12
95413,1040487,1,3,6,0,0,12
95414,1040487,1,4,1,1,0,13
95415,1040487,1,4,2,1,0,14
95416,1040487,1,4,3,6,0,20
95417,1040487,1,4,4,1,0,21
95418,1040487,1,4,5,0,0,21
95419,1040487,1,4,6,4,0,25
95420,1040487,1,5,1,0,0,25
95421,1040487,1,5,2,1,0,26
95422,1040487,1,5,3,1,0,27
95423,1040487,1,5,4,0,0,27
95424,1040487,1,5,5,6,0,33
95425,1040487,1,5,6,0,0,33
95426,1040487,1,6,1,1,0,34
95427,1040487,1,6,2,1,0,35
95428,1040487,1,6,3,1,0,36
95429,1040487,1,6,4,1,0,37
95430,1040487,1,6,5,1,0,38
95431,1040487,1,6,6,1,0,39
95432,1040487,1,7,1,1,0,40
95433,1040487,1,7,2,1,0,41
95434,1040487,1,7,3,1,0,42
95435,1040487,1,7,4,1,0,43
95436,1040487,1,7,5,6,0,49
95437,1040487,1,7,6,4,0,53
95438,1040487,1,8,1,1,0,54
95439,1040487,1,8,2,1,0,55
95440,1040487,1,8,3,0,0,55
95441,1040487,1,8,4,0,0,55
95442,1040487,1,8,5,0,0,55
95443,1040487,1,8,6,6,0,61
95444,1040487,1,9,1,4,0,65
95445,1040487,1,9,2,1,0,66
95446,1040487,1,9,3,0,1,66
95447,1040487,1,9,4,0,0,66
95448,1040487,1,9,5,3,0,69
95449,1040487,1,9,6,0,0,69
95450,1040487,1,10,1,0,1,69
95451,1040487,1,10,2,1,0,70
95452,1040487,1,10,3,0,0,70
95453,1040487,1,10,4,1,0,71
95454,1040487,1,10,5,1,0,72
95455,1040487,1,10,6,0,0,72
95456,1040487,1,11,1,1,0,73
95457,1040487,1,11,2,1,0,74
95458,1040487,1,11,3,1,0,75
95459,1040487,1,11,4,6,0,81
95460,1040487,1,11,5,1,0,82
95461,1040487,1,11,6,0,0,82
95462,1040487,1,12,1,1,0,83
95463,1040487,1,12,2,1,0,84
95464,1040487,1,12,3,6,0,90
95465,1040487,1,12,4,1,0,91
95466,1040487,1,12,5,1,0,92
95467,1040487,1,12,6,1,0,93
95468,1040487,1,13,1,1,0,94
95469,1040487,1,13,2,6,0,100
95470,1040487,1,13,3,0,0,100
95471,1040487,1,13,4,1,0,101
95472,1040487,1,13,5,1,0,102
95473,1040487,1,13,6,4,0,106
95474,1040487,1,14,1,0,0,106
95475,1040487,1,14,2,1,0,107
95476,1040487,1,14,3,1,0,108
95477,1040487,1,14,4,1,0,109
95478,1040487,1,14,5,2,0,111
95479,1040487,1,14,6,0,0,111
95480,1040487,1,15,1,0,0,111
95481,1040487,1,15,2,4,0,115
95482,1040487,1,15,3,2,0,117
95483,1040487,1,15,4,1,0,118
95484,1040487,1,15,5,0,1,118
95485,1040487,1,15,6,5,0,123
95486,1040487,1,16,1,0,0,123
95487,1040487,1,16,2,1,0,124
95488,1040487,1,16,3,1,0,125
95489,1040487,1,16,4,4,0,129
95490,1040487,1,16,5,0,0,129
95491,1040487,1,16,6,1,0,130
95492,1040487,1,17,1,0,0,130
95493,1040487,1,17,2,1,0,131
95494,1040487,1,17,3,4,0,135
95495,1040487,1,17,4,4,0,139
95496,1040487,1,17,5,1,0,140
95497,1040487,1,17,6,6,0,146
95498,1040487,1,18,1,0,0,146
95499,1040487,1,18,2,1,0,147
95500,1040487,1,18,3,7,0,154
95501,1040487,1,18,4,2,0,156
95502,1040487,1,18,5,4,0,160
95503,1040487,1,18,6,4,0,164
95504,1040487,1,19,1,1,0,165
95505,1040487,1,19,2,1,0,166
95506,1040487,1,19,3,4,0,170
95507,1040487,1,19,4,0,0,170
95508,1040487,1,19,5,1,0,171
95509,1040487,1,19,6,4,0,175
95510,1040487,1,20,1,0,1,175
95511,1040487,1,20,2,0,1,175
95512,1040487,1,20,3,2,0,177
95513,1040487,1,20,4,0,0,177
95514,1040487,1,20,5,1,1,178
95515,1040487,1,20,6,6,0,184
95582,1040489,1,1,1,0,0,0
95583,1040489,1,1,2,4,0,4
95584,1040489,1,1,3,6,0,10
95585,1040489,1,1,4,0,0,10
95586,1040489,1,1,5,0,0,10
95587,1040489,1,1,6,4,0,14
95588,1040489,1,2,1,0,0,14
95589,1040489,1,2,2,1,0,15
95590,1040489,1,2,3,0,0,15
95591,1040489,1,2,4,4,0,19
95592,1040489,1,2,5,1,0,20
95593,1040489,1,2,6,1,0,21
95594,1040489,1,3,1,1,0,22
95595,1040489,1,3,2,0,0,22
95596,1040489,1,3,3,1,0,23
95597,1040489,1,3,4,0,1,23
95598,1040489,1,3,5,1,0,24
95599,1040489,1,3,6,2,0,26
95600,1040489,1,4,1,1,0,27
95601,1040489,1,4,2,1,0,28
95602,1040489,1,4,3,0,0,28
95603,1040489,1,4,4,4,0,32
95604,1040489,1,4,5,0,0,32
95605,1040489,1,4,6,6,0,38
95606,1040489,1,5,1,1,0,39
95607,1040489,1,5,2,0,0,39
95608,1040489,1,5,3,4,0,43
95609,1040489,1,5,4,1,0,44
95610,1040489,1,5,5,1,0,45
95611,1040489,1,5,6,6,0,51
95612,1040489,1,6,1,1,0,52
95613,1040489,1,6,2,0,0,52
95614,1040489,1,6,3,4,0,56
95615,1040489,1,6,4,0,0,56
95616,1040489,1,6,5,6,0,62
95617,1040489,1,6,6,1,0,63
95618,1040489,1,7,1,2,0,65
95619,1040489,1,7,2,4,0,69
95620,1040489,1,7,3,0,0,69
95621,1040489,1,7,4,1,0,70
95622,1040489,1,7,5,0,0,70
95623,1040489,1,7,6,2,0,72
95624,1040489,1,8,1,0,0,72
95625,1040489,1,8,2,1,0,73
95626,1040489,1,8,3,1,0,74
95627,1040489,1,8,4,1,0,75
95628,1040489,1,8,5,4,0,79
95629,1040489,1,8,6,0,0,79
95630,1040489,1,9,1,1,0,80
95631,1040489,1,9,2,0,0,80
95632,1040489,1,9,3,0,0,80
95633,1040489,1,9,4,4,0,84
95634,1040489,1,9,5,4,0,88
95635,1040489,1,9,6,1,0,89
95636,1040489,1,10,1,0,0,89
95637,1040489,1,10,2,1,0,90
95638,1040489,1,10,3,4,0,94
95639,1040489,1,10,4,1,0,95
95640,1040489,1,10,5,0,0,95
95641,1040489,1,10,6,0,0,95
95642,1040489,1,11,1,2,0,97
95643,1040489,1,11,2,0,1,97
95644,1040489,1,11,3,3,0,100
95645,1040489,1,11,4,6,0,106
95646,1040489,1,11,5,1,0,107
95647,1040489,1,11,6,1,0,108
95648,1040489,1,12,1,6,0,114
95649,1040489,1,12,2,1,0,115
95650,1040489,1,12,3,4,0,119
95651,1040489,1,12,4,0,1,119
95652,1040489,1,12,5,0,0,119
95653,1040489,1,12,6,0,0,119
95654,1040489,1,13,1,1,0,120
95655,1040489,1,13,2,1,0,121
95656,1040489,1,13,3,0,1,121
95657,1040489,1,13,4,0,0,121
95658,1040489,1,13,5,0,1,121
95659,1040489,1,13,6,1,0,122
95660,1040489,1,14,1,3,0,125
95661,1040489,1,14,2,1,0,126
95662,1040489,1,14,3,0,0,126
95663,1040489,1,14,4,1,0,127
95664,1040489,1,14,5,1,0,128
95665,1040489,1,14,6,1,0,129
95666,1040489,1,15,1,0,0,129
95667,1040489,1,15,2,6,0,135
95668,1040489,1,15,3,1,0,136
95669,1040489,1,15,4,1,0,137
95670,1040489,1,15,5,6,0,143
95671,1040489,1,15,6,2,0,145
95672,1040489,1,16,1,1,0,146
95673,1040489,1,16,2,4,0,150
95674,1040489,1,16,3,1,0,151
95675,1040489,1,16,4,1,0,152
95676,1040489,1,16,5,6,0,158
95677,1040489,1,16,6,0,0,158
95678,1040489,1,17,1,2,0,160
95679,1040489,1,17,2,0,0,160
95680,1040489,1,17,3,6,0,166
95681,1040489,1,17,4,2,0,168
95682,1040489,1,17,5,4,0,172
95683,1040489,1,17,6,6,0,178
95684,1040489,1,18,1,4,0,182
95685,1040489,1,18,2,2,0,184
95686,1040489,1,18,3,1,0,185
95687,1040489,1,18,4,0,0,185
95688,1040489,1,18,5,4,0,189
95689,1040489,1,18,6,6,0,195
95690,1040489,1,19,1,0,1,195
95691,1040489,1,19,2,4,0,199
95692,1040489,1,19,3,1,0,200
95693,1040489,1,19,4,6,0,206
95694,1040489,1,19,5,0,1,206
95695,1040489,1,19,6,4,0,210
95696,1040489,1,20,1,1,0,211
95697,1040489,1,20,2,6,0,217
95698,1040489,1,20,3,6,0,223
95699,1040489,1,20,4,6,0,229
95700,1040489,1,20,5,4,0,233
95701,1040489,1,20,6,0,1,233
95818,1041615,1,1,1,1,0,1
95819,1041615,1,1,2,6,0,7
95820,1041615,1,1,3,4,0,11
95821,1041615,1,1,4,1,0,12
95822,1041615,1,1,5,1,0,13
95823,1041615,1,1,6,4,0,17
95824,1041615,1,2,1,0,0,17
95825,1041615,1,2,2,1,0,18
95826,1041615,1,2,3,0,0,18
95827,1041615,1,2,4,4,0,22
95828,1041615,1,2,5,0,0,22
95829,1041615,1,2,6,2,0,24
95830,1041615,1,3,1,0,0,24
95831,1041615,1,3,2,2,0,26
95832,1041615,1,3,3,4,0,30
95833,1041615,1,3,4,2,0,32
95834,1041615,1,3,5,1,0,33
95835,1041615,1,3,6,0,0,33
95836,1041615,1,4,1,0,0,33
95837,1041615,1,4,2,2,0,35
95838,1041615,1,4,3,1,0,36
95839,1041615,1,4,4,4,0,40
95840,1041615,1,4,5,4,0,44
95841,1041615,1,4,6,2,0,46
95842,1041615,1,5,1,6,0,52
95843,1041615,1,5,2,4,0,56
95844,1041615,1,5,3,1,0,57
95845,1041615,1,5,4,0,0,57
95846,1041615,1,5,5,6,0,63
95847,1041615,1,5,6,1,0,64
95848,1041615,1,6,1,0,0,64
95849,1041615,1,6,2,1,0,65
95850,1041615,1,6,3,1,0,66
95851,1041615,1,6,4,6,0,72
95852,1041615,1,6,5,6,0,78
95853,1041615,1,6,6,0,0,78
95854,1041615,1,7,1,6,0,84
95855,1041615,1,7,2,6,0,90
95856,1041615,1,7,3,0,0,90
95857,1041615,1,7,4,0,0,90
95858,1041615,1,7,5,1,0,91
95859,1041615,1,7,6,0,0,91
95860,1041615,1,8,1,1,0,92
95861,1041615,1,8,2,6,0,98
95862,1041615,1,8,3,0,0,98
95863,1041615,1,8,4,2,0,100
95864,1041615,1,8,5,0,0,100
95865,1041615,1,8,6,1,0,101
95866,1041615,1,9,1,4,0,105
95867,1041615,1,9,2,6,0,111
95868,1041615,1,9,3,2,0,113
95869,1041615,1,9,4,1,0,114
95870,1041615,1,9,5,1,0,115
95871,1041615,1,9,6,6,0,121
95872,1041615,1,10,1,4,0,125
95873,1041615,1,10,2,1,0,126
95874,1041615,1,10,3,0,1,126
95875,1041615,1,10,4,1,0,127
95876,1041615,1,10,5,4,0,131
95877,1041615,1,10,6,1,0,132
95878,1041615,1,11,1,6,0,138
95879,1041615,1,11,2,6,0,144
95880,1041615,1,11,3,7,0,151
95881,1041615,1,11,4,6,0,157
95882,1041615,1,11,5,6,0,163
95883,1041615,1,11,6,1,0,164
95884,1041615,1,12,1,2,0,166
95885,1041615,1,12,2,0,0,166
95886,1041615,1,12,3,0,0,166
95887,1041615,1,12,4,1,0,167
95888,1041615,1,12,5,1,0,168
95889,1041615,1,12,6,0,0,168
95890,1041615,1,13,1,1,0,169
95891,1041615,1,13,2,0,0,169
95892,1041615,1,13,3,4,0,173
95893,1041615,1,13,4,1,0,174
95894,1041615,1,13,5,6,0,180
95895,1041615,1,13,6,1,0,181
95896,1041615,1,14,1,1,0,182
95897,1041615,1,14,2,0,0,182
95898,1041615,1,14,3,0,0,182
95899,1041615,1,14,4,6,0,188
95900,1041615,1,14,5,0,0,188
95901,1041615,1,14,6,1,0,189
95902,1041615,1,15,1,1,0,190
95903,1041615,1,15,2,6,0,196
95904,1041615,1,15,3,1,0,197
95905,1041615,1,15,4,1,0,198
95906,1041615,1,15,5,1,0,199
95907,1041615,1,15,6,0,0,199
95908,1041615,1,16,1,1,0,200
95909,1041615,1,16,2,4,0,204
95910,1041615,1,16,3,0,1,204
95911,1041615,1,16,4,1,0,205
95912,1041615,1,16,5,0,1,205
95913,1041615,1,16,6,0,0,205
95914,1041615,1,17,1,1,0,206
95915,1041615,1,17,2,1,0,207
95916,1041615,1,17,3,6,0,213
95917,1041615,1,17,4,0,0,213
95918,1041615,1,17,5,1,0,214
95919,1041615,1,17,6,1,0,215
95920,1041615,1,18,1,2,0,217
95921,1041615,1,18,2,6,0,223
95922,1041615,1,18,3,1,0,224
95923,1041615,1,18,4,0,0,224
95924,1041615,1,18,5,1,0,225
95925,1041615,1,18,6,0,0,225
95926,1041615,1,19,1,1,0,226
95927,1041615,1,19,2,0,0,226
95928,1041615,1,19,3,1,0,227
95929,1041615,1,19,4,7,0,234
95930,1041615,1,19,5,1,0,235
95931,1041615,1,19,6,0,0,235
95932,1041615,1,20,1,7,1,242
95933,1041615,1,20,2,1,0,243
95934,1041615,1,20,3,1,0,244
95935,1041615,1,20,4,0,1,244
95936,1041615,1,20,5,0,1,244
95937,1041615,1,20,6,1,0,245
96058,1050217,1,1,1,1,0,1
96059,1050217,1,1,2,1,0,2
96060,1050217,1,1,3,1,0,3
96061,1050217,1,1,4,0,0,3
96062,1050217,1,1,5,0,1,3
96063,1050217,1,1,6,0,0,3
96064,1050217,1,2,1,1,0,4
96065,1050217,1,2,2,1,0,5
96066,1050217,1,2,3,0,0,5
96067,1050217,1,2,4,0,0,5
96068,1050217,1,2,5,2,0,7
96069,1050217,1,2,6,4,0,11
96070,1050217,1,3,1,0,0,11
96071,1050217,1,3,2,0,1,11
96072,1050217,1,3,3,4,0,15
96073,1050217,1,3,4,0,1,15
96074,1050217,1,3,5,0,0,15
96075,1050217,1,3,6,1,0,16
96076,1050217,1,4,1,0,0,16
96077,1050217,1,4,2,1,0,17
96078,1050217,1,4,3,0,0,17
96079,1050217,1,4,4,0,1,17
96080,1050217,1,4,5,1,0,18
96081,1050217,1,4,6,0,0,18
96082,1050217,1,5,1,0,0,18
96083,1050217,1,5,2,4,0,22
96084,1050217,1,5,3,0,1,22
96085,1050217,1,5,4,0,0,22
96086,1050217,1,5,5,0,0,22
96087,1050217,1,5,6,0,0,22
96088,1050217,1,6,1,0,0,22
96089,1050217,1,6,2,0,0,22
96090,1050217,1,6,3,1,0,23
96091,1050217,1,6,4,1,0,24
96092,1050217,1,6,5,0,0,24
96093,1050217,1,6,6,1,0,25
96094,1050217,1,7,1,0,0,25
96095,1050217,1,7,2,1,0,26
96096,1050217,1,7,3,1,0,27
96097,1050217,1,7,4,1,0,28
96098,1050217,1,7,5,1,0,29
96099,1050217,1,7,6,1,0,30
96100,1050217,1,8,1,1,0,31
96101,1050217,1,8,2,4,0,35
96102,1050217,1,8,3,1,0,36
96103,1050217,1,8,4,1,0,37
96104,1050217,1,8,5,1,0,38
96105,1050217,1,8,6,1,0,39
96106,1050217,1,9,1,0,0,39
96107,1050217,1,9,2,0,0,39
96108,1050217,1,9,3,1,0,40
96109,1050217,1,9,4,1,0,41
96110,1050217,1,9,5,1,0,42
96111,1050217,1,9,6,1,0,43
96112,1050217,1,10,1,0,0,43
96113,1050217,1,10,2,1,0,44
96114,1050217,1,10,3,0,0,44
96115,1050217,1,10,4,1,0,45
96116,1050217,1,10,5,1,0,46
96117,1050217,1,10,6,0,0,46
96118,1050217,1,11,1,0,0,46
96119,1050217,1,11,2,1,0,47
96120,1050217,1,11,3,0,1,47
96121,1050217,1,11,4,0,0,47
96122,1050217,1,11,5,0,1,47
96123,1050217,1,11,6,1,0,48
96124,1050217,1,12,1,0,0,48
96125,1050217,1,12,2,0,0,48
96126,1050217,1,12,3,0,1,48
96127,1050217,1,12,4,0,0,48
96128,1050217,1,12,5,0,0,48
96129,1050217,1,12,6,0,0,48
96130,1050217,1,13,1,1,0,49
96131,1050217,1,13,2,0,0,49
96132,1050217,1,13,3,1,0,50
96133,1050217,1,13,4,0,0,50
96134,1050217,1,13,5,6,0,56
96135,1050217,1,13,6,0,0,56
96136,1050217,1,14,1,0,0,56
96137,1050217,1,14,2,0,0,56
96138,1050217,1,14,3,1,0,57
96139,1050217,1,14,4,0,0,57
96140,1050217,1,14,5,1,0,58
96141,1050217,1,14,6,0,0,58
96142,1050217,1,15,1,6,0,64
96143,1050217,1,15,2,1,0,65
96144,1050217,1,15,3,1,0,66
96145,1050217,1,15,4,4,0,70
96146,1050217,1,15,5,0,0,70
96147,1050217,1,15,6,1,0,71
96148,1050217,1,16,1,2,0,73
96149,1050217,1,16,2,5,0,78
96150,1050217,1,16,3,1,0,79
96151,1050217,1,16,4,1,0,80
96152,1050217,1,16,5,4,0,84
96153,1050217,1,16,6,6,0,90
96154,1050217,1,17,1,6,0,96
96155,1050217,1,17,2,0,0,96
96156,1050217,1,17,3,0,0,96
96157,1050217,1,17,4,0,0,96
96158,1050217,1,17,5,2,0,98
96159,1050217,1,17,6,0,0,98
96160,1050217,1,18,1,1,0,99
96161,1050217,1,18,2,0,0,99
96162,1050217,1,18,3,0,0,99
96163,1050217,1,18,4,1,0,100
96164,1050217,1,18,5,0,0,100
96165,1050217,1,18,6,1,0,101
96166,1050217,1,19,1,2,0,103
96167,1050217,1,19,2,0,0,103
96168,1050217,1,19,3,0,0,103
96169,1050217,1,19,4,6,0,109
96170,1050217,1,19,5,1,0,110
96171,1050217,1,19,6,2,0,112
96172,1050217,1,20,1,2,0,114
96173,1050217,1,20,2,0,1,114
96174,1050217,1,20,3,1,0,115
96175,1050217,1,20,4,0,0,115
96176,1050217,1,20,5,0,1,115
96263,1050219,1,1,1,1,0,1
96264,1050219,1,1,2,0,0,1
96265,1050219,1,1,3,0,0,1
96266,1050219,1,1,4,0,0,1
96267,1050219,1,1,5,1,0,2
96268,1050219,1,1,6,0,0,2
96269,1050219,1,2,1,0,0,2
96270,1050219,1,2,2,0,0,2
96271,1050219,1,2,3,0,0,2
96272,1050219,1,2,4,1,0,3
96273,1050219,1,2,5,1,0,4
96274,1050219,1,2,6,0,0,4
96275,1050219,1,3,1,0,0,4
96276,1050219,1,3,2,0,1,4
96277,1050219,1,3,3,0,0,4
96278,1050219,1,3,4,2,0,6
96279,1050219,1,3,5,1,0,7
96280,1050219,1,3,6,6,0,13
96281,1050219,1,4,1,0,0,13
96282,1050219,1,4,2,1,0,14
96283,1050219,1,4,3,4,0,18
96284,1050219,1,4,4,0,0,18
96285,1050219,1,4,5,2,0,20
96286,1050219,1,4,6,4,0,24
96287,1050219,1,5,1,1,0,25
96288,1050219,1,5,2,1,0,26
96289,1050219,1,5,3,1,0,27
96290,1050219,1,5,4,2,0,29
96291,1050219,1,5,5,2,0,31
96292,1050219,1,5,6,1,0,32
96293,1050219,1,6,1,1,0,33
96294,1050219,1,6,2,0,0,33
96295,1050219,1,6,3,4,0,37
96296,1050219,1,6,4,1,0,38
96297,1050219,1,6,5,1,0,39
96298,1050219,1,6,6,0,0,39
96299,1050219,1,7,1,1,0,40
96300,1050219,1,7,2,1,0,41
96301,1050219,1,7,3,1,0,42
96302,1050219,1,7,4,0,0,42
96303,1050219,1,7,5,2,0,44
96304,1050219,1,7,6,1,0,45
96305,1050219,1,8,1,2,0,47
96306,1050219,1,8,2,4,0,51
96307,1050219,1,8,3,1,0,52
96308,1050219,1,8,4,1,0,53
96309,1050219,1,8,5,1,0,54
96310,1050219,1,8,6,4,0,58
96311,1050219,1,9,1,0,1,58
96312,1050219,1,9,2,1,0,59
96313,1050219,1,9,3,0,0,59
96314,1050219,1,9,4,1,0,60
96315,1050219,1,9,5,1,0,61
96316,1050219,1,9,6,1,0,62
96317,1050219,1,10,1,0,0,62
96318,1050219,1,10,2,1,0,63
96319,1050219,1,10,3,4,0,67
96320,1050219,1,10,4,1,0,68
96321,1050219,1,10,5,1,0,69
96322,1050219,1,10,6,4,0,73
96323,1050219,1,11,1,1,0,74
96324,1050219,1,11,2,1,0,75
96325,1050219,1,11,3,4,0,79
96326,1050219,1,11,4,0,0,79
96327,1050219,1,11,5,1,0,80
96328,1050219,1,11,6,1,0,81
96329,1050219,1,12,1,0,0,81
96330,1050219,1,12,2,2,0,83
96331,1050219,1,12,3,1,0,84
96332,1050219,1,12,4,1,1,85
96333,1050219,1,12,5,0,0,85
96334,1050219,1,12,6,1,0,86
96335,1050219,1,13,1,0,0,86
96336,1050219,1,13,2,0,0,86
96337,1050219,1,13,3,1,0,87
96338,1050219,1,13,4,1,0,88
96339,1050219,1,13,5,1,0,89
96340,1050219,1,13,6,0,0,89
96341,1050219,1,14,1,2,0,91
96342,1050219,1,14,2,2,0,93
96343,1050219,1,14,3,1,0,94
96344,1050219,1,14,4,1,0,95
96345,1050219,1,14,5,4,0,99
96346,1050219,1,14,6,1,0,100
96347,1050219,1,15,1,0,0,100
96348,1050219,1,15,2,1,0,101
96349,1050219,1,15,3,4,0,105
96350,1050219,1,15,4,1,0,106
96351,1050219,1,15,5,0,0,106
96352,1050219,1,15,6,4,0,110
96353,1050219,1,16,1,1,0,111
96354,1050219,1,16,2,0,0,111
96355,1050219,1,16,3,2,0,113
96356,1050219,1,16,4,2,0,115
96357,1050219,1,16,5,1,0,116
96358,1050219,1,16,6,1,0,117
96359,1050219,1,17,1,4,0,121
96360,1050219,1,17,2,2,0,123
96361,1050219,1,17,3,1,0,124
96362,1050219,1,17,4,2,0,126
96363,1050219,1,17,5,4,0,130
96364,1050219,1,17,6,2,0,132
96365,1050219,1,18,1,2,0,134
96366,1050219,1,18,2,6,0,140
96367,1050219,1,18,3,1,0,141
96368,1050219,1,18,4,2,0,143
96369,1050219,1,18,5,2,0,145
96370,1050219,1,18,6,0,0,145
96371,1050219,1,19,1,1,0,146
96372,1050219,1,19,2,1,0,147
96373,1050219,1,19,3,0,0,147
96374,1050219,1,19,4,1,0,148
96375,1050219,1,19,5,4,0,152
96376,1050219,1,19,6,1,0,153
96377,1050219,1,20,1,1,0,154
96378,1050219,1,20,2,0,1,154
96379,1050219,1,20,3,1,0,155
96380,1050219,1,20,4,0,0,155
96381,1050219,1,20,5,4,0,159
96382,1050219,1,20,6,1,0,160
96503,1050221,1,1,1,3,0,3
96504,1050221,1,1,2,0,0,3
96505,1050221,1,1,3,1,0,4
96506,1050221,1,1,4,1,0,5
96507,1050221,1,1,5,0,0,5
96508,1050221,1,1,6,1,0,6
96509,1050221,1,2,1,0,0,6
96510,1050221,1,2,2,4,0,10
96511,1050221,1,2,3,0,0,10
96512,1050221,1,2,4,0,0,10
96513,1050221,1,2,5,1,0,11
96514,1050221,1,2,6,1,0,12
96515,1050221,1,3,1,0,0,12
96516,1050221,1,3,2,0,1,12
96517,1050221,1,3,3,0,1,12
96518,1050221,1,3,4,0,0,12
96519,1050221,1,3,5,1,0,13
96520,1050221,1,3,6,0,0,13
96521,1050221,1,4,1,1,0,14
96522,1050221,1,4,2,0,0,14
96523,1050221,1,4,3,0,0,14
96524,1050221,1,4,4,0,0,14
96525,1050221,1,4,5,0,0,14
96526,1050221,1,4,6,2,0,16
96527,1050221,1,5,1,0,0,16
96528,1050221,1,5,2,1,0,17
96529,1050221,1,5,3,0,0,17
96530,1050221,1,5,4,0,1,17
96531,1050221,1,5,5,4,0,21
96532,1050221,1,5,6,0,0,21
96533,1050221,1,6,1,0,0,21
96534,1050221,1,6,2,0,0,21
96535,1050221,1,6,3,1,0,22
96536,1050221,1,6,4,0,0,22
96537,1050221,1,6,5,0,0,22
96538,1050221,1,6,6,4,0,26
96539,1050221,1,7,1,0,0,26
96540,1050221,1,7,2,0,0,26
96541,1050221,1,7,3,0,0,26
96542,1050221,1,7,4,1,0,27
96543,1050221,1,7,5,1,0,28
96544,1050221,1,7,6,0,0,28
96545,1050221,1,8,1,1,0,29
96546,1050221,1,8,2,0,0,29
96547,1050221,1,8,3,0,0,29
96548,1050221,1,8,4,0,0,29
96549,1050221,1,8,5,1,0,30
96550,1050221,1,8,6,1,0,31
96551,1050221,1,9,1,0,1,31
96552,1050221,1,9,2,1,0,32
96553,1050221,1,9,3,1,0,33
96554,1050221,1,9,4,1,0,34
96555,1050221,1,9,5,2,0,36
96556,1050221,1,9,6,0,0,36
96557,1050221,1,10,1,1,0,37
96558,1050221,1,10,2,1,0,38
96559,1050221,1,10,3,1,0,39
96560,1050221,1,10,4,4,0,43
96561,1050221,1,10,5,0,0,43
96562,1050221,1,10,6,1,0,44
96563,1050221,1,11,1,0,0,44
96564,1050221,1,11,2,4,0,48
96565,1050221,1,11,3,1,0,49
96566,1050221,1,11,4,2,0,51
96567,1050221,1,11,5,1,0,52
96568,1050221,1,11,6,2,0,54
96569,1050221,1,12,1,2,0,56
96570,1050221,1,12,2,1,0,57
96571,1050221,1,12,3,0,0,57
96572,1050221,1,12,4,0,0,57
96573,1050221,1,12,5,1,0,58
96574,1050221,1,12,6,0,0,58
96575,1050221,1,13,1,1,0,59
96576,1050221,1,13,2,0,0,59
96577,1050221,1,13,3,6,0,65
96578,1050221,1,13,4,1,1,66
96579,1050221,1,13,5,0,0,66
96580,1050221,1,13,6,1,0,67
96581,1050221,1,14,1,1,0,68
96582,1050221,1,14,2,1,0,69
96583,1050221,1,14,3,0,0,69
96584,1050221,1,14,4,0,0,69
96585,1050221,1,14,5,1,0,70
96586,1050221,1,14,6,1,0,71
96587,1050221,1,15,1,1,0,72
96588,1050221,1,15,2,0,0,72
96589,1050221,1,15,3,1,0,73
96590,1050221,1,15,4,1,0,74
96591,1050221,1,15,5,1,0,75
96592,1050221,1,15,6,0,0,75
96593,1050221,1,16,1,0,0,75
96594,1050221,1,16,2,0,0,75
96595,1050221,1,16,3,1,0,76
96596,1050221,1,16,4,1,0,77
96597,1050221,1,16,5,0,0,77
96598,1050221,1,16,6,0,0,77
96599,1050221,1,17,1,2,0,79
96600,1050221,1,17,2,1,0,80
96601,1050221,1,17,3,0,0,80
96602,1050221,1,17,4,4,0,84
96603,1050221,1,17,5,1,0,85
96604,1050221,1,17,6,2,0,87
96605,1050221,1,18,1,1,0,88
96606,1050221,1,18,2,1,0,89
96607,1050221,1,18,3,2,0,91
96608,1050221,1,18,4,1,0,92
96609,1050221,1,18,5,1,0,93
96610,1050221,1,18,6,1,0,94
96611,1050221,1,19,1,0,0,94
96612,1050221,1,19,2,1,0,95
96613,1050221,1,19,3,0,0,95
96614,1050221,1,19,4,1,0,96
96615,1050221,1,19,5,1,0,97
96616,1050221,1,19,6,1,0,98
96617,1050221,1,20,1,1,0,99
96618,1050221,1,20,2,0,0,99
96619,1050221,1,20,3,1,0,100
96620,1050221,1,20,4,2,0,102
96621,1050221,1,20,5,1,0,103
96622,1050221,1,20,6,0,0,103
96714,1072316,1,1,1,1,0,1
96715,1072316,1,1,2,4,0,5
96716,1072316,1,1,3,1,0,6
96717,1072316,1,1,4,1,0,7
96718,1072316,1,1,5,1,0,8
96719,1072316,1,1,6,3,0,11
96720,1072316,1,2,1,0,1,11
96721,1072316,1,2,2,0,1,11
96722,1072316,1,2,3,3,0,14
96723,1072316,1,2,4,0,0,14
96724,1072316,1,2,5,0,0,14
96725,1072316,1,2,6,1,0,15
96726,1072316,1,3,1,1,0,16
96727,1072316,1,3,2,0,0,16
96728,1072316,1,3,3,0,0,16
96729,1072316,1,3,4,0,0,16
96730,1072316,1,3,5,0,0,16
96731,1072316,1,3,6,0,0,16
96732,1072316,1,4,1,0,0,16
96733,1072316,1,4,2,0,1,16
96734,1072316,1,4,3,0,0,16
96735,1072316,1,4,4,0,0,16
96736,1072316,1,4,5,0,0,16
96737,1072316,1,4,6,1,0,17
96738,1072316,1,5,1,1,0,18
96739,1072316,1,5,2,0,0,18
96740,1072316,1,5,3,0,0,18
96741,1072316,1,5,4,4,0,22
96742,1072316,1,5,5,1,0,23
96743,1072316,1,5,6,2,0,25
96744,1072316,1,6,1,1,0,26
96745,1072316,1,6,2,1,0,27
96746,1072316,1,6,3,2,0,29
96747,1072316,1,6,4,0,0,29
96748,1072316,1,6,5,0,0,29
96749,1072316,1,6,6,0,0,29
96750,1072316,1,7,1,1,0,30
96751,1072316,1,7,2,0,0,30
96752,1072316,1,7,3,2,0,32
96753,1072316,1,7,4,1,0,33
96754,1072316,1,7,5,0,0,33
96755,1072316,1,7,6,1,0,34
96756,1072316,1,8,1,0,0,34
96757,1072316,1,8,2,0,1,34
96758,1072316,1,8,3,1,0,35
96759,1072316,1,8,4,2,0,37
96760,1072316,1,8,5,1,0,38
96761,1072316,1,8,6,2,0,40
96762,1072316,1,9,1,0,0,40
96763,1072316,1,9,2,0,0,40
96764,1072316,1,9,3,1,0,41
96765,1072316,1,9,4,3,0,44
96766,1072316,1,9,5,1,0,45
96767,1072316,1,9,6,0,0,45
96768,1072316,1,10,1,1,0,46
96769,1072316,1,10,2,2,0,48
96770,1072316,1,10,3,0,0,48
96771,1072316,1,10,4,0,0,48
96772,1072316,1,10,5,1,0,49
96773,1072316,1,10,6,0,0,49
96774,1072316,1,11,1,1,0,50
96775,1072316,1,11,2,1,0,51
96776,1072316,1,11,3,0,0,51
96777,1072316,1,11,4,1,0,52
96778,1072316,1,11,5,1,0,53
96779,1072316,1,11,6,1,0,54
96780,1072316,1,12,1,1,0,55
96781,1072316,1,12,2,0,0,55
96782,1072316,1,12,3,2,0,57
96783,1072316,1,12,4,2,0,59
96784,1072316,1,12,5,0,0,59
96785,1072316,1,12,6,1,0,60
96786,1072316,1,13,1,0,1,60
96787,1072316,1,13,2,0,0,60
96788,1072316,1,13,3,1,0,61
96789,1072316,1,13,4,1,0,62
96790,1072316,1,13,5,0,0,62
96791,1072316,1,13,6,1,0,63
96792,1072316,1,14,1,0,0,63
96793,1072316,1,14,2,4,0,67
96794,1072316,1,14,3,0,0,67
96795,1072316,1,14,4,1,0,68
96796,1072316,1,14,5,0,0,68
96797,1072316,1,14,6,1,0,69
96798,1072316,1,15,1,1,0,70
96799,1072316,1,15,2,6,0,76
96800,1072316,1,15,3,0,0,76
96801,1072316,1,15,4,6,0,82
96802,1072316,1,15,5,1,0,83
96803,1072316,1,15,6,0,0,83
96804,1072316,1,16,1,1,0,84
96805,1072316,1,16,2,1,0,85
96806,1072316,1,16,3,3,0,88
96807,1072316,1,16,4,1,0,89
96808,1072316,1,16,5,1,0,90
96809,1072316,1,16,6,0,1,90
96810,1072316,1,17,1,0,0,90
96811,1072316,1,17,2,0,0,90
96812,1072316,1,17,3,1,0,91
96813,1072316,1,17,4,0,0,91
96814,1072316,1,17,5,1,0,92
96815,1072316,1,17,6,0,0,92
96816,1072316,1,18,1,0,0,92
96817,1072316,1,18,2,0,1,92
96818,1072316,1,18,3,1,0,93
96819,1072316,1,18,4,1,0,94
96820,1072316,1,18,5,2,0,96
96821,1072316,1,18,6,7,0,103
96822,1072316,1,19,1,1,0,104
96823,1072316,1,19,2,1,0,105
96824,1072316,1,19,3,1,0,106
96825,1072316,1,19,4,1,0,107
96826,1072316,1,19,5,0,0,107
96827,1072316,1,19,6,6,0,113
96828,1072316,1,20,1,1,0,114
96829,1072316,1,20,2,0,1,114
96830,1072316,1,20,3,1,0,115
96831,1072316,1,20,4,2,0,117
96832,1072316,1,20,5,0,0,117
96833,1072316,1,20,6,0,1,117
96903,1072317,1,1,1,2,0,2
96904,1072317,1,1,2,0,0,2
96905,1072317,1,1,3,5,0,7
96906,1072317,1,1,4,2,0,9
96907,1072317,1,1,5,1,0,10
96908,1072317,1,1,6,1,0,11
96909,1072317,1,2,1,4,0,15
96910,1072317,1,2,2,1,0,16
96911,1072317,1,2,3,0,0,16
96912,1072317,1,2,4,0,1,16
96913,1072317,1,2,5,1,0,17
96914,1072317,1,2,6,0,0,17
96915,1072317,1,3,1,4,0,21
96916,1072317,1,3,2,0,0,21
96917,1072317,1,3,3,4,0,25
96918,1072317,1,3,4,6,0,31
96919,1072317,1,3,5,2,0,33
96920,1072317,1,3,6,0,0,33
96921,1072317,1,4,1,4,0,37
96922,1072317,1,4,2,0,0,37
96923,1072317,1,4,3,0,0,37
96924,1072317,1,4,4,4,0,41
96925,1072317,1,4,5,1,0,42
96926,1072317,1,4,6,0,0,42
96927,1072317,1,5,1,4,0,46
96928,1072317,1,5,2,0,0,46
96929,1072317,1,5,3,1,0,47
96930,1072317,1,5,4,1,0,48
96931,1072317,1,5,5,1,0,49
96932,1072317,1,5,6,1,0,50
96933,1072317,1,6,1,0,0,50
96934,1072317,1,6,2,1,0,51
96935,1072317,1,6,3,1,0,52
96936,1072317,1,6,4,0,0,52
96937,1072317,1,6,5,4,0,56
96938,1072317,1,6,6,4,0,60
96939,1072317,1,7,1,0,1,60
96940,1072317,1,7,2,0,0,60
96941,1072317,1,7,3,1,0,61
96942,1072317,1,7,4,2,0,63
96943,1072317,1,7,5,1,0,64
96944,1072317,1,7,6,1,0,65
96945,1072317,1,8,1,4,0,69
96946,1072317,1,8,2,2,0,71
96947,1072317,1,8,3,6,0,77
96948,1072317,1,8,4,0,0,77
96949,1072317,1,8,5,1,0,78
96950,1072317,1,8,6,1,0,79
96951,1072317,1,9,1,0,0,79
96952,1072317,1,9,2,2,0,81
96953,1072317,1,9,3,0,0,81
96954,1072317,1,9,4,1,0,82
96955,1072317,1,9,5,0,0,82
96956,1072317,1,9,6,6,0,88
96957,1072317,1,10,1,0,0,88
96958,1072317,1,10,2,2,0,90
96959,1072317,1,10,3,4,0,94
96960,1072317,1,10,4,0,1,94
96961,1072317,1,10,5,1,0,95
96962,1072317,1,10,6,1,0,96
96963,1072317,1,11,1,1,0,97
96964,1072317,1,11,2,0,0,97
96965,1072317,1,11,3,0,0,97
96966,1072317,1,11,4,1,0,98
96967,1072317,1,11,5,1,0,99
96968,1072317,1,11,6,4,0,103
96969,1072317,1,12,1,1,0,104
96970,1072317,1,12,2,1,0,105
96971,1072317,1,12,3,1,0,106
96972,1072317,1,12,4,0,0,106
96973,1072317,1,12,5,1,0,107
96974,1072317,1,12,6,0,0,107
96975,1072317,1,13,1,1,0,108
96976,1072317,1,13,2,1,1,109
96977,1072317,1,13,3,0,0,109
96978,1072317,1,13,4,1,0,110
96979,1072317,1,13,5,2,0,112
96980,1072317,1,13,6,1,0,113
96981,1072317,1,14,1,4,0,117
96982,1072317,1,14,2,1,0,118
96983,1072317,1,14,3,1,0,119
96984,1072317,1,14,4,0,0,119
96985,1072317,1,14,5,2,0,121
96986,1072317,1,14,6,1,0,122
96987,1072317,1,15,1,0,1,122
96988,1072317,1,15,2,0,0,122
96989,1072317,1,15,3,1,0,123
96990,1072317,1,15,4,1,0,124
96991,1072317,1,15,5,1,0,125
96992,1072317,1,15,6,0,0,125
96993,1072317,1,16,1,0,0,125
96994,1072317,1,16,2,1,0,126
96995,1072317,1,16,3,0,1,126
96996,1072317,1,16,4,0,1,126
96997,1072317,1,16,5,1,0,127
96998,1072317,1,16,6,0,0,127
96999,1072317,1,17,1,0,0,127
97000,1072317,1,17,2,0,0,127
97001,1072317,1,17,3,0,1,127
97002,1072317,1,17,4,2,0,129
97003,1072317,1,17,5,1,0,130
97004,1072317,1,17,6,6,0,136
97005,1072317,1,18,1,1,0,137
97006,1072317,1,18,2,0,1,137
97007,1072317,1,18,3,1,0,138
97008,1072317,1,18,4,1,0,139
97009,1072317,1,18,5,1,0,140
97010,1072317,1,18,6,0,0,140
97011,1072317,1,19,1,1,0,141
97012,1072317,1,19,2,0,0,141
97013,1072317,1,19,3,0,0,141
97014,1072317,1,19,4,1,0,142
97015,1072317,1,19,5,1,0,143
97016,1072317,1,19,6,0,0,143
97017,1072317,1,20,1,2,0,145
97018,1072317,1,20,2,1,0,146
97019,1072317,1,20,3,0,0,146
97020,1072317,1,20,4,2,0,148
97021,1072317,1,20,5,1,0,149
97022,1072317,1,20,6,6,0,155
97134,1072318,1,1,1,2,0,2
97135,1072318,1,1,2,1,0,3
97136,1072318,1,1,3,1,0,4
97137,1072318,1,1,4,3,0,7
97138,1072318,1,1,5,0,0,7
97139,1072318,1,1,6,5,0,12
97140,1072318,1,2,1,0,0,12
97141,1072318,1,2,2,0,1,12
97142,1072318,1,2,3,1,0,13
97143,1072318,1,2,4,0,0,13
97144,1072318,1,2,5,0,0,13
97145,1072318,1,2,6,2,0,15
97146,1072318,1,3,1,1,0,16
97147,1072318,1,3,2,0,1,16
97148,1072318,1,3,3,1,0,17
97149,1072318,1,3,4,1,0,18
97150,1072318,1,3,5,4,0,22
97151,1072318,1,3,6,4,0,26
97152,1072318,1,4,1,0,0,26
97153,1072318,1,4,2,2,0,28
97154,1072318,1,4,3,1,0,29
97155,1072318,1,4,4,1,0,30
97156,1072318,1,4,5,4,0,34
97157,1072318,1,4,6,0,1,34
97158,1072318,1,5,1,0,0,34
97159,1072318,1,5,2,0,0,34
97160,1072318,1,5,3,0,0,34
97161,1072318,1,5,4,0,0,34
97162,1072318,1,5,5,1,0,35
97163,1072318,1,5,6,1,0,36
97164,1072318,1,6,1,1,0,37
97165,1072318,1,6,2,0,0,37
97166,1072318,1,6,3,0,0,37
97167,1072318,1,6,4,4,0,41
97168,1072318,1,6,5,0,0,41
97169,1072318,1,6,6,1,0,42
97170,1072318,1,7,1,2,0,44
97171,1072318,1,7,2,1,0,45
97172,1072318,1,7,3,0,0,45
97173,1072318,1,7,4,0,0,45
97174,1072318,1,7,5,1,0,46
97175,1072318,1,7,6,3,0,49
97176,1072318,1,8,1,0,0,49
97177,1072318,1,8,2,1,0,50
97178,1072318,1,8,3,0,0,50
97179,1072318,1,8,4,0,0,50
97180,1072318,1,8,5,1,0,51
97181,1072318,1,8,6,2,0,53
97182,1072318,1,9,1,1,0,54
97183,1072318,1,9,2,1,0,55
97184,1072318,1,9,3,0,0,55
97185,1072318,1,9,4,1,0,56
97186,1072318,1,9,5,4,0,60
97187,1072318,1,9,6,1,0,61
97188,1072318,1,10,1,1,0,62
97189,1072318,1,10,2,1,0,63
97190,1072318,1,10,3,0,0,63
97191,1072318,1,10,4,1,0,64
97192,1072318,1,10,5,2,0,66
97193,1072318,1,10,6,1,0,67
97194,1072318,1,11,1,0,0,67
97195,1072318,1,11,2,1,0,68
97196,1072318,1,11,3,2,0,70
97197,1072318,1,11,4,0,1,70
97198,1072318,1,11,5,0,0,70
97199,1072318,1,11,6,0,0,70
97200,1072318,1,12,1,0,0,70
97201,1072318,1,12,2,0,0,70
97202,1072318,1,12,3,1,0,71
97203,1072318,1,12,4,0,0,71
97204,1072318,1,12,5,0,0,71
97205,1072318,1,12,6,1,0,72
97206,1072318,1,13,1,0,0,72
97207,1072318,1,13,2,0,0,72
97208,1072318,1,13,3,1,0,73
97209,1072318,1,13,4,0,0,73
97210,1072318,1,13,5,1,0,74
97211,1072318,1,13,6,0,0,74
97212,1072318,1,14,1,1,0,75
97213,1072318,1,14,2,1,0,76
97214,1072318,1,14,3,1,0,77
97215,1072318,1,14,4,6,0,83
97216,1072318,1,14,5,1,0,84
97217,1072318,1,14,6,0,0,84
97218,1072318,1,15,1,0,0,84
97219,1072318,1,15,2,1,0,85
97220,1072318,1,15,3,0,0,85
97221,1072318,1,15,4,2,0,87
97222,1072318,1,15,5,1,0,88
97223,1072318,1,15,6,0,0,88
97224,1072318,1,16,1,1,0,89
97225,1072318,1,16,2,4,0,93
97226,1072318,1,16,3,1,0,94
97227,1072318,1,16,4,0,0,94
97228,1072318,1,16,5,1,0,95
97229,1072318,1,16,6,0,0,95
97230,1072318,1,17,1,1,0,96
97231,1072318,1,17,2,5,0,101
97232,1072318,1,17,3,1,0,102
97233,1072318,1,17,4,0,0,102
97234,1072318,1,17,5,2,0,104
97235,1072318,1,17,6,1,0,105
97236,1072318,1,18,1,4,0,109
97237,1072318,1,18,2,4,0,113
97238,1072318,1,18,3,0,1,113
97239,1072318,1,18,4,4,0,117
97240,1072318,1,18,5,1,0,118
97241,1072318,1,18,6,2,0,120
97242,1072318,1,19,1,1,0,121
97243,1072318,1,19,2,1,0,122
97244,1072318,1,19,3,4,0,126
97245,1072318,1,19,4,0,0,126
97246,1072318,1,19,5,1,0,127
97247,1072318,1,19,6,2,0,129
97248,1072318,1,20,1,4,0,133
97249,1072318,1,20,2,0,1,133
97250,1072318,1,20,3,2,0,135
97251,1072318,1,20,4,1,0,136
97252,1072318,1,20,5,1,0,137
97253,1072318,1,20,6,0,1,137
97341,1072319,1,1,1,2,0,2
97342,1072319,1,1,2,0,0,2
97343,1072319,1,1,3,1,0,3
97344,1072319,1,1,4,0,0,3
97345,1072319,1,1,5,0,0,3
97346,1072319,1,1,6,1,0,4
97347,1072319,1,2,1,4,0,8
97348,1072319,1,2,2,1,0,9
97349,1072319,1,2,3,0,0,9
97350,1072319,1,2,4,0,0,9
97351,1072319,1,2,5,4,0,13
97352,1072319,1,2,6,4,0,17
97353,1072319,1,3,1,1,0,18
97354,1072319,1,3,2,4,0,22
97355,1072319,1,3,3,4,0,26
97356,1072319,1,3,4,0,0,26
97357,1072319,1,3,5,0,0,26
97358,1072319,1,3,6,0,0,26
97359,1072319,1,4,1,1,0,27
97360,1072319,1,4,2,1,0,28
97361,1072319,1,4,3,0,0,28
97362,1072319,1,4,4,0,0,28
97363,1072319,1,4,5,4,0,32
97364,1072319,1,4,6,1,0,33
97365,1072319,1,5,1,1,0,34
97366,1072319,1,5,2,4,0,38
97367,1072319,1,5,3,1,0,39
97368,1072319,1,5,4,0,1,39
97369,1072319,1,5,5,2,0,41
97370,1072319,1,5,6,1,0,42
97371,1072319,1,6,1,0,0,42
97372,1072319,1,6,2,1,0,43
97373,1072319,1,6,3,1,0,44
97374,1072319,1,6,4,1,0,45
97375,1072319,1,6,5,1,0,46
97376,1072319,1,6,6,4,0,50
97377,1072319,1,7,1,1,0,51
97378,1072319,1,7,2,1,0,52
97379,1072319,1,7,3,1,0,53
97380,1072319,1,7,4,1,0,54
97381,1072319,1,7,5,1,0,55
97382,1072319,1,7,6,1,0,56
97383,1072319,1,8,1,0,0,56
97384,1072319,1,8,2,1,0,57
97385,1072319,1,8,3,0,0,57
97386,1072319,1,8,4,1,0,58
97387,1072319,1,8,5,1,0,59
97388,1072319,1,8,6,1,0,60
97389,1072319,1,9,1,1,0,61
97390,1072319,1,9,2,1,0,62
97391,1072319,1,9,3,1,0,63
97392,1072319,1,9,4,1,0,64
97393,1072319,1,9,5,6,0,70
97394,1072319,1,9,6,1,0,71
97395,1072319,1,10,1,1,0,72
97396,1072319,1,10,2,0,0,72
97397,1072319,1,10,3,4,0,76
97398,1072319,1,10,4,2,0,78
97399,1072319,1,10,5,4,0,82
97400,1072319,1,10,6,1,0,83
97401,1072319,1,11,1,1,0,84
97402,1072319,1,11,2,1,0,85
97403,1072319,1,11,3,1,0,86
97404,1072319,1,11,4,6,0,92
97405,1072319,1,11,5,6,0,98
97406,1072319,1,11,6,1,0,99
97407,1072319,1,12,1,1,0,100
97408,1072319,1,12,2,0,0,100
97409,1072319,1,12,3,2,0,102
97410,1072319,1,12,4,2,0,104
97411,1072319,1,12,5,4,0,108
97412,1072319,1,12,6,1,0,109
97413,1072319,1,13,1,1,0,110
97414,1072319,1,13,2,0,0,110
97415,1072319,1,13,3,1,0,111
97416,1072319,1,13,4,1,0,112
97417,1072319,1,13,5,7,0,119
97418,1072319,1,13,6,0,0,119
97419,1072319,1,14,1,1,0,120
97420,1072319,1,14,2,0,0,120
97421,1072319,1,14,3,1,0,121
97422,1072319,1,14,4,0,1,121
97423,1072319,1,14,5,0,1,121
97424,1072319,1,14,6,1,0,122
97425,1072319,1,15,1,6,0,128
97426,1072319,1,15,2,1,0,129
97427,1072319,1,15,3,0,0,129
97428,1072319,1,15,4,2,0,131
97429,1072319,1,15,5,1,0,132
97430,1072319,1,15,6,2,0,134
97431,1072319,1,16,1,6,0,140
97432,1072319,1,16,2,6,0,146
97433,1072319,1,16,3,0,0,146
97434,1072319,1,16,4,3,0,149
97435,1072319,1,16,5,1,0,150
97436,1072319,1,16,6,4,0,154
97437,1072319,1,17,1,1,0,155
97438,1072319,1,17,2,2,0,157
97439,1072319,1,17,3,2,0,159
97440,1072319,1,17,4,1,0,160
97441,1072319,1,17,5,6,0,166
97442,1072319,1,17,6,0,0,166
97443,1072319,1,18,1,0,0,166
97444,1072319,1,18,2,0,0,166
97445,1072319,1,18,3,2,0,168
97446,1072319,1,18,4,1,0,169
97447,1072319,1,18,5,0,0,169
97448,1072319,1,18,6,0,1,169
97449,1072319,1,19,1,6,0,175
97450,1072319,1,19,2,0,0,175
97451,1072319,1,19,3,3,0,178
97452,1072319,1,19,4,1,0,179
97453,1072319,1,19,5,1,0,180
97454,1072319,1,19,6,1,1,181
97455,1072319,1,20,1,0,0,181
97456,1072319,1,20,2,2,0,183
97457,1072319,1,20,3,6,0,189
97458,1072319,1,20,4,6,0,195
97459,1072319,1,20,5,0,0,195
97460,1072319,1,20,6,1,0,196
97581,1072320,1,1,1,4,0,4
97582,1072320,1,1,2,0,0,4
97583,1072320,1,1,3,0,0,4
97584,1072320,1,1,4,2,0,6
97585,1072320,1,1,5,2,0,8
97586,1072320,1,1,6,4,0,12
97587,1072320,1,2,1,3,0,15
97588,1072320,1,2,2,4,0,19
97589,1072320,1,2,3,0,0,19
97590,1072320,1,2,4,0,0,19
97591,1072320,1,2,5,0,0,19
97592,1072320,1,2,6,6,0,25
97593,1072320,1,3,1,4,0,29
97594,1072320,1,3,2,0,0,29
97595,1072320,1,3,3,1,0,30
97596,1072320,1,3,4,0,0,30
97597,1072320,1,3,5,1,0,31
97598,1072320,1,3,6,0,0,31
97599,1072320,1,4,1,0,0,31
97600,1072320,1,4,2,6,0,37
97601,1072320,1,4,3,0,0,37
97602,1072320,1,4,4,1,0,38
97603,1072320,1,4,5,4,0,42
97604,1072320,1,4,6,1,0,43
97605,1072320,1,5,1,1,0,44
97606,1072320,1,5,2,1,0,45
97607,1072320,1,5,3,1,0,46
97608,1072320,1,5,4,6,0,52
97609,1072320,1,5,5,0,0,52
97610,1072320,1,5,6,4,0,56
97611,1072320,1,6,1,4,0,60
97612,1072320,1,6,2,0,0,60
97613,1072320,1,6,3,4,0,64
97614,1072320,1,6,4,2,0,66
97615,1072320,1,6,5,0,0,66
97616,1072320,1,6,6,1,0,67
97617,1072320,1,7,1,0,0,67
97618,1072320,1,7,2,1,0,68
97619,1072320,1,7,3,6,0,74
97620,1072320,1,7,4,1,0,75
97621,1072320,1,7,5,1,0,76
97622,1072320,1,7,6,0,0,76
97623,1072320,1,8,1,1,0,77
97624,1072320,1,8,2,0,0,77
97625,1072320,1,8,3,4,0,81
97626,1072320,1,8,4,1,0,82
97627,1072320,1,8,5,1,0,83
97628,1072320,1,8,6,1,0,84
97629,1072320,1,9,1,1,0,85
97630,1072320,1,9,2,1,0,86
97631,1072320,1,9,3,6,0,92
97632,1072320,1,9,4,0,0,92
97633,1072320,1,9,5,2,0,94
97634,1072320,1,9,6,1,0,95
97635,1072320,1,10,1,1,0,96
97636,1072320,1,10,2,6,0,102
97637,1072320,1,10,3,1,0,103
97638,1072320,1,10,4,6,0,109
97639,1072320,1,10,5,4,0,113
97640,1072320,1,10,6,1,0,114
97641,1072320,1,11,1,6,0,120
97642,1072320,1,11,2,6,0,126
97643,1072320,1,11,3,6,0,132
97644,1072320,1,11,4,0,1,132
97645,1072320,1,11,5,1,0,133
97646,1072320,1,11,6,6,0,139
97647,1072320,1,12,1,1,0,140
97648,1072320,1,12,2,1,0,141
97649,1072320,1,12,3,4,0,145
97650,1072320,1,12,4,2,0,147
97651,1072320,1,12,5,1,0,148
97652,1072320,1,12,6,4,0,152
97653,1072320,1,13,1,1,0,153
97654,1072320,1,13,2,0,0,153
97655,1072320,1,13,3,1,0,154
97656,1072320,1,13,4,1,0,155
97657,1072320,1,13,5,0,1,155
97658,1072320,1,13,6,1,0,156
97659,1072320,1,14,1,1,0,157
97660,1072320,1,14,2,0,0,157
97661,1072320,1,14,3,1,0,158
97662,1072320,1,14,4,1,0,159
97663,1072320,1,14,5,1,0,160
97664,1072320,1,14,6,6,0,166
97665,1072320,1,15,1,1,0,167
97666,1072320,1,15,2,0,0,167
97667,1072320,1,15,3,6,0,173
97668,1072320,1,15,4,4,0,177
97669,1072320,1,15,5,6,0,183
97670,1072320,1,15,6,1,0,184
97671,1072320,1,16,1,13,0,197
97672,1072320,1,16,2,1,0,198
97673,1072320,1,16,3,1,0,199
97674,1072320,1,16,4,1,0,200
97675,1072320,1,16,5,2,0,202
97676,1072320,1,16,6,4,0,206
97677,1072320,1,17,1,1,0,207
97678,1072320,1,17,2,2,0,209
97679,1072320,1,17,3,2,0,211
97680,1072320,1,17,4,1,1,212
97681,1072320,1,17,5,0,0,212
97682,1072320,1,17,6,2,0,214
97683,1072320,1,18,1,1,0,215
97684,1072320,1,18,2,3,0,218
97685,1072320,1,18,3,0,0,218
97686,1072320,1,18,4,1,0,219
97687,1072320,1,18,5,1,0,220
97688,1072320,1,18,6,0,1,220
97689,1072320,1,19,1,2,0,222
97690,1072320,1,19,2,0,1,222
97691,1072320,1,19,3,1,0,223
97692,1072320,1,19,4,1,0,224
97693,1072320,1,19,5,0,1,224
97694,1072320,1,19,6,1,0,225
97695,1072320,1,20,1,1,0,226
97696,1072320,1,20,2,0,0,226
97697,1072320,1,20,3,1,0,227
97698,1072320,1,20,4,2,0,229
97699,1072320,1,20,5,6,0,235
97700,1072320,1,20,6,8,0,243
97814,1072321,1,1,1,0,0,0
97815,1072321,1,1,2,0,0,0
97816,1072321,1,1,3,6,0,6
97817,1072321,1,1,4,4,0,10
97818,1072321,1,1,5,0,0,10
97819,1072321,1,1,6,1,0,11
97820,1072321,1,2,1,2,0,13
97821,1072321,1,2,2,1,0,14
97822,1072321,1,2,3,4,0,18
97823,1072321,1,2,4,4,0,22
97824,1072321,1,2,5,0,0,22
97825,1072321,1,2,6,0,0,22
97826,1072321,1,3,1,0,0,22
97827,1072321,1,3,2,0,0,22
97828,1072321,1,3,3,0,1,22
97829,1072321,1,3,4,1,0,23
97830,1072321,1,3,5,0,0,23
97831,1072321,1,3,6,1,0,24
97832,1072321,1,4,1,0,1,24
97833,1072321,1,4,2,0,0,24
97834,1072321,1,4,3,0,0,24
97835,1072321,1,4,4,0,0,24
97836,1072321,1,4,5,1,0,25
97837,1072321,1,4,6,2,0,27
97838,1072321,1,5,1,1,0,28
97839,1072321,1,5,2,4,0,32
97840,1072321,1,5,3,4,0,36
97841,1072321,1,5,4,0,0,36
97842,1072321,1,5,5,0,0,36
97843,1072321,1,5,6,1,0,37
97844,1072321,1,6,1,1,0,38
97845,1072321,1,6,2,1,0,39
97846,1072321,1,6,3,1,0,40
97847,1072321,1,6,4,1,0,41
97848,1072321,1,6,5,0,0,41
97849,1072321,1,6,6,0,0,41
97850,1072321,1,7,1,1,0,42
97851,1072321,1,7,2,6,0,48
97852,1072321,1,7,3,1,0,49
97853,1072321,1,7,4,6,0,55
97854,1072321,1,7,5,1,0,56
97855,1072321,1,7,6,1,0,57
97856,1072321,1,8,1,0,0,57
97857,1072321,1,8,2,2,0,59
97858,1072321,1,8,3,0,0,59
97859,1072321,1,8,4,0,0,59
97860,1072321,1,8,5,0,0,59
97861,1072321,1,8,6,1,0,60
97862,1072321,1,9,1,1,0,61
97863,1072321,1,9,2,1,0,62
97864,1072321,1,9,3,6,0,68
97865,1072321,1,9,4,1,0,69
97866,1072321,1,9,5,1,0,70
97867,1072321,1,9,6,1,0,71
97868,1072321,1,10,1,6,0,77
97869,1072321,1,10,2,1,0,78
97870,1072321,1,10,3,1,0,79
97871,1072321,1,10,4,6,0,85
97872,1072321,1,10,5,0,0,85
97873,1072321,1,10,6,0,0,85
97874,1072321,1,11,1,4,0,89
97875,1072321,1,11,2,5,0,94
97876,1072321,1,11,3,4,0,98
97877,1072321,1,11,4,6,0,104
97878,1072321,1,11,5,2,0,106
97879,1072321,1,11,6,0,0,106
97880,1072321,1,12,1,0,0,106
97881,1072321,1,12,2,2,0,108
97882,1072321,1,12,3,8,0,116
97883,1072321,1,12,4,0,0,116
97884,1072321,1,12,5,0,0,116
97885,1072321,1,12,6,1,0,117
97886,1072321,1,13,1,0,1,117
97887,1072321,1,13,2,1,0,118
97888,1072321,1,13,3,1,0,119
97889,1072321,1,13,4,1,0,120
97890,1072321,1,13,5,0,0,120
97891,1072321,1,13,6,0,0,120
97892,1072321,1,14,1,1,0,121
97893,1072321,1,14,2,1,0,122
97894,1072321,1,14,3,0,0,122
97895,1072321,1,14,4,0,0,122
97896,1072321,1,14,5,1,0,123
97897,1072321,1,14,6,0,1,123
97898,1072321,1,15,1,1,0,124
97899,1072321,1,15,2,1,0,125
97900,1072321,1,15,3,1,0,126
97901,1072321,1,15,4,1,0,127
97902,1072321,1,15,5,0,0,127
97903,1072321,1,15,6,0,0,127
97904,1072321,1,16,1,1,0,128
97905,1072321,1,16,2,1,0,129
97906,1072321,1,16,3,1,0,130
97907,1072321,1,16,4,1,0,131
97908,1072321,1,16,5,1,0,132
97909,1072321,1,16,6,1,0,133
97910,1072321,1,17,1,6,0,139
97911,1072321,1,17,2,1,0,140
97912,1072321,1,17,3,1,0,141
97913,1072321,1,17,4,6,0,147
97914,1072321,1,17,5,1,0,148
97915,1072321,1,17,6,0,0,148
97916,1072321,1,18,1,6,0,154
97917,1072321,1,18,2,4,0,158
97918,1072321,1,18,3,6,0,164
97919,1072321,1,18,4,1,0,165
97920,1072321,1,18,5,0,1,165
97921,1072321,1,18,6,1,0,166
97922,1072321,1,19,1,4,0,170
97923,1072321,1,19,2,1,0,171
97924,1072321,1,19,3,0,0,171
97925,1072321,1,19,4,1,0,172
97926,1072321,1,19,5,4,0,176
97927,1072321,1,19,6,0,1,176
97928,1072321,1,20,1,1,0,177
97929,1072321,1,20,2,6,0,183
97930,1072321,1,20,3,4,0,187
97931,1072321,1,20,4,0,1,187
97932,1072321,1,20,5,1,0,188
97933,1072321,1,20,6,6,0,194
98054,1072322,1,1,1,2,0,2
98055,1072322,1,1,2,1,0,3
98056,1072322,1,1,3,0,0,3
98057,1072322,1,1,4,1,0,4
98058,1072322,1,1,5,6,0,10
98059,1072322,1,1,6,2,0,12
98060,1072322,1,2,1,1,0,13
98061,1072322,1,2,2,0,0,13
98062,1072322,1,2,3,4,0,17
98063,1072322,1,2,4,0,0,17
98064,1072322,1,2,5,4,0,21
98065,1072322,1,2,6,1,0,22
98066,1072322,1,3,1,1,0,23
98067,1072322,1,3,2,4,0,27
98068,1072322,1,3,3,4,0,31
98069,1072322,1,3,4,4,0,35
98070,1072322,1,3,5,1,0,36
98071,1072322,1,3,6,1,0,37
98072,1072322,1,4,1,6,0,43
98073,1072322,1,4,2,0,0,43
98074,1072322,1,4,3,1,0,44
98075,1072322,1,4,4,1,0,45
98076,1072322,1,4,5,1,0,46
98077,1072322,1,4,6,0,0,46
98078,1072322,1,5,1,1,0,47
98079,1072322,1,5,2,1,0,48
98080,1072322,1,5,3,0,1,48
98081,1072322,1,5,4,1,0,49
98082,1072322,1,5,5,4,0,53
98083,1072322,1,5,6,0,0,53
98084,1072322,1,6,1,6,0,59
98085,1072322,1,6,2,0,1,59
98086,1072322,1,6,3,0,0,59
98087,1072322,1,6,4,0,0,59
98088,1072322,1,6,5,0,0,59
98089,1072322,1,6,6,4,0,63
98090,1072322,1,7,1,0,0,63
98091,1072322,1,7,2,1,0,64
98092,1072322,1,7,3,1,0,65
98093,1072322,1,7,4,1,0,66
98094,1072322,1,7,5,0,0,66
98095,1072322,1,7,6,2,0,68
98096,1072322,1,8,1,1,0,69
98097,1072322,1,8,2,1,0,70
98098,1072322,1,8,3,2,0,72
98099,1072322,1,8,4,0,1,72
98100,1072322,1,8,5,1,0,73
98101,1072322,1,8,6,0,1,73
98102,1072322,1,9,1,2,0,75
98103,1072322,1,9,2,1,0,76
98104,1072322,1,9,3,2,0,78
98105,1072322,1,9,4,2,0,80
98106,1072322,1,9,5,4,0,84
98107,1072322,1,9,6,1,0,85
98108,1072322,1,10,1,1,0,86
98109,1072322,1,10,2,4,0,90
98110,1072322,1,10,3,0,0,90
98111,1072322,1,10,4,1,0,91
98112,1072322,1,10,5,0,1,91
98113,1072322,1,10,6,1,0,92
98114,1072322,1,11,1,1,0,93
98115,1072322,1,11,2,0,1,93
98116,1072322,1,11,3,0,0,93
98117,1072322,1,11,4,0,0,93
98118,1072322,1,11,5,0,0,93
98119,1072322,1,11,6,1,0,94
98120,1072322,1,12,1,1,0,95
98121,1072322,1,12,2,0,0,95
98122,1072322,1,12,3,2,0,97
98123,1072322,1,12,4,1,0,98
98124,1072322,1,12,5,1,0,99
98125,1072322,1,12,6,1,0,100
98126,1072322,1,13,1,0,0,100
98127,1072322,1,13,2,1,0,101
98128,1072322,1,13,3,0,0,101
98129,1072322,1,13,4,0,1,101
98130,1072322,1,13,5,1,0,102
98131,1072322,1,13,6,1,0,103
98132,1072322,1,14,1,2,0,105
98133,1072322,1,14,2,1,0,106
98134,1072322,1,14,3,4,0,110
98135,1072322,1,14,4,0,1,110
98136,1072322,1,14,5,1,0,111
98137,1072322,1,14,6,0,0,111
98138,1072322,1,15,1,2,0,113
98139,1072322,1,15,2,1,0,114
98140,1072322,1,15,3,0,0,114
98141,1072322,1,15,4,0,0,114
98142,1072322,1,15,5,1,0,115
98143,1072322,1,15,6,1,0,116
98144,1072322,1,16,1,1,0,117
98145,1072322,1,16,2,1,0,118
98146,1072322,1,16,3,0,0,118
98147,1072322,1,16,4,1,0,119
98148,1072322,1,16,5,0,0,119
98149,1072322,1,16,6,1,0,120
98150,1072322,1,17,1,0,0,120
98151,1072322,1,17,2,1,0,121
98152,1072322,1,17,3,4,0,125
98153,1072322,1,17,4,1,0,126
98154,1072322,1,17,5,0,0,126
98155,1072322,1,17,6,1,0,127
98156,1072322,1,18,1,0,0,127
98157,1072322,1,18,2,1,0,128
98158,1072322,1,18,3,0,0,128
98159,1072322,1,18,4,0,0,128
98160,1072322,1,18,5,0,0,128
98161,1072322,1,18,6,1,0,129
98162,1072322,1,19,1,6,0,135
98163,1072322,1,19,2,0,0,135
98164,1072322,1,19,3,0,0,135
98165,1072322,1,19,4,2,0,137
98166,1072322,1,19,5,3,0,140
98167,1072322,1,19,6,0,0,140
98168,1072322,1,20,1,6,0,146
98169,1072322,1,20,2,1,0,147
98170,1072322,1,20,3,1,0,148
98171,1072322,1,20,4,0,1,148
98172,1072322,1,20,5,1,0,149
98173,1072322,1,20,6,1,0,150
98262,1074958,1,1,1,1,0,1
98263,1074958,1,1,2,0,0,1
98264,1074958,1,1,3,0,0,1
98265,1074958,1,1,4,2,0,3
98266,1074958,1,1,5,0,0,3
98267,1074958,1,1,6,0,0,3
98268,1074958,1,2,1,0,0,3
98269,1074958,1,2,2,4,0,7
98270,1074958,1,2,3,0,0,7
98271,1074958,1,2,4,1,0,8
98272,1074958,1,2,5,1,0,9
98273,1074958,1,2,6,0,0,9
98274,1074958,1,3,1,0,0,9
98275,1074958,1,3,2,0,0,9
98276,1074958,1,3,3,0,0,9
98277,1074958,1,3,4,4,0,13
98278,1074958,1,3,5,2,0,15
98279,1074958,1,3,6,4,0,19
98280,1074958,1,4,1,0,0,19
98281,1074958,1,4,2,1,0,20
98282,1074958,1,4,3,1,0,21
98283,1074958,1,4,4,4,0,25
98284,1074958,1,4,5,0,0,25
98285,1074958,1,4,6,2,0,27
98286,1074958,1,5,1,0,0,27
98287,1074958,1,5,2,4,0,31
98288,1074958,1,5,3,0,0,31
98289,1074958,1,5,4,0,0,31
98290,1074958,1,5,5,1,0,32
98291,1074958,1,5,6,4,0,36
98292,1074958,1,6,1,0,0,36
98293,1074958,1,6,2,0,1,36
98294,1074958,1,6,3,2,0,38
98295,1074958,1,6,4,4,0,42
98296,1074958,1,6,5,0,0,42
98297,1074958,1,6,6,0,0,42
98298,1074958,1,7,1,2,0,44
98299,1074958,1,7,2,1,0,45
98300,1074958,1,7,3,1,0,46
98301,1074958,1,7,4,0,0,46
98302,1074958,1,7,5,0,0,46
98303,1074958,1,7,6,1,0,47
98304,1074958,1,8,1,1,0,48
98305,1074958,1,8,2,1,0,49
98306,1074958,1,8,3,1,0,50
98307,1074958,1,8,4,1,0,51
98308,1074958,1,8,5,0,0,51
98309,1074958,1,8,6,0,0,51
98310,1074958,1,9,1,1,0,52
98311,1074958,1,9,2,1,0,53
98312,1074958,1,9,3,1,0,54
98313,1074958,1,9,4,1,0,55
98314,1074958,1,9,5,1,0,56
98315,1074958,1,9,6,0,1,56
98316,1074958,1,10,1,0,0,56
98317,1074958,1,10,2,2,0,58
98318,1074958,1,10,3,1,0,59
98319,1074958,1,10,4,0,0,59
98320,1074958,1,10,5,4,0,63
98321,1074958,1,10,6,0,0,63
98322,1074958,1,11,1,0,0,63
98323,1074958,1,11,2,2,0,65
98324,1074958,1,11,3,1,0,66
98325,1074958,1,11,4,0,0,66
98326,1074958,1,11,5,1,0,67
98327,1074958,1,11,6,0,1,67
98328,1074958,1,12,1,1,0,68
98329,1074958,1,12,2,0,0,68
98330,1074958,1,12,3,0,0,68
98331,1074958,1,12,4,1,0,69
98332,1074958,1,12,5,2,0,71
98333,1074958,1,12,6,4,0,75
98334,1074958,1,13,1,1,0,76
98335,1074958,1,13,2,0,1,76
98336,1074958,1,13,3,0,0,76
98337,1074958,1,13,4,0,0,76
98338,1074958,1,13,5,3,0,79
98339,1074958,1,13,6,0,0,79
98340,1074958,1,14,1,1,0,80
98341,1074958,1,14,2,0,0,80
98342,1074958,1,14,3,1,0,81
98343,1074958,1,14,4,4,0,85
98344,1074958,1,14,5,1,0,86
98345,1074958,1,14,6,0,0,86
98346,1074958,1,15,1,0,0,86
98347,1074958,1,15,2,0,0,86
98348,1074958,1,15,3,2,0,88
98349,1074958,1,15,4,1,0,89
98350,1074958,1,15,5,1,0,90
98351,1074958,1,15,6,1,0,91
98352,1074958,1,16,1,2,0,93
98353,1074958,1,16,2,1,0,94
98354,1074958,1,16,3,1,0,95
98355,1074958,1,16,4,4,0,99
98356,1074958,1,16,5,1,0,100
98357,1074958,1,16,6,0,1,100
98358,1074958,1,17,1,2,0,102
98359,1074958,1,17,2,0,1,102
98360,1074958,1,17,3,1,0,103
98361,1074958,1,17,4,1,0,104
98362,1074958,1,17,5,2,0,106
98363,1074958,1,17,6,1,0,107
98364,1074958,1,18,1,1,0,108
98365,1074958,1,18,2,0,0,108
98366,1074958,1,18,3,0,0,108
98367,1074958,1,18,4,1,0,109
98368,1074958,1,18,5,1,0,110
98369,1074958,1,18,6,4,0,114
98370,1074958,1,19,1,4,0,118
98371,1074958,1,19,2,2,0,120
98372,1074958,1,19,3,1,0,121
98373,1074958,1,19,4,0,0,121
98374,1074958,1,19,5,0,0,121
98375,1074958,1,19,6,0,0,121
98376,1074958,1,20,1,1,0,122
98377,1074958,1,20,2,0,0,122
98378,1074958,1,20,3,0,0,122
98379,1074958,1,20,4,1,0,123
98380,1074958,1,20,5,1,0,124
98381,1074958,1,20,6,1,0,125
98494,1074971,1,1,1,0,0,0
98495,1074971,1,1,2,0,0,0
98496,1074971,1,1,3,0,0,0
98497,1074971,1,1,4,2,0,2
98498,1074971,1,1,5,4,0,6
98499,1074971,1,1,6,0,0,6
98500,1074971,1,2,1,4,0,10
98501,1074971,1,2,2,4,0,14
98502,1074971,1,2,3,0,1,14
98503,1074971,1,2,4,2,0,16
98504,1074971,1,2,5,0,0,16
98505,1074971,1,2,6,6,0,22
98506,1074971,1,3,1,0,0,22
98507,1074971,1,3,2,0,0,22
98508,1074971,1,3,3,1,0,23
98509,1074971,1,3,4,1,0,24
98510,1074971,1,3,5,1,0,25
98511,1074971,1,3,6,1,0,26
98512,1074971,1,4,1,1,0,27
98513,1074971,1,4,2,4,0,31
98514,1074971,1,4,3,1,0,32
98515,1074971,1,4,4,0,0,32
98516,1074971,1,4,5,0,1,32
98517,1074971,1,4,6,0,0,32
98518,1074971,1,5,1,2,0,34
98519,1074971,1,5,2,0,0,34
98520,1074971,1,5,3,1,0,35
98521,1074971,1,5,4,1,0,36
98522,1074971,1,5,5,0,0,36
98523,1074971,1,5,6,1,0,37
98524,1074971,1,6,1,0,1,37
98525,1074971,1,6,2,0,0,37
98526,1074971,1,6,3,4,0,41
98527,1074971,1,6,4,0,0,41
98528,1074971,1,6,5,0,1,41
98529,1074971,1,6,6,0,0,41
98530,1074971,1,7,1,1,0,42
98531,1074971,1,7,2,1,0,43
98532,1074971,1,7,3,1,0,44
98533,1074971,1,7,4,0,0,44
98534,1074971,1,7,5,1,0,45
98535,1074971,1,7,6,1,0,46
98536,1074971,1,8,1,0,0,46
98537,1074971,1,8,2,0,0,46
98538,1074971,1,8,3,0,1,46
98539,1074971,1,8,4,0,0,46
98540,1074971,1,8,5,0,1,46
98541,1074971,1,8,6,1,0,47
98542,1074971,1,9,1,0,0,47
98543,1074971,1,9,2,2,0,49
98544,1074971,1,9,3,1,0,50
98545,1074971,1,9,4,0,0,50
98546,1074971,1,9,5,1,0,51
98547,1074971,1,9,6,0,0,51
98548,1074971,1,10,1,0,0,51
98549,1074971,1,10,2,0,0,51
98550,1074971,1,10,3,1,0,52
98551,1074971,1,10,4,0,0,52
98552,1074971,1,10,5,4,0,56
98553,1074971,1,10,6,0,0,56
98554,1074971,1,11,1,0,0,56
98555,1074971,1,11,2,2,0,58
98556,1074971,1,11,3,0,0,58
98557,1074971,1,11,4,1,0,59
98558,1074971,1,11,5,0,0,59
98559,1074971,1,11,6,1,0,60
98560,1074971,1,12,1,0,0,60
98561,1074971,1,12,2,1,0,61
98562,1074971,1,12,3,1,0,62
98563,1074971,1,12,4,1,0,63
98564,1074971,1,12,5,0,1,63
98565,1074971,1,12,6,2,0,65
98566,1074971,1,13,1,0,1,65
98567,1074971,1,13,2,0,0,65
98568,1074971,1,13,3,1,0,66
98569,1074971,1,13,4,2,0,68
98570,1074971,1,13,5,0,1,68
98571,1074971,1,13,6,2,0,70
98572,1074971,1,14,1,1,0,71
98573,1074971,1,14,2,0,1,71
98621,1075507,1,1,1,1,0,1
98622,1075507,1,1,2,1,0,2
98623,1075507,1,1,3,4,0,6
98624,1075507,1,1,4,1,0,7
98625,1075507,1,1,5,1,0,8
98626,1075507,1,1,6,2,0,10
98627,1075507,1,2,1,1,0,11
98628,1075507,1,2,2,0,0,11
98629,1075507,1,2,3,2,0,13
98630,1075507,1,2,4,4,0,17
98631,1075507,1,2,5,1,0,18
98632,1075507,1,2,6,0,1,18
98633,1075507,1,3,1,0,0,18
98634,1075507,1,3,2,1,0,19
98635,1075507,1,3,3,0,0,19
98636,1075507,1,3,4,1,0,20
98637,1075507,1,3,5,4,0,24
98638,1075507,1,3,6,2,0,26
98639,1075507,1,4,1,4,0,30
98640,1075507,1,4,2,0,0,30
98641,1075507,1,4,3,0,0,30
98642,1075507,1,4,4,1,0,31
98643,1075507,1,4,5,1,0,32
98644,1075507,1,4,6,1,0,33
98645,1075507,1,5,1,4,0,37
98646,1075507,1,5,2,1,0,38
98647,1075507,1,5,3,0,0,38
98648,1075507,1,5,4,0,0,38
98649,1075507,1,5,5,5,0,43
98650,1075507,1,5,6,4,0,47
98651,1075507,1,6,1,1,0,48
98652,1075507,1,6,2,4,0,52
98653,1075507,1,6,3,1,0,53
98654,1075507,1,6,4,4,0,57
98655,1075507,1,6,5,4,0,61
98656,1075507,1,6,6,4,0,65
98657,1075507,1,7,1,1,0,66
98658,1075507,1,7,2,0,0,66
98659,1075507,1,7,3,2,0,68
98660,1075507,1,7,4,4,0,72
98661,1075507,1,7,5,4,0,76
98662,1075507,1,7,6,1,0,77
98663,1075507,1,8,1,1,0,78
98664,1075507,1,8,2,1,0,79
98665,1075507,1,8,3,1,0,80
98666,1075507,1,8,4,1,0,81
98667,1075507,1,8,5,1,0,82
98668,1075507,1,8,6,1,0,83
98669,1075507,1,9,1,1,0,84
98670,1075507,1,9,2,1,0,85
98671,1075507,1,9,3,1,0,86
98672,1075507,1,9,4,2,0,88
98673,1075507,1,9,5,1,0,89
98674,1075507,1,9,6,1,0,90
98675,1075507,1,10,1,1,0,91
98676,1075507,1,10,2,2,0,93
98677,1075507,1,10,3,1,0,94
98678,1075507,1,10,4,1,0,95
98679,1075507,1,10,5,2,0,97
98680,1075507,1,10,6,0,1,97
98681,1075507,1,11,1,1,0,98
98682,1075507,1,11,2,1,0,99
98683,1075507,1,11,3,0,0,99
98684,1075507,1,11,4,2,0,101
98685,1075507,1,11,5,1,0,102
98686,1075507,1,11,6,0,0,102
98687,1075507,1,12,1,1,0,103
98688,1075507,1,12,2,0,0,103
98689,1075507,1,12,3,6,0,109
98690,1075507,1,12,4,2,0,111
98691,1075507,1,12,5,0,0,111
98692,1075507,1,12,6,1,0,112
98693,1075507,1,13,1,2,0,114
98694,1075507,1,13,2,1,0,115
98695,1075507,1,13,3,6,0,121
98696,1075507,1,13,4,1,0,122
98697,1075507,1,13,5,0,1,122
98698,1075507,1,13,6,1,0,123
98699,1075507,1,14,1,1,0,124
98700,1075507,1,14,2,2,0,126
98701,1075507,1,14,3,1,0,127
98702,1075507,1,14,4,1,0,128
98703,1075507,1,14,5,1,0,129
98704,1075507,1,14,6,1,0,130
98705,1075507,1,15,1,0,0,130
98706,1075507,1,15,2,0,0,130
98707,1075507,1,15,3,1,0,131
98708,1075507,1,15,4,0,0,131
98709,1075507,1,15,5,1,0,132
98710,1075507,1,15,6,1,1,133
98711,1075507,1,16,1,1,0,134
98712,1075507,1,16,2,2,0,136
98713,1075507,1,16,3,4,0,140
98714,1075507,1,16,4,1,0,141
98715,1075507,1,16,5,1,0,142
98716,1075507,1,16,6,2,0,144
98717,1075507,1,17,1,1,0,145
98718,1075507,1,17,2,6,0,151
98719,1075507,1,17,3,2,0,153
98720,1075507,1,17,4,1,0,154
98721,1075507,1,17,5,1,0,155
98722,1075507,1,17,6,2,0,157
98723,1075507,1,18,1,1,0,158
98724,1075507,1,18,2,2,0,160
98725,1075507,1,18,3,1,0,161
98726,1075507,1,18,4,2,0,163
98727,1075507,1,18,5,2,0,165
98728,1075507,1,18,6,6,0,171
98729,1075507,1,19,1,2,0,173
98730,1075507,1,19,2,4,0,177
98731,1075507,1,19,3,1,0,178
98732,1075507,1,19,4,2,0,180
98733,1075507,1,19,5,0,0,180
98734,1075507,1,19,6,6,0,186
98735,1075507,1,20,1,1,0,187
98736,1075507,1,20,2,4,0,191
98737,1075507,1,20,3,1,0,192
98738,1075507,1,20,4,1,0,193
98739,1075507,1,20,5,1,0,194
98740,1075507,1,20,6,1,0,195
98861,1075508,1,1,1,0,0,0
98862,1075508,1,1,2,0,0,0
98863,1075508,1,1,3,0,0,0
98864,1075508,1,1,4,4,0,4
98865,1075508,1,1,5,1,0,5
98866,1075508,1,1,6,4,0,9
98867,1075508,1,2,1,2,0,11
98868,1075508,1,2,2,0,0,11
98869,1075508,1,2,3,4,0,15
98870,1075508,1,2,4,1,0,16
98871,1075508,1,2,5,1,0,17
98872,1075508,1,2,6,6,0,23
98873,1075508,1,3,1,0,0,23
98874,1075508,1,3,2,0,0,23
98875,1075508,1,3,3,0,1,23
98876,1075508,1,3,4,0,0,23
98877,1075508,1,3,5,1,0,24
98878,1075508,1,3,6,1,0,25
98879,1075508,1,4,1,1,0,26
98880,1075508,1,4,2,1,0,27
98881,1075508,1,4,3,2,0,29
98882,1075508,1,4,4,1,0,30
98883,1075508,1,4,5,0,0,30
98884,1075508,1,4,6,0,0,30
98885,1075508,1,5,1,4,0,34
98886,1075508,1,5,2,0,0,34
98887,1075508,1,5,3,1,0,35
98888,1075508,1,5,4,2,0,37
98889,1075508,1,5,5,0,0,37
98890,1075508,1,5,6,0,1,37
98891,1075508,1,6,1,1,0,38
98892,1075508,1,6,2,1,0,39
98893,1075508,1,6,3,1,0,40
98894,1075508,1,6,4,0,0,40
98895,1075508,1,6,5,1,0,41
98896,1075508,1,6,6,4,0,45
98897,1075508,1,7,1,1,0,46
98898,1075508,1,7,2,1,0,47
98899,1075508,1,7,3,0,0,47
98900,1075508,1,7,4,1,0,48
98901,1075508,1,7,5,0,0,48
98902,1075508,1,7,6,1,0,49
98903,1075508,1,8,1,4,0,53
98904,1075508,1,8,2,1,0,54
98905,1075508,1,8,3,6,0,60
98906,1075508,1,8,4,4,0,64
98907,1075508,1,8,5,1,0,65
98908,1075508,1,8,6,1,0,66
98909,1075508,1,9,1,1,0,67
98910,1075508,1,9,2,1,0,68
98911,1075508,1,9,3,1,0,69
98912,1075508,1,9,4,1,0,70
98913,1075508,1,9,5,0,0,70
98914,1075508,1,9,6,4,0,74
98915,1075508,1,10,1,0,0,74
98916,1075508,1,10,2,1,0,75
98917,1075508,1,10,3,1,0,76
98918,1075508,1,10,4,2,0,78
98919,1075508,1,10,5,0,1,78
98920,1075508,1,10,6,0,0,78
98921,1075508,1,11,1,1,0,79
98922,1075508,1,11,2,0,0,79
98923,1075508,1,11,3,1,0,80
98924,1075508,1,11,4,1,0,81
98925,1075508,1,11,5,1,0,82
98926,1075508,1,11,6,1,0,83
98927,1075508,1,12,1,1,0,84
98928,1075508,1,12,2,2,0,86
98929,1075508,1,12,3,1,0,87
98930,1075508,1,12,4,2,0,89
98931,1075508,1,12,5,2,0,91
98932,1075508,1,12,6,4,0,95
98933,1075508,1,13,1,4,0,99
98934,1075508,1,13,2,0,0,99
98935,1075508,1,13,3,1,0,100
98936,1075508,1,13,4,2,0,102
98937,1075508,1,13,5,2,0,104
98938,1075508,1,13,6,4,0,108
98939,1075508,1,14,1,2,0,110
98940,1075508,1,14,2,4,0,114
98941,1075508,1,14,3,1,0,115
98942,1075508,1,14,4,4,0,119
98943,1075508,1,14,5,4,0,123
98944,1075508,1,14,6,1,0,124
98945,1075508,1,15,1,1,0,125
98946,1075508,1,15,2,1,0,126
98947,1075508,1,15,3,1,0,127
98948,1075508,1,15,4,0,0,127
98949,1075508,1,15,5,6,0,133
98950,1075508,1,15,6,1,0,134
98951,1075508,1,16,1,1,0,135
98952,1075508,1,16,2,4,0,139
98953,1075508,1,16,3,1,0,140
98954,1075508,1,16,4,4,0,144
98955,1075508,1,16,5,6,0,150
98956,1075508,1,16,6,7,0,157
98957,1075508,1,17,1,0,0,157
98958,1075508,1,17,2,0,0,157
98959,1075508,1,17,3,0,1,157
98960,1075508,1,17,4,4,0,161
98961,1075508,1,17,5,1,0,162
98962,1075508,1,17,6,1,0,163
98963,1075508,1,18,1,2,0,165
98964,1075508,1,18,2,1,0,166
98965,1075508,1,18,3,5,0,171
98966,1075508,1,18,4,6,0,177
98967,1075508,1,18,5,1,0,178
98968,1075508,1,18,6,0,0,178
98969,1075508,1,19,1,6,0,184
98970,1075508,1,19,2,6,0,190
98971,1075508,1,19,3,6,0,196
98972,1075508,1,19,4,6,0,202
98973,1075508,1,19,5,6,0,208
98974,1075508,1,19,6,1,0,209
98975,1075508,1,20,1,4,0,213
98976,1075508,1,20,2,4,0,217
98977,1075508,1,20,3,2,0,219
98978,1075508,1,20,4,2,0,221
98979,1075508,1,20,5,1,0,222
98980,1075508,1,20,6,2,0,224
99092,1077947,1,1,1,0,0,0
99093,1077947,1,1,2,1,0,1
99094,1077947,1,1,3,0,0,1
99095,1077947,1,1,4,0,0,1
99096,1077947,1,1,5,1,0,2
99097,1077947,1,1,6,1,0,3
99098,1077947,1,2,1,0,0,3
99099,1077947,1,2,2,1,0,4
99100,1077947,1,2,3,1,0,5
99101,1077947,1,2,4,0,0,5
99102,1077947,1,2,5,6,0,11
99103,1077947,1,2,6,1,0,12
99104,1077947,1,3,1,0,0,12
99105,1077947,1,3,2,1,1,13
99106,1077947,1,3,3,0,0,13
99107,1077947,1,3,4,1,0,14
99108,1077947,1,3,5,0,0,14
99109,1077947,1,3,6,4,0,18
99110,1077947,1,4,1,0,0,18
99111,1077947,1,4,2,1,0,19
99112,1077947,1,4,3,1,0,20
99113,1077947,1,4,4,0,0,20
99114,1077947,1,4,5,0,0,20
99115,1077947,1,4,6,0,0,20
99116,1077947,1,5,1,0,0,20
99117,1077947,1,5,2,0,0,20
99118,1077947,1,5,3,6,0,26
99119,1077947,1,5,4,0,0,26
99120,1077947,1,5,5,2,0,28
99121,1077947,1,5,6,0,0,28
99122,1077947,1,6,1,4,0,32
99123,1077947,1,6,2,0,0,32
99124,1077947,1,6,3,0,0,32
99125,1077947,1,6,4,0,0,32
99126,1077947,1,6,5,1,0,33
99127,1077947,1,6,6,1,0,34
99128,1077947,1,7,1,1,0,35
99129,1077947,1,7,2,0,0,35
99130,1077947,1,7,3,0,1,35
99131,1077947,1,7,4,1,0,36
99132,1077947,1,7,5,1,0,37
99133,1077947,1,7,6,0,0,37
99134,1077947,1,8,1,0,0,37
99135,1077947,1,8,2,0,1,37
99136,1077947,1,8,3,1,0,38
99137,1077947,1,8,4,0,1,38
99138,1077947,1,8,5,0,0,38
99139,1077947,1,8,6,0,0,38
99140,1077947,1,9,1,1,0,39
99141,1077947,1,9,2,0,0,39
99142,1077947,1,9,3,0,0,39
99143,1077947,1,9,4,1,0,40
99144,1077947,1,9,5,2,0,42
99145,1077947,1,9,6,0,0,42
99146,1077947,1,10,1,0,0,42
99147,1077947,1,10,2,0,1,42
99148,1077947,1,10,3,0,0,42
99149,1077947,1,10,4,1,0,43
99150,1077947,1,10,5,0,0,43
99151,1077947,1,10,6,1,0,44
99152,1077947,1,11,1,0,0,44
99153,1077947,1,11,2,1,0,45
99154,1077947,1,11,3,0,0,45
99155,1077947,1,11,4,4,0,49
99156,1077947,1,11,5,0,1,49
99157,1077947,1,11,6,0,0,49
99158,1077947,1,12,1,0,0,49
99159,1077947,1,12,2,1,0,50
99160,1077947,1,12,3,0,0,50
99161,1077947,1,12,4,0,0,50
99162,1077947,1,12,5,0,0,50
99163,1077947,1,12,6,1,0,51
99164,1077947,1,13,1,1,0,52
99165,1077947,1,13,2,4,0,56
99166,1077947,1,13,3,0,0,56
99167,1077947,1,13,4,1,0,57
99168,1077947,1,13,5,1,0,58
99169,1077947,1,13,6,0,0,58
99170,1077947,1,14,1,0,0,58
99171,1077947,1,14,2,1,0,59
99172,1077947,1,14,3,0,0,59
99173,1077947,1,14,4,0,0,59
99174,1077947,1,14,5,1,0,60
99175,1077947,1,14,6,0,0,60
99176,1077947,1,15,1,0,0,60
99177,1077947,1,15,2,1,0,61
99178,1077947,1,15,3,1,0,62
99179,1077947,1,15,4,1,0,63
99180,1077947,1,15,5,1,0,64
99181,1077947,1,15,6,3,0,67
99182,1077947,1,16,1,0,0,67
99183,1077947,1,16,2,1,0,68
99184,1077947,1,16,3,1,0,69
99185,1077947,1,16,4,1,0,70
99186,1077947,1,16,5,2,0,72
99187,1077947,1,16,6,2,0,74
99188,1077947,1,17,1,0,1,74
99189,1077947,1,17,2,1,0,75
99190,1077947,1,17,3,6,0,81
99191,1077947,1,17,4,0,0,81
99192,1077947,1,17,5,0,0,81
99193,1077947,1,17,6,4,0,85
99194,1077947,1,18,1,0,0,85
99195,1077947,1,18,2,1,0,86
99196,1077947,1,18,3,0,0,86
99197,1077947,1,18,4,1,0,87
99198,1077947,1,18,5,0,0,87
99199,1077947,1,18,6,4,0,91
99200,1077947,1,19,1,4,0,95
99201,1077947,1,19,2,6,0,101
99202,1077947,1,19,3,0,0,101
99203,1077947,1,19,4,1,0,102
99204,1077947,1,19,5,2,0,104
99205,1077947,1,19,6,1,0,105
99206,1077947,1,20,1,0,0,105
99207,1077947,1,20,2,1,0,106
99208,1077947,1,20,3,1,0,107
99209,1077947,1,20,4,0,0,107
99210,1077947,1,20,5,4,0,111
99211,1077947,1,20,6,0,1,111
99315,1077948,1,1,1,0,0,0
99316,1077948,1,1,2,0,0,0
99317,1077948,1,1,3,0,0,0
99318,1077948,1,1,4,0,0,0
99319,1077948,1,1,5,0,1,0
99320,1077948,1,1,6,4,0,4
99321,1077948,1,2,1,1,0,5
99322,1077948,1,2,2,1,0,6
99323,1077948,1,2,3,4,0,10
99324,1077948,1,2,4,1,0,11
99325,1077948,1,2,5,0,0,11
99326,1077948,1,2,6,1,0,12
99327,1077948,1,3,1,0,0,12
99328,1077948,1,3,2,1,0,13
99329,1077948,1,3,3,0,0,13
99330,1077948,1,3,4,0,0,13
99331,1077948,1,3,5,1,0,14
99332,1077948,1,3,6,1,0,15
99333,1077948,1,4,1,0,0,15
99334,1077948,1,4,2,0,0,15
99335,1077948,1,4,3,0,0,15
99336,1077948,1,4,4,0,0,15
99337,1077948,1,4,5,0,0,15
99338,1077948,1,4,6,0,0,15
99339,1077948,1,5,1,1,0,16
99340,1077948,1,5,2,0,0,16
99341,1077948,1,5,3,4,0,20
99342,1077948,1,5,4,0,0,20
99343,1077948,1,5,5,4,0,24
99344,1077948,1,5,6,1,0,25
99345,1077948,1,6,1,2,0,27
99346,1077948,1,6,2,0,0,27
99347,1077948,1,6,3,0,0,27
99348,1077948,1,6,4,4,0,31
99349,1077948,1,6,5,1,0,32
99350,1077948,1,6,6,1,0,33
99351,1077948,1,7,1,1,0,34
99352,1077948,1,7,2,1,0,35
99353,1077948,1,7,3,1,0,36
99354,1077948,1,7,4,0,0,36
99355,1077948,1,7,5,1,0,37
99356,1077948,1,7,6,0,0,37
99357,1077948,1,8,1,1,0,38
99358,1077948,1,8,2,2,0,40
99359,1077948,1,8,3,0,0,40
99360,1077948,1,8,4,1,0,41
99361,1077948,1,8,5,0,1,41
99362,1077948,1,8,6,1,0,42
99363,1077948,1,9,1,0,0,42
99364,1077948,1,9,2,1,0,43
99365,1077948,1,9,3,0,1,43
99366,1077948,1,9,4,0,0,43
99367,1077948,1,9,5,0,0,43
99368,1077948,1,9,6,2,0,45
99369,1077948,1,10,1,0,0,45
99370,1077948,1,10,2,0,0,45
99371,1077948,1,10,3,1,0,46
99372,1077948,1,10,4,1,0,47
99373,1077948,1,10,5,1,0,48
99374,1077948,1,10,6,1,0,49
99375,1077948,1,11,1,0,0,49
99376,1077948,1,11,2,1,0,50
99377,1077948,1,11,3,1,0,51
99378,1077948,1,11,4,0,1,51
99379,1077948,1,11,5,0,0,51
99380,1077948,1,11,6,1,0,52
99381,1077948,1,12,1,1,0,53
99382,1077948,1,12,2,0,0,53
99383,1077948,1,12,3,6,0,59
99384,1077948,1,12,4,4,0,63
99385,1077948,1,12,5,0,0,63
99386,1077948,1,12,6,4,0,67
99387,1077948,1,13,1,0,0,67
99388,1077948,1,13,2,0,0,67
99389,1077948,1,13,3,4,0,71
99390,1077948,1,13,4,1,0,72
99391,1077948,1,13,5,1,0,73
99392,1077948,1,13,6,1,0,74
99393,1077948,1,14,1,1,0,75
99394,1077948,1,14,2,0,0,75
99395,1077948,1,14,3,2,0,77
99396,1077948,1,14,4,1,0,78
99397,1077948,1,14,5,0,0,78
99398,1077948,1,14,6,0,0,78
99399,1077948,1,15,1,4,0,82
99400,1077948,1,15,2,2,0,84
99401,1077948,1,15,3,2,0,86
99402,1077948,1,15,4,1,0,87
99403,1077948,1,15,5,0,1,87
99404,1077948,1,15,6,0,0,87
99405,1077948,1,16,1,0,0,87
99406,1077948,1,16,2,0,0,87
99407,1077948,1,16,3,0,0,87
99408,1077948,1,16,4,0,1,87
99409,1077948,1,16,5,4,0,91
99410,1077948,1,16,6,0,1,91
99411,1077948,1,17,1,4,0,95
99412,1077948,1,17,2,0,0,95
99413,1077948,1,17,3,0,1,95
99414,1077948,1,17,4,1,0,96
99415,1077948,1,17,5,1,0,97
99416,1077948,1,17,6,1,0,98
99417,1077948,1,18,1,1,0,99
99418,1077948,1,18,2,1,0,100
99419,1077948,1,18,3,1,0,101
99420,1077948,1,18,4,1,0,102
99421,1077948,1,18,5,2,0,104
99422,1077948,1,18,6,4,0,108
99423,1077948,1,19,1,1,0,109
99424,1077948,1,19,2,1,0,110
99425,1077948,1,19,3,6,0,116
99426,1077948,1,19,4,2,0,118
99427,1077948,1,19,5,4,0,122
99428,1077948,1,19,6,2,0,124
99429,1077948,1,20,1,0,0,124
99430,1077948,1,20,2,1,0,125
99431,1077948,1,20,3,6,0,131
99432,1077948,1,20,4,0,1,131
99433,1077948,1,20,5,1,0,132
99434,1077948,1,20,6,0,1,132
99555,1083449,1,1,1,0,0,0
99556,1083449,1,1,2,0,1,0
99557,1083449,1,1,3,0,0,0
99558,1083449,1,1,4,0,0,0
99559,1083449,1,1,5,6,0,6
99560,1083449,1,1,6,0,0,6
99561,1083449,1,2,1,3,0,9
99562,1083449,1,2,2,0,0,9
99563,1083449,1,2,3,4,0,13
99564,1083449,1,2,4,3,0,16
99565,1083449,1,2,5,1,0,17
99566,1083449,1,2,6,1,0,18
99567,1083449,1,3,1,1,0,19
99568,1083449,1,3,2,4,0,23
99569,1083449,1,3,3,4,0,27
99570,1083449,1,3,4,1,0,28
99571,1083449,1,3,5,0,0,28
99572,1083449,1,3,6,0,0,28
99573,1083449,1,4,1,1,0,29
99574,1083449,1,4,2,1,0,30
99575,1083449,1,4,3,4,0,34
99576,1083449,1,4,4,1,0,35
99577,1083449,1,4,5,4,0,39
99578,1083449,1,4,6,1,0,40
99579,1083449,1,5,1,2,0,42
99580,1083449,1,5,2,0,0,42
99581,1083449,1,5,3,3,0,45
99582,1083449,1,5,4,5,0,50
99583,1083449,1,5,5,1,0,51
99584,1083449,1,5,6,6,0,57
99585,1083449,1,6,1,0,1,57
99586,1083449,1,6,2,0,0,57
99587,1083449,1,6,3,0,0,57
99588,1083449,1,6,4,0,0,57
99589,1083449,1,6,5,0,1,57
99590,1083449,1,6,6,1,0,58
99591,1083449,1,7,1,0,0,58
99592,1083449,1,7,2,1,0,59
99593,1083449,1,7,3,0,0,59
99594,1083449,1,7,4,1,0,60
99595,1083449,1,7,5,4,0,64
99596,1083449,1,7,6,1,0,65
99597,1083449,1,8,1,1,0,66
99598,1083449,1,8,2,0,0,66
99599,1083449,1,8,3,1,0,67
99600,1083449,1,8,4,0,0,67
99601,1083449,1,8,5,1,0,68
99602,1083449,1,8,6,1,0,69
99603,1083449,1,9,1,1,0,70
99604,1083449,1,9,2,0,1,70
99605,1083449,1,9,3,0,0,70
99606,1083449,1,9,4,1,0,71
99607,1083449,1,9,5,0,0,71
99608,1083449,1,9,6,0,0,71
99609,1083449,1,10,1,1,0,72
99610,1083449,1,10,2,2,0,74
99611,1083449,1,10,3,0,0,74
99612,1083449,1,10,4,1,0,75
99613,1083449,1,10,5,0,0,75
99614,1083449,1,10,6,1,0,76
99615,1083449,1,11,1,1,0,77
99616,1083449,1,11,2,2,0,79
99617,1083449,1,11,3,1,0,80
99618,1083449,1,11,4,1,0,81
99619,1083449,1,11,5,1,0,82
99620,1083449,1,11,6,0,0,82
99621,1083449,1,12,1,0,1,82
99622,1083449,1,12,2,2,0,84
99623,1083449,1,12,3,0,0,84
99624,1083449,1,12,4,0,0,84
99625,1083449,1,12,5,0,0,84
99626,1083449,1,12,6,1,0,85
99627,1083449,1,13,1,0,0,85
99628,1083449,1,13,2,2,0,87
99629,1083449,1,13,3,1,0,88
99630,1083449,1,13,4,1,0,89
99631,1083449,1,13,5,1,0,90
99632,1083449,1,13,6,4,0,94
99633,1083449,1,14,1,0,0,94
99634,1083449,1,14,2,1,0,95
99635,1083449,1,14,3,1,0,96
99636,1083449,1,14,4,1,0,97
99637,1083449,1,14,5,1,0,98
99638,1083449,1,14,6,4,0,102
99639,1083449,1,15,1,1,0,103
99640,1083449,1,15,2,1,0,104
99641,1083449,1,15,3,3,0,107
99642,1083449,1,15,4,2,0,109
99643,1083449,1,15,5,2,0,111
99644,1083449,1,15,6,1,0,112
99645,1083449,1,16,1,2,0,114
99646,1083449,1,16,2,4,0,118
99647,1083449,1,16,3,1,0,119
99648,1083449,1,16,4,0,0,119
99649,1083449,1,16,5,0,0,119
99650,1083449,1,16,6,4,0,123
99651,1083449,1,17,1,4,0,127
99652,1083449,1,17,2,1,0,128
99653,1083449,1,17,3,1,0,129
99654,1083449,1,17,4,1,0,130
99655,1083449,1,17,5,0,0,130
99656,1083449,1,17,6,1,0,131
99657,1083449,1,18,1,1,0,132
99658,1083449,1,18,2,1,0,133
99659,1083449,1,18,3,1,0,134
99660,1083449,1,18,4,0,0,134
99661,1083449,1,18,5,1,0,135
99662,1083449,1,18,6,4,0,139
99663,1083449,1,19,1,0,1,139
99664,1083449,1,19,2,2,0,141
99665,1083449,1,19,3,2,0,143
99666,1083449,1,19,4,0,0,143
99667,1083449,1,19,5,2,0,145
99668,1083449,1,19,6,1,0,146
99669,1083449,1,20,1,1,0,147
99670,1083449,1,20,2,1,0,148
99671,1083449,1,20,3,1,0,149
99672,1083449,1,20,4,4,0,153
99673,1083449,1,20,5,1,0,154
99674,1083449,1,20,6,1,0,155
99788,1083450,1,1,1,0,0,0
99789,1083450,1,1,2,0,0,0
99790,1083450,1,1,3,0,0,0
99791,1083450,1,1,4,1,0,1
99792,1083450,1,1,5,4,0,5
99793,1083450,1,1,6,0,0,5
99794,1083450,1,2,1,0,0,5
99795,1083450,1,2,2,1,0,6
99796,1083450,1,2,3,1,0,7
99797,1083450,1,2,4,0,0,7
99798,1083450,1,2,5,4,0,11
99799,1083450,1,2,6,4,0,15
99800,1083450,1,3,1,1,0,16
99801,1083450,1,3,2,1,0,17
99802,1083450,1,3,3,4,0,21
99803,1083450,1,3,4,1,0,22
99804,1083450,1,3,5,0,0,22
99805,1083450,1,3,6,2,0,24
99806,1083450,1,4,1,1,0,25
99807,1083450,1,4,2,6,0,31
99808,1083450,1,4,3,1,0,32
99809,1083450,1,4,4,0,0,32
99810,1083450,1,4,5,6,0,38
99811,1083450,1,4,6,4,0,42
99812,1083450,1,5,1,1,0,43
99813,1083450,1,5,2,1,0,44
99814,1083450,1,5,3,0,0,44
99815,1083450,1,5,4,4,0,48
99816,1083450,1,5,5,1,0,49
99817,1083450,1,5,6,7,0,56
99818,1083450,1,6,1,0,0,56
99819,1083450,1,6,2,2,0,58
99820,1083450,1,6,3,4,0,62
99821,1083450,1,6,4,4,0,66
99822,1083450,1,6,5,0,0,66
99823,1083450,1,6,6,2,0,68
99824,1083450,1,7,1,2,0,70
99825,1083450,1,7,2,1,0,71
99826,1083450,1,7,3,0,1,71
99827,1083450,1,7,4,1,0,72
99828,1083450,1,7,5,1,0,73
99829,1083450,1,7,6,1,0,74
99830,1083450,1,8,1,1,0,75
99831,1083450,1,8,2,2,0,77
99832,1083450,1,8,3,1,0,78
99833,1083450,1,8,4,0,0,78
99834,1083450,1,8,5,0,1,78
99835,1083450,1,8,6,1,0,79
99836,1083450,1,9,1,1,0,80
99837,1083450,1,9,2,1,0,81
99838,1083450,1,9,3,0,0,81
99839,1083450,1,9,4,1,0,82
99840,1083450,1,9,5,6,0,88
99841,1083450,1,9,6,1,0,89
99842,1083450,1,10,1,1,0,90
99843,1083450,1,10,2,1,0,91
99844,1083450,1,10,3,1,0,92
99845,1083450,1,10,4,4,0,96
99846,1083450,1,10,5,4,0,100
99847,1083450,1,10,6,1,0,101
99848,1083450,1,11,1,0,0,101
99849,1083450,1,11,2,1,0,102
99850,1083450,1,11,3,1,0,103
99851,1083450,1,11,4,1,0,104
99852,1083450,1,11,5,1,0,105
99853,1083450,1,11,6,2,0,107
99854,1083450,1,12,1,1,0,108
99855,1083450,1,12,2,1,0,109
99856,1083450,1,12,3,4,0,113
99857,1083450,1,12,4,4,0,117
99858,1083450,1,12,5,0,0,117
99859,1083450,1,12,6,1,0,118
99860,1083450,1,13,1,2,0,120
99861,1083450,1,13,2,1,0,121
99862,1083450,1,13,3,2,0,123
99863,1083450,1,13,4,0,0,123
99864,1083450,1,13,5,1,0,124
99865,1083450,1,13,6,0,0,124
99866,1083450,1,14,1,0,1,124
99867,1083450,1,14,2,1,0,125
99868,1083450,1,14,3,2,0,127
99869,1083450,1,14,4,2,0,129
99870,1083450,1,14,5,2,0,131
99871,1083450,1,14,6,1,0,132
99872,1083450,1,15,1,0,0,132
99873,1083450,1,15,2,0,0,132
99874,1083450,1,15,3,1,0,133
99875,1083450,1,15,4,1,0,134
99876,1083450,1,15,5,1,0,135
99877,1083450,1,15,6,1,0,136
99878,1083450,1,16,1,1,0,137
99879,1083450,1,16,2,0,0,137
99880,1083450,1,16,3,0,0,137
99881,1083450,1,16,4,1,0,138
99882,1083450,1,16,5,1,0,139
99883,1083450,1,16,6,0,1,139
99884,1083450,1,17,1,1,0,140
99885,1083450,1,17,2,1,0,141
99886,1083450,1,17,3,0,0,141
99887,1083450,1,17,4,6,0,147
99888,1083450,1,17,5,4,0,151
99889,1083450,1,17,6,1,0,152
99890,1083450,1,18,1,0,1,152
99891,1083450,1,18,2,1,0,153
99892,1083450,1,18,3,1,0,154
99893,1083450,1,18,4,2,0,156
99894,1083450,1,18,5,4,0,160
99895,1083450,1,18,6,6,0,166
99896,1083450,1,19,1,1,0,167
99897,1083450,1,19,2,2,0,169
99898,1083450,1,19,3,0,1,169
99899,1083450,1,19,4,0,1,169
99900,1083450,1,19,5,0,1,169
99901,1083450,1,19,6,1,0,170
99902,1083450,1,20,1,0,0,170
99903,1083450,1,20,2,1,0,171
99904,1083450,1,20,3,0,0,171
99905,1083450,1,20,4,1,0,172
99906,1083450,1,20,5,4,0,176
99907,1083450,1,20,6,0,1,176
100016,1085495,1,1,1,4,0,4
100017,1085495,1,1,2,0,1,4
100018,1085495,1,1,3,0,0,4
100019,1085495,1,1,4,0,1,4
100020,1085495,1,1,5,1,0,5
100021,1085495,1,1,6,0,0,5
100022,1085495,1,2,1,1,0,6
100023,1085495,1,2,2,0,0,6
100024,1085495,1,2,3,0,0,6
100025,1085495,1,2,4,2,0,8
100026,1085495,1,2,5,4,0,12
100027,1085495,1,2,6,0,0,12
100028,1085495,1,3,1,1,0,13
100029,1085495,1,3,2,4,0,17
100030,1085495,1,3,3,1,0,18
100031,1085495,1,3,4,0,0,18
100032,1085495,1,3,5,1,0,19
100033,1085495,1,3,6,0,0,19
100034,1085495,1,4,1,2,0,21
100035,1085495,1,4,2,0,0,21
100036,1085495,1,4,3,0,0,21
100037,1085495,1,4,4,0,0,21
100038,1085495,1,4,5,4,0,25
100039,1085495,1,4,6,0,0,25
100040,1085495,1,5,1,1,0,26
100041,1085495,1,5,2,1,0,27
100042,1085495,1,5,3,0,0,27
100043,1085495,1,5,4,1,0,28
100044,1085495,1,5,5,0,0,28
100045,1085495,1,5,6,4,0,32
100046,1085495,1,6,1,1,0,33
100047,1085495,1,6,2,1,0,34
100048,1085495,1,6,3,6,0,40
100049,1085495,1,6,4,1,0,41
100050,1085495,1,6,5,1,0,42
100051,1085495,1,6,6,0,0,42
100052,1085495,1,7,1,0,0,42
100053,1085495,1,7,2,2,0,44
100054,1085495,1,7,3,1,0,45
100055,1085495,1,7,4,0,0,45
100056,1085495,1,7,5,0,0,45
100057,1085495,1,7,6,4,0,49
100058,1085495,1,8,1,1,0,50
100059,1085495,1,8,2,2,0,52
100060,1085495,1,8,3,1,0,53
100061,1085495,1,8,4,1,0,54
100062,1085495,1,8,5,1,0,55
100063,1085495,1,8,6,4,0,59
100064,1085495,1,9,1,0,0,59
100065,1085495,1,9,2,1,0,60
100066,1085495,1,9,3,1,0,61
100067,1085495,1,9,4,1,0,62
100068,1085495,1,9,5,0,0,62
100069,1085495,1,9,6,0,0,62
100070,1085495,1,10,1,1,0,63
100071,1085495,1,10,2,1,0,64
100072,1085495,1,10,3,2,0,66
100073,1085495,1,10,4,6,0,72
100074,1085495,1,10,5,0,0,72
100075,1085495,1,10,6,4,0,76
100076,1085495,1,11,1,1,0,77
100077,1085495,1,11,2,1,0,78
100078,1085495,1,11,3,1,0,79
100079,1085495,1,11,4,5,0,84
100080,1085495,1,11,5,1,0,85
100081,1085495,1,11,6,1,0,86
100082,1085495,1,12,1,1,0,87
100083,1085495,1,12,2,1,0,88
100084,1085495,1,12,3,1,0,89
100085,1085495,1,12,4,1,0,90
100086,1085495,1,12,5,1,0,91
100087,1085495,1,12,6,1,0,92
100088,1085495,1,13,1,0,1,92
100089,1085495,1,13,2,0,0,92
100090,1085495,1,13,3,0,0,92
100091,1085495,1,13,4,0,0,92
100092,1085495,1,13,5,0,0,92
100093,1085495,1,13,6,1,0,93
100094,1085495,1,14,1,0,0,93
100095,1085495,1,14,2,1,0,94
100096,1085495,1,14,3,1,0,95
100097,1085495,1,14,4,0,1,95
100098,1085495,1,14,5,0,0,95
100099,1085495,1,14,6,1,0,96
100100,1085495,1,15,1,1,0,97
100101,1085495,1,15,2,1,0,98
100102,1085495,1,15,3,6,0,104
100103,1085495,1,15,4,1,0,105
100104,1085495,1,15,5,1,0,106
100105,1085495,1,15,6,0,0,106
100106,1085495,1,16,1,1,0,107
100107,1085495,1,16,2,1,0,108
100108,1085495,1,16,3,7,0,115
100109,1085495,1,16,4,0,1,115
100110,1085495,1,16,5,1,0,116
100111,1085495,1,16,6,0,0,116
100112,1085495,1,17,1,1,0,117
100113,1085495,1,17,2,1,0,118
100114,1085495,1,17,3,1,0,119
100115,1085495,1,17,4,1,0,120
100116,1085495,1,17,5,1,0,121
100117,1085495,1,17,6,1,0,122
100118,1085495,1,18,1,2,0,124
100119,1085495,1,18,2,0,1,124
100120,1085495,1,18,3,1,0,125
100121,1085495,1,18,4,1,0,126
100122,1085495,1,18,5,0,0,126
100123,1085495,1,18,6,1,0,127
100124,1085495,1,19,1,2,0,129
100125,1085495,1,19,2,1,0,130
100126,1085495,1,19,3,0,1,130
100127,1085495,1,19,4,2,0,132
100128,1085495,1,19,5,0,0,132
100129,1085495,1,19,6,0,0,132
100130,1085495,1,20,1,0,1,132
100131,1085495,1,20,2,0,0,132
100132,1085495,1,20,3,1,0,133
100133,1085495,1,20,4,1,0,134
100134,1085495,1,20,5,1,0,135
100135,1085495,1,20,6,2,0,137
100225,1085496,1,1,1,1,0,1
100226,1085496,1,1,2,4,0,5
100227,1085496,1,1,3,1,0,6
100228,1085496,1,1,4,0,0,6
100229,1085496,1,1,5,0,0,6
100230,1085496,1,1,6,0,0,6
100231,1085496,1,2,1,2,0,8
100232,1085496,1,2,2,0,0,8
100233,1085496,1,2,3,6,0,14
100234,1085496,1,2,4,1,0,15
100235,1085496,1,2,5,0,0,15
100236,1085496,1,2,6,1,0,16
100237,1085496,1,3,1,0,0,16
100238,1085496,1,3,2,6,0,22
100239,1085496,1,3,3,4,0,26
100240,1085496,1,3,4,1,0,27
100241,1085496,1,3,5,0,1,27
100242,1085496,1,3,6,0,0,27
100243,1085496,1,4,1,0,0,27
100244,1085496,1,4,2,0,0,27
100245,1085496,1,4,3,0,0,27
100246,1085496,1,4,4,0,0,27
100247,1085496,1,4,5,0,0,27
100248,1085496,1,4,6,0,0,27
100249,1085496,1,5,1,1,0,28
100250,1085496,1,5,2,0,0,28
100251,1085496,1,5,3,0,0,28
100252,1085496,1,5,4,6,0,34
100253,1085496,1,5,5,1,0,35
100254,1085496,1,5,6,0,0,35
100255,1085496,1,6,1,0,0,35
100256,1085496,1,6,2,6,0,41
100257,1085496,1,6,3,0,0,41
100258,1085496,1,6,4,0,0,41
100259,1085496,1,6,5,1,0,42
100260,1085496,1,6,6,0,0,42
100261,1085496,1,7,1,0,0,42
100262,1085496,1,7,2,0,0,42
100263,1085496,1,7,3,6,0,48
100264,1085496,1,7,4,1,0,49
100265,1085496,1,7,5,1,0,50
100266,1085496,1,7,6,0,0,50
100267,1085496,1,8,1,0,0,50
100268,1085496,1,8,2,0,0,50
100269,1085496,1,8,3,1,0,51
100270,1085496,1,8,4,1,0,52
100271,1085496,1,8,5,0,0,52
100272,1085496,1,8,6,0,0,52
100273,1085496,1,9,1,0,1,52
100274,1085496,1,9,2,0,0,52
100275,1085496,1,9,3,0,0,52
100276,1085496,1,9,4,1,0,53
100277,1085496,1,9,5,0,0,53
100278,1085496,1,9,6,0,0,53
100279,1085496,1,10,1,0,0,53
100280,1085496,1,10,2,1,0,54
100281,1085496,1,10,3,0,0,54
100282,1085496,1,10,4,1,0,55
100283,1085496,1,10,5,0,0,55
100284,1085496,1,10,6,4,0,59
100285,1085496,1,11,1,0,0,59
100286,1085496,1,11,2,0,0,59
100287,1085496,1,11,3,0,0,59
100288,1085496,1,11,4,0,0,59
100289,1085496,1,11,5,0,0,59
100290,1085496,1,11,6,0,1,59
100291,1085496,1,12,1,1,0,60
100292,1085496,1,12,2,0,0,60
100293,1085496,1,12,3,0,0,60
100294,1085496,1,12,4,1,0,61
100295,1085496,1,12,5,6,0,67
100296,1085496,1,12,6,6,0,73
100297,1085496,1,13,1,0,1,73
100298,1085496,1,13,2,0,1,73
100299,1085496,1,13,3,0,0,73
100300,1085496,1,13,4,0,0,73
100301,1085496,1,13,5,0,0,73
100302,1085496,1,13,6,0,0,73
100303,1085496,1,14,1,1,0,74
100304,1085496,1,14,2,1,0,75
100305,1085496,1,14,3,0,0,75
100306,1085496,1,14,4,0,0,75
100307,1085496,1,14,5,2,0,77
100308,1085496,1,14,6,0,0,77
100309,1085496,1,15,1,2,0,79
100310,1085496,1,15,2,2,0,81
100311,1085496,1,15,3,1,0,82
100312,1085496,1,15,4,0,1,82
100313,1085496,1,15,5,0,0,82
100314,1085496,1,15,6,1,0,83
100315,1085496,1,16,1,0,0,83
100316,1085496,1,16,2,0,1,83
100317,1085496,1,16,3,1,0,84
100318,1085496,1,16,4,0,0,84
100319,1085496,1,16,5,2,0,86
100320,1085496,1,16,6,0,0,86
100321,1085496,1,17,1,1,0,87
100322,1085496,1,17,2,1,0,88
100323,1085496,1,17,3,1,0,89
100324,1085496,1,17,4,1,0,90
100325,1085496,1,17,5,4,0,94
100326,1085496,1,17,6,1,0,95
100327,1085496,1,18,1,6,0,101
100328,1085496,1,18,2,1,0,102
100329,1085496,1,18,3,2,0,104
100330,1085496,1,18,4,1,0,105
100331,1085496,1,18,5,1,0,106
100332,1085496,1,18,6,2,0,108
100333,1085496,1,19,1,6,0,114
100334,1085496,1,19,2,0,0,114
100335,1085496,1,19,3,4,0,118
100336,1085496,1,19,4,2,0,120
100337,1085496,1,19,5,1,0,121
100338,1085496,1,19,6,0,1,121
100339,1085496,1,20,1,0,0,121
100340,1085496,1,20,2,1,0,122
100341,1085496,1,20,3,0,0,122
100342,1085496,1,20,4,0,0,122
100343,1085496,1,20,5,1,0,123
100344,1085496,1,20,6,1,0,124
100459,1089776,1,1,1,0,0,0
100460,1089776,1,1,2,1,0,1
100461,1089776,1,1,3,0,0,1
100462,1089776,1,1,4,1,0,2
100463,1089776,1,1,5,4,0,6
100464,1089776,1,1,6,4,0,10
100465,1089776,1,2,1,0,0,10
100466,1089776,1,2,2,0,0,10
100467,1089776,1,2,3,0,0,10
100468,1089776,1,2,4,0,0,10
100469,1089776,1,2,5,0,0,10
100470,1089776,1,2,6,1,0,11
100471,1089776,1,3,1,0,0,11
100472,1089776,1,3,2,4,0,15
100473,1089776,1,3,3,1,0,16
100474,1089776,1,3,4,0,0,16
100475,1089776,1,3,5,4,0,20
100476,1089776,1,3,6,0,0,20
100477,1089776,1,4,1,1,0,21
100478,1089776,1,4,2,0,1,21
100479,1089776,1,4,3,0,0,21
100480,1089776,1,4,4,4,0,25
100481,1089776,1,4,5,1,0,26
100482,1089776,1,4,6,0,0,26
100483,1089776,1,5,1,0,1,26
100484,1089776,1,5,2,0,0,26
100485,1089776,1,5,3,0,0,26
100486,1089776,1,5,4,0,0,26
100487,1089776,1,5,5,0,1,26
100488,1089776,1,5,6,0,0,26
100489,1089776,1,6,1,1,0,27
100490,1089776,1,6,2,1,0,28
100491,1089776,1,6,3,0,0,28
100492,1089776,1,6,4,0,0,28
100493,1089776,1,6,5,0,0,28
100494,1089776,1,6,6,4,0,32
100495,1089776,1,7,1,1,0,33
100496,1089776,1,7,2,1,0,34
100497,1089776,1,7,3,1,0,35
100498,1089776,1,7,4,0,0,35
100499,1089776,1,7,5,0,0,35
100500,1089776,1,7,6,1,0,36
100501,1089776,1,8,1,0,0,36
100502,1089776,1,8,2,0,0,36
100503,1089776,1,8,3,0,0,36
100504,1089776,1,8,4,2,0,38
100505,1089776,1,8,5,0,0,38
100506,1089776,1,8,6,0,0,38
100507,1089776,1,9,1,2,0,40
100508,1089776,1,9,2,1,0,41
100509,1089776,1,9,3,1,0,42
100510,1089776,1,9,4,0,0,42
100511,1089776,1,9,5,0,1,42
100512,1089776,1,9,6,0,0,42
100513,1089776,1,10,1,0,0,42
100514,1089776,1,10,2,1,0,43
100515,1089776,1,10,3,0,0,43
100516,1089776,1,10,4,0,0,43
100517,1089776,1,10,5,2,0,45
100518,1089776,1,10,6,0,0,45
100519,1089776,1,11,1,0,0,45
100520,1089776,1,11,2,0,0,45
100521,1089776,1,11,3,0,0,45
100522,1089776,1,11,4,1,0,46
100523,1089776,1,11,5,0,1,46
100524,1089776,1,11,6,0,0,46
100525,1089776,1,12,1,0,1,46
100526,1089776,1,12,2,0,0,46
100527,1089776,1,12,3,0,0,46
100528,1089776,1,12,4,0,1,46
100529,1089776,1,12,5,1,0,47
100530,1089776,1,12,6,4,0,51
100531,1089776,1,13,1,1,0,52
100532,1089776,1,13,2,1,0,53
100533,1089776,1,13,3,1,0,54
100534,1089776,1,13,4,1,0,55
100535,1089776,1,13,5,1,0,56
100536,1089776,1,13,6,1,0,57
100537,1089776,1,14,1,0,0,57
100538,1089776,1,14,2,0,0,57
100539,1089776,1,14,3,1,0,58
100540,1089776,1,14,4,0,1,58
100541,1089776,1,14,5,0,0,58
100542,1089776,1,14,6,0,0,58
100543,1089776,1,15,1,0,0,58
100544,1089776,1,15,2,1,0,59
100545,1089776,1,15,3,1,0,60
100546,1089776,1,15,4,1,0,61
100547,1089776,1,15,5,1,0,62
100548,1089776,1,15,6,0,0,62
100549,1089776,1,16,1,1,0,63
100550,1089776,1,16,2,1,0,64
100551,1089776,1,16,3,1,0,65
100552,1089776,1,16,4,2,0,67
100553,1089776,1,16,5,1,0,68
100554,1089776,1,16,6,1,0,69
100555,1089776,1,17,1,1,0,70
100556,1089776,1,17,2,0,0,70
100557,1089776,1,17,3,1,0,71
100558,1089776,1,17,4,1,0,72
100559,1089776,1,17,5,0,0,72
100560,1089776,1,17,6,0,0,72
100561,1089776,1,18,1,1,0,73
100562,1089776,1,18,2,1,0,74
100563,1089776,1,18,3,1,0,75
100564,1089776,1,18,4,1,0,76
100565,1089776,1,18,5,1,0,77
100566,1089776,1,18,6,1,0,78
100567,1089776,1,19,1,6,0,84
100568,1089776,1,19,2,6,0,90
100569,1089776,1,19,3,4,0,94
100570,1089776,1,19,4,0,0,94
100571,1089776,1,19,5,0,1,94
100572,1089776,1,19,6,0,0,94
100573,1089776,1,20,1,4,0,98
100574,1089776,1,20,2,4,0,102
100575,1089776,1,20,3,6,0,108
100576,1089776,1,20,4,1,0,109
100577,1089776,1,20,5,1,0,110
100578,1089776,1,20,6,0,1,110
100678,1089777,1,1,1,0,0,0
100679,1089777,1,1,2,4,0,4
100680,1089777,1,1,3,1,0,5
100681,1089777,1,1,4,0,0,5
100682,1089777,1,1,5,1,0,6
100683,1089777,1,1,6,5,0,11
100684,1089777,1,2,1,1,0,12
100685,1089777,1,2,2,0,0,12
100686,1089777,1,2,3,2,0,14
100687,1089777,1,2,4,4,0,18
100688,1089777,1,2,5,1,0,19
100689,1089777,1,2,6,0,0,19
100690,1089777,1,3,1,1,0,20
100691,1089777,1,3,2,4,0,24
100692,1089777,1,3,3,0,0,24
100693,1089777,1,3,4,1,0,25
100694,1089777,1,3,5,4,0,29
100695,1089777,1,3,6,1,0,30
100696,1089777,1,4,1,0,0,30
100697,1089777,1,4,2,1,0,31
100698,1089777,1,4,3,1,0,32
100699,1089777,1,4,4,1,0,33
100700,1089777,1,4,5,6,0,39
100701,1089777,1,4,6,1,0,40
100702,1089777,1,5,1,1,0,41
100703,1089777,1,5,2,1,0,42
100704,1089777,1,5,3,0,1,42
100705,1089777,1,5,4,6,0,48
100706,1089777,1,5,5,1,0,49
100707,1089777,1,5,6,2,0,51
100708,1089777,1,6,1,0,0,51
100709,1089777,1,6,2,1,0,52
100710,1089777,1,6,3,0,0,52
100711,1089777,1,6,4,0,0,52
100712,1089777,1,6,5,0,0,52
100713,1089777,1,6,6,0,0,52
100714,1089777,1,7,1,1,0,53
100715,1089777,1,7,2,6,0,59
100716,1089777,1,7,3,1,0,60
100717,1089777,1,7,4,0,0,60
100718,1089777,1,7,5,2,0,62
100719,1089777,1,7,6,1,0,63
100720,1089777,1,8,1,1,0,64
100721,1089777,1,8,2,0,0,64
100722,1089777,1,8,3,1,0,65
100723,1089777,1,8,4,0,0,65
100724,1089777,1,8,5,5,0,70
100725,1089777,1,8,6,1,0,71
100726,1089777,1,9,1,0,0,71
100727,1089777,1,9,2,0,0,71
100728,1089777,1,9,3,2,0,73
100729,1089777,1,9,4,0,0,73
100730,1089777,1,9,5,1,0,74
100731,1089777,1,9,6,0,0,74
100732,1089777,1,10,1,0,1,74
100733,1089777,1,10,2,1,0,75
100734,1089777,1,10,3,0,0,75
100735,1089777,1,10,4,1,0,76
100736,1089777,1,10,5,1,0,77
100737,1089777,1,10,6,1,0,78
100738,1089777,1,11,1,0,0,78
100739,1089777,1,11,2,0,0,78
100740,1089777,1,11,3,0,0,78
100741,1089777,1,11,4,0,0,78
100742,1089777,1,11,5,1,0,79
100743,1089777,1,11,6,0,0,79
100744,1089777,1,12,1,0,0,79
100745,1089777,1,12,2,1,0,80
100746,1089777,1,12,3,0,0,80
100747,1089777,1,12,4,0,0,80
100748,1089777,1,12,5,1,0,81
100749,1089777,1,12,6,6,0,87
100750,1089777,1,13,1,1,0,88
100751,1089777,1,13,2,1,0,89
100752,1089777,1,13,3,1,0,90
100753,1089777,1,13,4,1,0,91
100754,1089777,1,13,5,4,0,95
100755,1089777,1,13,6,2,0,97
100756,1089777,1,14,1,0,0,97
100757,1089777,1,14,2,0,0,97
100758,1089777,1,14,3,0,1,97
100759,1089777,1,14,4,1,0,98
100760,1089777,1,14,5,1,0,99
100761,1089777,1,14,6,0,0,99
100762,1089777,1,15,1,0,0,99
100763,1089777,1,15,2,6,0,105
100764,1089777,1,15,3,1,0,106
100765,1089777,1,15,4,3,0,109
100766,1089777,1,15,5,1,0,110
100767,1089777,1,15,6,2,0,112
100849,1089778,1,1,1,0,0,0
100850,1089778,1,1,2,0,0,0
100851,1089778,1,1,3,0,0,0
100852,1089778,1,1,4,0,0,0
100853,1089778,1,1,5,2,0,2
100854,1089778,1,1,6,4,0,6
100855,1089778,1,2,1,1,0,7
100856,1089778,1,2,2,0,0,7
100857,1089778,1,2,3,6,0,13
100858,1089778,1,2,4,1,0,14
100859,1089778,1,2,5,0,1,14
100860,1089778,1,2,6,0,0,14
100861,1089778,1,3,1,1,0,15
100862,1089778,1,3,2,4,0,19
100863,1089778,1,3,3,4,0,23
100864,1089778,1,3,4,4,0,27
100865,1089778,1,3,5,0,0,27
100866,1089778,1,3,6,0,0,27
100867,1089778,1,4,1,0,0,27
100868,1089778,1,4,2,2,0,29
100869,1089778,1,4,3,1,0,30
100870,1089778,1,4,4,6,0,36
100871,1089778,1,4,5,0,0,36
100872,1089778,1,4,6,4,0,40
100873,1089778,1,5,1,0,0,40
100874,1089778,1,5,2,0,0,40
100875,1089778,1,5,3,4,0,44
100876,1089778,1,5,4,0,0,44
100877,1089778,1,5,5,1,0,45
100878,1089778,1,5,6,0,1,45
100879,1089778,1,6,1,0,0,45
100880,1089778,1,6,2,0,0,45
100881,1089778,1,6,3,1,0,46
100882,1089778,1,6,4,2,0,48
100883,1089778,1,6,5,0,0,48
100884,1089778,1,6,6,0,0,48
100885,1089778,1,7,1,1,0,49
100886,1089778,1,7,2,1,0,50
100887,1089778,1,7,3,0,0,50
100888,1089778,1,7,4,0,0,50
100889,1089778,1,7,5,0,0,50
100890,1089778,1,7,6,1,0,51
100891,1089778,1,8,1,1,0,52
100892,1089778,1,8,2,0,0,52
100893,1089778,1,8,3,1,0,53
100894,1089778,1,8,4,0,0,53
100895,1089778,1,8,5,0,0,53
100896,1089778,1,8,6,2,0,55
100897,1089778,1,9,1,1,0,56
100898,1089778,1,9,2,1,0,57
100899,1089778,1,9,3,0,1,57
100900,1089778,1,9,4,1,0,58
100901,1089778,1,9,5,0,0,58
100902,1089778,1,9,6,1,0,59
100903,1089778,1,10,1,0,0,59
100904,1089778,1,10,2,1,0,60
100905,1089778,1,10,3,0,0,60
100906,1089778,1,10,4,0,0,60
100907,1089778,1,10,5,0,0,60
100908,1089778,1,10,6,1,0,61
100909,1089778,1,11,1,1,0,62
100910,1089778,1,11,2,0,0,62
100911,1089778,1,11,3,1,0,63
100912,1089778,1,11,4,0,0,63
100913,1089778,1,11,5,0,0,63
100914,1089778,1,11,6,0,0,63
100915,1089778,1,12,1,1,0,64
100916,1089778,1,12,2,0,0,64
100917,1089778,1,12,3,1,0,65
100918,1089778,1,12,4,0,0,65
100919,1089778,1,12,5,0,0,65
100920,1089778,1,12,6,1,0,66
100921,1089778,1,13,1,0,0,66
100922,1089778,1,13,2,6,0,72
100923,1089778,1,13,3,2,0,74
100924,1089778,1,13,4,4,0,78
100925,1089778,1,13,5,0,0,78
100926,1089778,1,13,6,2,0,80
100927,1089778,1,14,1,1,0,81
100928,1089778,1,14,2,2,0,83
100929,1089778,1,14,3,0,0,83
100930,1089778,1,14,4,1,0,84
100931,1089778,1,14,5,1,0,85
100932,1089778,1,14,6,1,0,86
100933,1089778,1,15,1,6,0,92
100934,1089778,1,15,2,4,0,96
100935,1089778,1,15,3,0,1,96
100936,1089778,1,15,4,0,0,96
100937,1089778,1,15,5,0,0,96
100938,1089778,1,15,6,1,0,97
100939,1089778,1,16,1,5,0,102
100940,1089778,1,16,2,1,0,103
100941,1089778,1,16,3,1,0,104
100942,1089778,1,16,4,0,0,104
100943,1089778,1,16,5,3,0,107
100944,1089778,1,16,6,1,0,108
100945,1089778,1,17,1,0,0,108
100946,1089778,1,17,2,0,1,108
100947,1089778,1,17,3,4,0,112
100948,1089778,1,17,4,1,0,113
100949,1089778,1,17,5,0,0,113
100950,1089778,1,17,6,1,0,114
100951,1089778,1,18,1,0,0,114
100952,1089778,1,18,2,0,0,114
100953,1089778,1,18,3,1,0,115
100954,1089778,1,18,4,1,0,116
100955,1089778,1,18,5,2,0,118
100956,1089778,1,18,6,4,0,122
100957,1089778,1,19,1,1,0,123
100958,1089778,1,19,2,1,0,124
100959,1089778,1,19,3,6,0,130
100960,1089778,1,19,4,4,0,134
100961,1089778,1,19,5,4,0,138
100962,1089778,1,19,6,0,1,138
100963,1089778,1,20,1,1,0,139
100964,1089778,1,20,2,0,0,139
100965,1089778,1,20,3,0,0,139
100966,1089778,1,20,4,6,0,145
100967,1089778,1,20,5,0,0,145
100968,1089778,1,20,6,1,0,146
101085,1098211,1,1,1,4,0,4
101086,1098211,1,1,2,1,0,5
101087,1098211,1,1,3,4,0,9
101088,1098211,1,1,4,0,0,9
101089,1098211,1,1,5,4,0,13
101090,1098211,1,1,6,0,0,13
101091,1098211,1,2,1,4,0,17
101092,1098211,1,2,2,4,0,21
101093,1098211,1,2,3,0,0,21
101094,1098211,1,2,4,0,0,21
101095,1098211,1,2,5,1,0,22
101096,1098211,1,2,6,4,0,26
101097,1098211,1,3,1,1,0,27
101098,1098211,1,3,2,0,0,27
101099,1098211,1,3,3,1,0,28
101100,1098211,1,3,4,0,0,28
101101,1098211,1,3,5,4,0,32
101102,1098211,1,3,6,0,0,32
101103,1098211,1,4,1,0,0,32
101104,1098211,1,4,2,0,0,32
101105,1098211,1,4,3,4,0,36
101106,1098211,1,4,4,4,0,40
101107,1098211,1,4,5,1,0,41
101108,1098211,1,4,6,1,0,42
101109,1098211,1,5,1,4,0,46
101110,1098211,1,5,2,1,0,47
101111,1098211,1,5,3,0,0,47
101112,1098211,1,5,4,4,0,51
101113,1098211,1,5,5,2,0,53
101114,1098211,1,5,6,1,0,54
101115,1098211,1,6,1,6,0,60
101116,1098211,1,6,2,4,0,64
101117,1098211,1,6,3,0,1,64
101118,1098211,1,6,4,1,0,65
101119,1098211,1,6,5,0,1,65
101120,1098211,1,6,6,1,0,66
101121,1098211,1,7,1,0,0,66
101122,1098211,1,7,2,1,0,67
101123,1098211,1,7,3,1,0,68
101124,1098211,1,7,4,1,0,69
101125,1098211,1,7,5,2,0,71
101126,1098211,1,7,6,0,0,71
101127,1098211,1,8,1,1,0,72
101128,1098211,1,8,2,0,0,72
101129,1098211,1,8,3,4,0,76
101130,1098211,1,8,4,1,0,77
101131,1098211,1,8,5,1,0,78
101132,1098211,1,8,6,0,0,78
101133,1098211,1,9,1,1,0,79
101134,1098211,1,9,2,1,0,80
101135,1098211,1,9,3,4,0,84
101136,1098211,1,9,4,1,0,85
101137,1098211,1,9,5,1,0,86
101138,1098211,1,9,6,1,0,87
101139,1098211,1,10,1,1,0,88
101140,1098211,1,10,2,0,0,88
101141,1098211,1,10,3,4,0,92
101142,1098211,1,10,4,0,0,92
101143,1098211,1,10,5,0,0,92
101144,1098211,1,10,6,1,0,93
101145,1098211,1,11,1,1,0,94
101146,1098211,1,11,2,0,0,94
101147,1098211,1,11,3,0,0,94
101148,1098211,1,11,4,1,0,95
101149,1098211,1,11,5,6,0,101
101150,1098211,1,11,6,4,0,105
101151,1098211,1,12,1,2,0,107
101152,1098211,1,12,2,1,0,108
101153,1098211,1,12,3,1,0,109
101154,1098211,1,12,4,0,0,109
101155,1098211,1,12,5,1,0,110
101156,1098211,1,12,6,4,0,114
101157,1098211,1,13,1,1,0,115
101158,1098211,1,13,2,0,0,115
101159,1098211,1,13,3,6,0,121
101160,1098211,1,13,4,1,0,122
101161,1098211,1,13,5,0,0,122
101162,1098211,1,13,6,6,0,128
101163,1098211,1,14,1,0,0,128
101164,1098211,1,14,2,1,0,129
101165,1098211,1,14,3,1,0,130
101166,1098211,1,14,4,0,0,130
101167,1098211,1,14,5,1,0,131
101168,1098211,1,14,6,4,0,135
101169,1098211,1,15,1,1,0,136
101170,1098211,1,15,2,1,0,137
101171,1098211,1,15,3,0,0,137
101172,1098211,1,15,4,1,0,138
101173,1098211,1,15,5,1,0,139
101174,1098211,1,15,6,1,0,140
101175,1098211,1,16,1,6,0,146
101176,1098211,1,16,2,4,0,150
101177,1098211,1,16,3,1,0,151
101178,1098211,1,16,4,0,1,151
101179,1098211,1,16,5,1,0,152
101180,1098211,1,16,6,1,0,153
101181,1098211,1,17,1,1,0,154
101182,1098211,1,17,2,1,0,155
101183,1098211,1,17,3,1,0,156
101184,1098211,1,17,4,0,1,156
101185,1098211,1,17,5,0,1,156
101186,1098211,1,17,6,2,0,158
101187,1098211,1,18,1,2,0,160
101188,1098211,1,18,2,1,0,161
101189,1098211,1,18,3,1,0,162
101190,1098211,1,18,4,1,0,163
101191,1098211,1,18,5,1,0,164
101192,1098211,1,18,6,0,1,164
101193,1098211,1,19,1,1,0,165
101194,1098211,1,19,2,3,0,168
101195,1098211,1,19,3,1,0,169
101196,1098211,1,19,4,1,0,170
101197,1098211,1,19,5,1,0,171
101198,1098211,1,19,6,1,0,172
101199,1098211,1,20,1,1,0,173
101200,1098211,1,20,2,6,0,179
101201,1098211,1,20,3,4,0,183
101202,1098211,1,20,4,1,0,184
101203,1098211,1,20,5,2,0,186
101204,1098211,1,20,6,4,0,190
101316,1109610,1,1,1,1,0,1
101317,1109610,1,1,2,1,0,2
101318,1109610,1,1,3,0,0,2
101319,1109610,1,1,4,2,0,4
101320,1109610,1,1,5,0,0,4
101321,1109610,1,1,6,0,0,4
101322,1109610,1,2,1,1,0,5
101323,1109610,1,2,2,0,0,5
101324,1109610,1,2,3,4,0,9
101325,1109610,1,2,4,4,0,13
101326,1109610,1,2,5,4,0,17
101327,1109610,1,2,6,2,0,19
101328,1109610,1,3,1,4,0,23
101329,1109610,1,3,2,0,1,23
101330,1109610,1,3,3,4,0,27
101331,1109610,1,3,4,0,0,27
101332,1109610,1,3,5,4,0,31
101333,1109610,1,3,6,1,0,32
101334,1109610,1,4,1,6,0,38
101335,1109610,1,4,2,6,0,44
101336,1109610,1,4,3,1,0,45
101337,1109610,1,4,4,1,0,46
101338,1109610,1,4,5,0,0,46
101339,1109610,1,4,6,0,0,46
101340,1109610,1,5,1,0,0,46
101341,1109610,1,5,2,0,0,46
101342,1109610,1,5,3,0,1,46
101343,1109610,1,5,4,1,0,47
101344,1109610,1,5,5,0,0,47
101345,1109610,1,5,6,0,0,47
101346,1109610,1,6,1,4,0,51
101347,1109610,1,6,2,1,0,52
101348,1109610,1,6,3,4,0,56
101349,1109610,1,6,4,0,0,56
101350,1109610,1,6,5,4,0,60
101351,1109610,1,6,6,0,0,60
101352,1109610,1,7,1,1,0,61
101353,1109610,1,7,2,1,0,62
101354,1109610,1,7,3,0,1,62
101355,1109610,1,7,4,0,0,62
101356,1109610,1,7,5,1,0,63
101357,1109610,1,7,6,2,0,65
101358,1109610,1,8,1,0,0,65
101359,1109610,1,8,2,0,0,65
101360,1109610,1,8,3,0,0,65
101361,1109610,1,8,4,1,0,66
101362,1109610,1,8,5,0,0,66
101363,1109610,1,8,6,1,0,67
101364,1109610,1,9,1,6,0,73
101365,1109610,1,9,2,0,0,73
101366,1109610,1,9,3,1,0,74
101367,1109610,1,9,4,0,0,74
101368,1109610,1,9,5,6,0,80
101369,1109610,1,9,6,4,0,84
101370,1109610,1,10,1,0,0,84
101371,1109610,1,10,2,0,0,84
101372,1109610,1,10,3,0,0,84
101373,1109610,1,10,4,0,0,84
101374,1109610,1,10,5,6,0,90
101375,1109610,1,10,6,0,0,90
101376,1109610,1,11,1,1,0,91
101377,1109610,1,11,2,2,0,93
101378,1109610,1,11,3,1,0,94
101379,1109610,1,11,4,2,0,96
101380,1109610,1,11,5,1,0,97
101381,1109610,1,11,6,1,0,98
101382,1109610,1,12,1,1,0,99
101383,1109610,1,12,2,0,1,99
101384,1109610,1,12,3,1,0,100
101385,1109610,1,12,4,0,0,100
101386,1109610,1,12,5,1,0,101
101387,1109610,1,12,6,0,0,101
101388,1109610,1,13,1,0,0,101
101389,1109610,1,13,2,1,0,102
101390,1109610,1,13,3,1,0,103
101391,1109610,1,13,4,0,0,103
101392,1109610,1,13,5,1,0,104
101393,1109610,1,13,6,1,0,105
101394,1109610,1,14,1,2,0,107
101395,1109610,1,14,2,6,0,113
101396,1109610,1,14,3,0,1,113
101397,1109610,1,14,4,0,0,113
101398,1109610,1,14,5,0,0,113
101399,1109610,1,14,6,0,1,113
101400,1109610,1,15,1,0,0,113
101401,1109610,1,15,2,1,0,114
101402,1109610,1,15,3,0,0,114
101403,1109610,1,15,4,1,0,115
101404,1109610,1,15,5,1,0,116
101405,1109610,1,15,6,2,0,118
101406,1109610,1,16,1,2,0,120
101407,1109610,1,16,2,1,0,121
101408,1109610,1,16,3,2,0,123
101409,1109610,1,16,4,1,0,124
101410,1109610,1,16,5,1,0,125
101411,1109610,1,16,6,2,0,127
101412,1109610,1,17,1,1,0,128
101413,1109610,1,17,2,4,0,132
101414,1109610,1,17,3,2,0,134
101415,1109610,1,17,4,0,1,134
101416,1109610,1,17,5,1,0,135
101417,1109610,1,17,6,1,0,136
101418,1109610,1,18,1,0,0,136
101419,1109610,1,18,2,1,0,137
101420,1109610,1,18,3,0,0,137
101421,1109610,1,18,4,1,0,138
101422,1109610,1,18,5,0,0,138
101423,1109610,1,18,6,6,0,144
101424,1109610,1,19,1,2,0,146
101425,1109610,1,19,2,1,0,147
101426,1109610,1,19,3,0,0,147
101427,1109610,1,19,4,2,0,149
101428,1109610,1,19,5,4,0,153
101429,1109610,1,19,6,4,0,157
101430,1109610,1,20,1,4,0,161
101431,1109610,1,20,2,0,0,161
101432,1109610,1,20,3,1,0,162
101433,1109610,1,20,4,1,0,163
101434,1109610,1,20,5,6,0,169
101435,1109610,1,20,6,1,0,170
101552,1115798,1,1,1,1,0,1
101553,1115798,1,1,2,0,0,1
101554,1115798,1,1,3,0,0,1
101555,1115798,1,1,4,0,0,1
101556,1115798,1,1,5,0,0,1
101557,1115798,1,1,6,0,0,1
101558,1115798,1,2,1,4,0,5
101559,1115798,1,2,2,0,0,5
101560,1115798,1,2,3,0,1,5
101561,1115798,1,2,4,1,0,6
101562,1115798,1,2,5,1,0,7
101563,1115798,1,2,6,1,0,8
101564,1115798,1,3,1,1,0,9
101565,1115798,1,3,2,0,0,9
101566,1115798,1,3,3,0,0,9
101567,1115798,1,3,4,4,0,13
101568,1115798,1,3,5,0,0,13
101569,1115798,1,3,6,1,0,14
101570,1115798,1,4,1,1,0,15
101571,1115798,1,4,2,1,0,16
101572,1115798,1,4,3,4,0,20
101573,1115798,1,4,4,4,0,24
101574,1115798,1,4,5,2,0,26
101575,1115798,1,4,6,4,0,30
101576,1115798,1,5,1,0,0,30
101577,1115798,1,5,2,0,0,30
101578,1115798,1,5,3,0,0,30
101579,1115798,1,5,4,1,0,31
101580,1115798,1,5,5,4,0,35
101581,1115798,1,5,6,0,0,35
101582,1115798,1,6,1,1,0,36
101583,1115798,1,6,2,1,0,37
101584,1115798,1,6,3,2,0,39
101585,1115798,1,6,4,1,0,40
101586,1115798,1,6,5,0,0,40
101587,1115798,1,6,6,0,0,40
101588,1115798,1,7,1,1,0,41
101589,1115798,1,7,2,1,0,42
101590,1115798,1,7,3,1,0,43
101591,1115798,1,7,4,1,0,44
101592,1115798,1,7,5,1,0,45
101593,1115798,1,7,6,1,0,46
101594,1115798,1,8,1,1,0,47
101595,1115798,1,8,2,1,0,48
101596,1115798,1,8,3,1,0,49
101597,1115798,1,8,4,1,0,50
101598,1115798,1,8,5,6,0,56
101599,1115798,1,8,6,1,0,57
101600,1115798,1,9,1,1,0,58
101601,1115798,1,9,2,1,0,59
101602,1115798,1,9,3,1,0,60
101603,1115798,1,9,4,4,0,64
101604,1115798,1,9,5,6,0,70
101605,1115798,1,9,6,6,0,76
101606,1115798,1,10,1,1,0,77
101607,1115798,1,10,2,1,0,78
101608,1115798,1,10,3,1,0,79
101609,1115798,1,10,4,1,0,80
101610,1115798,1,10,5,1,0,81
101611,1115798,1,10,6,0,0,81
101612,1115798,1,11,1,0,0,81
101613,1115798,1,11,2,2,0,83
101614,1115798,1,11,3,1,0,84
101615,1115798,1,11,4,0,0,84
101616,1115798,1,11,5,1,0,85
101617,1115798,1,11,6,4,0,89
101618,1115798,1,12,1,1,0,90
101619,1115798,1,12,2,1,0,91
101620,1115798,1,12,3,0,1,91
101621,1115798,1,12,4,1,0,92
101622,1115798,1,12,5,0,0,92
101623,1115798,1,12,6,1,0,93
101624,1115798,1,13,1,4,0,97
101625,1115798,1,13,2,2,0,99
101626,1115798,1,13,3,1,0,100
101627,1115798,1,13,4,1,0,101
101628,1115798,1,13,5,6,0,107
101629,1115798,1,13,6,1,0,108
101630,1115798,1,14,1,4,0,112
101631,1115798,1,14,2,2,0,114
101632,1115798,1,14,3,4,0,118
101633,1115798,1,14,4,0,1,118
101634,1115798,1,14,5,1,0,119
101635,1115798,1,14,6,0,0,119
101636,1115798,1,15,1,1,0,120
101637,1115798,1,15,2,0,1,120
101638,1115798,1,15,3,1,0,121
101639,1115798,1,15,4,1,0,122
101640,1115798,1,15,5,1,0,123
101641,1115798,1,15,6,1,0,124
101642,1115798,1,16,1,4,0,128
101643,1115798,1,16,2,1,0,129
101644,1115798,1,16,3,4,0,133
101645,1115798,1,16,4,1,0,134
101646,1115798,1,16,5,1,0,135
101647,1115798,1,16,6,1,0,136
101648,1115798,1,17,1,1,0,137
101649,1115798,1,17,2,1,0,138
101650,1115798,1,17,3,2,0,140
101651,1115798,1,17,4,1,0,141
101652,1115798,1,17,5,6,0,147
101653,1115798,1,17,6,2,0,149
101654,1115798,1,18,1,0,1,149
101655,1115798,1,18,2,2,0,151
101656,1115798,1,18,3,0,0,151
101657,1115798,1,18,4,0,0,151
101658,1115798,1,18,5,1,0,152
101659,1115798,1,18,6,1,0,153
101660,1115798,1,19,1,0,0,153
101661,1115798,1,19,2,0,1,153
101662,1115798,1,19,3,4,0,157
101663,1115798,1,19,4,1,0,158
101664,1115798,1,19,5,0,1,158
101665,1115798,1,19,6,4,0,162
101666,1115798,1,20,1,6,0,168
101667,1115798,1,20,2,9,0,177
101668,1115798,1,20,3,0,0,177
101669,1115798,1,20,4,6,0,183
101670,1115798,1,20,5,2,0,185
101671,1115798,1,20,6,2,0,187
101786,1115800,1,1,1,4,0,4
101787,1115800,1,1,2,0,0,4
101788,1115800,1,1,3,1,0,5
101789,1115800,1,1,4,0,0,5
101790,1115800,1,1,5,1,0,6
101791,1115800,1,1,6,4,0,10
101792,1115800,1,2,1,6,0,16
101793,1115800,1,2,2,2,0,18
101794,1115800,1,2,3,1,0,19
101795,1115800,1,2,4,1,0,20
101796,1115800,1,2,5,1,0,21
101797,1115800,1,2,6,1,0,22
101798,1115800,1,3,1,1,0,23
101799,1115800,1,3,2,1,0,24
101800,1115800,1,3,3,3,0,27
101801,1115800,1,3,4,1,0,28
101802,1115800,1,3,5,6,0,34
101803,1115800,1,3,6,0,0,34
101804,1115800,1,4,1,0,0,34
101805,1115800,1,4,2,0,0,34
101806,1115800,1,4,3,0,0,34
101807,1115800,1,4,4,4,0,38
101808,1115800,1,4,5,0,0,38
101809,1115800,1,4,6,4,0,42
101810,1115800,1,5,1,4,0,46
101811,1115800,1,5,2,4,0,50
101812,1115800,1,5,3,0,0,50
101813,1115800,1,5,4,1,0,51
101814,1115800,1,5,5,1,0,52
101815,1115800,1,5,6,0,0,52
101816,1115800,1,6,1,4,0,56
101817,1115800,1,6,2,1,0,57
101818,1115800,1,6,3,0,0,57
101819,1115800,1,6,4,1,0,58
101820,1115800,1,6,5,1,0,59
101821,1115800,1,6,6,4,0,63
101822,1115800,1,7,1,1,0,64
101823,1115800,1,7,2,0,0,64
101824,1115800,1,7,3,1,0,65
101825,1115800,1,7,4,1,0,66
101826,1115800,1,7,5,6,0,72
101827,1115800,1,7,6,1,0,73
101828,1115800,1,8,1,1,0,74
101829,1115800,1,8,2,1,0,75
101830,1115800,1,8,3,1,0,76
101831,1115800,1,8,4,2,0,78
101832,1115800,1,8,5,1,0,79
101833,1115800,1,8,6,1,0,80
101834,1115800,1,9,1,6,0,86
101835,1115800,1,9,2,6,0,92
101836,1115800,1,9,3,1,0,93
101837,1115800,1,9,4,1,0,94
101838,1115800,1,9,5,1,0,95
101839,1115800,1,9,6,1,0,96
101840,1115800,1,10,1,2,0,98
101841,1115800,1,10,2,2,0,100
101842,1115800,1,10,3,8,0,108
101843,1115800,1,10,4,2,0,110
101844,1115800,1,10,5,6,0,116
101845,1115800,1,10,6,2,0,118
101846,1115800,1,11,1,1,0,119
101847,1115800,1,11,2,0,0,119
101848,1115800,1,11,3,1,0,120
101849,1115800,1,11,4,6,0,126
101850,1115800,1,11,5,1,0,127
101851,1115800,1,11,6,1,0,128
101852,1115800,1,12,1,6,0,134
101853,1115800,1,12,2,2,0,136
101854,1115800,1,12,3,0,1,136
101855,1115800,1,12,4,1,0,137
101856,1115800,1,12,5,0,0,137
101857,1115800,1,12,6,0,0,137
101858,1115800,1,13,1,0,0,137
101859,1115800,1,13,2,4,0,141
101860,1115800,1,13,3,2,0,143
101861,1115800,1,13,4,1,0,144
101862,1115800,1,13,5,6,0,150
101863,1115800,1,13,6,7,0,157
101864,1115800,1,14,1,0,0,157
101865,1115800,1,14,2,6,0,163
101866,1115800,1,14,3,1,0,164
101867,1115800,1,14,4,1,0,165
101868,1115800,1,14,5,1,0,166
101869,1115800,1,14,6,1,0,167
101870,1115800,1,15,1,6,0,173
101871,1115800,1,15,2,6,0,179
101872,1115800,1,15,3,0,0,179
101873,1115800,1,15,4,1,0,180
101874,1115800,1,15,5,1,0,181
101875,1115800,1,15,6,2,0,183
101876,1115800,1,16,1,1,0,184
101877,1115800,1,16,2,1,0,185
101878,1115800,1,16,3,4,0,189
101879,1115800,1,16,4,1,0,190
101880,1115800,1,16,5,1,0,191
101881,1115800,1,16,6,0,1,191
101882,1115800,1,17,1,2,0,193
101883,1115800,1,17,2,1,0,194
101884,1115800,1,17,3,2,0,196
101885,1115800,1,17,4,6,0,202
101886,1115800,1,17,5,1,0,203
101887,1115800,1,17,6,1,0,204
101888,1115800,1,18,1,0,1,204
101889,1115800,1,18,2,1,0,205
101890,1115800,1,18,3,1,0,206
101891,1115800,1,18,4,1,0,207
101892,1115800,1,18,5,2,0,209
101893,1115800,1,18,6,2,0,211
101894,1115800,1,19,1,1,0,212
101895,1115800,1,19,2,0,0,212
101896,1115800,1,19,3,6,0,218
101897,1115800,1,19,4,4,0,222
101898,1115800,1,19,5,4,0,226
101899,1115800,1,19,6,0,1,226
101900,1115800,1,20,1,0,1,226
101901,1115800,1,20,2,0,0,226
101902,1115800,1,20,3,6,0,232
101903,1115800,1,20,4,4,0,236
101904,1115800,1,20,5,1,0,237
101905,1115800,1,20,6,6,0,243
102005,1115807,1,1,1,1,0,1
102006,1115807,1,1,2,0,0,1
102007,1115807,1,1,3,0,0,1
102008,1115807,1,1,4,0,0,1
102009,1115807,1,1,5,0,0,1
102010,1115807,1,1,6,0,0,1
102011,1115807,1,2,1,2,0,3
102012,1115807,1,2,2,0,0,3
102013,1115807,1,2,3,1,1,4
102014,1115807,1,2,4,0,0,4
102015,1115807,1,2,5,0,0,4
102016,1115807,1,2,6,0,0,4
102017,1115807,1,3,1,0,0,4
102018,1115807,1,3,2,0,1,4
102019,1115807,1,3,3,4,0,8
102020,1115807,1,3,4,0,0,8
102021,1115807,1,3,5,0,0,8
102022,1115807,1,3,6,2,0,10
102023,1115807,1,4,1,1,0,11
102024,1115807,1,4,2,1,0,12
102025,1115807,1,4,3,0,0,12
102026,1115807,1,4,4,3,0,15
102027,1115807,1,4,5,0,1,15
102028,1115807,1,4,6,0,0,15
102029,1115807,1,5,1,1,0,16
102030,1115807,1,5,2,0,0,16
102031,1115807,1,5,3,1,0,17
102032,1115807,1,5,4,0,0,17
102033,1115807,1,5,5,4,0,21
102034,1115807,1,5,6,0,0,21
102035,1115807,1,6,1,1,0,22
102036,1115807,1,6,2,0,0,22
102037,1115807,1,6,3,0,0,22
102038,1115807,1,6,4,0,1,22
102039,1115807,1,6,5,1,0,23
102040,1115807,1,6,6,1,0,24
102041,1115807,1,7,1,3,0,27
102042,1115807,1,7,2,0,0,27
102043,1115807,1,7,3,4,0,31
102044,1115807,1,7,4,0,0,31
102045,1115807,1,7,5,0,0,31
102046,1115807,1,7,6,0,0,31
102047,1115807,1,8,1,0,0,31
102048,1115807,1,8,2,1,0,32
102049,1115807,1,8,3,1,0,33
102050,1115807,1,8,4,1,0,34
102051,1115807,1,8,5,0,0,34
102052,1115807,1,8,6,1,0,35
102053,1115807,1,9,1,1,0,36
102054,1115807,1,9,2,1,0,37
102055,1115807,1,9,3,0,0,37
102056,1115807,1,9,4,0,0,37
102057,1115807,1,9,5,1,0,38
102058,1115807,1,9,6,0,0,38
102059,1115807,1,10,1,0,1,38
102060,1115807,1,10,2,0,1,38
102061,1115807,1,10,3,0,0,38
102062,1115807,1,10,4,0,0,38
102063,1115807,1,10,5,1,0,39
102064,1115807,1,10,6,0,0,39
102065,1115807,1,11,1,1,0,40
102066,1115807,1,11,2,1,0,41
102067,1115807,1,11,3,0,0,41
102068,1115807,1,11,4,1,0,42
102069,1115807,1,11,5,1,0,43
102070,1115807,1,11,6,1,0,44
102071,1115807,1,12,1,0,0,44
102072,1115807,1,12,2,1,0,45
102073,1115807,1,12,3,1,0,46
102074,1115807,1,12,4,1,0,47
102075,1115807,1,12,5,0,0,47
102076,1115807,1,12,6,0,0,47
102077,1115807,1,13,1,1,0,48
102078,1115807,1,13,2,1,0,49
102079,1115807,1,13,3,1,0,50
102080,1115807,1,13,4,2,0,52
102081,1115807,1,13,5,0,0,52
102082,1115807,1,13,6,0,0,52
102083,1115807,1,14,1,0,0,52
102084,1115807,1,14,2,0,0,52
102085,1115807,1,14,3,0,0,52
102086,1115807,1,14,4,1,0,53
102087,1115807,1,14,5,0,1,53
102088,1115807,1,14,6,0,0,53
102089,1115807,1,15,1,1,0,54
102090,1115807,1,15,2,1,0,55
102091,1115807,1,15,3,1,0,56
102092,1115807,1,15,4,6,0,62
102093,1115807,1,15,5,0,0,62
102094,1115807,1,15,6,1,0,63
102095,1115807,1,16,1,1,0,64
102096,1115807,1,16,2,1,0,65
102097,1115807,1,16,3,1,0,66
102098,1115807,1,16,4,1,0,67
102099,1115807,1,16,5,1,0,68
102100,1115807,1,16,6,2,0,70
102101,1115807,1,17,1,0,0,70
102102,1115807,1,17,2,7,0,77
102103,1115807,1,17,3,6,0,83
102104,1115807,1,17,4,0,1,83
102105,1115807,1,17,5,1,0,84
102106,1115807,1,17,6,0,0,84
102107,1115807,1,18,1,1,0,85
102108,1115807,1,18,2,0,0,85
102109,1115807,1,18,3,1,0,86
102110,1115807,1,18,4,0,0,86
102111,1115807,1,18,5,1,0,87
102112,1115807,1,18,6,1,0,88
102113,1115807,1,19,1,1,0,89
102114,1115807,1,19,2,0,0,89
102115,1115807,1,19,3,1,0,90
102116,1115807,1,19,4,0,1,90
102117,1115807,1,19,5,2,0,92
102118,1115807,1,19,6,1,0,93
102119,1115807,1,20,1,4,0,97
102120,1115807,1,20,2,2,0,99
102121,1115807,1,20,3,6,0,105
102122,1115807,1,20,4,0,1,105
102219,1115808,1,1,1,0,0,0
102220,1115808,1,1,2,0,0,0
102221,1115808,1,1,3,4,0,4
102222,1115808,1,1,4,1,0,5
102223,1115808,1,1,5,0,0,5
102224,1115808,1,1,6,1,0,6
102225,1115808,1,2,1,0,0,6
102226,1115808,1,2,2,4,0,10
102227,1115808,1,2,3,3,0,13
102228,1115808,1,2,4,1,0,14
102229,1115808,1,2,5,4,0,18
102230,1115808,1,2,6,0,0,18
102231,1115808,1,3,1,1,0,19
102232,1115808,1,3,2,4,0,23
102233,1115808,1,3,3,0,0,23
102234,1115808,1,3,4,1,0,24
102235,1115808,1,3,5,0,0,24
102236,1115808,1,3,6,1,0,25
102237,1115808,1,4,1,4,0,29
102238,1115808,1,4,2,0,0,29
102239,1115808,1,4,3,1,0,30
102240,1115808,1,4,4,0,0,30
102241,1115808,1,4,5,0,0,30
102242,1115808,1,4,6,0,0,30
102243,1115808,1,5,1,4,0,34
102244,1115808,1,5,2,1,0,35
102245,1115808,1,5,3,4,0,39
102246,1115808,1,5,4,0,0,39
102247,1115808,1,5,5,1,0,40
102248,1115808,1,5,6,4,0,44
102249,1115808,1,6,1,0,0,44
102250,1115808,1,6,2,4,0,48
102251,1115808,1,6,3,4,0,52
102252,1115808,1,6,4,1,0,53
102253,1115808,1,6,5,4,0,57
102254,1115808,1,6,6,0,0,57
102255,1115808,1,7,1,0,0,57
102256,1115808,1,7,2,1,0,58
102257,1115808,1,7,3,1,0,59
102258,1115808,1,7,4,0,0,59
102259,1115808,1,7,5,1,0,60
102260,1115808,1,7,6,1,0,61
102261,1115808,1,8,1,1,0,62
102262,1115808,1,8,2,1,0,63
102263,1115808,1,8,3,6,0,69
102264,1115808,1,8,4,6,0,75
102265,1115808,1,8,5,2,0,77
102266,1115808,1,8,6,6,0,83
102267,1115808,1,9,1,2,0,85
102268,1115808,1,9,2,0,0,85
102269,1115808,1,9,3,0,0,85
102270,1115808,1,9,4,1,0,86
102271,1115808,1,9,5,0,0,86
102272,1115808,1,9,6,0,0,86
102273,1115808,1,10,1,0,0,86
102274,1115808,1,10,2,0,0,86
102275,1115808,1,10,3,1,0,87
102276,1115808,1,10,4,1,0,88
102277,1115808,1,10,5,6,0,94
102278,1115808,1,10,6,0,1,94
102279,1115808,1,11,1,1,0,95
102280,1115808,1,11,2,1,0,96
102281,1115808,1,11,3,0,1,96
102282,1115808,1,11,4,1,0,97
102283,1115808,1,11,5,2,0,99
102284,1115808,1,11,6,1,0,100
102285,1115808,1,12,1,1,0,101
102286,1115808,1,12,2,1,0,102
102287,1115808,1,12,3,3,0,105
102288,1115808,1,12,4,1,0,106
102289,1115808,1,12,5,1,0,107
102290,1115808,1,12,6,1,0,108
102291,1115808,1,13,1,4,0,112
102292,1115808,1,13,2,2,0,114
102293,1115808,1,13,3,4,0,118
102294,1115808,1,13,4,1,0,119
102295,1115808,1,13,5,1,0,120
102296,1115808,1,13,6,1,0,121
102297,1115808,1,14,1,1,0,122
102298,1115808,1,14,2,1,0,123
102299,1115808,1,14,3,1,0,124
102300,1115808,1,14,4,2,0,126
102301,1115808,1,14,5,0,0,126
102302,1115808,1,14,6,4,0,130
102303,1115808,1,15,1,1,0,131
102304,1115808,1,15,2,1,0,132
102305,1115808,1,15,3,1,0,133
102306,1115808,1,15,4,2,0,135
102307,1115808,1,15,5,1,0,136
102308,1115808,1,15,6,1,0,137
102309,1115808,1,16,1,6,0,143
102310,1115808,1,16,2,0,0,143
102311,1115808,1,16,3,0,0,143
102312,1115808,1,16,4,2,0,145
102313,1115808,1,16,5,4,0,149
102314,1115808,1,16,6,1,0,150
102315,1115808,1,17,1,4,0,154
102316,1115808,1,17,2,1,0,155
102317,1115808,1,17,3,4,0,159
102318,1115808,1,17,4,6,0,165
102319,1115808,1,17,5,2,0,167
102320,1115808,1,17,6,1,0,168
102321,1115808,1,18,1,2,0,170
102322,1115808,1,18,2,1,0,171
102323,1115808,1,18,3,7,0,178
102324,1115808,1,18,4,2,0,180
102325,1115808,1,18,5,1,0,181
102326,1115808,1,18,6,0,0,181
102327,1115808,1,19,1,0,0,181
102328,1115808,1,19,2,6,0,187
102329,1115808,1,19,3,0,1,187
102330,1115808,1,19,4,1,0,188
102331,1115808,1,19,5,0,1,188
102332,1115808,1,19,6,2,0,190
102333,1115808,1,20,1,1,0,191
102334,1115808,1,20,2,1,0,192
102335,1115808,1,20,3,4,0,196
102336,1115808,1,20,4,0,0,196
102337,1115808,1,20,5,1,0,197
102338,1115808,1,20,6,4,0,201
102450,1115809,1,1,1,1,0,1
102451,1115809,1,1,2,0,0,1
102452,1115809,1,1,3,2,0,3
102453,1115809,1,1,4,4,0,7
102454,1115809,1,1,5,0,0,7
102455,1115809,1,1,6,0,0,7
102456,1115809,1,2,1,4,0,11
102457,1115809,1,2,2,1,0,12
102458,1115809,1,2,3,0,0,12
102459,1115809,1,2,4,0,0,12
102460,1115809,1,2,5,0,0,12
102461,1115809,1,2,6,3,0,15
102462,1115809,1,3,1,0,0,15
102463,1115809,1,3,2,0,0,15
102464,1115809,1,3,3,0,0,15
102465,1115809,1,3,4,2,0,17
102466,1115809,1,3,5,4,0,21
102467,1115809,1,3,6,4,0,25
102468,1115809,1,4,1,0,0,25
102469,1115809,1,4,2,4,0,29
102470,1115809,1,4,3,1,0,30
102471,1115809,1,4,4,0,0,30
102472,1115809,1,4,5,0,0,30
102473,1115809,1,4,6,0,1,30
102474,1115809,1,5,1,0,0,30
102475,1115809,1,5,2,1,0,31
102476,1115809,1,5,3,2,0,33
102477,1115809,1,5,4,0,0,33
102478,1115809,1,5,5,1,0,34
102479,1115809,1,5,6,0,0,34
102480,1115809,1,6,1,0,0,34
102481,1115809,1,6,2,0,0,34
102482,1115809,1,6,3,4,0,38
102483,1115809,1,6,4,1,0,39
102484,1115809,1,6,5,6,0,45
102485,1115809,1,6,6,0,0,45
102486,1115809,1,7,1,1,0,46
102487,1115809,1,7,2,4,0,50
102488,1115809,1,7,3,1,0,51
102489,1115809,1,7,4,0,0,51
102490,1115809,1,7,5,0,0,51
102491,1115809,1,7,6,1,0,52
102492,1115809,1,8,1,1,0,53
102493,1115809,1,8,2,1,0,54
102494,1115809,1,8,3,1,0,55
102495,1115809,1,8,4,2,0,57
102496,1115809,1,8,5,0,0,57
102497,1115809,1,8,6,0,0,57
102498,1115809,1,9,1,1,0,58
102499,1115809,1,9,2,1,0,59
102500,1115809,1,9,3,4,0,63
102501,1115809,1,9,4,1,0,64
102502,1115809,1,9,5,2,0,66
102503,1115809,1,9,6,0,1,66
102504,1115809,1,10,1,0,0,66
102505,1115809,1,10,2,1,0,67
102506,1115809,1,10,3,0,0,67
102507,1115809,1,10,4,1,0,68
102508,1115809,1,10,5,0,0,68
102509,1115809,1,10,6,4,0,72
102510,1115809,1,11,1,3,0,75
102511,1115809,1,11,2,1,0,76
102512,1115809,1,11,3,1,0,77
102513,1115809,1,11,4,4,0,81
102514,1115809,1,11,5,1,0,82
102515,1115809,1,11,6,0,0,82
102516,1115809,1,12,1,1,0,83
102517,1115809,1,12,2,1,0,84
102518,1115809,1,12,3,1,0,85
102519,1115809,1,12,4,4,0,89
102520,1115809,1,12,5,0,0,89
102521,1115809,1,12,6,4,0,93
102522,1115809,1,13,1,2,0,95
102523,1115809,1,13,2,2,0,97
102524,1115809,1,13,3,0,0,97
102525,1115809,1,13,4,1,0,98
102526,1115809,1,13,5,2,0,100
102527,1115809,1,13,6,1,0,101
102528,1115809,1,14,1,3,0,104
102529,1115809,1,14,2,0,0,104
102530,1115809,1,14,3,1,0,105
102531,1115809,1,14,4,1,0,106
102532,1115809,1,14,5,0,1,106
102533,1115809,1,14,6,1,0,107
102534,1115809,1,15,1,1,0,108
102535,1115809,1,15,2,1,0,109
102536,1115809,1,15,3,5,0,114
102537,1115809,1,15,4,1,0,115
102538,1115809,1,15,5,2,0,117
102539,1115809,1,15,6,4,0,121
102540,1115809,1,16,1,1,0,122
102541,1115809,1,16,2,1,0,123
102542,1115809,1,16,3,0,0,123
102543,1115809,1,16,4,0,0,123
102544,1115809,1,16,5,0,1,123
102545,1115809,1,16,6,0,0,123
102546,1115809,1,17,1,4,0,127
102547,1115809,1,17,2,1,0,128
102548,1115809,1,17,3,1,0,129
102549,1115809,1,17,4,0,0,129
102550,1115809,1,17,5,5,0,134
102551,1115809,1,17,6,1,0,135
102552,1115809,1,18,1,1,0,136
102553,1115809,1,18,2,6,0,142
102554,1115809,1,18,3,2,0,144
102555,1115809,1,18,4,6,0,150
102556,1115809,1,18,5,6,0,156
102557,1115809,1,18,6,0,1,156
102558,1115809,1,19,1,2,0,158
102559,1115809,1,19,2,4,0,162
102560,1115809,1,19,3,2,0,164
102561,1115809,1,19,4,0,1,164
102562,1115809,1,19,5,1,0,165
102563,1115809,1,19,6,0,0,165
102564,1115809,1,20,1,1,0,166
102565,1115809,1,20,2,1,0,167
102566,1115809,1,20,3,2,0,169
102567,1115809,1,20,4,2,0,171
102568,1115809,1,20,5,4,0,175
102569,1115809,1,20,6,6,0,181
102690,1119501,1,1,1,0,0,0
102691,1119501,1,1,2,0,0,0
102692,1119501,1,1,3,4,0,4
102693,1119501,1,1,4,4,0,8
102694,1119501,1,1,5,0,1,8
102695,1119501,1,1,6,0,0,8
102696,1119501,1,2,1,0,0,8
102697,1119501,1,2,2,0,0,8
102698,1119501,1,2,3,4,0,12
102699,1119501,1,2,4,1,0,13
102700,1119501,1,2,5,1,0,14
102701,1119501,1,2,6,1,0,15
102702,1119501,1,3,1,0,0,15
102703,1119501,1,3,2,2,0,17
102704,1119501,1,3,3,0,0,17
102705,1119501,1,3,4,0,0,17
102706,1119501,1,3,5,4,0,21
102707,1119501,1,3,6,4,0,25
102708,1119501,1,4,1,0,0,25
102709,1119501,1,4,2,1,0,26
102710,1119501,1,4,3,1,0,27
102711,1119501,1,4,4,0,0,27
102712,1119501,1,4,5,0,0,27
102713,1119501,1,4,6,1,0,28
102714,1119501,1,5,1,0,0,28
102715,1119501,1,5,2,1,0,29
102716,1119501,1,5,3,1,0,30
102717,1119501,1,5,4,2,0,32
102718,1119501,1,5,5,2,0,34
102719,1119501,1,5,6,2,0,36
102720,1119501,1,6,1,4,0,40
102721,1119501,1,6,2,1,0,41
102722,1119501,1,6,3,2,0,43
102723,1119501,1,6,4,4,0,47
102724,1119501,1,6,5,1,0,48
102725,1119501,1,6,6,1,0,49
102726,1119501,1,7,1,2,0,51
102727,1119501,1,7,2,4,0,55
102728,1119501,1,7,3,0,1,55
102729,1119501,1,7,4,1,0,56
102730,1119501,1,7,5,1,0,57
102731,1119501,1,7,6,0,0,57
102732,1119501,1,8,1,0,0,57
102733,1119501,1,8,2,1,0,58
102734,1119501,1,8,3,1,0,59
102735,1119501,1,8,4,1,0,60
102736,1119501,1,8,5,1,0,61
102737,1119501,1,8,6,1,0,62
102738,1119501,1,9,1,0,0,62
102739,1119501,1,9,2,6,0,68
102740,1119501,1,9,3,1,0,69
102741,1119501,1,9,4,1,0,70
102742,1119501,1,9,5,1,0,71
102743,1119501,1,9,6,1,0,72
102744,1119501,1,10,1,1,0,73
102745,1119501,1,10,2,2,0,75
102746,1119501,1,10,3,0,0,75
102747,1119501,1,10,4,1,0,76
102748,1119501,1,10,5,0,1,76
102749,1119501,1,10,6,1,0,77
102750,1119501,1,11,1,1,0,78
102751,1119501,1,11,2,0,0,78
102752,1119501,1,11,3,1,0,79
102753,1119501,1,11,4,0,0,79
102754,1119501,1,11,5,1,0,80
102755,1119501,1,11,6,0,0,80
102756,1119501,1,12,1,1,0,81
102757,1119501,1,12,2,0,0,81
102758,1119501,1,12,3,1,0,82
102759,1119501,1,12,4,0,0,82
102760,1119501,1,12,5,4,0,86
102761,1119501,1,12,6,0,0,86
102762,1119501,1,13,1,1,0,87
102763,1119501,1,13,2,0,1,87
102764,1119501,1,13,3,0,0,87
102765,1119501,1,13,4,0,0,87
102766,1119501,1,13,5,1,0,88
102767,1119501,1,13,6,0,0,88
102768,1119501,1,14,1,0,0,88
102769,1119501,1,14,2,1,0,89
102770,1119501,1,14,3,0,1,89
102771,1119501,1,14,4,1,0,90
102772,1119501,1,14,5,1,0,91
102773,1119501,1,14,6,1,0,92
102774,1119501,1,15,1,0,0,92
102775,1119501,1,15,2,0,0,92
102776,1119501,1,15,3,1,0,93
102777,1119501,1,15,4,1,0,94
102778,1119501,1,15,5,0,0,94
102779,1119501,1,15,6,1,0,95
102780,1119501,1,16,1,0,0,95
102781,1119501,1,16,2,1,0,96
102782,1119501,1,16,3,1,0,97
102783,1119501,1,16,4,0,0,97
102784,1119501,1,16,5,1,0,98
102785,1119501,1,16,6,1,0,99
102786,1119501,1,17,1,0,0,99
102787,1119501,1,17,2,1,0,100
102788,1119501,1,17,3,4,0,104
102789,1119501,1,17,4,0,0,104
102790,1119501,1,17,5,6,0,110
102791,1119501,1,17,6,1,0,111
102792,1119501,1,18,1,0,1,111
102793,1119501,1,18,2,1,0,112
102794,1119501,1,18,3,1,0,113
102795,1119501,1,18,4,0,1,113
102796,1119501,1,18,5,0,0,113
102797,1119501,1,18,6,0,0,113
102798,1119501,1,19,1,1,1,114
102799,1119501,1,19,2,0,0,114
102800,1119501,1,19,3,4,0,118
102801,1119501,1,19,4,0,0,118
102835,1119502,1,1,1,4,0,4
102836,1119502,1,1,2,0,0,4
102837,1119502,1,1,3,4,0,8
102838,1119502,1,1,4,0,1,8
102839,1119502,1,1,5,0,0,8
102840,1119502,1,1,6,0,1,8
102841,1119502,1,2,1,1,0,9
102842,1119502,1,2,2,0,0,9
102843,1119502,1,2,3,0,0,9
102844,1119502,1,2,4,2,0,11
102845,1119502,1,2,5,0,0,11
102846,1119502,1,2,6,1,0,12
102847,1119502,1,3,1,4,0,16
102848,1119502,1,3,2,0,1,16
102849,1119502,1,3,3,0,0,16
102850,1119502,1,3,4,0,0,16
102851,1119502,1,3,5,0,0,16
102852,1119502,1,3,6,0,0,16
102853,1119502,1,4,1,1,0,17
102854,1119502,1,4,2,1,0,18
102855,1119502,1,4,3,3,0,21
102856,1119502,1,4,4,0,0,21
102857,1119502,1,4,5,6,0,27
102858,1119502,1,4,6,0,0,27
102859,1119502,1,5,1,0,0,27
102860,1119502,1,5,2,0,0,27
102861,1119502,1,5,3,0,1,27
102862,1119502,1,5,4,0,0,27
102863,1119502,1,5,5,4,0,31
102864,1119502,1,5,6,0,0,31
102865,1119502,1,6,1,1,0,32
102866,1119502,1,6,2,0,0,32
102867,1119502,1,6,3,4,0,36
102868,1119502,1,6,4,1,0,37
102869,1119502,1,6,5,0,0,37
102870,1119502,1,6,6,1,0,38
102871,1119502,1,7,1,2,0,40
102872,1119502,1,7,2,0,0,40
102873,1119502,1,7,3,2,0,42
102874,1119502,1,7,4,1,0,43
102875,1119502,1,7,5,0,0,43
102876,1119502,1,7,6,0,0,43
102877,1119502,1,8,1,0,0,43
102878,1119502,1,8,2,1,0,44
102879,1119502,1,8,3,2,0,46
102880,1119502,1,8,4,0,0,46
102881,1119502,1,8,5,1,0,47
102882,1119502,1,8,6,0,0,47
102883,1119502,1,9,1,4,0,51
102884,1119502,1,9,2,1,0,52
102885,1119502,1,9,3,0,0,52
102886,1119502,1,9,4,1,0,53
102887,1119502,1,9,5,0,0,53
102888,1119502,1,9,6,1,0,54
102889,1119502,1,10,1,1,0,55
102890,1119502,1,10,2,0,0,55
102891,1119502,1,10,3,4,0,59
102892,1119502,1,10,4,0,0,59
102893,1119502,1,10,5,1,1,60
102894,1119502,1,10,6,1,0,61
102895,1119502,1,11,1,0,0,61
102896,1119502,1,11,2,1,0,62
102897,1119502,1,11,3,1,0,63
102898,1119502,1,11,4,0,0,63
102899,1119502,1,11,5,3,0,66
102900,1119502,1,11,6,1,0,67
102901,1119502,1,12,1,0,1,67
102902,1119502,1,12,2,0,0,67
102903,1119502,1,12,3,0,0,67
102904,1119502,1,12,4,0,0,67
102905,1119502,1,12,5,1,0,68
102906,1119502,1,12,6,1,0,69
102907,1119502,1,13,1,0,0,69
102908,1119502,1,13,2,1,0,70
102909,1119502,1,13,3,0,0,70
102910,1119502,1,13,4,0,1,70
102911,1119502,1,13,5,0,0,70
102912,1119502,1,13,6,1,0,71
102913,1119502,1,14,1,1,0,72
102914,1119502,1,14,2,1,0,73
102915,1119502,1,14,3,1,0,74
102916,1119502,1,14,4,1,0,75
102917,1119502,1,14,5,2,0,77
102918,1119502,1,14,6,0,0,77
102919,1119502,1,15,1,1,0,78
102920,1119502,1,15,2,0,0,78
102921,1119502,1,15,3,0,0,78
102922,1119502,1,15,4,1,0,79
102923,1119502,1,15,5,1,0,80
102924,1119502,1,15,6,5,0,85
102925,1119502,1,16,1,1,0,86
102926,1119502,1,16,2,1,0,87
102927,1119502,1,16,3,0,0,87
102928,1119502,1,16,4,1,0,88
102929,1119502,1,16,5,1,0,89
102930,1119502,1,16,6,1,0,90
102931,1119502,1,17,1,6,0,96
102932,1119502,1,17,2,0,0,96
102933,1119502,1,17,3,2,0,98
102934,1119502,1,17,4,1,0,99
102935,1119502,1,17,5,1,0,100
102936,1119502,1,17,6,1,0,101
102937,1119502,1,18,1,1,0,102
102938,1119502,1,18,2,1,0,103
102939,1119502,1,18,3,0,1,103
102940,1119502,1,18,4,1,0,104
102941,1119502,1,18,5,0,0,104
102942,1119502,1,18,6,0,0,104
102943,1119502,1,19,1,3,0,107
102944,1119502,1,19,2,0,0,107
102945,1119502,1,19,3,4,0,111
102946,1119502,1,19,4,1,0,112
102947,1119502,1,19,5,1,0,113
102948,1119502,1,19,6,1,0,114
102949,1119502,1,20,1,0,0,114
102950,1119502,1,20,2,1,0,115
102951,1119502,1,20,3,0,1,115
102952,1119502,1,20,4,0,0,115
102953,1119502,1,20,5,3,0,118
102954,1119502,1,20,6,0,1,118
103048,1119542,1,1,1,4,0,4
103049,1119542,1,1,2,0,0,4
103050,1119542,1,1,3,4,0,8
103051,1119542,1,1,4,0,0,8
103052,1119542,1,1,5,4,0,12
103053,1119542,1,1,6,1,0,13
103054,1119542,1,2,1,0,0,13
103055,1119542,1,2,2,1,0,14
103056,1119542,1,2,3,1,0,15
103057,1119542,1,2,4,1,0,16
103058,1119542,1,2,5,0,0,16
103059,1119542,1,2,6,1,0,17
103060,1119542,1,3,1,0,0,17
103061,1119542,1,3,2,4,0,21
103062,1119542,1,3,3,1,0,22
103063,1119542,1,3,4,4,0,26
103064,1119542,1,3,5,1,0,27
103065,1119542,1,3,6,6,0,33
103066,1119542,1,4,1,4,0,37
103067,1119542,1,4,2,1,0,38
103068,1119542,1,4,3,6,0,44
103069,1119542,1,4,4,4,0,48
103070,1119542,1,4,5,4,0,52
103071,1119542,1,4,6,4,0,56
103072,1119542,1,5,1,0,0,56
103073,1119542,1,5,2,1,0,57
103074,1119542,1,5,3,1,0,58
103075,1119542,1,5,4,1,0,59
103076,1119542,1,5,5,0,0,59
103077,1119542,1,5,6,0,0,59
103078,1119542,1,6,1,1,0,60
103079,1119542,1,6,2,4,0,64
103080,1119542,1,6,3,6,0,70
103081,1119542,1,6,4,0,0,70
103082,1119542,1,6,5,0,0,70
103083,1119542,1,6,6,0,0,70
103084,1119542,1,7,1,2,0,72
103085,1119542,1,7,2,1,0,73
103086,1119542,1,7,3,0,0,73
103087,1119542,1,7,4,6,0,79
103088,1119542,1,7,5,4,0,83
103089,1119542,1,7,6,0,0,83
103090,1119542,1,8,1,1,0,84
103091,1119542,1,8,2,1,0,85
103092,1119542,1,8,3,1,0,86
103093,1119542,1,8,4,6,0,92
103094,1119542,1,8,5,0,0,92
103095,1119542,1,8,6,0,0,92
103096,1119542,1,9,1,0,0,92
103097,1119542,1,9,2,1,0,93
103098,1119542,1,9,3,0,0,93
103099,1119542,1,9,4,2,0,95
103100,1119542,1,9,5,0,1,95
103101,1119542,1,9,6,3,0,98
103102,1119542,1,10,1,4,0,102
103103,1119542,1,10,2,6,0,108
103104,1119542,1,10,3,0,1,108
103105,1119542,1,10,4,1,0,109
103106,1119542,1,10,5,1,0,110
103107,1119542,1,10,6,6,0,116
103108,1119542,1,11,1,4,0,120
103109,1119542,1,11,2,2,0,122
103110,1119542,1,11,3,1,0,123
103111,1119542,1,11,4,4,0,127
103112,1119542,1,11,5,0,0,127
103113,1119542,1,11,6,1,0,128
103114,1119542,1,12,1,1,0,129
103115,1119542,1,12,2,2,0,131
103116,1119542,1,12,3,1,0,132
103117,1119542,1,12,4,0,1,132
103118,1119542,1,12,5,1,0,133
103119,1119542,1,12,6,1,0,134
103120,1119542,1,13,1,1,0,135
103121,1119542,1,13,2,6,0,141
103122,1119542,1,13,3,1,0,142
103123,1119542,1,13,4,1,0,143
103124,1119542,1,13,5,1,0,144
103125,1119542,1,13,6,0,0,144
103126,1119542,1,14,1,4,0,148
103127,1119542,1,14,2,1,0,149
103128,1119542,1,14,3,2,0,151
103129,1119542,1,14,4,2,0,153
103130,1119542,1,14,5,0,0,153
103131,1119542,1,14,6,1,0,154
103132,1119542,1,15,1,1,0,155
103133,1119542,1,15,2,1,0,156
103134,1119542,1,15,3,0,0,156
103135,1119542,1,15,4,2,0,158
103136,1119542,1,15,5,4,0,162
103137,1119542,1,15,6,1,0,163
103138,1119542,1,16,1,4,0,167
103139,1119542,1,16,2,5,0,172
103140,1119542,1,16,3,1,0,173
103141,1119542,1,16,4,4,0,177
103142,1119542,1,16,5,0,0,177
103143,1119542,1,16,6,1,0,178
103144,1119542,1,17,1,4,0,182
103145,1119542,1,17,2,1,0,183
103146,1119542,1,17,3,1,0,184
103147,1119542,1,17,4,6,0,190
103148,1119542,1,17,5,1,0,191
103149,1119542,1,17,6,4,0,195
103150,1119542,1,18,1,1,0,196
103151,1119542,1,18,2,1,0,197
103152,1119542,1,18,3,4,0,201
103153,1119542,1,18,4,1,0,202
103154,1119542,1,18,5,2,0,204
103155,1119542,1,18,6,0,0,204
103156,1119542,1,19,1,0,1,204
103157,1119542,1,19,2,6,0,210
103158,1119542,1,19,3,1,0,211
103159,1119542,1,19,4,0,0,211
103160,1119542,1,19,5,1,0,212
103161,1119542,1,19,6,1,0,213
103162,1119542,1,20,1,0,0,213
103163,1119542,1,20,2,0,0,213
103164,1119542,1,20,3,1,0,214
103165,1119542,1,20,4,1,0,215
103166,1119542,1,20,5,0,1,215
103167,1119542,1,20,6,6,0,221
103286,1119543,1,1,1,0,0,0
103287,1119543,1,1,2,2,0,2
103288,1119543,1,1,3,0,0,2
103289,1119543,1,1,4,4,0,6
103290,1119543,1,1,5,4,0,10
103291,1119543,1,1,6,1,0,11
103292,1119543,1,2,1,0,0,11
103293,1119543,1,2,2,4,0,15
103294,1119543,1,2,3,1,0,16
103295,1119543,1,2,4,0,0,16
103296,1119543,1,2,5,0,0,16
103297,1119543,1,2,6,4,0,20
103298,1119543,1,3,1,0,0,20
103299,1119543,1,3,2,0,0,20
103300,1119543,1,3,3,2,0,22
103301,1119543,1,3,4,4,0,26
103302,1119543,1,3,5,2,0,28
103303,1119543,1,3,6,0,0,28
103304,1119543,1,4,1,0,0,28
103305,1119543,1,4,2,1,0,29
103306,1119543,1,4,3,4,0,33
103307,1119543,1,4,4,1,0,34
103308,1119543,1,4,5,6,0,40
103309,1119543,1,4,6,4,0,44
103310,1119543,1,5,1,0,0,44
103311,1119543,1,5,2,1,0,45
103312,1119543,1,5,3,4,0,49
103313,1119543,1,5,4,0,0,49
103314,1119543,1,5,5,1,0,50
103315,1119543,1,5,6,0,1,50
103316,1119543,1,6,1,2,0,52
103317,1119543,1,6,2,1,0,53
103318,1119543,1,6,3,0,0,53
103319,1119543,1,6,4,0,0,53
103320,1119543,1,6,5,0,0,53
103321,1119543,1,6,6,0,0,53
103322,1119543,1,7,1,1,0,54
103323,1119543,1,7,2,1,0,55
103324,1119543,1,7,3,1,0,56
103325,1119543,1,7,4,1,0,57
103326,1119543,1,7,5,0,0,57
103327,1119543,1,7,6,2,0,59
103328,1119543,1,8,1,1,0,60
103329,1119543,1,8,2,1,0,61
103330,1119543,1,8,3,0,0,61
103331,1119543,1,8,4,0,0,61
103332,1119543,1,8,5,1,0,62
103333,1119543,1,8,6,4,0,66
103334,1119543,1,9,1,0,0,66
103335,1119543,1,9,2,0,0,66
103336,1119543,1,9,3,1,0,67
103337,1119543,1,9,4,4,0,71
103338,1119543,1,9,5,0,0,71
103339,1119543,1,9,6,1,0,72
103340,1119543,1,10,1,4,0,76
103341,1119543,1,10,2,0,0,76
103342,1119543,1,10,3,0,0,76
103343,1119543,1,10,4,0,0,76
103344,1119543,1,10,5,0,0,76
103345,1119543,1,10,6,1,0,77
103346,1119543,1,11,1,4,0,81
103347,1119543,1,11,2,6,0,87
103348,1119543,1,11,3,4,0,91
103349,1119543,1,11,4,1,0,92
103350,1119543,1,11,5,2,0,94
103351,1119543,1,11,6,1,0,95
103352,1119543,1,12,1,0,0,95
103353,1119543,1,12,2,0,0,95
103354,1119543,1,12,3,0,1,95
103355,1119543,1,12,4,3,0,98
103356,1119543,1,12,5,0,0,98
103357,1119543,1,12,6,2,0,100
103358,1119543,1,13,1,1,0,101
103359,1119543,1,13,2,0,0,101
103360,1119543,1,13,3,1,0,102
103361,1119543,1,13,4,3,0,105
103362,1119543,1,13,5,0,0,105
103363,1119543,1,13,6,1,0,106
103364,1119543,1,14,1,0,1,106
103365,1119543,1,14,2,1,0,107
103366,1119543,1,14,3,0,1,107
103367,1119543,1,14,4,0,1,107
103368,1119543,1,14,5,1,0,108
103369,1119543,1,14,6,1,0,109
103370,1119543,1,15,1,1,0,110
103371,1119543,1,15,2,0,0,110
103372,1119543,1,15,3,1,0,111
103373,1119543,1,15,4,1,0,112
103374,1119543,1,15,5,0,0,112
103375,1119543,1,15,6,0,0,112
103376,1119543,1,16,1,1,0,113
103377,1119543,1,16,2,4,0,117
103378,1119543,1,16,3,0,0,117
103379,1119543,1,16,4,0,1,117
103380,1119543,1,16,5,0,0,117
103381,1119543,1,16,6,0,0,117
103382,1119543,1,17,1,6,0,123
103383,1119543,1,17,2,2,0,125
103384,1119543,1,17,3,0,0,125
103385,1119543,1,17,4,4,0,129
103386,1119543,1,17,5,4,0,133
103387,1119543,1,17,6,4,0,137
103388,1119543,1,18,1,2,0,139
103389,1119543,1,18,2,2,0,141
103390,1119543,1,18,3,0,0,141
103391,1119543,1,18,4,0,1,141
103392,1119543,1,18,5,6,0,147
103393,1119543,1,18,6,1,0,148
103394,1119543,1,19,1,0,0,148
103395,1119543,1,19,2,1,0,149
103396,1119543,1,19,3,0,1,149
103397,1119543,1,19,4,1,0,150
103398,1119543,1,19,5,0,0,150
103399,1119543,1,19,6,1,0,151
103400,1119543,1,20,1,1,0,152
103401,1119543,1,20,2,0,0,152
103402,1119543,1,20,3,1,0,153
103403,1119543,1,20,4,3,0,156
103404,1119543,1,20,5,1,0,157
103405,1119543,1,20,6,2,0,159
103516,1119544,1,1,1,0,0,0
103517,1119544,1,1,2,0,0,0
103518,1119544,1,1,3,0,0,0
103519,1119544,1,1,4,0,0,0
103520,1119544,1,1,5,1,0,1
103521,1119544,1,1,6,0,0,1
103522,1119544,1,2,1,1,0,2
103523,1119544,1,2,2,0,0,2
103524,1119544,1,2,3,1,0,3
103525,1119544,1,2,4,4,0,7
103526,1119544,1,2,5,0,0,7
103527,1119544,1,2,6,0,1,7
103528,1119544,1,3,1,1,0,8
103529,1119544,1,3,2,0,0,8
103530,1119544,1,3,3,1,0,9
103531,1119544,1,3,4,3,0,12
103532,1119544,1,3,5,1,0,13
103533,1119544,1,3,6,0,0,13
103534,1119544,1,4,1,1,0,14
103535,1119544,1,4,2,1,0,15
103536,1119544,1,4,3,1,0,16
103537,1119544,1,4,4,1,0,17
103538,1119544,1,4,5,4,0,21
103539,1119544,1,4,6,1,0,22
103540,1119544,1,5,1,0,0,22
103541,1119544,1,5,2,0,1,22
103542,1119544,1,5,3,0,0,22
103543,1119544,1,5,4,0,0,22
103544,1119544,1,5,5,0,1,22
103545,1119544,1,5,6,1,0,23
103546,1119544,1,6,1,4,0,27
103547,1119544,1,6,2,1,0,28
103548,1119544,1,6,3,1,0,29
103549,1119544,1,6,4,0,0,29
103550,1119544,1,6,5,2,0,31
103551,1119544,1,6,6,0,0,31
103552,1119544,1,7,1,0,0,31
103553,1119544,1,7,2,0,0,31
103554,1119544,1,7,3,0,0,31
103555,1119544,1,7,4,1,0,32
103556,1119544,1,7,5,0,0,32
103557,1119544,1,7,6,4,0,36
103558,1119544,1,8,1,0,0,36
103559,1119544,1,8,2,1,0,37
103560,1119544,1,8,3,1,0,38
103561,1119544,1,8,4,1,0,39
103562,1119544,1,8,5,1,0,40
103563,1119544,1,8,6,1,0,41
103564,1119544,1,9,1,0,0,41
103565,1119544,1,9,2,2,0,43
103566,1119544,1,9,3,0,0,43
103567,1119544,1,9,4,2,0,45
103568,1119544,1,9,5,2,0,47
103569,1119544,1,9,6,1,0,48
103570,1119544,1,10,1,0,0,48
103571,1119544,1,10,2,0,0,48
103572,1119544,1,10,3,1,0,49
103573,1119544,1,10,4,1,0,50
103574,1119544,1,10,5,1,0,51
103575,1119544,1,10,6,1,0,52
103576,1119544,1,11,1,1,0,53
103577,1119544,1,11,2,2,0,55
103578,1119544,1,11,3,1,0,56
103579,1119544,1,11,4,1,0,57
103580,1119544,1,11,5,4,0,61
103581,1119544,1,11,6,6,0,67
103582,1119544,1,12,1,6,0,73
103583,1119544,1,12,2,1,0,74
103584,1119544,1,12,3,1,0,75
103585,1119544,1,12,4,1,0,76
103586,1119544,1,12,5,2,0,78
103587,1119544,1,12,6,1,0,79
103588,1119544,1,13,1,0,0,79
103589,1119544,1,13,2,0,1,79
103590,1119544,1,13,3,1,0,80
103591,1119544,1,13,4,0,0,80
103592,1119544,1,13,5,1,0,81
103593,1119544,1,13,6,1,0,82
103594,1119544,1,14,1,0,0,82
103595,1119544,1,14,2,4,0,86
103596,1119544,1,14,3,0,0,86
103597,1119544,1,14,4,1,0,87
103598,1119544,1,14,5,2,0,89
103599,1119544,1,14,6,0,0,89
103600,1119544,1,15,1,0,0,89
103601,1119544,1,15,2,0,0,89
103602,1119544,1,15,3,0,0,89
103603,1119544,1,15,4,0,0,89
103604,1119544,1,15,5,4,0,93
103605,1119544,1,15,6,0,0,93
103606,1119544,1,16,1,2,0,95
103607,1119544,1,16,2,0,0,95
103608,1119544,1,16,3,2,0,97
103609,1119544,1,16,4,1,0,98
103610,1119544,1,16,5,1,0,99
103611,1119544,1,16,6,2,0,101
103612,1119544,1,17,1,1,0,102
103613,1119544,1,17,2,1,0,103
103614,1119544,1,17,3,1,0,104
103615,1119544,1,17,4,6,0,110
103616,1119544,1,17,5,1,0,111
103617,1119544,1,17,6,0,0,111
103618,1119544,1,18,1,0,1,111
103619,1119544,1,18,2,1,0,112
103620,1119544,1,18,3,1,0,113
103621,1119544,1,18,4,0,0,113
103622,1119544,1,18,5,2,0,115
103623,1119544,1,18,6,0,0,115
103624,1119544,1,19,1,2,0,117
103625,1119544,1,19,2,1,0,118
103626,1119544,1,19,3,0,0,118
103627,1119544,1,19,4,0,0,118
103628,1119544,1,19,5,6,0,124
103629,1119544,1,19,6,2,0,126
103630,1119544,1,20,1,2,0,128
103631,1119544,1,20,2,4,0,132
103632,1119544,1,20,3,2,0,134
103633,1119544,1,20,4,6,0,140
103634,1119544,1,20,5,4,0,144
103635,1119544,1,20,6,4,0,148
103754,1119545,1,1,1,1,0,1
103755,1119545,1,1,2,0,0,1
103756,1119545,1,1,3,4,0,5
103757,1119545,1,1,4,4,0,9
103758,1119545,1,1,5,0,0,9
103759,1119545,1,1,6,4,0,13
103760,1119545,1,2,1,0,0,13
103761,1119545,1,2,2,0,0,13
103762,1119545,1,2,3,1,0,14
103763,1119545,1,2,4,4,0,18
103764,1119545,1,2,5,4,0,22
103765,1119545,1,2,6,1,0,23
103766,1119545,1,3,1,0,0,23
103767,1119545,1,3,2,0,0,23
103768,1119545,1,3,3,4,0,27
103769,1119545,1,3,4,0,0,27
103770,1119545,1,3,5,1,0,28
103771,1119545,1,3,6,1,0,29
103772,1119545,1,4,1,4,0,33
103773,1119545,1,4,2,0,0,33
103774,1119545,1,4,3,0,0,33
103775,1119545,1,4,4,4,0,37
103776,1119545,1,4,5,0,0,37
103777,1119545,1,4,6,6,0,43
103778,1119545,1,5,1,1,0,44
103779,1119545,1,5,2,0,0,44
103780,1119545,1,5,3,6,0,50
103781,1119545,1,5,4,0,0,50
103782,1119545,1,5,5,0,0,50
103783,1119545,1,5,6,1,0,51
103784,1119545,1,6,1,4,0,55
103785,1119545,1,6,2,4,0,59
103786,1119545,1,6,3,6,0,65
103787,1119545,1,6,4,6,0,71
103788,1119545,1,6,5,1,0,72
103789,1119545,1,6,6,1,0,73
103790,1119545,1,7,1,0,0,73
103791,1119545,1,7,2,1,0,74
103792,1119545,1,7,3,1,0,75
103793,1119545,1,7,4,1,0,76
103794,1119545,1,7,5,6,0,82
103795,1119545,1,7,6,0,0,82
103796,1119545,1,8,1,1,0,83
103797,1119545,1,8,2,6,0,89
103798,1119545,1,8,3,1,0,90
103799,1119545,1,8,4,4,0,94
103800,1119545,1,8,5,0,1,94
103801,1119545,1,8,6,0,0,94
103802,1119545,1,9,1,0,0,94
103803,1119545,1,9,2,1,0,95
103804,1119545,1,9,3,0,0,95
103805,1119545,1,9,4,0,0,95
103806,1119545,1,9,5,1,0,96
103807,1119545,1,9,6,1,0,97
103808,1119545,1,10,1,6,0,103
103809,1119545,1,10,2,0,1,103
103810,1119545,1,10,3,1,0,104
103811,1119545,1,10,4,0,0,104
103812,1119545,1,10,5,7,0,111
103813,1119545,1,10,6,0,0,111
103814,1119545,1,11,1,1,0,112
103815,1119545,1,11,2,1,0,113
103816,1119545,1,11,3,1,0,114
103817,1119545,1,11,4,0,0,114
103818,1119545,1,11,5,0,0,114
103819,1119545,1,11,6,4,0,118
103820,1119545,1,12,1,0,0,118
103821,1119545,1,12,2,0,0,118
103822,1119545,1,12,3,1,0,119
103823,1119545,1,12,4,0,0,119
103824,1119545,1,12,5,0,0,119
103825,1119545,1,12,6,1,0,120
103826,1119545,1,13,1,1,0,121
103827,1119545,1,13,2,1,0,122
103828,1119545,1,13,3,0,0,122
103829,1119545,1,13,4,2,0,124
103830,1119545,1,13,5,4,0,128
103831,1119545,1,13,6,4,0,132
103832,1119545,1,14,1,2,0,134
103833,1119545,1,14,2,0,1,134
103834,1119545,1,14,3,0,0,134
103835,1119545,1,14,4,0,0,134
103836,1119545,1,14,5,6,0,140
103837,1119545,1,14,6,0,1,140
103838,1119545,1,15,1,2,0,142
103839,1119545,1,15,2,1,0,143
103840,1119545,1,15,3,0,0,143
103841,1119545,1,15,4,0,0,143
103842,1119545,1,15,5,6,0,149
103843,1119545,1,15,6,1,0,150
103844,1119545,1,16,1,1,0,151
103845,1119545,1,16,2,4,0,155
103846,1119545,1,16,3,1,0,156
103847,1119545,1,16,4,1,0,157
103848,1119545,1,16,5,1,0,158
103849,1119545,1,16,6,1,0,159
103850,1119545,1,17,1,4,0,163
103851,1119545,1,17,2,6,0,169
103852,1119545,1,17,3,1,0,170
103853,1119545,1,17,4,4,0,174
103854,1119545,1,17,5,1,0,175
103855,1119545,1,17,6,0,0,175
103856,1119545,1,18,1,1,0,176
103857,1119545,1,18,2,1,0,177
103858,1119545,1,18,3,0,0,177
103859,1119545,1,18,4,0,1,177
103860,1119545,1,18,5,4,0,181
103861,1119545,1,18,6,0,1,181
103862,1119545,1,19,1,1,0,182
103863,1119545,1,19,2,1,0,183
103864,1119545,1,19,3,0,1,183
103865,1119545,1,19,4,6,0,189
103866,1119545,1,19,5,1,0,190
103867,1119545,1,19,6,1,0,191
103868,1119545,1,20,1,1,0,192
103869,1119545,1,20,2,2,0,194
103870,1119545,1,20,3,0,1,194
103871,1119545,1,20,4,4,0,198
103872,1119545,1,20,5,0,0,198
103873,1119545,1,20,6,0,1,198
103986,1120093,1,1,1,0,0,0
103987,1120093,1,1,2,0,0,0
103988,1120093,1,1,3,1,0,1
103989,1120093,1,1,4,0,0,1
103990,1120093,1,1,5,1,0,2
103991,1120093,1,1,6,0,0,2
103992,1120093,1,2,1,0,0,2
103993,1120093,1,2,2,4,0,6
103994,1120093,1,2,3,4,0,10
103995,1120093,1,2,4,0,0,10
103996,1120093,1,2,5,2,0,12
103997,1120093,1,2,6,1,0,13
103998,1120093,1,3,1,0,0,13
103999,1120093,1,3,2,1,0,14
104000,1120093,1,3,3,6,0,20
104001,1120093,1,3,4,1,0,21
104002,1120093,1,3,5,0,0,21
104003,1120093,1,3,6,0,0,21
104004,1120093,1,4,1,0,0,21
104005,1120093,1,4,2,1,0,22
104006,1120093,1,4,3,4,0,26
104007,1120093,1,4,4,0,0,26
104008,1120093,1,4,5,4,0,30
104009,1120093,1,4,6,0,0,30
104010,1120093,1,5,1,1,0,31
104011,1120093,1,5,2,5,0,36
104012,1120093,1,5,3,1,0,37
104013,1120093,1,5,4,0,0,37
104014,1120093,1,5,5,1,0,38
104015,1120093,1,5,6,0,0,38
104016,1120093,1,6,1,0,0,38
104017,1120093,1,6,2,1,0,39
104018,1120093,1,6,3,2,0,41
104019,1120093,1,6,4,1,0,42
104020,1120093,1,6,5,0,0,42
104021,1120093,1,6,6,4,0,46
104022,1120093,1,7,1,1,0,47
104023,1120093,1,7,2,0,0,47
104024,1120093,1,7,3,1,0,48
104025,1120093,1,7,4,4,0,52
104026,1120093,1,7,5,0,0,52
104027,1120093,1,7,6,1,0,53
104028,1120093,1,8,1,1,0,54
104029,1120093,1,8,2,0,0,54
104030,1120093,1,8,3,0,0,54
104031,1120093,1,8,4,1,0,55
104032,1120093,1,8,5,1,0,56
104033,1120093,1,8,6,0,0,56
104034,1120093,1,9,1,2,0,58
104035,1120093,1,9,2,1,0,59
104036,1120093,1,9,3,1,0,60
104037,1120093,1,9,4,1,0,61
104038,1120093,1,9,5,7,0,68
104039,1120093,1,9,6,6,0,74
104040,1120093,1,10,1,1,0,75
104041,1120093,1,10,2,1,0,76
104042,1120093,1,10,3,1,0,77
104043,1120093,1,10,4,1,0,78
104044,1120093,1,10,5,1,0,79
104045,1120093,1,10,6,1,0,80
104046,1120093,1,11,1,1,0,81
104047,1120093,1,11,2,6,0,87
104048,1120093,1,11,3,1,0,88
104049,1120093,1,11,4,1,0,89
104050,1120093,1,11,5,4,0,93
104051,1120093,1,11,6,1,0,94
104052,1120093,1,12,1,1,0,95
104053,1120093,1,12,2,1,0,96
104054,1120093,1,12,3,1,0,97
104055,1120093,1,12,4,1,0,98
104056,1120093,1,12,5,1,0,99
104057,1120093,1,12,6,1,0,100
104058,1120093,1,13,1,6,0,106
104059,1120093,1,13,2,4,0,110
104060,1120093,1,13,3,0,0,110
104061,1120093,1,13,4,1,0,111
104062,1120093,1,13,5,2,0,113
104063,1120093,1,13,6,1,0,114
104064,1120093,1,14,1,1,0,115
104065,1120093,1,14,2,1,0,116
104066,1120093,1,14,3,1,0,117
104067,1120093,1,14,4,1,0,118
104068,1120093,1,14,5,1,0,119
104069,1120093,1,14,6,6,0,125
104070,1120093,1,15,1,0,0,125
104071,1120093,1,15,2,6,0,131
104072,1120093,1,15,3,4,0,135
104073,1120093,1,15,4,4,0,139
104074,1120093,1,15,5,1,0,140
104075,1120093,1,15,6,0,0,140
104076,1120093,1,16,1,6,0,146
104077,1120093,1,16,2,1,0,147
104078,1120093,1,16,3,4,0,151
104079,1120093,1,16,4,4,0,155
104080,1120093,1,16,5,1,0,156
104081,1120093,1,16,6,2,0,158
104082,1120093,1,17,1,0,0,158
104083,1120093,1,17,2,0,1,158
104084,1120093,1,17,3,0,0,158
104085,1120093,1,17,4,0,1,158
104086,1120093,1,17,5,1,0,159
104087,1120093,1,17,6,1,0,160
104088,1120093,1,18,1,4,0,164
104089,1120093,1,18,2,1,0,165
104090,1120093,1,18,3,6,0,171
104091,1120093,1,18,4,1,0,172
104092,1120093,1,18,5,1,0,173
104093,1120093,1,18,6,1,0,174
104094,1120093,1,19,1,0,0,174
104095,1120093,1,19,2,6,0,180
104096,1120093,1,19,3,1,0,181
104097,1120093,1,19,4,0,0,181
104098,1120093,1,19,5,4,0,185
104099,1120093,1,19,6,0,1,185
104100,1120093,1,20,1,6,0,191
104101,1120093,1,20,2,1,0,192
104102,1120093,1,20,3,6,0,198
104103,1120093,1,20,4,1,0,199
104104,1120093,1,20,5,2,0,201
104105,1120093,1,20,6,1,0,202
104226,1120094,1,1,1,0,0,0
104227,1120094,1,1,2,0,0,0
104228,1120094,1,1,3,4,0,4
104229,1120094,1,1,4,0,0,4
104230,1120094,1,1,5,0,0,4
104231,1120094,1,1,6,1,0,5
104232,1120094,1,2,1,4,0,9
104233,1120094,1,2,2,1,0,10
104234,1120094,1,2,3,0,0,10
104235,1120094,1,2,4,4,0,14
104236,1120094,1,2,5,0,0,14
104237,1120094,1,2,6,1,0,15
104238,1120094,1,3,1,0,0,15
104239,1120094,1,3,2,0,0,15
104240,1120094,1,3,3,1,0,16
104241,1120094,1,3,4,1,0,17
104242,1120094,1,3,5,0,0,17
104243,1120094,1,3,6,4,0,21
104244,1120094,1,4,1,0,0,21
104245,1120094,1,4,2,0,0,21
104246,1120094,1,4,3,1,0,22
104247,1120094,1,4,4,0,0,22
104248,1120094,1,4,5,1,0,23
104249,1120094,1,4,6,1,0,24
104250,1120094,1,5,1,0,0,24
104251,1120094,1,5,2,6,0,30
104252,1120094,1,5,3,4,0,34
104253,1120094,1,5,4,6,0,40
104254,1120094,1,5,5,1,0,41
104255,1120094,1,5,6,0,0,41
104256,1120094,1,6,1,0,0,41
104257,1120094,1,6,2,1,0,42
104258,1120094,1,6,3,1,0,43
104259,1120094,1,6,4,1,0,44
104260,1120094,1,6,5,4,0,48
104261,1120094,1,6,6,0,0,48
104262,1120094,1,7,1,0,0,48
104263,1120094,1,7,2,1,0,49
104264,1120094,1,7,3,1,0,50
104265,1120094,1,7,4,1,0,51
104266,1120094,1,7,5,0,0,51
104267,1120094,1,7,6,1,0,52
104268,1120094,1,8,1,0,0,52
104269,1120094,1,8,2,1,0,53
104270,1120094,1,8,3,1,0,54
104271,1120094,1,8,4,6,0,60
104272,1120094,1,8,5,2,0,62
104273,1120094,1,8,6,6,0,68
104274,1120094,1,9,1,0,0,68
104275,1120094,1,9,2,2,0,70
104276,1120094,1,9,3,0,0,70
104277,1120094,1,9,4,1,0,71
104278,1120094,1,9,5,1,0,72
104279,1120094,1,9,6,0,0,72
104280,1120094,1,10,1,1,0,73
104281,1120094,1,10,2,0,0,73
104282,1120094,1,10,3,6,0,79
104283,1120094,1,10,4,1,0,80
104284,1120094,1,10,5,2,0,82
104285,1120094,1,10,6,1,0,83
104286,1120094,1,11,1,1,0,84
104287,1120094,1,11,2,1,0,85
104288,1120094,1,11,3,6,0,91
104289,1120094,1,11,4,1,0,92
104290,1120094,1,11,5,6,0,98
104291,1120094,1,11,6,6,0,104
104292,1120094,1,12,1,1,1,105
104293,1120094,1,12,2,0,0,105
104294,1120094,1,12,3,2,0,107
104295,1120094,1,12,4,0,0,107
104296,1120094,1,12,5,0,0,107
104297,1120094,1,12,6,1,0,108
104298,1120094,1,13,1,1,0,109
104299,1120094,1,13,2,1,0,110
104300,1120094,1,13,3,1,0,111
104301,1120094,1,13,4,6,0,117
104302,1120094,1,13,5,1,0,118
104303,1120094,1,13,6,4,0,122
104304,1120094,1,14,1,1,0,123
104305,1120094,1,14,2,1,0,124
104306,1120094,1,14,3,4,0,128
104307,1120094,1,14,4,0,0,128
104308,1120094,1,14,5,2,0,130
104309,1120094,1,14,6,6,0,136
104310,1120094,1,15,1,4,0,140
104311,1120094,1,15,2,0,1,140
104312,1120094,1,15,3,1,0,141
104313,1120094,1,15,4,1,0,142
104314,1120094,1,15,5,4,0,146
104315,1120094,1,15,6,1,0,147
104316,1120094,1,16,1,1,0,148
104317,1120094,1,16,2,1,0,149
104318,1120094,1,16,3,0,0,149
104319,1120094,1,16,4,4,0,153
104320,1120094,1,16,5,1,0,154
104321,1120094,1,16,6,4,0,158
104322,1120094,1,17,1,6,0,164
104323,1120094,1,17,2,2,0,166
104324,1120094,1,17,3,2,0,168
104325,1120094,1,17,4,4,0,172
104326,1120094,1,17,5,1,0,173
104327,1120094,1,17,6,1,0,174
104328,1120094,1,18,1,0,0,174
104329,1120094,1,18,2,1,0,175
104330,1120094,1,18,3,1,0,176
104331,1120094,1,18,4,0,0,176
104332,1120094,1,18,5,2,0,178
104333,1120094,1,18,6,1,0,179
104334,1120094,1,19,1,1,0,180
104335,1120094,1,19,2,1,0,181
104336,1120094,1,19,3,2,0,183
104337,1120094,1,19,4,1,0,184
104338,1120094,1,19,5,1,0,185
104339,1120094,1,19,6,2,0,187
104340,1120094,1,20,1,2,0,189
104341,1120094,1,20,2,1,0,190
104342,1120094,1,20,3,4,0,194
104343,1120094,1,20,4,1,0,195
104344,1120094,1,20,5,0,0,195
104345,1120094,1,20,6,1,0,196
104466,1120095,1,1,1,1,0,1
104467,1120095,1,1,2,0,0,1
104468,1120095,1,1,3,0,0,1
104469,1120095,1,1,4,2,0,3
104470,1120095,1,1,5,4,0,7
104471,1120095,1,1,6,0,0,7
104472,1120095,1,2,1,0,0,7
104473,1120095,1,2,2,2,0,9
104474,1120095,1,2,3,0,0,9
104475,1120095,1,2,4,4,0,13
104476,1120095,1,2,5,0,0,13
104477,1120095,1,2,6,1,0,14
104478,1120095,1,3,1,1,0,15
104479,1120095,1,3,2,0,1,15
104480,1120095,1,3,3,0,1,15
104481,1120095,1,3,4,1,0,16
104482,1120095,1,3,5,1,0,17
104483,1120095,1,3,6,1,0,18
104484,1120095,1,4,1,4,0,22
104485,1120095,1,4,2,6,0,28
104486,1120095,1,4,3,1,0,29
104487,1120095,1,4,4,1,0,30
104488,1120095,1,4,5,0,1,30
104489,1120095,1,4,6,1,0,31
104490,1120095,1,5,1,4,0,35
104491,1120095,1,5,2,0,0,35
104492,1120095,1,5,3,1,0,36
104493,1120095,1,5,4,0,0,36
104494,1120095,1,5,5,2,0,38
104495,1120095,1,5,6,2,0,40
104496,1120095,1,6,1,7,0,47
104497,1120095,1,6,2,0,0,47
104498,1120095,1,6,3,1,0,48
104499,1120095,1,6,4,0,1,48
104500,1120095,1,6,5,1,0,49
104501,1120095,1,6,6,1,0,50
104502,1120095,1,7,1,0,0,50
104503,1120095,1,7,2,1,0,51
104504,1120095,1,7,3,2,0,53
104505,1120095,1,7,4,1,0,54
104506,1120095,1,7,5,6,0,60
104507,1120095,1,7,6,1,0,61
104508,1120095,1,8,1,1,0,62
104509,1120095,1,8,2,0,1,62
104510,1120095,1,8,3,2,0,64
104511,1120095,1,8,4,2,0,66
104512,1120095,1,8,5,0,0,66
104513,1120095,1,8,6,1,0,67
104562,1120291,1,1,1,1,0,1
104563,1120291,1,1,2,0,0,1
104564,1120291,1,1,3,0,1,1
104565,1120291,1,1,4,2,0,3
104566,1120291,1,1,5,1,0,4
104567,1120291,1,1,6,4,0,8
104568,1120291,1,2,1,4,0,12
104569,1120291,1,2,2,0,0,12
104570,1120291,1,2,3,0,0,12
104571,1120291,1,2,4,2,0,14
104572,1120291,1,2,5,1,0,15
104573,1120291,1,2,6,1,0,16
104574,1120291,1,3,1,4,0,20
104575,1120291,1,3,2,2,0,22
104576,1120291,1,3,3,1,0,23
104577,1120291,1,3,4,0,0,23
104578,1120291,1,3,5,1,0,24
104579,1120291,1,3,6,1,0,25
104580,1120291,1,4,1,0,0,25
104581,1120291,1,4,2,4,0,29
104582,1120291,1,4,3,0,0,29
104583,1120291,1,4,4,0,1,29
104584,1120291,1,4,5,0,0,29
104585,1120291,1,4,6,0,0,29
104586,1120291,1,5,1,0,0,29
104587,1120291,1,5,2,1,0,30
104588,1120291,1,5,3,1,0,31
104589,1120291,1,5,4,1,0,32
104590,1120291,1,5,5,1,0,33
104591,1120291,1,5,6,1,0,34
104592,1120291,1,6,1,1,0,35
104593,1120291,1,6,2,0,0,35
104594,1120291,1,6,3,1,0,36
104595,1120291,1,6,4,0,0,36
104596,1120291,1,6,5,4,0,40
104597,1120291,1,6,6,0,0,40
104598,1120291,1,7,1,1,0,41
104599,1120291,1,7,2,1,0,42
104600,1120291,1,7,3,1,0,43
104601,1120291,1,7,4,1,0,44
104602,1120291,1,7,5,0,0,44
104603,1120291,1,7,6,0,0,44
104604,1120291,1,8,1,1,0,45
104605,1120291,1,8,2,1,0,46
104606,1120291,1,8,3,1,0,47
104607,1120291,1,8,4,1,0,48
104608,1120291,1,8,5,1,0,49
104609,1120291,1,8,6,1,0,50
104610,1120291,1,9,1,1,0,51
104611,1120291,1,9,2,0,1,51
104612,1120291,1,9,3,0,0,51
104613,1120291,1,9,4,1,0,52
104614,1120291,1,9,5,0,0,52
104615,1120291,1,9,6,1,0,53
104616,1120291,1,10,1,1,0,54
104617,1120291,1,10,2,1,0,55
104618,1120291,1,10,3,1,0,56
104619,1120291,1,10,4,0,0,56
104620,1120291,1,10,5,1,0,57
104621,1120291,1,10,6,1,0,58
104622,1120291,1,11,1,0,1,58
104623,1120291,1,11,2,1,0,59
104624,1120291,1,11,3,4,0,63
104625,1120291,1,11,4,1,0,64
104626,1120291,1,11,5,1,0,65
104627,1120291,1,11,6,1,0,66
104628,1120291,1,12,1,0,1,66
104629,1120291,1,12,2,0,0,66
104630,1120291,1,12,3,0,0,66
104631,1120291,1,12,4,0,1,66
104632,1120291,1,12,5,0,0,66
104633,1120291,1,12,6,0,0,66
104634,1120291,1,13,1,2,0,68
104635,1120291,1,13,2,0,0,68
104636,1120291,1,13,3,0,1,68
104637,1120291,1,13,4,0,0,68
104638,1120291,1,13,5,0,0,68
104639,1120291,1,13,6,4,0,72
104640,1120291,1,14,1,0,0,72
104641,1120291,1,14,2,6,0,78
104642,1120291,1,14,3,2,0,80
104643,1120291,1,14,4,2,0,82
104644,1120291,1,14,5,0,0,82
104645,1120291,1,14,6,0,0,82
104646,1120291,1,15,1,1,0,83
104647,1120291,1,15,2,0,0,83
104648,1120291,1,15,3,0,0,83
104649,1120291,1,15,4,0,0,83
104650,1120291,1,15,5,0,0,83
104651,1120291,1,15,6,0,0,83
104652,1120291,1,16,1,0,0,83
104653,1120291,1,16,2,1,0,84
104654,1120291,1,16,3,0,0,84
104655,1120291,1,16,4,1,0,85
104656,1120291,1,16,5,0,1,85
104657,1120291,1,16,6,2,0,87
104658,1120291,1,17,1,0,1,87
104659,1120291,1,17,2,1,0,88
104660,1120291,1,17,3,1,0,89
104661,1120291,1,17,4,1,0,90
104662,1120291,1,17,5,1,0,91
104663,1120291,1,17,6,0,0,91
104664,1120291,1,18,1,0,0,91
104665,1120291,1,18,2,0,0,91
104666,1120291,1,18,3,1,0,92
104667,1120291,1,18,4,1,0,93
104668,1120291,1,18,5,1,0,94
104669,1120291,1,18,6,1,0,95
104670,1120291,1,19,1,6,0,101
104671,1120291,1,19,2,1,0,102
104672,1120291,1,19,3,0,1,102
104777,1120292,1,1,1,0,0,0
104778,1120292,1,1,2,0,0,0
104779,1120292,1,1,3,1,0,1
104780,1120292,1,1,4,0,0,1
104781,1120292,1,1,5,0,0,1
104782,1120292,1,1,6,0,0,1
104783,1120292,1,2,1,0,0,1
104784,1120292,1,2,2,4,0,5
104785,1120292,1,2,3,0,0,5
104786,1120292,1,2,4,0,0,5
104787,1120292,1,2,5,4,0,9
104788,1120292,1,2,6,0,0,9
104789,1120292,1,3,1,0,0,9
104790,1120292,1,3,2,4,0,13
104791,1120292,1,3,3,1,0,14
104792,1120292,1,3,4,0,0,14
104793,1120292,1,3,5,1,0,15
104794,1120292,1,3,6,1,0,16
104795,1120292,1,4,1,4,0,20
104796,1120292,1,4,2,0,0,20
104797,1120292,1,4,3,1,0,21
104798,1120292,1,4,4,1,0,22
104799,1120292,1,4,5,0,0,22
104800,1120292,1,4,6,4,0,26
104801,1120292,1,5,1,1,0,27
104802,1120292,1,5,2,1,0,28
104803,1120292,1,5,3,0,0,28
104804,1120292,1,5,4,1,0,29
104805,1120292,1,5,5,3,0,32
104806,1120292,1,5,6,2,0,34
104807,1120292,1,6,1,0,0,34
104808,1120292,1,6,2,1,0,35
104809,1120292,1,6,3,6,0,41
104810,1120292,1,6,4,1,0,42
104811,1120292,1,6,5,0,0,42
104812,1120292,1,6,6,0,0,42
104813,1120292,1,7,1,0,0,42
104814,1120292,1,7,2,1,0,43
104815,1120292,1,7,3,0,0,43
104816,1120292,1,7,4,0,1,43
104817,1120292,1,7,5,1,0,44
104818,1120292,1,7,6,1,0,45
104819,1120292,1,8,1,1,0,46
104820,1120292,1,8,2,0,0,46
104821,1120292,1,8,3,0,0,46
104822,1120292,1,8,4,1,0,47
104823,1120292,1,8,5,1,0,48
104824,1120292,1,8,6,0,0,48
104825,1120292,1,9,1,2,0,50
104826,1120292,1,9,2,1,0,51
104827,1120292,1,9,3,1,0,52
104828,1120292,1,9,4,1,0,53
104829,1120292,1,9,5,1,0,54
104830,1120292,1,9,6,1,0,55
104831,1120292,1,10,1,2,0,57
104832,1120292,1,10,2,1,0,58
104833,1120292,1,10,3,1,0,59
104834,1120292,1,10,4,1,0,60
104835,1120292,1,10,5,1,0,61
104836,1120292,1,10,6,0,0,61
104837,1120292,1,11,1,4,0,65
104838,1120292,1,11,2,1,0,66
104839,1120292,1,11,3,2,0,68
104840,1120292,1,11,4,0,0,68
104841,1120292,1,11,5,0,0,68
104842,1120292,1,11,6,1,0,69
104843,1120292,1,12,1,1,0,70
104844,1120292,1,12,2,0,0,70
104845,1120292,1,12,3,0,0,70
104846,1120292,1,12,4,1,0,71
104847,1120292,1,12,5,0,0,71
104848,1120292,1,12,6,2,0,73
104849,1120292,1,13,1,1,0,74
104850,1120292,1,13,2,1,0,75
104851,1120292,1,13,3,4,0,79
104852,1120292,1,13,4,1,0,80
104853,1120292,1,13,5,4,0,84
104854,1120292,1,13,6,2,0,86
104855,1120292,1,14,1,1,0,87
104856,1120292,1,14,2,1,0,88
104857,1120292,1,14,3,1,0,89
104858,1120292,1,14,4,1,0,90
104859,1120292,1,14,5,3,0,93
104860,1120292,1,14,6,2,0,95
104861,1120292,1,15,1,1,0,96
104862,1120292,1,15,2,0,0,96
104863,1120292,1,15,3,1,0,97
104864,1120292,1,15,4,1,0,98
104865,1120292,1,15,5,0,0,98
104866,1120292,1,15,6,0,0,98
104867,1120292,1,16,1,1,0,99
104868,1120292,1,16,2,0,0,99
104869,1120292,1,16,3,4,0,103
104870,1120292,1,16,4,1,0,104
104871,1120292,1,16,5,1,0,105
104872,1120292,1,16,6,1,0,106
104873,1120292,1,17,1,0,0,106
104874,1120292,1,17,2,0,1,106
104875,1120292,1,17,3,0,0,106
104876,1120292,1,17,4,1,0,107
104877,1120292,1,17,5,0,1,107
104878,1120292,1,17,6,1,0,108
104879,1120292,1,18,1,1,0,109
104880,1120292,1,18,2,0,1,109
104881,1120292,1,18,3,1,0,110
104882,1120292,1,18,4,1,0,111
104883,1120292,1,18,5,0,1,111
104884,1120292,1,18,6,0,0,111
104885,1120292,1,19,1,2,0,113
104886,1120292,1,19,2,0,0,113
104887,1120292,1,19,3,4,0,117
104888,1120292,1,19,4,0,1,117
104889,1120292,1,19,5,0,1,117
104890,1120292,1,19,6,0,1,117
104891,1120292,1,20,1,1,0,118
104892,1120292,1,20,2,1,0,119
104893,1120292,1,20,3,0,1,119
104894,1120292,1,20,4,1,0,120
104895,1120292,1,20,5,4,0,124
104896,1120292,1,20,6,0,0,124
105016,1120293,1,1,1,4,0,4
105017,1120293,1,1,2,1,0,5
105018,1120293,1,1,3,0,0,5
105019,1120293,1,1,4,3,0,8
105020,1120293,1,1,5,0,0,8
105021,1120293,1,1,6,0,0,8
105022,1120293,1,2,1,0,0,8
105023,1120293,1,2,2,1,0,9
105024,1120293,1,2,3,1,0,10
105025,1120293,1,2,4,1,0,11
105026,1120293,1,2,5,0,0,11
105027,1120293,1,2,6,2,0,13
105028,1120293,1,3,1,0,0,13
105029,1120293,1,3,2,1,0,14
105030,1120293,1,3,3,1,0,15
105031,1120293,1,3,4,2,0,17
105032,1120293,1,3,5,0,0,17
105033,1120293,1,3,6,2,0,19
105034,1120293,1,4,1,4,0,23
105035,1120293,1,4,2,1,0,24
105036,1120293,1,4,3,0,0,24
105037,1120293,1,4,4,1,0,25
105038,1120293,1,4,5,1,0,26
105039,1120293,1,4,6,3,0,29
105040,1120293,1,5,1,0,0,29
105041,1120293,1,5,2,0,0,29
105042,1120293,1,5,3,4,0,33
105043,1120293,1,5,4,1,0,34
105044,1120293,1,5,5,1,0,35
105045,1120293,1,5,6,2,0,37
105046,1120293,1,6,1,0,0,37
105047,1120293,1,6,2,2,0,39
105048,1120293,1,6,3,2,0,41
105049,1120293,1,6,4,1,0,42
105050,1120293,1,6,5,1,0,43
105051,1120293,1,6,6,4,0,47
105052,1120293,1,7,1,1,0,48
105053,1120293,1,7,2,1,0,49
105054,1120293,1,7,3,1,0,50
105055,1120293,1,7,4,0,0,50
105056,1120293,1,7,5,1,0,51
105057,1120293,1,7,6,1,0,52
105058,1120293,1,8,1,1,0,53
105059,1120293,1,8,2,1,0,54
105060,1120293,1,8,3,1,0,55
105061,1120293,1,8,4,1,0,56
105062,1120293,1,8,5,1,0,57
105063,1120293,1,8,6,0,1,57
105064,1120293,1,9,1,1,0,58
105065,1120293,1,9,2,1,0,59
105066,1120293,1,9,3,4,0,63
105067,1120293,1,9,4,1,0,64
105068,1120293,1,9,5,1,0,65
105069,1120293,1,9,6,0,0,65
105070,1120293,1,10,1,1,0,66
105071,1120293,1,10,2,1,0,67
105072,1120293,1,10,3,2,0,69
105073,1120293,1,10,4,1,0,70
105074,1120293,1,10,5,0,0,70
105075,1120293,1,10,6,1,0,71
105076,1120293,1,11,1,6,0,77
105077,1120293,1,11,2,1,0,78
105078,1120293,1,11,3,1,0,79
105079,1120293,1,11,4,4,0,83
105080,1120293,1,11,5,1,0,84
105081,1120293,1,11,6,1,0,85
105082,1120293,1,12,1,1,0,86
105083,1120293,1,12,2,1,0,87
105084,1120293,1,12,3,1,0,88
105085,1120293,1,12,4,1,0,89
105086,1120293,1,12,5,1,0,90
105087,1120293,1,12,6,1,0,91
105088,1120293,1,13,1,0,1,91
105089,1120293,1,13,2,1,0,92
105090,1120293,1,13,3,1,0,93
105091,1120293,1,13,4,1,0,94
105092,1120293,1,13,5,1,0,95
105093,1120293,1,13,6,4,0,99
105094,1120293,1,14,1,1,0,100
105095,1120293,1,14,2,1,0,101
105096,1120293,1,14,3,1,0,102
105097,1120293,1,14,4,0,0,102
105098,1120293,1,14,5,0,0,102
105099,1120293,1,14,6,1,0,103
105100,1120293,1,15,1,1,0,104
105101,1120293,1,15,2,1,0,105
105102,1120293,1,15,3,0,0,105
105103,1120293,1,15,4,1,0,106
105104,1120293,1,15,5,1,0,107
105105,1120293,1,15,6,1,0,108
105106,1120293,1,16,1,0,0,108
105107,1120293,1,16,2,1,0,109
105108,1120293,1,16,3,6,0,115
105109,1120293,1,16,4,4,0,119
105110,1120293,1,16,5,4,0,123
105111,1120293,1,16,6,1,0,124
105112,1120293,1,17,1,1,0,125
105113,1120293,1,17,2,2,0,127
105114,1120293,1,17,3,0,0,127
105115,1120293,1,17,4,1,0,128
105116,1120293,1,17,5,1,0,129
105117,1120293,1,17,6,5,0,134
105118,1120293,1,18,1,2,0,136
105119,1120293,1,18,2,4,0,140
105120,1120293,1,18,3,1,0,141
105121,1120293,1,18,4,1,0,142
105122,1120293,1,18,5,4,0,146
105123,1120293,1,18,6,1,0,147
105124,1120293,1,19,1,1,0,148
105125,1120293,1,19,2,1,0,149
105126,1120293,1,19,3,4,0,153
105127,1120293,1,19,4,1,0,154
105128,1120293,1,19,5,1,0,155
105129,1120293,1,19,6,2,0,157
105130,1120293,1,20,1,1,0,158
105131,1120293,1,20,2,2,0,160
105132,1120293,1,20,3,6,0,166
105133,1120293,1,20,4,0,1,166
105134,1120293,1,20,5,13,0,179
105135,1120293,1,20,6,1,0,180
105256,1122285,1,1,1,0,0,0
105257,1122285,1,1,2,6,0,6
105258,1122285,1,1,3,1,0,7
105259,1122285,1,1,4,1,0,8
105260,1122285,1,1,5,6,0,14
105261,1122285,1,1,6,4,0,18
105262,1122285,1,2,1,1,0,19
105263,1122285,1,2,2,4,0,23
105264,1122285,1,2,3,0,0,23
105265,1122285,1,2,4,0,0,23
105266,1122285,1,2,5,0,1,23
105267,1122285,1,2,6,1,0,24
105268,1122285,1,3,1,0,0,24
105269,1122285,1,3,2,1,0,25
105270,1122285,1,3,3,1,0,26
105271,1122285,1,3,4,1,0,27
105272,1122285,1,3,5,6,0,33
105273,1122285,1,3,6,4,0,37
105274,1122285,1,4,1,6,0,43
105275,1122285,1,4,2,0,0,43
105276,1122285,1,4,3,2,0,45
105277,1122285,1,4,4,0,0,45
105278,1122285,1,4,5,4,0,49
105279,1122285,1,4,6,0,1,49
105280,1122285,1,5,1,0,0,49
105281,1122285,1,5,2,0,0,49
105282,1122285,1,5,3,2,0,51
105283,1122285,1,5,4,1,0,52
105284,1122285,1,5,5,4,0,56
105285,1122285,1,5,6,4,0,60
105286,1122285,1,6,1,4,0,64
105287,1122285,1,6,2,1,0,65
105288,1122285,1,6,3,1,0,66
105289,1122285,1,6,4,1,0,67
105290,1122285,1,6,5,6,0,73
105291,1122285,1,6,6,5,0,78
105292,1122285,1,7,1,0,0,78
105293,1122285,1,7,2,1,0,79
105294,1122285,1,7,3,0,0,79
105295,1122285,1,7,4,1,0,80
105296,1122285,1,7,5,0,0,80
105297,1122285,1,7,6,4,0,84
105298,1122285,1,8,1,0,0,84
105299,1122285,1,8,2,4,0,88
105300,1122285,1,8,3,2,0,90
105301,1122285,1,8,4,6,0,96
105302,1122285,1,8,5,1,0,97
105303,1122285,1,8,6,1,0,98
105304,1122285,1,9,1,1,0,99
105305,1122285,1,9,2,1,0,100
105306,1122285,1,9,3,0,0,100
105307,1122285,1,9,4,4,0,104
105308,1122285,1,9,5,1,0,105
105309,1122285,1,9,6,1,0,106
105310,1122285,1,10,1,1,0,107
105311,1122285,1,10,2,1,0,108
105312,1122285,1,10,3,0,1,108
105313,1122285,1,10,4,1,0,109
105314,1122285,1,10,5,0,0,109
105315,1122285,1,10,6,1,0,110
105316,1122285,1,11,1,1,0,111
105317,1122285,1,11,2,0,0,111
105318,1122285,1,11,3,1,0,112
105319,1122285,1,11,4,2,0,114
105320,1122285,1,11,5,1,0,115
105321,1122285,1,11,6,1,0,116
105322,1122285,1,12,1,6,0,122
105323,1122285,1,12,2,1,0,123
105324,1122285,1,12,3,4,0,127
105325,1122285,1,12,4,1,0,128
105326,1122285,1,12,5,0,0,128
105327,1122285,1,12,6,0,0,128
105328,1122285,1,13,1,0,0,128
105329,1122285,1,13,2,4,0,132
105330,1122285,1,13,3,2,0,134
105331,1122285,1,13,4,2,0,136
105332,1122285,1,13,5,1,0,137
105333,1122285,1,13,6,1,0,138
105334,1122285,1,14,1,0,0,138
105335,1122285,1,14,2,1,0,139
105336,1122285,1,14,3,4,0,143
105337,1122285,1,14,4,1,0,144
105338,1122285,1,14,5,1,0,145
105339,1122285,1,14,6,4,0,149
105340,1122285,1,15,1,1,0,150
105341,1122285,1,15,2,0,0,150
105342,1122285,1,15,3,5,0,155
105343,1122285,1,15,4,0,1,155
105344,1122285,1,15,5,1,0,156
105345,1122285,1,15,6,1,0,157
105346,1122285,1,16,1,3,0,160
105347,1122285,1,16,2,0,0,160
105348,1122285,1,16,3,1,0,161
105349,1122285,1,16,4,2,0,163
105350,1122285,1,16,5,1,0,164
105351,1122285,1,16,6,0,0,164
105352,1122285,1,17,1,2,0,166
105353,1122285,1,17,2,1,0,167
105354,1122285,1,17,3,1,0,168
105355,1122285,1,17,4,1,0,169
105356,1122285,1,17,5,2,0,171
105357,1122285,1,17,6,4,0,175
105358,1122285,1,18,1,1,0,176
105359,1122285,1,18,2,4,0,180
105360,1122285,1,18,3,1,0,181
105361,1122285,1,18,4,0,0,181
105362,1122285,1,18,5,1,0,182
105363,1122285,1,18,6,1,0,183
105364,1122285,1,19,1,0,1,183
105365,1122285,1,19,2,1,0,184
105366,1122285,1,19,3,4,0,188
105367,1122285,1,19,4,4,0,192
105368,1122285,1,19,5,1,0,193
105369,1122285,1,19,6,1,0,194
105370,1122285,1,20,1,1,0,195
105371,1122285,1,20,2,3,0,198
105372,1122285,1,20,3,1,0,199
105373,1122285,1,20,4,2,0,201
105374,1122285,1,20,5,1,0,202
105375,1122285,1,20,6,1,0,203
105496,1122286,1,1,1,0,0,0
105497,1122286,1,1,2,0,0,0
105498,1122286,1,1,3,0,0,0
105499,1122286,1,1,4,0,0,0
105500,1122286,1,1,5,0,0,0
105501,1122286,1,1,6,0,0,0
105502,1122286,1,2,1,0,1,0
105503,1122286,1,2,2,0,0,0
105504,1122286,1,2,3,2,0,2
105505,1122286,1,2,4,4,0,6
105506,1122286,1,2,5,0,0,6
105507,1122286,1,2,6,2,0,8
105508,1122286,1,3,1,4,0,12
105509,1122286,1,3,2,6,0,18
105510,1122286,1,3,3,4,0,22
105511,1122286,1,3,4,0,0,22
105512,1122286,1,3,5,6,0,28
105513,1122286,1,3,6,0,0,28
105514,1122286,1,4,1,0,0,28
105515,1122286,1,4,2,0,0,28
105516,1122286,1,4,3,4,0,32
105517,1122286,1,4,4,0,0,32
105518,1122286,1,4,5,4,0,36
105519,1122286,1,4,6,4,0,40
105520,1122286,1,5,1,4,0,44
105521,1122286,1,5,2,0,1,44
105522,1122286,1,5,3,0,0,44
105523,1122286,1,5,4,1,0,45
105524,1122286,1,5,5,0,0,45
105525,1122286,1,5,6,0,0,45
105526,1122286,1,6,1,0,0,45
105527,1122286,1,6,2,0,0,45
105528,1122286,1,6,3,0,1,45
105529,1122286,1,6,4,0,0,45
105530,1122286,1,6,5,0,0,45
105531,1122286,1,6,6,0,0,45
105532,1122286,1,7,1,1,0,46
105533,1122286,1,7,2,1,0,47
105534,1122286,1,7,3,1,0,48
105535,1122286,1,7,4,1,0,49
105536,1122286,1,7,5,1,0,50
105537,1122286,1,7,6,3,0,53
105538,1122286,1,8,1,1,0,54
105539,1122286,1,8,2,2,0,56
105540,1122286,1,8,3,1,0,57
105541,1122286,1,8,4,0,0,57
105542,1122286,1,8,5,1,0,58
105543,1122286,1,8,6,0,0,58
105544,1122286,1,9,1,1,0,59
105545,1122286,1,9,2,0,0,59
105546,1122286,1,9,3,1,0,60
105547,1122286,1,9,4,1,0,61
105548,1122286,1,9,5,4,0,65
105549,1122286,1,9,6,1,0,66
105550,1122286,1,10,1,4,0,70
105551,1122286,1,10,2,2,0,72
105552,1122286,1,10,3,0,0,72
105553,1122286,1,10,4,6,0,78
105554,1122286,1,10,5,6,0,84
105555,1122286,1,10,6,1,0,85
105556,1122286,1,11,1,1,0,86
105557,1122286,1,11,2,0,0,86
105558,1122286,1,11,3,4,0,90
105559,1122286,1,11,4,0,1,90
105560,1122286,1,11,5,0,0,90
105561,1122286,1,11,6,2,0,92
105562,1122286,1,12,1,0,0,92
105563,1122286,1,12,2,1,0,93
105564,1122286,1,12,3,0,0,93
105565,1122286,1,12,4,1,0,94
105566,1122286,1,12,5,2,0,96
105567,1122286,1,12,6,1,0,97
105568,1122286,1,13,1,0,0,97
105569,1122286,1,13,2,4,0,101
105570,1122286,1,13,3,4,0,105
105571,1122286,1,13,4,1,0,106
105572,1122286,1,13,5,0,0,106
105573,1122286,1,13,6,0,0,106
105574,1122286,1,14,1,1,0,107
105575,1122286,1,14,2,6,0,113
105576,1122286,1,14,3,1,0,114
105577,1122286,1,14,4,0,0,114
105578,1122286,1,14,5,1,0,115
105579,1122286,1,14,6,1,0,116
105580,1122286,1,15,1,2,0,118
105581,1122286,1,15,2,2,0,120
105582,1122286,1,15,3,1,0,121
105583,1122286,1,15,4,1,0,122
105584,1122286,1,15,5,1,0,123
105585,1122286,1,15,6,1,0,124
105586,1122286,1,16,1,6,0,130
105587,1122286,1,16,2,0,0,130
105588,1122286,1,16,3,1,0,131
105589,1122286,1,16,4,0,0,131
105590,1122286,1,16,5,1,0,132
105591,1122286,1,16,6,1,0,133
105592,1122286,1,17,1,5,0,138
105593,1122286,1,17,2,4,0,142
105594,1122286,1,17,3,1,0,143
105595,1122286,1,17,4,1,0,144
105596,1122286,1,17,5,1,0,145
105597,1122286,1,17,6,1,0,146
105598,1122286,1,18,1,2,0,148
105599,1122286,1,18,2,4,0,152
105600,1122286,1,18,3,0,0,152
105601,1122286,1,18,4,4,0,156
105602,1122286,1,18,5,1,0,157
105603,1122286,1,18,6,0,0,157
105604,1122286,1,19,1,1,0,158
105605,1122286,1,19,2,4,0,162
105606,1122286,1,19,3,1,0,163
105607,1122286,1,19,4,1,0,164
105608,1122286,1,19,5,6,0,170
105609,1122286,1,19,6,0,0,170
105610,1122286,1,20,1,1,0,171
105611,1122286,1,20,2,6,0,177
105612,1122286,1,20,3,4,0,181
105613,1122286,1,20,4,4,0,185
105614,1122286,1,20,5,2,0,187
105615,1122286,1,20,6,1,0,188
105728,1122287,1,1,1,4,0,4
105729,1122287,1,1,2,1,0,5
105730,1122287,1,1,3,0,0,5
105731,1122287,1,1,4,0,0,5
105732,1122287,1,1,5,4,0,9
105733,1122287,1,1,6,4,0,13
105734,1122287,1,2,1,1,0,14
105735,1122287,1,2,2,0,0,14
105736,1122287,1,2,3,0,1,14
105737,1122287,1,2,4,6,0,20
105738,1122287,1,2,5,2,0,22
105739,1122287,1,2,6,0,0,22
105740,1122287,1,3,1,1,0,23
105741,1122287,1,3,2,4,0,27
105742,1122287,1,3,3,1,0,28
105743,1122287,1,3,4,0,0,28
105744,1122287,1,3,5,1,0,29
105745,1122287,1,3,6,1,0,30
105746,1122287,1,4,1,0,0,30
105747,1122287,1,4,2,1,0,31
105748,1122287,1,4,3,0,0,31
105749,1122287,1,4,4,2,0,33
105750,1122287,1,4,5,2,0,35
105751,1122287,1,4,6,0,0,35
105752,1122287,1,5,1,4,0,39
105753,1122287,1,5,2,4,0,43
105754,1122287,1,5,3,1,0,44
105755,1122287,1,5,4,1,0,45
105756,1122287,1,5,5,1,0,46
105757,1122287,1,5,6,1,0,47
105758,1122287,1,6,1,2,0,49
105759,1122287,1,6,2,4,0,53
105760,1122287,1,6,3,1,0,54
105761,1122287,1,6,4,1,0,55
105762,1122287,1,6,5,1,0,56
105763,1122287,1,6,6,1,0,57
105764,1122287,1,7,1,0,0,57
105765,1122287,1,7,2,1,0,58
105766,1122287,1,7,3,1,0,59
105767,1122287,1,7,4,0,0,59
105768,1122287,1,7,5,2,0,61
105769,1122287,1,7,6,1,0,62
105770,1122287,1,8,1,1,0,63
105771,1122287,1,8,2,0,0,63
105772,1122287,1,8,3,0,0,63
105773,1122287,1,8,4,1,0,64
105774,1122287,1,8,5,0,0,64
105775,1122287,1,8,6,1,0,65
105776,1122287,1,9,1,1,0,66
105777,1122287,1,9,2,1,0,67
105778,1122287,1,9,3,1,0,68
105779,1122287,1,9,4,4,0,72
105780,1122287,1,9,5,2,0,74
105781,1122287,1,9,6,1,0,75
105782,1122287,1,10,1,1,0,76
105783,1122287,1,10,2,2,0,78
105784,1122287,1,10,3,1,0,79
105785,1122287,1,10,4,0,1,79
105786,1122287,1,10,5,1,0,80
105787,1122287,1,10,6,1,0,81
105788,1122287,1,11,1,1,0,82
105789,1122287,1,11,2,1,0,83
105790,1122287,1,11,3,0,0,83
105791,1122287,1,11,4,1,0,84
105792,1122287,1,11,5,0,0,84
105793,1122287,1,11,6,1,0,85
105794,1122287,1,12,1,6,0,91
105795,1122287,1,12,2,1,0,92
105796,1122287,1,12,3,4,0,96
105797,1122287,1,12,4,1,0,97
105798,1122287,1,12,5,1,0,98
105799,1122287,1,12,6,4,0,102
105800,1122287,1,13,1,1,0,103
105801,1122287,1,13,2,0,0,103
105802,1122287,1,13,3,2,0,105
105803,1122287,1,13,4,4,0,109
105804,1122287,1,13,5,1,0,110
105805,1122287,1,13,6,1,0,111
105806,1122287,1,14,1,0,1,111
105807,1122287,1,14,2,2,0,113
105808,1122287,1,14,3,1,0,114
105809,1122287,1,14,4,1,0,115
105810,1122287,1,14,5,1,0,116
105811,1122287,1,14,6,1,0,117
105812,1122287,1,15,1,3,0,120
105813,1122287,1,15,2,2,0,122
105814,1122287,1,15,3,0,0,122
105815,1122287,1,15,4,0,0,122
105816,1122287,1,15,5,1,0,123
105817,1122287,1,15,6,2,0,125
105818,1122287,1,16,1,1,1,126
105819,1122287,1,16,2,0,0,126
105820,1122287,1,16,3,1,0,127
105821,1122287,1,16,4,1,0,128
105822,1122287,1,16,5,1,0,129
105823,1122287,1,16,6,1,0,130
105824,1122287,1,17,1,1,0,131
105825,1122287,1,17,2,1,0,132
105826,1122287,1,17,3,2,0,134
105827,1122287,1,17,4,0,0,134
105828,1122287,1,17,5,1,0,135
105829,1122287,1,17,6,1,0,136
105830,1122287,1,18,1,2,0,138
105831,1122287,1,18,2,1,0,139
105832,1122287,1,18,3,6,0,145
105833,1122287,1,18,4,1,0,146
105834,1122287,1,18,5,0,0,146
105835,1122287,1,18,6,1,0,147
105836,1122287,1,19,1,4,0,151
105837,1122287,1,19,2,0,1,151
105838,1122287,1,19,3,2,0,153
105839,1122287,1,19,4,4,0,157
105840,1122287,1,19,5,4,0,161
105841,1122287,1,19,6,1,0,162
105842,1122287,1,20,1,1,0,163
105843,1122287,1,20,2,0,1,163
105844,1122287,1,20,3,4,0,167
105845,1122287,1,20,4,1,1,168
105846,1122287,1,20,5,3,0,171
105847,1122287,1,20,6,1,0,172
105968,1122729,1,1,1,2,0,2
105969,1122729,1,1,2,4,0,6
105970,1122729,1,1,3,0,0,6
105971,1122729,1,1,4,3,0,9
105972,1122729,1,1,5,0,0,9
105973,1122729,1,1,6,1,0,10
105974,1122729,1,2,1,1,0,11
105975,1122729,1,2,2,0,0,11
105976,1122729,1,2,3,1,0,12
105977,1122729,1,2,4,0,0,12
105978,1122729,1,2,5,0,0,12
105979,1122729,1,2,6,1,0,13
105980,1122729,1,3,1,1,0,14
105981,1122729,1,3,2,1,0,15
105982,1122729,1,3,3,0,0,15
105983,1122729,1,3,4,4,0,19
105984,1122729,1,3,5,1,0,20
105985,1122729,1,3,6,0,0,20
105986,1122729,1,4,1,4,0,24
105987,1122729,1,4,2,0,0,24
105988,1122729,1,4,3,1,0,25
105989,1122729,1,4,4,4,0,29
105990,1122729,1,4,5,1,0,30
105991,1122729,1,4,6,1,0,31
105992,1122729,1,5,1,1,0,32
105993,1122729,1,5,2,0,0,32
105994,1122729,1,5,3,1,0,33
105995,1122729,1,5,4,4,0,37
105996,1122729,1,5,5,1,0,38
105997,1122729,1,5,6,0,1,38
105998,1122729,1,6,1,1,0,39
105999,1122729,1,6,2,1,0,40
106000,1122729,1,6,3,2,0,42
106001,1122729,1,6,4,0,0,42
106002,1122729,1,6,5,4,0,46
106003,1122729,1,6,6,4,0,50
106004,1122729,1,7,1,0,0,50
106005,1122729,1,7,2,1,0,51
106006,1122729,1,7,3,0,0,51
106007,1122729,1,7,4,0,0,51
106008,1122729,1,7,5,1,0,52
106009,1122729,1,7,6,1,0,53
106010,1122729,1,8,1,2,0,55
106011,1122729,1,8,2,4,0,59
106012,1122729,1,8,3,4,0,63
106013,1122729,1,8,4,1,0,64
106014,1122729,1,8,5,0,0,64
106015,1122729,1,8,6,1,0,65
106016,1122729,1,9,1,1,0,66
106017,1122729,1,9,2,1,0,67
106018,1122729,1,9,3,1,0,68
106019,1122729,1,9,4,0,0,68
106020,1122729,1,9,5,6,0,74
106021,1122729,1,9,6,1,0,75
106022,1122729,1,10,1,1,0,76
106023,1122729,1,10,2,1,0,77
106024,1122729,1,10,3,4,0,81
106025,1122729,1,10,4,1,0,82
106026,1122729,1,10,5,1,0,83
106027,1122729,1,10,6,1,0,84
106028,1122729,1,11,1,0,0,84
106029,1122729,1,11,2,4,0,88
106030,1122729,1,11,3,1,0,89
106031,1122729,1,11,4,1,0,90
106032,1122729,1,11,5,0,0,90
106033,1122729,1,11,6,0,0,90
106034,1122729,1,12,1,4,0,94
106035,1122729,1,12,2,1,0,95
106036,1122729,1,12,3,1,0,96
106037,1122729,1,12,4,1,0,97
106038,1122729,1,12,5,1,0,98
106039,1122729,1,12,6,0,0,98
106040,1122729,1,13,1,0,0,98
106041,1122729,1,13,2,1,0,99
106042,1122729,1,13,3,2,0,101
106043,1122729,1,13,4,0,1,101
106044,1122729,1,13,5,0,0,101
106045,1122729,1,13,6,1,0,102
106046,1122729,1,14,1,1,0,103
106047,1122729,1,14,2,1,0,104
106048,1122729,1,14,3,4,0,108
106049,1122729,1,14,4,1,0,109
106050,1122729,1,14,5,0,0,109
106051,1122729,1,14,6,1,0,110
106052,1122729,1,15,1,1,0,111
106053,1122729,1,15,2,1,0,112
106054,1122729,1,15,3,0,1,112
106055,1122729,1,15,4,1,0,113
106056,1122729,1,15,5,1,0,114
106057,1122729,1,15,6,0,0,114
106058,1122729,1,16,1,1,0,115
106059,1122729,1,16,2,0,0,115
106060,1122729,1,16,3,1,0,116
106061,1122729,1,16,4,1,0,117
106062,1122729,1,16,5,1,0,118
106063,1122729,1,16,6,1,0,119
106064,1122729,1,17,1,5,0,124
106065,1122729,1,17,2,1,0,125
106066,1122729,1,17,3,6,0,131
106067,1122729,1,17,4,4,0,135
106068,1122729,1,17,5,2,0,137
106069,1122729,1,17,6,1,0,138
106070,1122729,1,18,1,1,0,139
106071,1122729,1,18,2,1,0,140
106072,1122729,1,18,3,1,0,141
106073,1122729,1,18,4,4,0,145
106074,1122729,1,18,5,1,0,146
106075,1122729,1,18,6,1,0,147
106076,1122729,1,19,1,0,0,147
106077,1122729,1,19,2,2,0,149
106078,1122729,1,19,3,3,0,152
106079,1122729,1,19,4,4,0,156
106080,1122729,1,19,5,1,0,157
106081,1122729,1,19,6,11,0,168
106082,1122729,1,20,1,2,0,170
106083,1122729,1,20,2,1,0,171
106084,1122729,1,20,3,1,0,172
106085,1122729,1,20,4,1,0,173
106086,1122729,1,20,5,1,0,174
106087,1122729,1,20,6,6,0,180
106184,1122730,1,1,1,0,0,0
106185,1122730,1,1,2,0,0,0
106186,1122730,1,1,3,4,0,4
106187,1122730,1,1,4,0,0,4
106188,1122730,1,1,5,4,0,8
106189,1122730,1,1,6,0,0,8
106190,1122730,1,2,1,0,0,8
106191,1122730,1,2,2,0,0,8
106192,1122730,1,2,3,1,0,9
106193,1122730,1,2,4,1,0,10
106194,1122730,1,2,5,4,0,14
106195,1122730,1,2,6,1,0,15
106196,1122730,1,3,1,0,0,15
106197,1122730,1,3,2,0,0,15
106198,1122730,1,3,3,0,0,15
106199,1122730,1,3,4,1,0,16
106200,1122730,1,3,5,1,0,17
106201,1122730,1,3,6,1,0,18
106202,1122730,1,4,1,2,0,20
106203,1122730,1,4,2,0,0,20
106204,1122730,1,4,3,0,0,20
106205,1122730,1,4,4,6,0,26
106206,1122730,1,4,5,0,0,26
106207,1122730,1,4,6,0,0,26
106208,1122730,1,5,1,6,0,32
106209,1122730,1,5,2,0,0,32
106210,1122730,1,5,3,1,0,33
106211,1122730,1,5,4,4,0,37
106212,1122730,1,5,5,6,0,43
106213,1122730,1,5,6,0,0,43
106214,1122730,1,6,1,4,0,47
106215,1122730,1,6,2,0,0,47
106216,1122730,1,6,3,4,0,51
106217,1122730,1,6,4,6,0,57
106218,1122730,1,6,5,1,0,58
106219,1122730,1,6,6,1,0,59
106220,1122730,1,7,1,1,0,60
106221,1122730,1,7,2,1,0,61
106222,1122730,1,7,3,1,0,62
106223,1122730,1,7,4,4,0,66
106224,1122730,1,7,5,1,0,67
106225,1122730,1,7,6,4,0,71
106226,1122730,1,8,1,4,0,75
106227,1122730,1,8,2,4,0,79
106228,1122730,1,8,3,1,0,80
106229,1122730,1,8,4,0,0,80
106230,1122730,1,8,5,6,0,86
106231,1122730,1,8,6,1,0,87
106232,1122730,1,9,1,0,0,87
106233,1122730,1,9,2,1,0,88
106234,1122730,1,9,3,6,0,94
106235,1122730,1,9,4,6,0,100
106236,1122730,1,9,5,4,0,104
106237,1122730,1,9,6,4,0,108
106238,1122730,1,10,1,1,0,109
106239,1122730,1,10,2,1,0,110
106240,1122730,1,10,3,1,0,111
106241,1122730,1,10,4,1,0,112
106242,1122730,1,10,5,1,0,113
106243,1122730,1,10,6,4,0,117
106244,1122730,1,11,1,1,0,118
106245,1122730,1,11,2,0,0,118
106246,1122730,1,11,3,6,0,124
106247,1122730,1,11,4,7,0,131
106248,1122730,1,11,5,6,0,137
106249,1122730,1,11,6,6,0,143
106250,1122730,1,12,1,1,0,144
106251,1122730,1,12,2,4,0,148
106252,1122730,1,12,3,0,0,148
106253,1122730,1,12,4,0,0,148
106254,1122730,1,12,5,0,0,148
106255,1122730,1,12,6,1,0,149
106256,1122730,1,13,1,6,0,155
106257,1122730,1,13,2,4,0,159
106258,1122730,1,13,3,6,0,165
106259,1122730,1,13,4,0,1,165
106260,1122730,1,13,5,0,0,165
106261,1122730,1,13,6,1,0,166
106262,1122730,1,14,1,4,0,170
106263,1122730,1,14,2,4,0,174
106264,1122730,1,14,3,1,0,175
106265,1122730,1,14,4,1,0,176
106266,1122730,1,14,5,0,0,176
106267,1122730,1,14,6,1,0,177
106268,1122730,1,15,1,1,0,178
106269,1122730,1,15,2,4,0,182
106270,1122730,1,15,3,1,0,183
106271,1122730,1,15,4,2,0,185
106272,1122730,1,15,5,7,0,192
106273,1122730,1,15,6,4,0,196
106274,1122730,1,16,1,0,0,196
106275,1122730,1,16,2,1,0,197
106276,1122730,1,16,3,1,0,198
106277,1122730,1,16,4,1,0,199
106278,1122730,1,16,5,1,0,200
106279,1122730,1,16,6,2,0,202
106280,1122730,1,17,1,6,0,208
106281,1122730,1,17,2,0,0,208
106282,1122730,1,17,3,1,0,209
106283,1122730,1,17,4,7,0,216
106284,1122730,1,17,5,1,0,217
106285,1122730,1,17,6,6,0,223
106286,1122730,1,18,1,1,0,224
106287,1122730,1,18,2,0,0,224
106288,1122730,1,18,3,6,0,230
106289,1122730,1,18,4,0,0,230
106290,1122730,1,18,5,0,0,230
106291,1122730,1,18,6,6,0,236
106292,1122730,1,19,1,1,0,237
106293,1122730,1,19,2,6,0,243
106294,1122730,1,19,3,0,1,243
106295,1122730,1,19,4,4,0,247
106296,1122730,1,19,5,6,0,253
106297,1122730,1,19,6,0,1,253
106298,1122730,1,20,1,1,0,254
106299,1122730,1,20,2,0,1,254
106300,1122730,1,20,3,1,0,255
106301,1122730,1,20,4,0,1,255
106302,1122730,1,20,5,4,0,259
106303,1122730,1,20,6,1,0,260
106408,1122731,1,1,1,0,0,0
106409,1122731,1,1,2,1,0,1
106410,1122731,1,1,3,0,0,1
106411,1122731,1,1,4,4,0,5
106412,1122731,1,1,5,1,0,6
106413,1122731,1,1,6,0,0,6
106414,1122731,1,2,1,0,0,6
106415,1122731,1,2,2,1,0,7
106416,1122731,1,2,3,1,0,8
106417,1122731,1,2,4,0,0,8
106418,1122731,1,2,5,0,1,8
106419,1122731,1,2,6,1,0,9
106420,1122731,1,3,1,0,0,9
106421,1122731,1,3,2,1,0,10
106422,1122731,1,3,3,0,0,10
106423,1122731,1,3,4,0,0,10
106424,1122731,1,3,5,4,0,14
106425,1122731,1,3,6,0,1,14
106426,1122731,1,4,1,0,0,14
106427,1122731,1,4,2,4,0,18
106428,1122731,1,4,3,0,1,18
106429,1122731,1,4,4,0,0,18
106430,1122731,1,4,5,1,0,19
106431,1122731,1,4,6,0,0,19
106432,1122731,1,5,1,1,0,20
106433,1122731,1,5,2,4,0,24
106434,1122731,1,5,3,0,0,24
106435,1122731,1,5,4,0,0,24
106436,1122731,1,5,5,1,0,25
106437,1122731,1,5,6,1,0,26
106438,1122731,1,6,1,1,0,27
106439,1122731,1,6,2,4,0,31
106440,1122731,1,6,3,2,0,33
106441,1122731,1,6,4,0,0,33
106442,1122731,1,6,5,4,0,37
106443,1122731,1,6,6,0,0,37
106444,1122731,1,7,1,1,0,38
106445,1122731,1,7,2,1,0,39
106446,1122731,1,7,3,4,0,43
106447,1122731,1,7,4,0,0,43
106448,1122731,1,7,5,2,0,45
106449,1122731,1,7,6,0,0,45
106450,1122731,1,8,1,0,0,45
106451,1122731,1,8,2,1,0,46
106452,1122731,1,8,3,4,0,50
106453,1122731,1,8,4,1,0,51
106454,1122731,1,8,5,1,0,52
106455,1122731,1,8,6,1,0,53
106456,1122731,1,9,1,1,0,54
106457,1122731,1,9,2,1,0,55
106458,1122731,1,9,3,1,1,56
106459,1122731,1,9,4,1,0,57
106460,1122731,1,9,5,0,0,57
106461,1122731,1,9,6,0,0,57
106462,1122731,1,10,1,1,0,58
106463,1122731,1,10,2,1,0,59
106464,1122731,1,10,3,2,0,61
106465,1122731,1,10,4,4,0,65
106466,1122731,1,10,5,0,0,65
106467,1122731,1,10,6,2,0,67
106468,1122731,1,11,1,1,0,68
106469,1122731,1,11,2,0,0,68
106470,1122731,1,11,3,0,0,68
106471,1122731,1,11,4,1,0,69
106472,1122731,1,11,5,1,0,70
106473,1122731,1,11,6,1,0,71
106474,1122731,1,12,1,1,0,72
106475,1122731,1,12,2,0,0,72
106476,1122731,1,12,3,0,0,72
106477,1122731,1,12,4,0,1,72
106478,1122731,1,12,5,1,0,73
106479,1122731,1,12,6,1,0,74
106480,1122731,1,13,1,1,0,75
106481,1122731,1,13,2,4,0,79
106482,1122731,1,13,3,0,0,79
106483,1122731,1,13,4,4,0,83
106484,1122731,1,13,5,2,0,85
106485,1122731,1,13,6,0,1,85
106486,1122731,1,14,1,1,0,86
106487,1122731,1,14,2,1,0,87
106488,1122731,1,14,3,1,0,88
106489,1122731,1,14,4,1,0,89
106490,1122731,1,14,5,1,0,90
106491,1122731,1,14,6,1,0,91
106492,1122731,1,15,1,0,0,91
106493,1122731,1,15,2,1,0,92
106494,1122731,1,15,3,2,0,94
106495,1122731,1,15,4,0,0,94
106496,1122731,1,15,5,1,0,95
106497,1122731,1,15,6,1,0,96
106498,1122731,1,16,1,1,0,97
106499,1122731,1,16,2,1,0,98
106500,1122731,1,16,3,1,0,99
106501,1122731,1,16,4,0,0,99
106502,1122731,1,16,5,1,0,100
106503,1122731,1,16,6,6,0,106
106504,1122731,1,17,1,1,0,107
106505,1122731,1,17,2,0,0,107
106506,1122731,1,17,3,2,0,109
106507,1122731,1,17,4,0,0,109
106508,1122731,1,17,5,1,0,110
106509,1122731,1,17,6,0,0,110
106510,1122731,1,18,1,1,0,111
106511,1122731,1,18,2,0,0,111
106512,1122731,1,18,3,0,1,111
106513,1122731,1,18,4,0,0,111
106514,1122731,1,18,5,1,0,112
106515,1122731,1,18,6,1,0,113
106516,1122731,1,19,1,0,0,113
106517,1122731,1,19,2,0,0,113
106518,1122731,1,19,3,1,0,114
106519,1122731,1,19,4,2,0,116
106520,1122731,1,19,5,0,0,116
106521,1122731,1,19,6,1,0,117
106522,1122731,1,20,1,1,0,118
106523,1122731,1,20,2,4,0,122
106524,1122731,1,20,3,4,0,126
106525,1122731,1,20,4,1,0,127
106526,1122731,1,20,5,6,0,133
106527,1122731,1,20,6,2,0,135
106644,1130746,1,1,1,1,0,1
106645,1130746,1,1,2,0,0,1
106646,1130746,1,1,3,4,0,5
106647,1130746,1,1,4,7,0,12
106648,1130746,1,1,5,1,0,13
106649,1130746,1,1,6,4,0,17
106650,1130746,1,2,1,1,0,18
106651,1130746,1,2,2,6,0,24
106652,1130746,1,2,3,1,0,25
106653,1130746,1,2,4,1,0,26
106654,1130746,1,2,5,0,0,26
106655,1130746,1,2,6,0,0,26
106656,1130746,1,3,1,1,0,27
106657,1130746,1,3,2,4,0,31
106658,1130746,1,3,3,4,0,35
106659,1130746,1,3,4,4,0,39
106660,1130746,1,3,5,1,0,40
106661,1130746,1,3,6,1,0,41
106662,1130746,1,4,1,1,0,42
106663,1130746,1,4,2,4,0,46
106664,1130746,1,4,3,1,0,47
106665,1130746,1,4,4,1,0,48
106666,1130746,1,4,5,1,0,49
106667,1130746,1,4,6,0,1,49
106668,1130746,1,5,1,0,0,49
106669,1130746,1,5,2,4,0,53
106670,1130746,1,5,3,1,0,54
106671,1130746,1,5,4,1,0,55
106672,1130746,1,5,5,2,0,57
106673,1130746,1,5,6,1,0,58
106674,1130746,1,6,1,4,0,62
106675,1130746,1,6,2,1,0,63
106676,1130746,1,6,3,6,0,69
106677,1130746,1,6,4,1,0,70
106678,1130746,1,6,5,1,0,71
106679,1130746,1,6,6,0,0,71
106680,1130746,1,7,1,1,0,72
106681,1130746,1,7,2,1,0,73
106682,1130746,1,7,3,0,0,73
106683,1130746,1,7,4,2,0,75
106684,1130746,1,7,5,4,0,79
106685,1130746,1,7,6,1,0,80
106686,1130746,1,8,1,0,0,80
106687,1130746,1,8,2,1,0,81
106688,1130746,1,8,3,1,0,82
106689,1130746,1,8,4,1,0,83
106690,1130746,1,8,5,1,0,84
106691,1130746,1,8,6,0,0,84
106692,1130746,1,9,1,0,0,84
106693,1130746,1,9,2,1,0,85
106694,1130746,1,9,3,4,0,89
106695,1130746,1,9,4,0,0,89
106696,1130746,1,9,5,0,0,89
106697,1130746,1,9,6,4,0,93
106698,1130746,1,10,1,2,0,95
106699,1130746,1,10,2,1,0,96
106700,1130746,1,10,3,1,0,97
106701,1130746,1,10,4,1,0,98
106702,1130746,1,10,5,0,0,98
106703,1130746,1,10,6,2,0,100
106704,1130746,1,11,1,0,1,100
106705,1130746,1,11,2,0,0,100
106706,1130746,1,11,3,0,1,100
106707,1130746,1,11,4,1,0,101
106708,1130746,1,11,5,1,0,102
106709,1130746,1,11,6,1,0,103
106710,1130746,1,12,1,0,0,103
106711,1130746,1,12,2,2,0,105
106712,1130746,1,12,3,1,0,106
106713,1130746,1,12,4,1,0,107
106714,1130746,1,12,5,2,0,109
106715,1130746,1,12,6,4,0,113
106716,1130746,1,13,1,6,0,119
106717,1130746,1,13,2,1,0,120
106718,1130746,1,13,3,1,0,121
106719,1130746,1,13,4,0,0,121
106720,1130746,1,13,5,1,0,122
106721,1130746,1,13,6,1,0,123
106722,1130746,1,14,1,1,0,124
106723,1130746,1,14,2,0,0,124
106724,1130746,1,14,3,0,0,124
106725,1130746,1,14,4,4,0,128
106726,1130746,1,14,5,2,0,130
106727,1130746,1,14,6,1,0,131
106728,1130746,1,15,1,0,0,131
106729,1130746,1,15,2,4,0,135
106730,1130746,1,15,3,1,0,136
106731,1130746,1,15,4,0,0,136
106732,1130746,1,15,5,2,0,138
106733,1130746,1,15,6,1,0,139
106734,1130746,1,16,1,0,0,139
106735,1130746,1,16,2,6,0,145
106736,1130746,1,16,3,2,0,147
106737,1130746,1,16,4,1,0,148
106738,1130746,1,16,5,4,0,152
106739,1130746,1,16,6,2,0,154
106740,1130746,1,17,1,1,0,155
106741,1130746,1,17,2,2,0,157
106742,1130746,1,17,3,2,0,159
106743,1130746,1,17,4,0,0,159
106744,1130746,1,17,5,1,0,160
106745,1130746,1,17,6,2,0,162
106746,1130746,1,18,1,4,0,166
106747,1130746,1,18,2,1,0,167
106748,1130746,1,18,3,1,0,168
106749,1130746,1,18,4,2,0,170
106750,1130746,1,18,5,0,0,170
106751,1130746,1,18,6,1,0,171
106752,1130746,1,19,1,2,0,173
106753,1130746,1,19,2,0,1,173
106754,1130746,1,19,3,2,0,175
106755,1130746,1,19,4,6,0,181
106756,1130746,1,19,5,0,0,181
106757,1130746,1,19,6,2,0,183
106758,1130746,1,20,1,2,0,185
106759,1130746,1,20,2,1,0,186
106760,1130746,1,20,3,0,1,186
106761,1130746,1,20,4,1,0,187
106762,1130746,1,20,5,4,0,191
106763,1130746,1,20,6,2,0,193
106864,1130747,1,1,1,1,0,1
106865,1130747,1,1,2,4,0,5
106866,1130747,1,1,3,1,0,6
106867,1130747,1,1,4,4,0,10
106868,1130747,1,1,5,0,0,10
106869,1130747,1,1,6,2,0,12
106870,1130747,1,2,1,1,0,13
106871,1130747,1,2,2,0,0,13
106872,1130747,1,2,3,0,0,13
106873,1130747,1,2,4,0,0,13
106874,1130747,1,2,5,2,0,15
106875,1130747,1,2,6,0,0,15
106876,1130747,1,3,1,1,0,16
106877,1130747,1,3,2,2,0,18
106878,1130747,1,3,3,1,0,19
106879,1130747,1,3,4,0,0,19
106880,1130747,1,3,5,6,0,25
106881,1130747,1,3,6,0,0,25
106882,1130747,1,4,1,0,0,25
106883,1130747,1,4,2,0,0,25
106884,1130747,1,4,3,6,0,31
106885,1130747,1,4,4,1,0,32
106886,1130747,1,4,5,6,0,38
106887,1130747,1,4,6,1,0,39
106888,1130747,1,5,1,4,0,43
106889,1130747,1,5,2,1,0,44
106890,1130747,1,5,3,1,0,45
106891,1130747,1,5,4,1,0,46
106892,1130747,1,5,5,1,0,47
106893,1130747,1,5,6,0,0,47
106894,1130747,1,6,1,4,0,51
106895,1130747,1,6,2,4,0,55
106896,1130747,1,6,3,1,0,56
106897,1130747,1,6,4,0,0,56
106898,1130747,1,6,5,1,0,57
106899,1130747,1,6,6,6,0,63
106900,1130747,1,7,1,0,0,63
106901,1130747,1,7,2,4,0,67
106902,1130747,1,7,3,1,0,68
106903,1130747,1,7,4,2,0,70
106904,1130747,1,7,5,1,0,71
106905,1130747,1,7,6,2,0,73
106906,1130747,1,8,1,1,0,74
106907,1130747,1,8,2,1,0,75
106908,1130747,1,8,3,0,0,75
106909,1130747,1,8,4,1,0,76
106910,1130747,1,8,5,1,0,77
106911,1130747,1,8,6,2,0,79
106912,1130747,1,9,1,1,0,80
106913,1130747,1,9,2,4,0,84
106914,1130747,1,9,3,1,0,85
106915,1130747,1,9,4,0,0,85
106916,1130747,1,9,5,0,0,85
106917,1130747,1,9,6,1,0,86
106918,1130747,1,10,1,2,0,88
106919,1130747,1,10,2,0,0,88
106920,1130747,1,10,3,1,0,89
106921,1130747,1,10,4,1,0,90
106922,1130747,1,10,5,0,0,90
106923,1130747,1,10,6,1,0,91
106924,1130747,1,11,1,1,0,92
106925,1130747,1,11,2,1,0,93
106926,1130747,1,11,3,4,0,97
106927,1130747,1,11,4,0,0,97
106928,1130747,1,11,5,1,0,98
106929,1130747,1,11,6,0,1,98
106930,1130747,1,12,1,1,0,99
106931,1130747,1,12,2,4,0,103
106932,1130747,1,12,3,2,0,105
106933,1130747,1,12,4,1,0,106
106934,1130747,1,12,5,1,0,107
106935,1130747,1,12,6,1,0,108
106936,1130747,1,13,1,1,0,109
106937,1130747,1,13,2,0,0,109
106938,1130747,1,13,3,1,0,110
106939,1130747,1,13,4,1,0,111
106940,1130747,1,13,5,7,0,118
106941,1130747,1,13,6,1,0,119
106942,1130747,1,14,1,4,0,123
106943,1130747,1,14,2,1,0,124
106944,1130747,1,14,3,1,0,125
106945,1130747,1,14,4,6,0,131
106946,1130747,1,14,5,2,0,133
106947,1130747,1,14,6,4,0,137
106948,1130747,1,15,1,6,0,143
106949,1130747,1,15,2,1,0,144
106950,1130747,1,15,3,2,0,146
106951,1130747,1,15,4,0,0,146
106952,1130747,1,15,5,1,0,147
106953,1130747,1,15,6,0,0,147
106954,1130747,1,16,1,1,0,148
106955,1130747,1,16,2,1,0,149
106956,1130747,1,16,3,0,1,149
106957,1130747,1,16,4,4,0,153
106958,1130747,1,16,5,1,0,154
106959,1130747,1,16,6,4,0,158
106960,1130747,1,17,1,1,0,159
106961,1130747,1,17,2,1,0,160
106962,1130747,1,17,3,0,1,160
106963,1130747,1,17,4,0,0,160
106964,1130747,1,17,5,0,0,160
106965,1130747,1,17,6,1,0,161
106966,1130747,1,18,1,1,0,162
106967,1130747,1,18,2,1,0,163
106968,1130747,1,18,3,6,0,169
106969,1130747,1,18,4,4,0,173
106970,1130747,1,18,5,4,0,177
106971,1130747,1,18,6,0,0,177
106972,1130747,1,19,1,4,0,181
106973,1130747,1,19,2,0,0,181
106974,1130747,1,19,3,4,0,185
106975,1130747,1,19,4,4,0,189
106976,1130747,1,19,5,4,0,193
106977,1130747,1,19,6,1,0,194
106978,1130747,1,20,1,4,0,198
106979,1130747,1,20,2,6,0,204
106980,1130747,1,20,3,1,0,205
106981,1130747,1,20,4,0,1,205
106982,1130747,1,20,5,3,0,208
106983,1130747,1,20,6,2,0,210
107096,1133817,1,1,1,0,0,0
107097,1133817,1,1,2,0,0,0
107098,1133817,1,1,3,0,0,0
107099,1133817,1,1,4,1,1,1
107100,1133817,1,1,5,1,0,2
107101,1133817,1,1,6,0,0,2
107102,1133817,1,2,1,1,0,3
107103,1133817,1,2,2,1,0,4
107104,1133817,1,2,3,4,0,8
107105,1133817,1,2,4,0,0,8
107106,1133817,1,2,5,1,0,9
107107,1133817,1,2,6,0,1,9
107108,1133817,1,3,1,1,0,10
107109,1133817,1,3,2,0,0,10
107110,1133817,1,3,3,0,0,10
107111,1133817,1,3,4,0,0,10
107112,1133817,1,3,5,0,0,10
107113,1133817,1,3,6,0,0,10
107114,1133817,1,4,1,0,0,10
107115,1133817,1,4,2,0,0,10
107116,1133817,1,4,3,4,0,14
107117,1133817,1,4,4,0,0,14
107118,1133817,1,4,5,3,0,17
107119,1133817,1,4,6,1,0,18
107120,1133817,1,5,1,4,0,22
107121,1133817,1,5,2,4,0,26
107122,1133817,1,5,3,1,0,27
107123,1133817,1,5,4,2,0,29
107124,1133817,1,5,5,2,0,31
107125,1133817,1,5,6,4,0,35
107126,1133817,1,6,1,1,0,36
107127,1133817,1,6,2,0,0,36
107128,1133817,1,6,3,1,0,37
107129,1133817,1,6,4,1,0,38
107130,1133817,1,6,5,1,0,39
107131,1133817,1,6,6,1,0,40
107132,1133817,1,7,1,1,0,41
107133,1133817,1,7,2,4,0,45
107134,1133817,1,7,3,0,0,45
107135,1133817,1,7,4,1,0,46
107136,1133817,1,7,5,1,0,47
107137,1133817,1,7,6,1,0,48
107138,1133817,1,8,1,1,0,49
107139,1133817,1,8,2,1,0,50
107140,1133817,1,8,3,6,0,56
107141,1133817,1,8,4,0,0,56
107142,1133817,1,8,5,0,0,56
107143,1133817,1,8,6,1,0,57
107144,1133817,1,9,1,1,0,58
107145,1133817,1,9,2,6,0,64
107146,1133817,1,9,3,6,0,70
107147,1133817,1,9,4,1,0,71
107148,1133817,1,9,5,0,0,71
107149,1133817,1,9,6,0,0,71
107150,1133817,1,10,1,1,0,72
107151,1133817,1,10,2,1,0,73
107152,1133817,1,10,3,3,0,76
107153,1133817,1,10,4,2,0,78
107154,1133817,1,10,5,1,0,79
107155,1133817,1,10,6,1,0,80
107156,1133817,1,11,1,2,0,82
107157,1133817,1,11,2,1,0,83
107158,1133817,1,11,3,1,0,84
107159,1133817,1,11,4,1,0,85
107160,1133817,1,11,5,4,0,89
107161,1133817,1,11,6,1,0,90
107162,1133817,1,12,1,4,0,94
107163,1133817,1,12,2,1,0,95
107164,1133817,1,12,3,4,0,99
107165,1133817,1,12,4,0,0,99
107166,1133817,1,12,5,0,0,99
107167,1133817,1,12,6,1,0,100
107168,1133817,1,13,1,1,0,101
107169,1133817,1,13,2,1,0,102
107170,1133817,1,13,3,2,0,104
107171,1133817,1,13,4,0,1,104
107172,1133817,1,13,5,1,0,105
107173,1133817,1,13,6,0,0,105
107174,1133817,1,14,1,1,0,106
107175,1133817,1,14,2,0,0,106
107176,1133817,1,14,3,1,0,107
107177,1133817,1,14,4,1,0,108
107178,1133817,1,14,5,0,0,108
107179,1133817,1,14,6,1,0,109
107180,1133817,1,15,1,1,0,110
107181,1133817,1,15,2,6,0,116
107182,1133817,1,15,3,1,0,117
107183,1133817,1,15,4,0,0,117
107184,1133817,1,15,5,6,0,123
107185,1133817,1,15,6,1,0,124
107186,1133817,1,16,1,1,0,125
107187,1133817,1,16,2,1,0,126
107188,1133817,1,16,3,1,0,127
107189,1133817,1,16,4,6,0,133
107190,1133817,1,16,5,0,0,133
107191,1133817,1,16,6,1,0,134
107192,1133817,1,17,1,6,0,140
107193,1133817,1,17,2,1,0,141
107194,1133817,1,17,3,1,0,142
107195,1133817,1,17,4,1,0,143
107196,1133817,1,17,5,1,0,144
107197,1133817,1,17,6,6,0,150
107198,1133817,1,18,1,0,0,150
107199,1133817,1,18,2,1,0,151
107200,1133817,1,18,3,1,0,152
107201,1133817,1,18,4,0,0,152
107202,1133817,1,18,5,1,0,153
107203,1133817,1,18,6,0,1,153
107204,1133817,1,19,1,1,0,154
107205,1133817,1,19,2,1,0,155
107206,1133817,1,19,3,1,0,156
107207,1133817,1,19,4,2,0,158
107208,1133817,1,19,5,1,0,159
107209,1133817,1,19,6,1,0,160
107210,1133817,1,20,1,1,0,161
107211,1133817,1,20,2,4,0,165
107212,1133817,1,20,3,4,0,169
107213,1133817,1,20,4,1,0,170
107214,1133817,1,20,5,4,0,174
107215,1133817,1,20,6,0,1,174
107327,1133818,1,1,1,0,0,0
107328,1133818,1,1,2,1,0,1
107329,1133818,1,1,3,0,0,1
107330,1133818,1,1,4,1,0,2
107331,1133818,1,1,5,3,0,5
107332,1133818,1,1,6,1,0,6
107333,1133818,1,2,1,4,0,10
107334,1133818,1,2,2,0,0,10
107335,1133818,1,2,3,0,0,10
107336,1133818,1,2,4,0,0,10
107337,1133818,1,2,5,0,0,10
107338,1133818,1,2,6,0,0,10
107339,1133818,1,3,1,1,0,11
107340,1133818,1,3,2,6,0,17
107341,1133818,1,3,3,2,0,19
107342,1133818,1,3,4,1,1,20
107343,1133818,1,3,5,1,0,21
107344,1133818,1,3,6,1,0,22
107345,1133818,1,4,1,0,0,22
107346,1133818,1,4,2,0,0,22
107347,1133818,1,4,3,0,0,22
107348,1133818,1,4,4,0,0,22
107349,1133818,1,4,5,1,0,23
107350,1133818,1,4,6,4,0,27
107351,1133818,1,5,1,0,0,27
107352,1133818,1,5,2,0,0,27
107353,1133818,1,5,3,0,0,27
107354,1133818,1,5,4,4,0,31
107355,1133818,1,5,5,4,0,35
107356,1133818,1,5,6,0,1,35
107357,1133818,1,6,1,0,0,35
107358,1133818,1,6,2,0,0,35
107359,1133818,1,6,3,0,0,35
107360,1133818,1,6,4,4,0,39
107361,1133818,1,6,5,4,0,43
107362,1133818,1,6,6,1,0,44
107363,1133818,1,7,1,1,0,45
107364,1133818,1,7,2,2,0,47
107365,1133818,1,7,3,1,0,48
107366,1133818,1,7,4,1,0,49
107367,1133818,1,7,5,2,0,51
107368,1133818,1,7,6,0,0,51
107369,1133818,1,8,1,0,0,51
107370,1133818,1,8,2,0,0,51
107371,1133818,1,8,3,1,0,52
107372,1133818,1,8,4,1,0,53
107373,1133818,1,8,5,1,0,54
107374,1133818,1,8,6,1,0,55
107375,1133818,1,9,1,4,0,59
107376,1133818,1,9,2,0,0,59
107377,1133818,1,9,3,1,0,60
107378,1133818,1,9,4,6,0,66
107379,1133818,1,9,5,0,1,66
107380,1133818,1,9,6,0,0,66
107381,1133818,1,10,1,1,0,67
107382,1133818,1,10,2,0,0,67
107383,1133818,1,10,3,0,0,67
107384,1133818,1,10,4,1,0,68
107385,1133818,1,10,5,1,0,69
107386,1133818,1,10,6,0,0,69
107387,1133818,1,11,1,0,0,69
107388,1133818,1,11,2,3,0,72
107389,1133818,1,11,3,0,0,72
107390,1133818,1,11,4,0,0,72
107391,1133818,1,11,5,0,1,72
107392,1133818,1,11,6,0,0,72
107393,1133818,1,12,1,0,0,72
107394,1133818,1,12,2,0,0,72
107395,1133818,1,12,3,1,0,73
107396,1133818,1,12,4,1,0,74
107397,1133818,1,12,5,1,0,75
107398,1133818,1,12,6,0,0,75
107399,1133818,1,13,1,2,0,77
107400,1133818,1,13,2,1,0,78
107401,1133818,1,13,3,1,0,79
107402,1133818,1,13,4,0,0,79
107403,1133818,1,13,5,1,0,80
107404,1133818,1,13,6,5,0,85
107405,1133818,1,14,1,4,0,89
107406,1133818,1,14,2,1,0,90
107407,1133818,1,14,3,1,0,91
107408,1133818,1,14,4,2,0,93
107409,1133818,1,14,5,2,0,95
107410,1133818,1,14,6,1,0,96
107411,1133818,1,15,1,1,0,97
107412,1133818,1,15,2,0,0,97
107413,1133818,1,15,3,1,0,98
107414,1133818,1,15,4,0,0,98
107415,1133818,1,15,5,2,0,100
107416,1133818,1,15,6,7,0,107
107417,1133818,1,16,1,0,1,107
107418,1133818,1,16,2,0,0,107
107419,1133818,1,16,3,1,0,108
107420,1133818,1,16,4,1,0,109
107421,1133818,1,16,5,1,0,110
107422,1133818,1,16,6,1,0,111
107423,1133818,1,17,1,1,0,112
107424,1133818,1,17,2,4,0,116
107425,1133818,1,17,3,1,0,117
107426,1133818,1,17,4,1,1,118
107427,1133818,1,17,5,1,0,119
107428,1133818,1,17,6,0,0,119
107429,1133818,1,18,1,0,0,119
107430,1133818,1,18,2,0,0,119
107431,1133818,1,18,3,0,0,119
107432,1133818,1,18,4,1,0,120
107433,1133818,1,18,5,0,0,120
107434,1133818,1,18,6,1,0,121
107435,1133818,1,19,1,4,0,125
107436,1133818,1,19,2,1,0,126
107437,1133818,1,19,3,6,0,132
107438,1133818,1,19,4,0,0,132
107439,1133818,1,19,5,2,1,134
107440,1133818,1,19,6,0,0,134
107441,1133818,1,20,1,0,0,134
107442,1133818,1,20,2,1,1,135
107443,1133818,1,20,3,1,0,136
107444,1133818,1,20,4,0,0,136
107445,1133818,1,20,5,1,0,137
107446,1133818,1,20,6,2,0,139
107559,1133819,1,1,1,1,0,1
107560,1133819,1,1,2,4,0,5
107561,1133819,1,1,3,1,0,6
107562,1133819,1,1,4,0,0,6
107563,1133819,1,1,5,1,0,7
107564,1133819,1,1,6,6,0,13
107565,1133819,1,2,1,2,0,15
107566,1133819,1,2,2,1,0,16
107567,1133819,1,2,3,2,0,18
107568,1133819,1,2,4,1,0,19
107569,1133819,1,2,5,4,0,23
107570,1133819,1,2,6,1,0,24
107571,1133819,1,3,1,4,0,28
107572,1133819,1,3,2,0,0,28
107573,1133819,1,3,3,0,0,28
107574,1133819,1,3,4,0,0,28
107575,1133819,1,3,5,1,0,29
107576,1133819,1,3,6,1,0,30
107577,1133819,1,4,1,6,0,36
107578,1133819,1,4,2,1,0,37
107579,1133819,1,4,3,6,0,43
107580,1133819,1,4,4,0,0,43
107581,1133819,1,4,5,2,0,45
107582,1133819,1,4,6,7,0,52
107583,1133819,1,5,1,0,0,52
107584,1133819,1,5,2,4,0,56
107585,1133819,1,5,3,0,1,56
107586,1133819,1,5,4,1,0,57
107587,1133819,1,5,5,1,0,58
107588,1133819,1,5,6,4,0,62
107589,1133819,1,6,1,0,0,62
107590,1133819,1,6,2,0,0,62
107591,1133819,1,6,3,4,0,66
107592,1133819,1,6,4,0,0,66
107593,1133819,1,6,5,4,0,70
107594,1133819,1,6,6,0,0,70
107595,1133819,1,7,1,1,0,71
107596,1133819,1,7,2,0,0,71
107597,1133819,1,7,3,1,0,72
107598,1133819,1,7,4,0,0,72
107599,1133819,1,7,5,0,0,72
107600,1133819,1,7,6,1,0,73
107601,1133819,1,8,1,1,0,74
107602,1133819,1,8,2,2,0,76
107603,1133819,1,8,3,1,0,77
107604,1133819,1,8,4,1,0,78
107605,1133819,1,8,5,1,0,79
107606,1133819,1,8,6,2,0,81
107607,1133819,1,9,1,0,0,81
107608,1133819,1,9,2,1,0,82
107609,1133819,1,9,3,1,0,83
107610,1133819,1,9,4,1,0,84
107611,1133819,1,9,5,1,0,85
107612,1133819,1,9,6,1,0,86
107613,1133819,1,10,1,1,0,87
107614,1133819,1,10,2,6,0,93
107615,1133819,1,10,3,1,0,94
107616,1133819,1,10,4,2,0,96
107617,1133819,1,10,5,2,0,98
107618,1133819,1,10,6,0,0,98
107619,1133819,1,11,1,1,0,99
107620,1133819,1,11,2,6,0,105
107621,1133819,1,11,3,4,0,109
107622,1133819,1,11,4,1,0,110
107623,1133819,1,11,5,0,0,110
107624,1133819,1,11,6,1,0,111
107625,1133819,1,12,1,6,0,117
107626,1133819,1,12,2,1,0,118
107627,1133819,1,12,3,1,0,119
107628,1133819,1,12,4,1,0,120
107629,1133819,1,12,5,2,0,122
107630,1133819,1,12,6,1,0,123
107631,1133819,1,13,1,2,0,125
107632,1133819,1,13,2,1,0,126
107633,1133819,1,13,3,1,0,127
107634,1133819,1,13,4,4,0,131
107635,1133819,1,13,5,4,0,135
107636,1133819,1,13,6,0,0,135
107637,1133819,1,14,1,6,0,141
107638,1133819,1,14,2,0,1,141
107639,1133819,1,14,3,1,0,142
107640,1133819,1,14,4,0,0,142
107641,1133819,1,14,5,0,1,142
107642,1133819,1,14,6,1,0,143
107643,1133819,1,15,1,4,0,147
107644,1133819,1,15,2,1,0,148
107645,1133819,1,15,3,2,0,150
107646,1133819,1,15,4,0,0,150
107647,1133819,1,15,5,0,0,150
107648,1133819,1,15,6,0,1,150
107649,1133819,1,16,1,1,0,151
107650,1133819,1,16,2,1,0,152
107651,1133819,1,16,3,1,0,153
107652,1133819,1,16,4,1,0,154
107653,1133819,1,16,5,1,0,155
107654,1133819,1,16,6,2,0,157
107655,1133819,1,17,1,1,0,158
107656,1133819,1,17,2,1,0,159
107657,1133819,1,17,3,4,0,163
107658,1133819,1,17,4,6,0,169
107659,1133819,1,17,5,4,0,173
107660,1133819,1,17,6,1,0,174
107661,1133819,1,18,1,1,0,175
107662,1133819,1,18,2,4,0,179
107663,1133819,1,18,3,4,0,183
107664,1133819,1,18,4,0,0,183
107665,1133819,1,18,5,0,0,183
107666,1133819,1,18,6,1,0,184
107667,1133819,1,19,1,6,0,190
107668,1133819,1,19,2,0,0,190
107669,1133819,1,19,3,1,0,191
107670,1133819,1,19,4,4,0,195
107671,1133819,1,19,5,2,0,197
107672,1133819,1,19,6,1,0,198
107673,1133819,1,20,1,5,0,203
107674,1133819,1,20,2,2,1,205
107675,1133819,1,20,3,1,0,206
107676,1133819,1,20,4,0,1,206
107677,1133819,1,20,5,8,0,214
107678,1133819,1,20,6,0,0,214
107797,1133820,1,1,1,5,0,5
107798,1133820,1,1,2,6,0,11
107799,1133820,1,1,3,0,0,11
107800,1133820,1,1,4,1,0,12
107801,1133820,1,1,5,2,0,14
107802,1133820,1,1,6,1,0,15
107803,1133820,1,2,1,6,0,21
107804,1133820,1,2,2,0,0,21
107805,1133820,1,2,3,2,0,23
107806,1133820,1,2,4,1,0,24
107807,1133820,1,2,5,0,0,24
107808,1133820,1,2,6,0,0,24
107809,1133820,1,3,1,1,1,25
107810,1133820,1,3,2,0,0,25
107811,1133820,1,3,3,2,0,27
107812,1133820,1,3,4,1,0,28
107813,1133820,1,3,5,4,0,32
107814,1133820,1,3,6,2,0,34
107815,1133820,1,4,1,0,1,34
107816,1133820,1,4,2,0,0,34
107817,1133820,1,4,3,0,0,34
107818,1133820,1,4,4,0,0,34
107819,1133820,1,4,5,1,0,35
107820,1133820,1,4,6,1,0,36
107821,1133820,1,5,1,0,0,36
107822,1133820,1,5,2,2,0,38
107823,1133820,1,5,3,4,0,42
107824,1133820,1,5,4,3,0,45
107825,1133820,1,5,5,0,0,45
107826,1133820,1,5,6,1,0,46
107827,1133820,1,6,1,4,0,50
107828,1133820,1,6,2,1,0,51
107829,1133820,1,6,3,1,0,52
107830,1133820,1,6,4,1,0,53
107831,1133820,1,6,5,0,0,53
107832,1133820,1,6,6,0,0,53
107833,1133820,1,7,1,1,0,54
107834,1133820,1,7,2,0,0,54
107835,1133820,1,7,3,1,0,55
107836,1133820,1,7,4,1,0,56
107837,1133820,1,7,5,1,0,57
107838,1133820,1,7,6,1,0,58
107839,1133820,1,8,1,1,0,59
107840,1133820,1,8,2,6,0,65
107841,1133820,1,8,3,1,0,66
107842,1133820,1,8,4,1,0,67
107843,1133820,1,8,5,8,0,75
107844,1133820,1,8,6,0,0,75
107845,1133820,1,9,1,1,0,76
107846,1133820,1,9,2,2,0,78
107847,1133820,1,9,3,0,0,78
107848,1133820,1,9,4,2,0,80
107849,1133820,1,9,5,4,0,84
107850,1133820,1,9,6,2,0,86
107851,1133820,1,10,1,0,0,86
107852,1133820,1,10,2,1,0,87
107853,1133820,1,10,3,0,0,87
107854,1133820,1,10,4,0,0,87
107855,1133820,1,10,5,1,0,88
107856,1133820,1,10,6,6,0,94
107857,1133820,1,11,1,2,0,96
107858,1133820,1,11,2,0,0,96
107859,1133820,1,11,3,0,0,96
107860,1133820,1,11,4,0,1,96
107861,1133820,1,11,5,6,0,102
107862,1133820,1,11,6,6,0,108
107863,1133820,1,12,1,1,0,109
107864,1133820,1,12,2,2,0,111
107865,1133820,1,12,3,0,0,111
107866,1133820,1,12,4,1,0,112
107867,1133820,1,12,5,1,0,113
107868,1133820,1,12,6,0,1,113
107869,1133820,1,13,1,0,0,113
107870,1133820,1,13,2,1,0,114
107871,1133820,1,13,3,0,0,114
107872,1133820,1,13,4,2,0,116
107873,1133820,1,13,5,0,0,116
107874,1133820,1,13,6,1,0,117
107875,1133820,1,14,1,1,0,118
107876,1133820,1,14,2,0,1,118
107877,1133820,1,14,3,0,0,118
107878,1133820,1,14,4,0,0,118
107879,1133820,1,14,5,1,0,119
107880,1133820,1,14,6,1,0,120
107881,1133820,1,15,1,0,1,120
107882,1133820,1,15,2,0,0,120
107883,1133820,1,15,3,1,0,121
107884,1133820,1,15,4,2,0,123
107885,1133820,1,15,5,0,0,123
107886,1133820,1,15,6,0,0,123
107887,1133820,1,16,1,2,0,125
107888,1133820,1,16,2,1,0,126
107889,1133820,1,16,3,1,0,127
107890,1133820,1,16,4,0,0,127
107891,1133820,1,16,5,1,0,128
107892,1133820,1,16,6,1,0,129
107893,1133820,1,17,1,4,0,133
107894,1133820,1,17,2,1,0,134
107895,1133820,1,17,3,1,0,135
107896,1133820,1,17,4,0,0,135
107897,1133820,1,17,5,0,0,135
107898,1133820,1,17,6,1,0,136
107899,1133820,1,18,1,1,0,137
107900,1133820,1,18,2,1,0,138
107901,1133820,1,18,3,7,0,145
107902,1133820,1,18,4,1,0,146
107903,1133820,1,18,5,0,0,146
107904,1133820,1,18,6,0,1,146
107905,1133820,1,19,1,4,0,150
107906,1133820,1,19,2,0,0,150
107907,1133820,1,19,3,1,0,151
107908,1133820,1,19,4,0,1,151
107909,1133820,1,19,5,0,1,151
107910,1133820,1,19,6,1,0,152
108016,1133821,1,1,1,0,0,0
108017,1133821,1,1,2,0,0,0
108018,1133821,1,1,3,1,0,1
108019,1133821,1,1,4,0,0,1
108020,1133821,1,1,5,1,0,2
108021,1133821,1,1,6,0,0,2
108022,1133821,1,2,1,0,0,2
108023,1133821,1,2,2,4,0,6
108024,1133821,1,2,3,0,0,6
108025,1133821,1,2,4,0,0,6
108026,1133821,1,2,5,1,0,7
108027,1133821,1,2,6,4,0,11
108028,1133821,1,3,1,0,0,11
108029,1133821,1,3,2,1,0,12
108030,1133821,1,3,3,0,0,12
108031,1133821,1,3,4,1,0,13
108032,1133821,1,3,5,1,0,14
108033,1133821,1,3,6,4,0,18
108034,1133821,1,4,1,1,0,19
108035,1133821,1,4,2,0,0,19
108036,1133821,1,4,3,0,0,19
108037,1133821,1,4,4,1,0,20
108038,1133821,1,4,5,1,0,21
108039,1133821,1,4,6,6,0,27
108040,1133821,1,5,1,1,0,28
108041,1133821,1,5,2,1,0,29
108042,1133821,1,5,3,0,0,29
108043,1133821,1,5,4,6,0,35
108044,1133821,1,5,5,0,0,35
108045,1133821,1,5,6,3,0,38
108046,1133821,1,6,1,4,0,42
108047,1133821,1,6,2,1,0,43
108048,1133821,1,6,3,1,0,44
108049,1133821,1,6,4,1,0,45
108050,1133821,1,6,5,0,0,45
108051,1133821,1,6,6,4,0,49
108052,1133821,1,7,1,1,0,50
108053,1133821,1,7,2,0,0,50
108054,1133821,1,7,3,4,0,54
108055,1133821,1,7,4,0,0,54
108056,1133821,1,7,5,0,0,54
108057,1133821,1,7,6,0,0,54
108058,1133821,1,8,1,1,0,55
108059,1133821,1,8,2,4,0,59
108060,1133821,1,8,3,1,0,60
108061,1133821,1,8,4,2,0,62
108062,1133821,1,8,5,1,0,63
108063,1133821,1,8,6,0,0,63
108064,1133821,1,9,1,1,0,64
108065,1133821,1,9,2,1,0,65
108066,1133821,1,9,3,1,0,66
108067,1133821,1,9,4,0,0,66
108068,1133821,1,9,5,1,0,67
108069,1133821,1,9,6,0,0,67
108070,1133821,1,10,1,1,0,68
108071,1133821,1,10,2,0,0,68
108072,1133821,1,10,3,1,0,69
108073,1133821,1,10,4,1,0,70
108074,1133821,1,10,5,0,1,70
108075,1133821,1,10,6,1,0,71
108076,1133821,1,11,1,0,0,71
108077,1133821,1,11,2,0,0,71
108078,1133821,1,11,3,1,0,72
108079,1133821,1,11,4,0,0,72
108080,1133821,1,11,5,6,0,78
108081,1133821,1,11,6,2,0,80
108082,1133821,1,12,1,1,0,81
108083,1133821,1,12,2,0,0,81
108084,1133821,1,12,3,0,0,81
108085,1133821,1,12,4,2,0,83
108086,1133821,1,12,5,1,0,84
108087,1133821,1,12,6,0,0,84
108088,1133821,1,13,1,1,0,85
108089,1133821,1,13,2,1,0,86
108090,1133821,1,13,3,4,0,90
108091,1133821,1,13,4,1,0,91
108092,1133821,1,13,5,1,0,92
108093,1133821,1,13,6,1,0,93
108094,1133821,1,14,1,1,0,94
108095,1133821,1,14,2,0,0,94
108096,1133821,1,14,3,6,0,100
108097,1133821,1,14,4,4,0,104
108098,1133821,1,14,5,0,0,104
108099,1133821,1,14,6,0,0,104
108100,1133821,1,15,1,2,0,106
108101,1133821,1,15,2,1,0,107
108102,1133821,1,15,3,0,0,107
108103,1133821,1,15,4,4,0,111
108104,1133821,1,15,5,4,0,115
108105,1133821,1,15,6,2,0,117
108106,1133821,1,16,1,1,0,118
108107,1133821,1,16,2,4,0,122
108108,1133821,1,16,3,1,0,123
108109,1133821,1,16,4,1,0,124
108110,1133821,1,16,5,1,0,125
108111,1133821,1,16,6,1,0,126
108112,1133821,1,17,1,1,0,127
108113,1133821,1,17,2,4,0,131
108114,1133821,1,17,3,1,0,132
108115,1133821,1,17,4,6,0,138
108116,1133821,1,17,5,1,0,139
108117,1133821,1,17,6,1,0,140
108118,1133821,1,18,1,1,0,141
108119,1133821,1,18,2,6,0,147
108120,1133821,1,18,3,1,0,148
108121,1133821,1,18,4,6,0,154
108122,1133821,1,18,5,1,0,155
108123,1133821,1,18,6,6,0,161
108124,1133821,1,19,1,0,0,161
108125,1133821,1,19,2,1,0,162
108126,1133821,1,19,3,4,0,166
108127,1133821,1,19,4,4,0,170
108128,1133821,1,19,5,1,0,171
108129,1133821,1,19,6,1,0,172
108130,1133821,1,20,1,0,1,172
108131,1133821,1,20,2,1,0,173
108132,1133821,1,20,3,1,0,174
108133,1133821,1,20,4,1,0,175
108134,1133821,1,20,5,1,0,176
108135,1133821,1,20,6,0,1,176
108256,1133822,1,1,1,0,0,0
108257,1133822,1,1,2,0,0,0
108258,1133822,1,1,3,0,0,0
108259,1133822,1,1,4,1,0,1
108260,1133822,1,1,5,1,0,2
108261,1133822,1,1,6,1,0,3
108262,1133822,1,2,1,1,0,4
108263,1133822,1,2,2,2,0,6
108264,1133822,1,2,3,1,0,7
108265,1133822,1,2,4,0,0,7
108266,1133822,1,2,5,4,0,11
108267,1133822,1,2,6,4,0,15
108268,1133822,1,3,1,0,1,15
108269,1133822,1,3,2,1,0,16
108270,1133822,1,3,3,4,0,20
108271,1133822,1,3,4,1,0,21
108272,1133822,1,3,5,0,0,21
108273,1133822,1,3,6,0,0,21
108274,1133822,1,4,1,1,0,22
108275,1133822,1,4,2,0,0,22
108276,1133822,1,4,3,0,0,22
108277,1133822,1,4,4,0,0,22
108278,1133822,1,4,5,0,0,22
108279,1133822,1,4,6,0,1,22
108280,1133822,1,5,1,1,0,23
108281,1133822,1,5,2,1,0,24
108282,1133822,1,5,3,1,0,25
108283,1133822,1,5,4,0,0,25
108284,1133822,1,5,5,0,0,25
108285,1133822,1,5,6,4,0,29
108286,1133822,1,6,1,2,0,31
108287,1133822,1,6,2,0,1,31
108288,1133822,1,6,3,1,0,32
108289,1133822,1,6,4,0,1,32
108290,1133822,1,6,5,0,0,32
108291,1133822,1,6,6,3,0,35
108292,1133822,1,7,1,0,0,35
108293,1133822,1,7,2,0,0,35
108294,1133822,1,7,3,1,0,36
108295,1133822,1,7,4,0,0,36
108296,1133822,1,7,5,0,0,36
108297,1133822,1,7,6,1,0,37
108298,1133822,1,8,1,1,0,38
108299,1133822,1,8,2,1,0,39
108300,1133822,1,8,3,1,0,40
108301,1133822,1,8,4,0,0,40
108302,1133822,1,8,5,0,0,40
108303,1133822,1,8,6,1,0,41
108304,1133822,1,9,1,0,1,41
108305,1133822,1,9,2,1,0,42
108306,1133822,1,9,3,1,0,43
108307,1133822,1,9,4,0,0,43
108308,1133822,1,9,5,0,0,43
108309,1133822,1,9,6,0,0,43
108310,1133822,1,10,1,4,0,47
108311,1133822,1,10,2,1,0,48
108312,1133822,1,10,3,1,0,49
108313,1133822,1,10,4,1,0,50
108314,1133822,1,10,5,2,0,52
108315,1133822,1,10,6,1,0,53
108316,1133822,1,11,1,0,0,53
108317,1133822,1,11,2,0,0,53
108318,1133822,1,11,3,1,0,54
108319,1133822,1,11,4,4,0,58
108320,1133822,1,11,5,4,0,62
108321,1133822,1,11,6,1,0,63
108322,1133822,1,12,1,1,0,64
108323,1133822,1,12,2,0,0,64
108324,1133822,1,12,3,2,0,66
108325,1133822,1,12,4,1,0,67
108326,1133822,1,12,5,0,0,67
108327,1133822,1,12,6,1,0,68
108328,1133822,1,13,1,2,0,70
108329,1133822,1,13,2,6,0,76
108330,1133822,1,13,3,4,0,80
108331,1133822,1,13,4,1,0,81
108332,1133822,1,13,5,4,0,85
108333,1133822,1,13,6,1,0,86
108334,1133822,1,14,1,1,0,87
108335,1133822,1,14,2,0,0,87
108336,1133822,1,14,3,2,0,89
108337,1133822,1,14,4,0,0,89
108338,1133822,1,14,5,0,0,89
108339,1133822,1,14,6,1,0,90
108340,1133822,1,15,1,4,0,94
108341,1133822,1,15,2,1,0,95
108342,1133822,1,15,3,0,0,95
108343,1133822,1,15,4,2,0,97
108344,1133822,1,15,5,1,0,98
108345,1133822,1,15,6,1,0,99
108346,1133822,1,16,1,2,0,101
108347,1133822,1,16,2,4,0,105
108348,1133822,1,16,3,1,0,106
108349,1133822,1,16,4,2,0,108
108350,1133822,1,16,5,1,0,109
108351,1133822,1,16,6,1,0,110
108352,1133822,1,17,1,1,0,111
108353,1133822,1,17,2,2,0,113
108354,1133822,1,17,3,6,0,119
108355,1133822,1,17,4,6,0,125
108356,1133822,1,17,5,2,0,127
108357,1133822,1,17,6,0,0,127
108358,1133822,1,18,1,1,0,128
108359,1133822,1,18,2,4,0,132
108360,1133822,1,18,3,2,0,134
108361,1133822,1,18,4,2,0,136
108362,1133822,1,18,5,0,0,136
108363,1133822,1,18,6,1,0,137
108364,1133822,1,19,1,1,0,138
108365,1133822,1,19,2,0,1,138
108366,1133822,1,19,3,6,0,144
108367,1133822,1,19,4,1,0,145
108368,1133822,1,19,5,3,0,148
108369,1133822,1,19,6,2,0,150
108370,1133822,1,20,1,4,0,154
108371,1133822,1,20,2,0,1,154
108372,1133822,1,20,3,2,0,156
108373,1133822,1,20,4,1,0,157
108374,1133822,1,20,5,1,0,158
108375,1133822,1,20,6,1,0,159
108495,1133823,1,1,1,1,0,1
108496,1133823,1,1,2,0,0,1
108497,1133823,1,1,3,2,0,3
108498,1133823,1,1,4,1,0,4
108499,1133823,1,1,5,1,0,5
108500,1133823,1,1,6,4,0,9
108501,1133823,1,2,1,1,0,10
108502,1133823,1,2,2,0,0,10
108503,1133823,1,2,3,0,0,10
108504,1133823,1,2,4,2,0,12
108505,1133823,1,2,5,1,0,13
108506,1133823,1,2,6,0,0,13
108507,1133823,1,3,1,3,0,16
108508,1133823,1,3,2,6,0,22
108509,1133823,1,3,3,1,0,23
108510,1133823,1,3,4,1,0,24
108511,1133823,1,3,5,1,0,25
108512,1133823,1,3,6,1,0,26
108513,1133823,1,4,1,1,0,27
108514,1133823,1,4,2,0,1,27
108515,1133823,1,4,3,0,0,27
108516,1133823,1,4,4,0,0,27
108517,1133823,1,4,5,0,0,27
108518,1133823,1,4,6,0,0,27
108519,1133823,1,5,1,0,0,27
108520,1133823,1,5,2,0,1,27
108521,1133823,1,5,3,1,0,28
108522,1133823,1,5,4,4,0,32
108523,1133823,1,5,5,1,0,33
108524,1133823,1,5,6,0,1,33
108525,1133823,1,6,1,1,0,34
108526,1133823,1,6,2,1,0,35
108527,1133823,1,6,3,0,0,35
108528,1133823,1,6,4,4,0,39
108529,1133823,1,6,5,0,0,39
108530,1133823,1,6,6,1,0,40
108531,1133823,1,7,1,1,0,41
108532,1133823,1,7,2,0,0,41
108533,1133823,1,7,3,1,0,42
108534,1133823,1,7,4,1,0,43
108535,1133823,1,7,5,1,0,44
108536,1133823,1,7,6,1,0,45
108537,1133823,1,8,1,1,0,46
108538,1133823,1,8,2,6,0,52
108539,1133823,1,8,3,4,0,56
108540,1133823,1,8,4,1,0,57
108541,1133823,1,8,5,1,0,58
108542,1133823,1,8,6,1,0,59
108543,1133823,1,9,1,1,0,60
108544,1133823,1,9,2,1,0,61
108545,1133823,1,9,3,0,0,61
108546,1133823,1,9,4,0,0,61
108547,1133823,1,9,5,1,0,62
108548,1133823,1,9,6,1,0,63
108549,1133823,1,10,1,1,0,64
108550,1133823,1,10,2,2,0,66
108551,1133823,1,10,3,1,0,67
108552,1133823,1,10,4,0,0,67
108553,1133823,1,10,5,1,0,68
108554,1133823,1,10,6,0,0,68
108555,1133823,1,11,1,0,1,68
108556,1133823,1,11,2,1,0,69
108557,1133823,1,11,3,1,0,70
108558,1133823,1,11,4,1,0,71
108559,1133823,1,11,5,0,0,71
108560,1133823,1,11,6,1,0,72
108561,1133823,1,12,1,2,0,74
108562,1133823,1,12,2,2,0,76
108563,1133823,1,12,3,3,0,79
108564,1133823,1,12,4,1,0,80
108565,1133823,1,12,5,1,0,81
108566,1133823,1,12,6,1,0,82
108567,1133823,1,13,1,1,0,83
108568,1133823,1,13,2,1,0,84
108569,1133823,1,13,3,0,0,84
108570,1133823,1,13,4,4,0,88
108571,1133823,1,13,5,1,0,89
108572,1133823,1,13,6,1,0,90
108573,1133823,1,14,1,4,0,94
108574,1133823,1,14,2,4,0,98
108575,1133823,1,14,3,0,0,98
108576,1133823,1,14,4,1,0,99
108577,1133823,1,14,5,0,0,99
108578,1133823,1,14,6,1,0,100
108579,1133823,1,15,1,4,0,104
108580,1133823,1,15,2,0,1,104
108581,1133823,1,15,3,1,0,105
108582,1133823,1,15,4,4,0,109
108583,1133823,1,15,5,0,0,109
108584,1133823,1,15,6,1,0,110
108585,1133823,1,16,1,1,0,111
108586,1133823,1,16,2,6,0,117
108587,1133823,1,16,3,1,0,118
108588,1133823,1,16,4,0,0,118
108589,1133823,1,16,5,1,0,119
108590,1133823,1,16,6,1,0,120
108591,1133823,1,17,1,6,0,126
108592,1133823,1,17,2,0,0,126
108593,1133823,1,17,3,6,0,132
108594,1133823,1,17,4,1,0,133
108595,1133823,1,17,5,0,1,133
108596,1133823,1,17,6,1,0,134
108597,1133823,1,18,1,1,0,135
108598,1133823,1,18,2,1,0,136
108599,1133823,1,18,3,0,0,136
108600,1133823,1,18,4,4,0,140
108601,1133823,1,18,5,4,0,144
108602,1133823,1,18,6,1,0,145
108603,1133823,1,19,1,2,0,147
108604,1133823,1,19,2,0,1,147
108605,1133823,1,19,3,1,1,148
108606,1133823,1,19,4,0,0,148
108607,1133823,1,19,5,0,0,148
108608,1133823,1,19,6,0,0,148
108609,1133823,1,20,1,4,0,152
108610,1133823,1,20,2,6,0,158
108611,1133823,1,20,3,0,0,158
108612,1133823,1,20,4,4,0,162
108613,1133823,1,20,5,2,0,164
108614,1133823,1,20,6,2,0,166
108735,1134031,1,1,1,1,0,1
108736,1134031,1,1,2,0,0,1
108737,1134031,1,1,3,0,0,1
108738,1134031,1,1,4,0,0,1
108739,1134031,1,1,5,4,0,5
108740,1134031,1,1,6,1,0,6
108741,1134031,1,2,1,4,0,10
108742,1134031,1,2,2,0,0,10
108743,1134031,1,2,3,0,0,10
108744,1134031,1,2,4,1,0,11
108745,1134031,1,2,5,0,0,11
108746,1134031,1,2,6,0,0,11
108747,1134031,1,3,1,0,0,11
108748,1134031,1,3,2,0,0,11
108749,1134031,1,3,3,1,0,12
108750,1134031,1,3,4,4,0,16
108751,1134031,1,3,5,0,0,16
108752,1134031,1,3,6,4,0,20
108753,1134031,1,4,1,6,0,26
108754,1134031,1,4,2,1,0,27
108755,1134031,1,4,3,4,0,31
108756,1134031,1,4,4,6,0,37
108757,1134031,1,4,5,0,0,37
108758,1134031,1,4,6,6,0,43
108759,1134031,1,5,1,1,0,44
108760,1134031,1,5,2,2,0,46
108761,1134031,1,5,3,0,0,46
108762,1134031,1,5,4,0,0,46
108763,1134031,1,5,5,1,0,47
108764,1134031,1,5,6,1,0,48
108765,1134031,1,6,1,0,0,48
108766,1134031,1,6,2,0,0,48
108767,1134031,1,6,3,0,0,48
108768,1134031,1,6,4,4,0,52
108769,1134031,1,6,5,0,1,52
108770,1134031,1,6,6,0,0,52
108771,1134031,1,7,1,1,0,53
108772,1134031,1,7,2,0,0,53
108773,1134031,1,7,3,0,0,53
108774,1134031,1,7,4,0,0,53
108775,1134031,1,7,5,0,0,53
108776,1134031,1,7,6,6,0,59
108777,1134031,1,8,1,1,0,60
108778,1134031,1,8,2,1,0,61
108779,1134031,1,8,3,1,0,62
108780,1134031,1,8,4,0,0,62
108781,1134031,1,8,5,0,0,62
108782,1134031,1,8,6,1,0,63
108783,1134031,1,9,1,1,0,64
108784,1134031,1,9,2,0,0,64
108785,1134031,1,9,3,1,0,65
108786,1134031,1,9,4,0,0,65
108787,1134031,1,9,5,0,0,65
108788,1134031,1,9,6,0,1,65
108789,1134031,1,10,1,0,1,65
108790,1134031,1,10,2,1,0,66
108791,1134031,1,10,3,1,0,67
108792,1134031,1,10,4,0,0,67
108793,1134031,1,10,5,1,0,68
108794,1134031,1,10,6,0,1,68
108795,1134031,1,11,1,0,0,68
108796,1134031,1,11,2,0,0,68
108797,1134031,1,11,3,0,0,68
108798,1134031,1,11,4,0,0,68
108799,1134031,1,11,5,2,0,70
108800,1134031,1,11,6,1,0,71
108801,1134031,1,12,1,2,0,73
108802,1134031,1,12,2,0,0,73
108803,1134031,1,12,3,0,0,73
108804,1134031,1,12,4,1,0,74
108805,1134031,1,12,5,1,0,75
108806,1134031,1,12,6,1,0,76
108807,1134031,1,13,1,0,0,76
108808,1134031,1,13,2,0,1,76
108809,1134031,1,13,3,1,0,77
108810,1134031,1,13,4,0,0,77
108811,1134031,1,13,5,1,0,78
108812,1134031,1,13,6,0,0,78
108813,1134031,1,14,1,0,0,78
108814,1134031,1,14,2,0,0,78
108815,1134031,1,14,3,1,0,79
108816,1134031,1,14,4,0,1,79
108817,1134031,1,14,5,1,0,80
108818,1134031,1,14,6,1,0,81
108819,1134031,1,15,1,0,0,81
108820,1134031,1,15,2,0,0,81
108821,1134031,1,15,3,0,1,81
108822,1134031,1,15,4,0,0,81
108823,1134031,1,15,5,0,0,81
108824,1134031,1,15,6,0,0,81
108825,1134031,1,16,1,2,0,83
108826,1134031,1,16,2,1,0,84
108827,1134031,1,16,3,0,0,84
108828,1134031,1,16,4,0,0,84
108829,1134031,1,16,5,0,0,84
108830,1134031,1,16,6,1,0,85
108831,1134031,1,17,1,0,1,85
108832,1134031,1,17,2,0,0,85
108833,1134031,1,17,3,0,0,85
108834,1134031,1,17,4,1,0,86
108835,1134031,1,17,5,1,0,87
108836,1134031,1,17,6,1,0,88
108837,1134031,1,18,1,4,0,92
108838,1134031,1,18,2,0,0,92
108839,1134031,1,18,3,1,0,93
108840,1134031,1,18,4,1,0,94
108841,1134031,1,18,5,1,0,95
108842,1134031,1,18,6,0,0,95
108843,1134031,1,19,1,3,0,98
108844,1134031,1,19,2,1,0,99
108845,1134031,1,19,3,2,0,101
108846,1134031,1,19,4,0,0,101
108847,1134031,1,19,5,2,0,103
108848,1134031,1,19,6,0,1,103
108849,1134031,1,20,1,4,0,107
108850,1134031,1,20,2,2,0,109
108851,1134031,1,20,3,0,0,109
108852,1134031,1,20,4,6,0,115
108853,1134031,1,20,5,4,0,119
108854,1134031,1,20,6,1,0,120
108944,1134032,1,1,1,0,0,0
108945,1134032,1,1,2,4,0,4
108946,1134032,1,1,3,0,0,4
108947,1134032,1,1,4,3,0,7
108948,1134032,1,1,5,0,0,7
108949,1134032,1,1,6,1,0,8
108950,1134032,1,2,1,0,0,8
108951,1134032,1,2,2,0,0,8
108952,1134032,1,2,3,4,0,12
108953,1134032,1,2,4,0,0,12
108954,1134032,1,2,5,0,0,12
108955,1134032,1,2,6,1,0,13
108956,1134032,1,3,1,0,0,13
108957,1134032,1,3,2,0,0,13
108958,1134032,1,3,3,0,0,13
108959,1134032,1,3,4,1,0,14
108960,1134032,1,3,5,4,0,18
108961,1134032,1,3,6,1,0,19
108962,1134032,1,4,1,0,0,19
108963,1134032,1,4,2,0,0,19
108964,1134032,1,4,3,0,0,19
108965,1134032,1,4,4,0,1,19
108966,1134032,1,4,5,1,0,20
108967,1134032,1,4,6,7,0,27
108968,1134032,1,5,1,4,0,31
108969,1134032,1,5,2,0,0,31
108970,1134032,1,5,3,0,0,31
108971,1134032,1,5,4,0,0,31
108972,1134032,1,5,5,0,0,31
108973,1134032,1,5,6,0,0,31
108974,1134032,1,6,1,1,0,32
108975,1134032,1,6,2,2,0,34
108976,1134032,1,6,3,6,0,40
108977,1134032,1,6,4,1,0,41
108978,1134032,1,6,5,4,0,45
108979,1134032,1,6,6,0,0,45
108980,1134032,1,7,1,1,0,46
108981,1134032,1,7,2,2,0,48
108982,1134032,1,7,3,0,0,48
108983,1134032,1,7,4,1,0,49
108984,1134032,1,7,5,2,0,51
108985,1134032,1,7,6,6,0,57
108986,1134032,1,8,1,0,0,57
108987,1134032,1,8,2,0,0,57
108988,1134032,1,8,3,1,0,58
108989,1134032,1,8,4,1,0,59
108990,1134032,1,8,5,1,0,60
108991,1134032,1,8,6,0,0,60
108992,1134032,1,9,1,5,0,65
108993,1134032,1,9,2,1,0,66
108994,1134032,1,9,3,6,0,72
108995,1134032,1,9,4,0,0,72
108996,1134032,1,9,5,1,0,73
108997,1134032,1,9,6,1,0,74
108998,1134032,1,10,1,1,0,75
108999,1134032,1,10,2,0,0,75
109000,1134032,1,10,3,0,1,75
109001,1134032,1,10,4,1,0,76
109002,1134032,1,10,5,0,0,76
109003,1134032,1,10,6,0,0,76
109004,1134032,1,11,1,1,0,77
109005,1134032,1,11,2,4,0,81
109006,1134032,1,11,3,1,0,82
109007,1134032,1,11,4,1,0,83
109008,1134032,1,11,5,1,0,84
109009,1134032,1,11,6,1,0,85
109010,1134032,1,12,1,1,0,86
109011,1134032,1,12,2,0,0,86
109012,1134032,1,12,3,1,0,87
109013,1134032,1,12,4,1,0,88
109014,1134032,1,12,5,0,1,88
109015,1134032,1,12,6,0,0,88
109016,1134032,1,13,1,1,0,89
109017,1134032,1,13,2,6,0,95
109018,1134032,1,13,3,1,0,96
109019,1134032,1,13,4,1,0,97
109020,1134032,1,13,5,2,0,99
109021,1134032,1,13,6,1,0,100
109022,1134032,1,14,1,4,0,104
109023,1134032,1,14,2,1,0,105
109024,1134032,1,14,3,1,0,106
109025,1134032,1,14,4,6,0,112
109026,1134032,1,14,5,0,0,112
109027,1134032,1,14,6,0,0,112
109028,1134032,1,15,1,1,0,113
109029,1134032,1,15,2,0,0,113
109030,1134032,1,15,3,1,0,114
109031,1134032,1,15,4,0,0,114
109032,1134032,1,15,5,4,0,118
109033,1134032,1,15,6,1,0,119
109034,1134032,1,16,1,2,0,121
109035,1134032,1,16,2,0,0,121
109036,1134032,1,16,3,0,0,121
109037,1134032,1,16,4,0,0,121
109038,1134032,1,16,5,4,0,125
109039,1134032,1,16,6,4,0,129
109040,1134032,1,17,1,0,0,129
109041,1134032,1,17,2,2,0,131
109042,1134032,1,17,3,0,0,131
109043,1134032,1,17,4,4,0,135
109044,1134032,1,17,5,2,0,137
109045,1134032,1,17,6,1,0,138
109046,1134032,1,18,1,1,0,139
109047,1134032,1,18,2,0,1,139
109048,1134032,1,18,3,4,0,143
109049,1134032,1,18,4,6,0,149
109050,1134032,1,18,5,6,0,155
109051,1134032,1,18,6,0,0,155
109052,1134032,1,19,1,0,1,155
109053,1134032,1,19,2,0,1,155
109054,1134032,1,19,3,1,0,156
109055,1134032,1,19,4,1,0,157
109056,1134032,1,19,5,0,0,157
109057,1134032,1,19,6,0,1,157
109058,1134032,1,20,1,0,0,157
109059,1134032,1,20,2,0,0,157
109060,1134032,1,20,3,0,1,157
109061,1134032,1,20,4,0,1,157
109062,1134032,1,20,5,0,0,157
109063,1134032,1,20,6,1,0,158
109184,1140069,1,1,1,0,0,0
109185,1140069,1,1,2,0,0,0
109186,1140069,1,1,3,4,0,4
109187,1140069,1,1,4,4,0,8
109188,1140069,1,1,5,4,0,12
109189,1140069,1,1,6,1,0,13
109190,1140069,1,2,1,0,0,13
109191,1140069,1,2,2,4,0,17
109192,1140069,1,2,3,1,0,18
109193,1140069,1,2,4,0,0,18
109194,1140069,1,2,5,1,0,19
109195,1140069,1,2,6,0,0,19
109196,1140069,1,3,1,0,0,19
109197,1140069,1,3,2,2,0,21
109198,1140069,1,3,3,4,0,25
109199,1140069,1,3,4,1,0,26
109200,1140069,1,3,5,1,0,27
109201,1140069,1,3,6,2,0,29
109202,1140069,1,4,1,0,0,29
109203,1140069,1,4,2,2,0,31
109204,1140069,1,4,3,4,0,35
109205,1140069,1,4,4,4,0,39
109206,1140069,1,4,5,0,0,39
109207,1140069,1,4,6,1,0,40
109208,1140069,1,5,1,1,0,41
109209,1140069,1,5,2,1,0,42
109210,1140069,1,5,3,0,0,42
109211,1140069,1,5,4,4,0,46
109212,1140069,1,5,5,0,0,46
109213,1140069,1,5,6,0,1,46
109214,1140069,1,6,1,0,0,46
109215,1140069,1,6,2,4,0,50
109216,1140069,1,6,3,1,0,51
109217,1140069,1,6,4,0,0,51
109218,1140069,1,6,5,4,0,55
109219,1140069,1,6,6,1,0,56
109220,1140069,1,7,1,0,0,56
109221,1140069,1,7,2,1,0,57
109222,1140069,1,7,3,1,0,58
109223,1140069,1,7,4,1,0,59
109224,1140069,1,7,5,6,0,65
109225,1140069,1,7,6,0,0,65
109226,1140069,1,8,1,0,1,65
109227,1140069,1,8,2,1,0,66
109228,1140069,1,8,3,1,0,67
109229,1140069,1,8,4,0,0,67
109230,1140069,1,8,5,1,0,68
109231,1140069,1,8,6,4,0,72
109232,1140069,1,9,1,1,0,73
109233,1140069,1,9,2,1,0,74
109234,1140069,1,9,3,1,0,75
109235,1140069,1,9,4,1,0,76
109236,1140069,1,9,5,2,0,78
109237,1140069,1,9,6,1,0,79
109238,1140069,1,10,1,3,0,82
109239,1140069,1,10,2,1,0,83
109240,1140069,1,10,3,4,0,87
109241,1140069,1,10,4,0,0,87
109242,1140069,1,10,5,6,0,93
109243,1140069,1,10,6,1,0,94
109244,1140069,1,11,1,0,0,94
109245,1140069,1,11,2,0,0,94
109246,1140069,1,11,3,1,0,95
109247,1140069,1,11,4,6,0,101
109248,1140069,1,11,5,0,0,101
109249,1140069,1,11,6,2,0,103
109250,1140069,1,12,1,1,0,104
109251,1140069,1,12,2,2,0,106
109252,1140069,1,12,3,0,0,106
109253,1140069,1,12,4,2,0,108
109254,1140069,1,12,5,1,0,109
109255,1140069,1,12,6,1,0,110
109256,1140069,1,13,1,4,0,114
109257,1140069,1,13,2,1,0,115
109258,1140069,1,13,3,1,0,116
109259,1140069,1,13,4,1,0,117
109260,1140069,1,13,5,1,0,118
109261,1140069,1,13,6,4,0,122
109262,1140069,1,14,1,1,0,123
109263,1140069,1,14,2,1,0,124
109264,1140069,1,14,3,0,0,124
109265,1140069,1,14,4,1,0,125
109266,1140069,1,14,5,1,0,126
109267,1140069,1,14,6,0,0,126
109268,1140069,1,15,1,1,0,127
109269,1140069,1,15,2,1,0,128
109270,1140069,1,15,3,6,0,134
109271,1140069,1,15,4,1,0,135
109272,1140069,1,15,5,1,0,136
109273,1140069,1,15,6,1,0,137
109274,1140069,1,16,1,2,0,139
109275,1140069,1,16,2,1,1,140
109276,1140069,1,16,3,2,0,142
109277,1140069,1,16,4,1,0,143
109278,1140069,1,16,5,1,0,144
109279,1140069,1,16,6,1,0,145
109280,1140069,1,17,1,1,0,146
109281,1140069,1,17,2,4,0,150
109282,1140069,1,17,3,0,1,150
109283,1140069,1,17,4,4,0,154
109284,1140069,1,17,5,1,0,155
109285,1140069,1,17,6,1,0,156
109286,1140069,1,18,1,0,1,156
109287,1140069,1,18,2,0,0,156
109288,1140069,1,18,3,1,0,157
109289,1140069,1,18,4,0,0,157
109290,1140069,1,18,5,1,0,158
109291,1140069,1,18,6,1,0,159
109292,1140069,1,19,1,2,0,161
109293,1140069,1,19,2,1,0,162
109294,1140069,1,19,3,4,0,166
109295,1140069,1,19,4,6,0,172
109296,1140069,1,19,5,4,0,176
109297,1140069,1,19,6,6,0,182
109298,1140069,1,20,1,4,0,186
109299,1140069,1,20,2,4,0,190
109300,1140069,1,20,3,6,0,196
109301,1140069,1,20,4,1,0,197
109302,1140069,1,20,5,2,0,199
109303,1140069,1,20,6,4,0,203
109386,1140070,1,1,1,0,0,0
109387,1140070,1,1,2,0,0,0
109388,1140070,1,1,3,4,0,4
109389,1140070,1,1,4,1,0,5
109390,1140070,1,1,5,0,0,5
109391,1140070,1,1,6,2,0,7
109392,1140070,1,2,1,1,0,8
109393,1140070,1,2,2,2,0,10
109394,1140070,1,2,3,1,0,11
109395,1140070,1,2,4,0,1,11
109396,1140070,1,2,5,0,0,11
109397,1140070,1,2,6,0,0,11
109398,1140070,1,3,1,0,0,11
109399,1140070,1,3,2,1,0,12
109400,1140070,1,3,3,2,0,14
109401,1140070,1,3,4,2,0,16
109402,1140070,1,3,5,0,0,16
109403,1140070,1,3,6,0,0,16
109404,1140070,1,4,1,4,0,20
109405,1140070,1,4,2,0,0,20
109406,1140070,1,4,3,4,0,24
109407,1140070,1,4,4,4,0,28
109408,1140070,1,4,5,1,0,29
109409,1140070,1,4,6,1,0,30
109410,1140070,1,5,1,0,0,30
109411,1140070,1,5,2,4,0,34
109412,1140070,1,5,3,6,0,40
109413,1140070,1,5,4,0,0,40
109414,1140070,1,5,5,1,0,41
109415,1140070,1,5,6,1,0,42
109416,1140070,1,6,1,0,0,42
109417,1140070,1,6,2,1,0,43
109418,1140070,1,6,3,2,0,45
109419,1140070,1,6,4,4,0,49
109420,1140070,1,6,5,1,0,50
109421,1140070,1,6,6,4,0,54
109422,1140070,1,7,1,2,0,56
109423,1140070,1,7,2,0,0,56
109424,1140070,1,7,3,1,0,57
109425,1140070,1,7,4,1,0,58
109426,1140070,1,7,5,1,0,59
109427,1140070,1,7,6,4,0,63
109428,1140070,1,8,1,1,0,64
109429,1140070,1,8,2,1,0,65
109430,1140070,1,8,3,1,0,66
109431,1140070,1,8,4,1,0,67
109432,1140070,1,8,5,1,0,68
109433,1140070,1,8,6,1,0,69
109434,1140070,1,9,1,0,0,69
109435,1140070,1,9,2,2,0,71
109436,1140070,1,9,3,0,0,71
109437,1140070,1,9,4,0,0,71
109438,1140070,1,9,5,0,0,71
109439,1140070,1,9,6,4,0,75
109440,1140070,1,10,1,1,0,76
109441,1140070,1,10,2,4,0,80
109442,1140070,1,10,3,1,0,81
109443,1140070,1,10,4,4,0,85
109444,1140070,1,10,5,4,0,89
109445,1140070,1,10,6,1,0,90
109446,1140070,1,11,1,1,0,91
109447,1140070,1,11,2,1,0,92
109448,1140070,1,11,3,4,0,96
109449,1140070,1,11,4,0,0,96
109450,1140070,1,11,5,1,0,97
109451,1140070,1,11,6,4,0,101
109452,1140070,1,12,1,1,0,102
109453,1140070,1,12,2,4,0,106
109454,1140070,1,12,3,2,0,108
109455,1140070,1,12,4,0,0,108
109456,1140070,1,12,5,4,0,112
109457,1140070,1,12,6,2,0,114
109458,1140070,1,13,1,4,0,118
109459,1140070,1,13,2,1,0,119
109460,1140070,1,13,3,1,0,120
109461,1140070,1,13,4,2,0,122
109462,1140070,1,13,5,0,0,122
109463,1140070,1,13,6,0,0,122
109464,1140070,1,14,1,2,0,124
109465,1140070,1,14,2,0,0,124
109466,1140070,1,14,3,1,0,125
109467,1140070,1,14,4,1,0,126
109468,1140070,1,14,5,4,0,130
109469,1140070,1,14,6,0,1,130
109470,1140070,1,15,1,4,0,134
109471,1140070,1,15,2,1,0,135
109472,1140070,1,15,3,0,0,135
109473,1140070,1,15,4,4,0,139
109474,1140070,1,15,5,1,0,140
109475,1140070,1,15,6,4,0,144
109476,1140070,1,16,1,1,0,145
109477,1140070,1,16,2,2,0,147
109478,1140070,1,16,3,1,0,148
109479,1140070,1,16,4,6,0,154
109480,1140070,1,16,5,1,0,155
109481,1140070,1,16,6,1,0,156
109482,1140070,1,17,1,6,0,162
109483,1140070,1,17,2,1,0,163
109484,1140070,1,17,3,1,0,164
109485,1140070,1,17,4,2,0,166
109486,1140070,1,17,5,1,0,167
109487,1140070,1,17,6,0,1,167
109488,1140070,1,18,1,1,0,168
109489,1140070,1,18,2,4,0,172
109490,1140070,1,18,3,1,0,173
109491,1140070,1,18,4,5,0,178
109492,1140070,1,18,5,1,0,179
109493,1140070,1,18,6,4,0,183
109494,1140070,1,19,1,4,0,187
109495,1140070,1,19,2,1,0,188
109496,1140070,1,19,3,0,0,188
109497,1140070,1,19,4,6,0,194
109498,1140070,1,19,5,1,0,195
109499,1140070,1,19,6,1,0,196
109500,1140070,1,20,1,2,0,198
109501,1140070,1,20,2,4,0,202
109502,1140070,1,20,3,1,0,203
109503,1140070,1,20,4,1,0,204
109504,1140070,1,20,5,0,0,204
109505,1140070,1,20,6,1,0,205
109622,1140071,1,1,1,0,0,0
109623,1140071,1,1,2,0,0,0
109624,1140071,1,1,3,0,0,0
109625,1140071,1,1,4,0,0,0
109626,1140071,1,1,5,0,0,0
109627,1140071,1,1,6,0,0,0
109628,1140071,1,2,1,1,0,1
109629,1140071,1,2,2,0,0,1
109630,1140071,1,2,3,1,0,2
109631,1140071,1,2,4,0,0,2
109632,1140071,1,2,5,0,0,2
109633,1140071,1,2,6,0,0,2
109634,1140071,1,3,1,0,1,2
109635,1140071,1,3,2,1,0,3
109636,1140071,1,3,3,1,0,4
109637,1140071,1,3,4,1,0,5
109638,1140071,1,3,5,4,0,9
109639,1140071,1,3,6,1,0,10
109640,1140071,1,4,1,1,0,11
109641,1140071,1,4,2,0,0,11
109642,1140071,1,4,3,0,0,11
109643,1140071,1,4,4,4,0,15
109644,1140071,1,4,5,0,0,15
109645,1140071,1,4,6,1,0,16
109646,1140071,1,5,1,0,0,16
109647,1140071,1,5,2,1,0,17
109648,1140071,1,5,3,0,0,17
109649,1140071,1,5,4,0,0,17
109650,1140071,1,5,5,1,0,18
109651,1140071,1,5,6,6,0,24
109652,1140071,1,6,1,1,0,25
109653,1140071,1,6,2,0,0,25
109654,1140071,1,6,3,0,0,25
109655,1140071,1,6,4,0,0,25
109656,1140071,1,6,5,4,0,29
109657,1140071,1,6,6,0,0,29
109658,1140071,1,7,1,0,0,29
109659,1140071,1,7,2,0,0,29
109660,1140071,1,7,3,6,0,35
109661,1140071,1,7,4,0,0,35
109662,1140071,1,7,5,6,0,41
109663,1140071,1,7,6,1,0,42
109664,1140071,1,8,1,0,0,42
109665,1140071,1,8,2,2,0,44
109666,1140071,1,8,3,0,0,44
109667,1140071,1,8,4,1,0,45
109668,1140071,1,8,5,0,0,45
109669,1140071,1,8,6,1,0,46
109670,1140071,1,9,1,0,0,46
109671,1140071,1,9,2,1,0,47
109672,1140071,1,9,3,1,0,48
109673,1140071,1,9,4,0,0,48
109674,1140071,1,9,5,4,0,52
109675,1140071,1,9,6,1,0,53
109676,1140071,1,10,1,1,0,54
109677,1140071,1,10,2,0,0,54
109678,1140071,1,10,3,4,0,58
109679,1140071,1,10,4,1,0,59
109680,1140071,1,10,5,4,0,63
109681,1140071,1,10,6,1,0,64
109682,1140071,1,11,1,0,0,64
109683,1140071,1,11,2,6,0,70
109684,1140071,1,11,3,0,0,70
109685,1140071,1,11,4,1,0,71
109686,1140071,1,11,5,1,0,72
109687,1140071,1,11,6,1,0,73
109688,1140071,1,12,1,1,0,74
109689,1140071,1,12,2,0,0,74
109690,1140071,1,12,3,0,1,74
109691,1140071,1,12,4,0,0,74
109692,1140071,1,12,5,1,0,75
109693,1140071,1,12,6,1,0,76
109694,1140071,1,13,1,1,0,77
109695,1140071,1,13,2,1,0,78
109696,1140071,1,13,3,1,0,79
109697,1140071,1,13,4,2,0,81
109698,1140071,1,13,5,0,0,81
109699,1140071,1,13,6,0,0,81
109700,1140071,1,14,1,6,0,87
109701,1140071,1,14,2,1,0,88
109702,1140071,1,14,3,1,0,89
109703,1140071,1,14,4,1,0,90
109704,1140071,1,14,5,0,1,90
109705,1140071,1,14,6,0,0,90
109706,1140071,1,15,1,0,0,90
109707,1140071,1,15,2,4,0,94
109708,1140071,1,15,3,1,0,95
109709,1140071,1,15,4,0,1,95
109710,1140071,1,15,5,1,0,96
109711,1140071,1,15,6,0,0,96
109712,1140071,1,16,1,0,1,96
109713,1140071,1,16,2,1,0,97
109714,1140071,1,16,3,0,0,97
109715,1140071,1,16,4,1,0,98
109716,1140071,1,16,5,0,0,98
109717,1140071,1,16,6,1,0,99
109718,1140071,1,17,1,1,0,100
109719,1140071,1,17,2,1,0,101
109720,1140071,1,17,3,2,0,103
109721,1140071,1,17,4,1,0,104
109722,1140071,1,17,5,1,0,105
109723,1140071,1,17,6,4,0,109
109724,1140071,1,18,1,1,0,110
109725,1140071,1,18,2,0,0,110
109726,1140071,1,18,3,4,0,114
109727,1140071,1,18,4,4,0,118
109728,1140071,1,18,5,1,0,119
109729,1140071,1,18,6,4,0,123
109730,1140071,1,19,1,2,0,125
109731,1140071,1,19,2,4,0,129
109732,1140071,1,19,3,1,0,130
109733,1140071,1,19,4,0,0,130
109734,1140071,1,19,5,4,0,134
109735,1140071,1,19,6,6,0,140
109736,1140071,1,20,1,0,0,140
109737,1140071,1,20,2,0,0,140
109738,1140071,1,20,3,0,1,140
109739,1140071,1,20,4,1,0,141
109740,1140071,1,20,5,6,0,147
109741,1140071,1,20,6,6,0,153
109843,1140384,1,1,1,0,0,0
109844,1140384,1,1,2,6,0,6
109845,1140384,1,1,3,0,0,6
109846,1140384,1,1,4,5,0,11
109847,1140384,1,1,5,1,0,12
109848,1140384,1,1,6,4,0,16
109849,1140384,1,2,1,4,0,20
109850,1140384,1,2,2,4,0,24
109851,1140384,1,2,3,1,0,25
109852,1140384,1,2,4,0,0,25
109853,1140384,1,2,5,4,0,29
109854,1140384,1,2,6,0,0,29
109855,1140384,1,3,1,1,0,30
109856,1140384,1,3,2,1,0,31
109857,1140384,1,3,3,0,0,31
109858,1140384,1,3,4,6,0,37
109859,1140384,1,3,5,0,0,37
109860,1140384,1,3,6,0,0,37
109861,1140384,1,4,1,4,0,41
109862,1140384,1,4,2,0,1,41
109863,1140384,1,4,3,4,0,45
109864,1140384,1,4,4,0,0,45
109865,1140384,1,4,5,0,1,45
109866,1140384,1,4,6,1,0,46
109867,1140384,1,5,1,1,0,47
109868,1140384,1,5,2,1,0,48
109869,1140384,1,5,3,0,0,48
109870,1140384,1,5,4,0,0,48
109871,1140384,1,5,5,4,0,52
109872,1140384,1,5,6,0,0,52
109873,1140384,1,6,1,0,0,52
109874,1140384,1,6,2,1,0,53
109875,1140384,1,6,3,4,0,57
109876,1140384,1,6,4,1,0,58
109877,1140384,1,6,5,1,0,59
109878,1140384,1,6,6,0,0,59
109879,1140384,1,7,1,1,0,60
109880,1140384,1,7,2,0,1,60
109881,1140384,1,7,3,0,0,60
109882,1140384,1,7,4,1,0,61
109883,1140384,1,7,5,1,0,62
109884,1140384,1,7,6,0,0,62
109885,1140384,1,8,1,1,0,63
109886,1140384,1,8,2,0,0,63
109887,1140384,1,8,3,1,0,64
109888,1140384,1,8,4,1,0,65
109889,1140384,1,8,5,0,0,65
109890,1140384,1,8,6,0,0,65
109891,1140384,1,9,1,0,0,65
109892,1140384,1,9,2,1,0,66
109893,1140384,1,9,3,1,0,67
109894,1140384,1,9,4,6,0,73
109895,1140384,1,9,5,1,0,74
109896,1140384,1,9,6,0,0,74
109897,1140384,1,10,1,4,0,78
109898,1140384,1,10,2,1,0,79
109899,1140384,1,10,3,1,0,80
109900,1140384,1,10,4,6,0,86
109901,1140384,1,10,5,2,0,88
109902,1140384,1,10,6,1,0,89
109903,1140384,1,11,1,1,0,90
109904,1140384,1,11,2,4,0,94
109905,1140384,1,11,3,1,0,95
109906,1140384,1,11,4,6,0,101
109907,1140384,1,11,5,6,0,107
109908,1140384,1,11,6,0,1,107
109909,1140384,1,12,1,0,0,107
109910,1140384,1,12,2,6,0,113
109911,1140384,1,12,3,0,0,113
109912,1140384,1,12,4,1,0,114
109913,1140384,1,12,5,1,0,115
109914,1140384,1,12,6,1,0,116
109915,1140384,1,13,1,1,0,117
109916,1140384,1,13,2,0,0,117
109917,1140384,1,13,3,6,0,123
109918,1140384,1,13,4,1,0,124
109919,1140384,1,13,5,1,0,125
109920,1140384,1,13,6,1,0,126
109921,1140384,1,14,1,1,0,127
109922,1140384,1,14,2,0,0,127
109923,1140384,1,14,3,1,0,128
109924,1140384,1,14,4,6,0,134
109925,1140384,1,14,5,6,0,140
109926,1140384,1,14,6,1,0,141
109927,1140384,1,15,1,4,0,145
109928,1140384,1,15,2,0,1,145
109929,1140384,1,15,3,1,0,146
109930,1140384,1,15,4,1,0,147
109931,1140384,1,15,5,1,0,148
109932,1140384,1,15,6,2,0,150
109933,1140384,1,16,1,0,0,150
109934,1140384,1,16,2,0,0,150
109935,1140384,1,16,3,0,0,150
109936,1140384,1,16,4,0,0,150
109937,1140384,1,16,5,1,0,151
109938,1140384,1,16,6,1,0,152
109939,1140384,1,17,1,1,0,153
109940,1140384,1,17,2,0,0,153
109941,1140384,1,17,3,4,0,157
109942,1140384,1,17,4,4,0,161
109943,1140384,1,17,5,0,0,161
109944,1140384,1,17,6,4,0,165
109945,1140384,1,18,1,1,0,166
109946,1140384,1,18,2,1,0,167
109947,1140384,1,18,3,1,0,168
109948,1140384,1,18,4,1,0,169
109949,1140384,1,18,5,1,0,170
109950,1140384,1,18,6,1,0,171
109951,1140384,1,19,1,2,0,173
109952,1140384,1,19,2,0,1,173
109953,1140384,1,19,3,0,1,173
109954,1140384,1,19,4,0,0,173
109955,1140384,1,19,5,4,0,177
109956,1140384,1,19,6,0,0,177
109957,1140384,1,20,1,4,0,181
109958,1140384,1,20,2,1,0,182
109959,1140384,1,20,3,2,0,184
109960,1140384,1,20,4,1,0,185
109961,1140384,1,20,5,0,1,185
109962,1140384,1,20,6,2,0,187
110083,1140992,1,1,1,0,0,0
110084,1140992,1,1,2,0,0,0
110085,1140992,1,1,3,1,0,1
110086,1140992,1,1,4,0,0,1
110087,1140992,1,1,5,0,0,1
110088,1140992,1,1,6,0,0,1
110089,1140992,1,2,1,2,0,3
110090,1140992,1,2,2,0,0,3
110091,1140992,1,2,3,4,0,7
110092,1140992,1,2,4,0,0,7
110093,1140992,1,2,5,4,0,11
110094,1140992,1,2,6,0,0,11
110095,1140992,1,3,1,0,0,11
110096,1140992,1,3,2,4,0,15
110097,1140992,1,3,3,1,0,16
110098,1140992,1,3,4,2,0,18
110099,1140992,1,3,5,6,0,24
110100,1140992,1,3,6,4,0,28
110101,1140992,1,4,1,0,0,28
110102,1140992,1,4,2,4,0,32
110103,1140992,1,4,3,0,0,32
110104,1140992,1,4,4,0,0,32
110105,1140992,1,4,5,4,0,36
110106,1140992,1,4,6,1,0,37
110107,1140992,1,5,1,1,0,38
110108,1140992,1,5,2,6,0,44
110109,1140992,1,5,3,1,0,45
110110,1140992,1,5,4,0,0,45
110111,1140992,1,5,5,4,0,49
110112,1140992,1,5,6,1,0,50
110113,1140992,1,6,1,1,0,51
110114,1140992,1,6,2,0,0,51
110115,1140992,1,6,3,0,0,51
110116,1140992,1,6,4,0,0,51
110117,1140992,1,6,5,2,0,53
110118,1140992,1,6,6,6,0,59
110119,1140992,1,7,1,1,0,60
110120,1140992,1,7,2,1,0,61
110121,1140992,1,7,3,1,0,62
110122,1140992,1,7,4,1,0,63
110123,1140992,1,7,5,1,0,64
110124,1140992,1,7,6,1,0,65
110125,1140992,1,8,1,1,0,66
110126,1140992,1,8,2,1,0,67
110127,1140992,1,8,3,1,0,68
110128,1140992,1,8,4,6,0,74
110129,1140992,1,8,5,1,0,75
110130,1140992,1,8,6,2,0,77
110131,1140992,1,9,1,1,0,78
110132,1140992,1,9,2,0,0,78
110133,1140992,1,9,3,1,0,79
110134,1140992,1,9,4,0,0,79
110135,1140992,1,9,5,1,0,80
110136,1140992,1,9,6,4,0,84
110137,1140992,1,10,1,0,0,84
110138,1140992,1,10,2,1,0,85
110139,1140992,1,10,3,1,0,86
110140,1140992,1,10,4,6,0,92
110141,1140992,1,10,5,1,0,93
110142,1140992,1,10,6,1,0,94
110143,1140992,1,11,1,6,0,100
110144,1140992,1,11,2,0,0,100
110145,1140992,1,11,3,0,0,100
110146,1140992,1,11,4,4,0,104
110147,1140992,1,11,5,1,0,105
110148,1140992,1,11,6,1,0,106
110149,1140992,1,12,1,1,0,107
110150,1140992,1,12,2,1,0,108
110151,1140992,1,12,3,1,0,109
110152,1140992,1,12,4,1,0,110
110153,1140992,1,12,5,1,0,111
110154,1140992,1,12,6,0,0,111
110155,1140992,1,13,1,1,0,112
110156,1140992,1,13,2,1,0,113
110157,1140992,1,13,3,6,0,119
110158,1140992,1,13,4,1,0,120
110159,1140992,1,13,5,0,0,120
110160,1140992,1,13,6,2,0,122
110161,1140992,1,14,1,1,0,123
110162,1140992,1,14,2,0,0,123
110163,1140992,1,14,3,1,0,124
110164,1140992,1,14,4,1,0,125
110165,1140992,1,14,5,4,0,129
110166,1140992,1,14,6,4,0,133
110167,1140992,1,15,1,6,0,139
110168,1140992,1,15,2,1,0,140
110169,1140992,1,15,3,1,0,141
110170,1140992,1,15,4,1,0,142
110171,1140992,1,15,5,6,0,148
110172,1140992,1,15,6,0,0,148
110173,1140992,1,16,1,4,0,152
110174,1140992,1,16,2,1,0,153
110175,1140992,1,16,3,2,0,155
110176,1140992,1,16,4,4,0,159
110177,1140992,1,16,5,1,0,160
110178,1140992,1,16,6,0,1,160
110179,1140992,1,17,1,4,0,164
110180,1140992,1,17,2,4,0,168
110181,1140992,1,17,3,0,0,168
110182,1140992,1,17,4,1,0,169
110183,1140992,1,17,5,4,0,173
110184,1140992,1,17,6,1,0,174
110185,1140992,1,18,1,1,0,175
110186,1140992,1,18,2,2,0,177
110187,1140992,1,18,3,6,0,183
110188,1140992,1,18,4,1,0,184
110189,1140992,1,18,5,2,1,186
110190,1140992,1,18,6,1,0,187
110191,1140992,1,19,1,1,0,188
110192,1140992,1,19,2,4,0,192
110193,1140992,1,19,3,1,0,193
110194,1140992,1,19,4,1,0,194
110195,1140992,1,19,5,1,0,195
110196,1140992,1,19,6,6,0,201
110197,1140992,1,20,1,1,0,202
110198,1140992,1,20,2,0,1,202
110199,1140992,1,20,3,0,1,202
110200,1140992,1,20,4,0,0,202
110201,1140992,1,20,5,0,1,202
110202,1140992,1,20,6,6,0,208
110323,1140993,1,1,1,0,0,0
110324,1140993,1,1,2,1,0,1
110325,1140993,1,1,3,1,0,2
110326,1140993,1,1,4,4,0,6
110327,1140993,1,1,5,5,0,11
110328,1140993,1,1,6,1,0,12
110329,1140993,1,2,1,1,0,13
110330,1140993,1,2,2,0,0,13
110331,1140993,1,2,3,2,0,15
110332,1140993,1,2,4,4,0,19
110333,1140993,1,2,5,0,0,19
110334,1140993,1,2,6,1,0,20
110335,1140993,1,3,1,1,0,21
110336,1140993,1,3,2,0,0,21
110337,1140993,1,3,3,1,0,22
110338,1140993,1,3,4,0,1,22
110339,1140993,1,3,5,1,0,23
110340,1140993,1,3,6,1,0,24
110341,1140993,1,4,1,1,0,25
110342,1140993,1,4,2,1,0,26
110343,1140993,1,4,3,1,0,27
110344,1140993,1,4,4,6,0,33
110345,1140993,1,4,5,0,0,33
110346,1140993,1,4,6,0,0,33
110347,1140993,1,5,1,6,0,39
110348,1140993,1,5,2,0,0,39
110349,1140993,1,5,3,6,0,45
110350,1140993,1,5,4,4,0,49
110351,1140993,1,5,5,1,0,50
110352,1140993,1,5,6,0,0,50
110353,1140993,1,6,1,1,0,51
110354,1140993,1,6,2,0,0,51
110355,1140993,1,6,3,0,0,51
110356,1140993,1,6,4,4,0,55
110357,1140993,1,6,5,1,0,56
110358,1140993,1,6,6,1,0,57
110359,1140993,1,7,1,1,0,58
110360,1140993,1,7,2,1,0,59
110361,1140993,1,7,3,1,0,60
110362,1140993,1,7,4,1,0,61
110363,1140993,1,7,5,1,0,62
110364,1140993,1,7,6,1,0,63
110365,1140993,1,8,1,1,0,64
110366,1140993,1,8,2,6,0,70
110367,1140993,1,8,3,7,0,77
110368,1140993,1,8,4,4,0,81
110369,1140993,1,8,5,1,0,82
110370,1140993,1,8,6,1,0,83
110371,1140993,1,9,1,0,0,83
110372,1140993,1,9,2,1,0,84
110373,1140993,1,9,3,2,0,86
110374,1140993,1,9,4,1,0,87
110375,1140993,1,9,5,1,0,88
110376,1140993,1,9,6,4,0,92
110377,1140993,1,10,1,1,0,93
110378,1140993,1,10,2,4,0,97
110379,1140993,1,10,3,1,0,98
110380,1140993,1,10,4,1,0,99
110381,1140993,1,10,5,0,0,99
110382,1140993,1,10,6,2,0,101
110383,1140993,1,11,1,6,0,107
110384,1140993,1,11,2,1,0,108
110385,1140993,1,11,3,1,0,109
110386,1140993,1,11,4,6,0,115
110387,1140993,1,11,5,2,0,117
110388,1140993,1,11,6,0,0,117
110389,1140993,1,12,1,6,0,123
110390,1140993,1,12,2,1,0,124
110391,1140993,1,12,3,1,0,125
110392,1140993,1,12,4,1,0,126
110393,1140993,1,12,5,1,0,127
110394,1140993,1,12,6,1,0,128
110395,1140993,1,13,1,0,1,128
110396,1140993,1,13,2,0,0,128
110397,1140993,1,13,3,0,1,128
110398,1140993,1,13,4,0,0,128
110399,1140993,1,13,5,1,0,129
110400,1140993,1,13,6,2,0,131
110401,1140993,1,14,1,1,0,132
110402,1140993,1,14,2,0,0,132
110403,1140993,1,14,3,0,0,132
110404,1140993,1,14,4,1,0,133
110405,1140993,1,14,5,1,0,134
110406,1140993,1,14,6,1,0,135
110407,1140993,1,15,1,1,0,136
110408,1140993,1,15,2,1,0,137
110409,1140993,1,15,3,0,0,137
110410,1140993,1,15,4,1,0,138
110411,1140993,1,15,5,5,0,143
110412,1140993,1,15,6,1,0,144
110413,1140993,1,16,1,0,0,144
110414,1140993,1,16,2,6,0,150
110415,1140993,1,16,3,1,0,151
110416,1140993,1,16,4,1,0,152
110417,1140993,1,16,5,4,0,156
110418,1140993,1,16,6,1,0,157
110419,1140993,1,17,1,4,0,161
110420,1140993,1,17,2,2,0,163
110421,1140993,1,17,3,1,0,164
110422,1140993,1,17,4,1,0,165
110423,1140993,1,17,5,1,0,166
110424,1140993,1,17,6,1,0,167
110425,1140993,1,18,1,1,0,168
110426,1140993,1,18,2,1,0,169
110427,1140993,1,18,3,0,1,169
110428,1140993,1,18,4,4,0,173
110429,1140993,1,18,5,1,0,174
110430,1140993,1,18,6,0,0,174
110431,1140993,1,19,1,1,0,175
110432,1140993,1,19,2,1,0,176
110433,1140993,1,19,3,1,0,177
110434,1140993,1,19,4,7,0,184
110435,1140993,1,19,5,6,0,190
110436,1140993,1,19,6,2,0,192
110437,1140993,1,20,1,3,0,195
110438,1140993,1,20,2,1,0,196
110439,1140993,1,20,3,6,0,202
110440,1140993,1,20,4,6,0,208
110441,1140993,1,20,5,4,0,212
110442,1140993,1,20,6,1,0,213
110518,1142501,1,1,1,1,0,1
110519,1142501,1,1,2,1,0,2
110520,1142501,1,1,3,4,0,6
110521,1142501,1,1,4,4,0,10
110522,1142501,1,1,5,1,0,11
110523,1142501,1,1,6,0,0,11
110524,1142501,1,2,1,1,0,12
110525,1142501,1,2,2,5,0,17
110526,1142501,1,2,3,4,0,21
110527,1142501,1,2,4,0,0,21
110528,1142501,1,2,5,1,0,22
110529,1142501,1,2,6,4,0,26
110530,1142501,1,3,1,1,0,27
110531,1142501,1,3,2,0,0,27
110532,1142501,1,3,3,0,1,27
110533,1142501,1,3,4,1,0,28
110534,1142501,1,3,5,0,0,28
110535,1142501,1,3,6,1,0,29
110536,1142501,1,4,1,0,0,29
110537,1142501,1,4,2,0,0,29
110538,1142501,1,4,3,6,0,35
110539,1142501,1,4,4,0,0,35
110540,1142501,1,4,5,1,0,36
110541,1142501,1,4,6,2,0,38
110542,1142501,1,5,1,4,0,42
110543,1142501,1,5,2,1,0,43
110544,1142501,1,5,3,1,0,44
110545,1142501,1,5,4,0,0,44
110546,1142501,1,5,5,1,0,45
110547,1142501,1,5,6,0,0,45
110548,1142501,1,6,1,1,1,46
110549,1142501,1,6,2,0,0,46
110550,1142501,1,6,3,1,0,47
110551,1142501,1,6,4,4,0,51
110552,1142501,1,6,5,1,0,52
110553,1142501,1,6,6,0,0,52
110554,1142501,1,7,1,0,1,52
110555,1142501,1,7,2,0,0,52
110556,1142501,1,7,3,0,1,52
110557,1142501,1,7,4,0,0,52
110558,1142501,1,7,5,1,0,53
110559,1142501,1,7,6,0,0,53
110560,1142501,1,8,1,0,0,53
110561,1142501,1,8,2,1,0,54
110562,1142501,1,8,3,1,0,55
110563,1142501,1,8,4,1,0,56
110564,1142501,1,8,5,1,0,57
110565,1142501,1,8,6,0,0,57
110566,1142501,1,9,1,1,0,58
110567,1142501,1,9,2,0,0,58
110568,1142501,1,9,3,1,0,59
110569,1142501,1,9,4,1,0,60
110570,1142501,1,9,5,0,0,60
110571,1142501,1,9,6,1,0,61
110572,1142501,1,10,1,1,0,62
110573,1142501,1,10,2,0,0,62
110574,1142501,1,10,3,2,0,64
110575,1142501,1,10,4,1,0,65
110576,1142501,1,10,5,0,0,65
110577,1142501,1,10,6,2,0,67
110578,1142501,1,11,1,0,0,67
110579,1142501,1,11,2,1,0,68
110580,1142501,1,11,3,1,0,69
110581,1142501,1,11,4,0,0,69
110582,1142501,1,11,5,1,0,70
110583,1142501,1,11,6,2,0,72
110584,1142501,1,12,1,1,0,73
110585,1142501,1,12,2,0,0,73
110586,1142501,1,12,3,2,0,75
110587,1142501,1,12,4,4,0,79
110588,1142501,1,12,5,2,0,81
110589,1142501,1,12,6,0,0,81
110590,1142501,1,13,1,0,0,81
110591,1142501,1,13,2,4,0,85
110592,1142501,1,13,3,1,0,86
110593,1142501,1,13,4,2,0,88
110594,1142501,1,13,5,0,0,88
110595,1142501,1,13,6,2,0,90
110596,1142501,1,14,1,0,0,90
110597,1142501,1,14,2,2,0,92
110598,1142501,1,14,3,4,0,96
110599,1142501,1,14,4,1,0,97
110600,1142501,1,14,5,1,0,98
110601,1142501,1,14,6,1,0,99
110602,1142501,1,15,1,4,0,103
110603,1142501,1,15,2,4,0,107
110604,1142501,1,15,3,0,0,107
110605,1142501,1,15,4,1,0,108
110606,1142501,1,15,5,4,0,112
110607,1142501,1,15,6,1,0,113
110608,1142501,1,16,1,2,0,115
110609,1142501,1,16,2,1,0,116
110610,1142501,1,16,3,0,1,116
110611,1142501,1,16,4,0,0,116
110612,1142501,1,16,5,0,0,116
110613,1142501,1,16,6,1,0,117
110614,1142501,1,17,1,0,1,117
110615,1142501,1,17,2,1,0,118
110616,1142501,1,17,3,2,0,120
110617,1142501,1,17,4,1,0,121
110618,1142501,1,17,5,1,0,122
110619,1142501,1,17,6,4,0,126
110620,1142501,1,18,1,1,0,127
110621,1142501,1,18,2,1,0,128
110622,1142501,1,18,3,1,0,129
110623,1142501,1,18,4,1,0,130
110624,1142501,1,18,5,1,0,131
110625,1142501,1,18,6,1,0,132
110626,1142501,1,19,1,4,0,136
110627,1142501,1,19,2,0,0,136
110628,1142501,1,19,3,0,1,136
110629,1142501,1,19,4,1,0,137
110630,1142501,1,19,5,1,0,138
110631,1142501,1,19,6,1,1,139
110632,1142501,1,20,1,0,1,139
110633,1142501,1,20,2,1,0,140
110634,1142501,1,20,3,2,0,142
110635,1142501,1,20,4,2,0,144
110636,1142501,1,20,5,0,1,144
110757,1142502,1,1,1,4,0,4
110758,1142502,1,1,2,2,0,6
110759,1142502,1,1,3,4,0,10
110760,1142502,1,1,4,4,0,14
110761,1142502,1,1,5,0,0,14
110762,1142502,1,1,6,0,0,14
110763,1142502,1,2,1,2,0,16
110764,1142502,1,2,2,2,0,18
110765,1142502,1,2,3,2,0,20
110766,1142502,1,2,4,0,0,20
110767,1142502,1,2,5,0,0,20
110768,1142502,1,2,6,0,0,20
110769,1142502,1,3,1,1,0,21
110770,1142502,1,3,2,0,0,21
110771,1142502,1,3,3,4,0,25
110772,1142502,1,3,4,4,0,29
110773,1142502,1,3,5,0,0,29
110774,1142502,1,3,6,6,0,35
110775,1142502,1,4,1,1,0,36
110776,1142502,1,4,2,1,0,37
110777,1142502,1,4,3,4,0,41
110778,1142502,1,4,4,1,0,42
110779,1142502,1,4,5,4,0,46
110780,1142502,1,4,6,4,0,50
110781,1142502,1,5,1,6,0,56
110782,1142502,1,5,2,1,0,57
110783,1142502,1,5,3,0,0,57
110784,1142502,1,5,4,0,0,57
110785,1142502,1,5,5,1,0,58
110786,1142502,1,5,6,0,0,58
110787,1142502,1,6,1,0,1,58
110788,1142502,1,6,2,0,0,58
110789,1142502,1,6,3,1,0,59
110790,1142502,1,6,4,2,0,61
110791,1142502,1,6,5,0,0,61
110792,1142502,1,6,6,0,0,61
110793,1142502,1,7,1,1,0,62
110794,1142502,1,7,2,0,0,62
110795,1142502,1,7,3,0,1,62
110796,1142502,1,7,4,0,0,62
110797,1142502,1,7,5,2,0,64
110798,1142502,1,7,6,1,0,65
110799,1142502,1,8,1,0,0,65
110800,1142502,1,8,2,1,0,66
110801,1142502,1,8,3,1,0,67
110802,1142502,1,8,4,4,0,71
110803,1142502,1,8,5,1,0,72
110804,1142502,1,8,6,3,0,75
110805,1142502,1,9,1,4,0,79
110806,1142502,1,9,2,0,0,79
110807,1142502,1,9,3,0,1,79
110808,1142502,1,9,4,1,0,80
110809,1142502,1,9,5,0,0,80
110810,1142502,1,9,6,2,0,82
110811,1142502,1,10,1,0,0,82
110812,1142502,1,10,2,0,0,82
110813,1142502,1,10,3,0,0,82
110814,1142502,1,10,4,1,0,83
110815,1142502,1,10,5,1,0,84
110816,1142502,1,10,6,0,0,84
110817,1142502,1,11,1,1,0,85
110818,1142502,1,11,2,1,0,86
110819,1142502,1,11,3,4,0,90
110820,1142502,1,11,4,1,0,91
110821,1142502,1,11,5,1,0,92
110822,1142502,1,11,6,0,0,92
110823,1142502,1,12,1,1,0,93
110824,1142502,1,12,2,1,0,94
110825,1142502,1,12,3,1,0,95
110826,1142502,1,12,4,1,0,96
110827,1142502,1,12,5,2,0,98
110828,1142502,1,12,6,0,0,98
110829,1142502,1,13,1,1,0,99
110830,1142502,1,13,2,1,0,100
110831,1142502,1,13,3,1,0,101
110832,1142502,1,13,4,1,0,102
110833,1142502,1,13,5,0,0,102
110834,1142502,1,13,6,1,0,103
110835,1142502,1,14,1,1,0,104
110836,1142502,1,14,2,1,0,105
110837,1142502,1,14,3,0,1,105
110838,1142502,1,14,4,1,0,106
110839,1142502,1,14,5,6,0,112
110840,1142502,1,14,6,4,0,116
110841,1142502,1,15,1,1,0,117
110842,1142502,1,15,2,1,0,118
110843,1142502,1,15,3,2,0,120
110844,1142502,1,15,4,1,0,121
110845,1142502,1,15,5,1,0,122
110846,1142502,1,15,6,1,0,123
110847,1142502,1,16,1,1,0,124
110848,1142502,1,16,2,1,0,125
110849,1142502,1,16,3,0,0,125
110850,1142502,1,16,4,1,0,126
110851,1142502,1,16,5,0,1,126
110852,1142502,1,16,6,1,0,127
110853,1142502,1,17,1,1,0,128
110854,1142502,1,17,2,1,0,129
110855,1142502,1,17,3,1,0,130
110856,1142502,1,17,4,1,0,131
110857,1142502,1,17,5,4,0,135
110858,1142502,1,17,6,1,0,136
110859,1142502,1,18,1,1,0,137
110860,1142502,1,18,2,1,0,138
110861,1142502,1,18,3,0,0,138
110862,1142502,1,18,4,6,0,144
110863,1142502,1,18,5,1,0,145
110864,1142502,1,18,6,0,1,145
110865,1142502,1,19,1,0,0,145
110866,1142502,1,19,2,1,0,146
110867,1142502,1,19,3,1,0,147
110868,1142502,1,19,4,0,0,147
110869,1142502,1,19,5,2,0,149
110870,1142502,1,19,6,1,0,150
110871,1142502,1,20,1,1,0,151
110872,1142502,1,20,2,1,0,152
110873,1142502,1,20,3,4,0,156
110874,1142502,1,20,4,0,0,156
110875,1142502,1,20,5,0,0,156
110876,1142502,1,20,6,2,0,158
110991,1142589,1,1,1,4,0,4
110992,1142589,1,1,2,4,0,8
110993,1142589,1,1,3,0,0,8
110994,1142589,1,1,4,4,0,12
110995,1142589,1,1,5,1,0,13
110996,1142589,1,1,6,0,0,13
110997,1142589,1,2,1,0,0,13
110998,1142589,1,2,2,1,0,14
110999,1142589,1,2,3,0,0,14
111000,1142589,1,2,4,0,0,14
111001,1142589,1,2,5,0,1,14
111002,1142589,1,2,6,0,0,14
111003,1142589,1,3,1,1,0,15
111004,1142589,1,3,2,1,0,16
111005,1142589,1,3,3,1,0,17
111006,1142589,1,3,4,0,0,17
111007,1142589,1,3,5,0,0,17
111008,1142589,1,3,6,1,0,18
111009,1142589,1,4,1,7,0,25
111010,1142589,1,4,2,1,0,26
111011,1142589,1,4,3,4,0,30
111012,1142589,1,4,4,0,1,30
111013,1142589,1,4,5,1,0,31
111014,1142589,1,4,6,0,0,31
111015,1142589,1,5,1,4,0,35
111016,1142589,1,5,2,4,0,39
111017,1142589,1,5,3,1,0,40
111018,1142589,1,5,4,0,0,40
111019,1142589,1,5,5,1,0,41
111020,1142589,1,5,6,1,0,42
111021,1142589,1,6,1,0,0,42
111022,1142589,1,6,2,0,0,42
111023,1142589,1,6,3,0,1,42
111024,1142589,1,6,4,0,0,42
111025,1142589,1,6,5,6,0,48
111026,1142589,1,6,6,0,0,48
111027,1142589,1,7,1,0,0,48
111028,1142589,1,7,2,1,0,49
111029,1142589,1,7,3,0,0,49
111030,1142589,1,7,4,4,0,53
111031,1142589,1,7,5,1,0,54
111032,1142589,1,7,6,0,0,54
111033,1142589,1,8,1,0,0,54
111034,1142589,1,8,2,0,0,54
111035,1142589,1,8,3,1,0,55
111036,1142589,1,8,4,1,0,56
111037,1142589,1,8,5,1,0,57
111038,1142589,1,8,6,0,1,57
111039,1142589,1,9,1,1,0,58
111040,1142589,1,9,2,0,0,58
111041,1142589,1,9,3,1,0,59
111042,1142589,1,9,4,1,0,60
111043,1142589,1,9,5,4,0,64
111044,1142589,1,9,6,0,0,64
111045,1142589,1,10,1,1,0,65
111046,1142589,1,10,2,1,0,66
111047,1142589,1,10,3,1,0,67
111048,1142589,1,10,4,1,0,68
111049,1142589,1,10,5,1,0,69
111050,1142589,1,10,6,0,0,69
111051,1142589,1,11,1,0,1,69
111052,1142589,1,11,2,0,0,69
111053,1142589,1,11,3,0,0,69
111054,1142589,1,11,4,0,1,69
111055,1142589,1,11,5,4,0,73
111056,1142589,1,11,6,0,1,73
111057,1142589,1,12,1,1,0,74
111058,1142589,1,12,2,0,0,74
111059,1142589,1,12,3,2,0,76
111060,1142589,1,12,4,0,0,76
111061,1142589,1,12,5,1,0,77
111062,1142589,1,12,6,1,0,78
111063,1142589,1,13,1,0,0,78
111064,1142589,1,13,2,1,0,79
111065,1142589,1,13,3,4,0,83
111066,1142589,1,13,4,0,0,83
111067,1142589,1,13,5,1,0,84
111068,1142589,1,13,6,0,0,84
111069,1142589,1,14,1,0,0,84
111070,1142589,1,14,2,0,0,84
111071,1142589,1,14,3,0,1,84
111072,1142589,1,14,4,0,0,84
111073,1142589,1,14,5,0,0,84
111074,1142589,1,14,6,1,0,85
111075,1142589,1,15,1,1,0,86
111076,1142589,1,15,2,1,0,87
111077,1142589,1,15,3,0,0,87
111078,1142589,1,15,4,1,0,88
111079,1142589,1,15,5,1,0,89
111080,1142589,1,15,6,0,0,89
111081,1142589,1,16,1,1,0,90
111082,1142589,1,16,2,1,0,91
111083,1142589,1,16,3,1,0,92
111084,1142589,1,16,4,1,0,93
111085,1142589,1,16,5,0,0,93
111086,1142589,1,16,6,0,1,93
111087,1142589,1,17,1,4,0,97
111088,1142589,1,17,2,1,0,98
111089,1142589,1,17,3,0,0,98
111090,1142589,1,17,4,0,1,98
111187,1142913,1,1,1,0,0,0
111188,1142913,1,1,2,6,0,6
111189,1142913,1,1,3,0,0,6
111190,1142913,1,1,4,0,0,6
111191,1142913,1,1,5,0,0,6
111192,1142913,1,1,6,0,0,6
111193,1142913,1,2,1,0,0,6
111194,1142913,1,2,2,3,0,9
111195,1142913,1,2,3,1,0,10
111196,1142913,1,2,4,2,0,12
111197,1142913,1,2,5,1,0,13
111198,1142913,1,2,6,0,1,13
111199,1142913,1,3,1,1,0,14
111200,1142913,1,3,2,0,0,14
111201,1142913,1,3,3,0,0,14
111202,1142913,1,3,4,1,0,15
111203,1142913,1,3,5,1,0,16
111204,1142913,1,3,6,1,0,17
111205,1142913,1,4,1,0,0,17
111206,1142913,1,4,2,0,0,17
111207,1142913,1,4,3,6,0,23
111208,1142913,1,4,4,4,0,27
111209,1142913,1,4,5,0,0,27
111210,1142913,1,4,6,0,0,27
111211,1142913,1,5,1,4,0,31
111212,1142913,1,5,2,2,0,33
111213,1142913,1,5,3,0,0,33
111214,1142913,1,5,4,1,0,34
111215,1142913,1,5,5,0,0,34
111216,1142913,1,5,6,6,0,40
111217,1142913,1,6,1,0,0,40
111218,1142913,1,6,2,0,0,40
111219,1142913,1,6,3,1,0,41
111220,1142913,1,6,4,1,0,42
111221,1142913,1,6,5,0,0,42
111222,1142913,1,6,6,0,0,42
111223,1142913,1,7,1,2,0,44
111224,1142913,1,7,2,0,1,44
111225,1142913,1,7,3,1,0,45
111226,1142913,1,7,4,2,0,47
111227,1142913,1,7,5,1,0,48
111228,1142913,1,7,6,1,0,49
111229,1142913,1,8,1,2,0,51
111230,1142913,1,8,2,0,0,51
111231,1142913,1,8,3,0,0,51
111232,1142913,1,8,4,1,0,52
111233,1142913,1,8,5,4,0,56
111234,1142913,1,8,6,2,0,58
111235,1142913,1,9,1,1,0,59
111236,1142913,1,9,2,1,0,60
111237,1142913,1,9,3,2,0,62
111238,1142913,1,9,4,1,0,63
111239,1142913,1,9,5,2,0,65
111240,1142913,1,9,6,0,0,65
111241,1142913,1,10,1,0,0,65
111242,1142913,1,10,2,4,0,69
111243,1142913,1,10,3,4,0,73
111244,1142913,1,10,4,5,0,78
111245,1142913,1,10,5,0,0,78
111246,1142913,1,10,6,0,1,78
111247,1142913,1,11,1,0,0,78
111248,1142913,1,11,2,0,0,78
111249,1142913,1,11,3,1,0,79
111250,1142913,1,11,4,2,0,81
111251,1142913,1,11,5,0,0,81
111252,1142913,1,11,6,0,0,81
111253,1142913,1,12,1,1,0,82
111254,1142913,1,12,2,1,0,83
111255,1142913,1,12,3,6,0,89
111256,1142913,1,12,4,1,0,90
111257,1142913,1,12,5,4,0,94
111258,1142913,1,12,6,3,0,97
111259,1142913,1,13,1,4,0,101
111260,1142913,1,13,2,1,0,102
111261,1142913,1,13,3,1,0,103
111262,1142913,1,13,4,1,0,104
111263,1142913,1,13,5,2,0,106
111264,1142913,1,13,6,3,0,109
111265,1142913,1,14,1,4,0,113
111266,1142913,1,14,2,1,0,114
111267,1142913,1,14,3,1,0,115
111268,1142913,1,14,4,1,0,116
111269,1142913,1,14,5,0,0,116
111270,1142913,1,14,6,1,0,117
111271,1142913,1,15,1,1,0,118
111272,1142913,1,15,2,2,0,120
111273,1142913,1,15,3,0,0,120
111274,1142913,1,15,4,0,1,120
111275,1142913,1,15,5,0,0,120
111276,1142913,1,15,6,1,0,121
111277,1142913,1,16,1,0,0,121
111278,1142913,1,16,2,1,0,122
111279,1142913,1,16,3,2,0,124
111280,1142913,1,16,4,1,0,125
111281,1142913,1,16,5,6,0,131
111282,1142913,1,16,6,6,0,137
111283,1142913,1,17,1,1,0,138
111284,1142913,1,17,2,0,0,138
111285,1142913,1,17,3,0,0,138
111286,1142913,1,17,4,0,0,138
111287,1142913,1,17,5,1,0,139
111288,1142913,1,17,6,0,0,139
111289,1142913,1,18,1,4,0,143
111290,1142913,1,18,2,1,0,144
111291,1142913,1,18,3,1,0,145
111292,1142913,1,18,4,1,0,146
111293,1142913,1,18,5,2,0,148
111294,1142913,1,18,6,6,0,154
111295,1142913,1,19,1,6,0,160
111296,1142913,1,19,2,0,0,160
111297,1142913,1,19,3,3,0,163
111298,1142913,1,19,4,2,0,165
111299,1142913,1,19,5,1,0,166
111300,1142913,1,19,6,2,0,168
111301,1142913,1,20,1,2,0,170
111302,1142913,1,20,2,0,0,170
111303,1142913,1,20,3,2,0,172
111304,1142913,1,20,4,1,0,173
111305,1142913,1,20,5,6,0,179
111306,1142913,1,20,6,3,0,182
111414,1142914,1,1,1,0,0,0
111415,1142914,1,1,2,0,0,0
111416,1142914,1,1,3,0,1,0
111417,1142914,1,1,4,0,0,0
111418,1142914,1,1,5,0,0,0
111419,1142914,1,1,6,1,0,1
111420,1142914,1,2,1,0,0,1
111421,1142914,1,2,2,4,0,5
111422,1142914,1,2,3,4,0,9
111423,1142914,1,2,4,0,0,9
111424,1142914,1,2,5,1,0,10
111425,1142914,1,2,6,1,0,11
111426,1142914,1,3,1,0,0,11
111427,1142914,1,3,2,0,0,11
111428,1142914,1,3,3,1,0,12
111429,1142914,1,3,4,0,0,12
111430,1142914,1,3,5,0,1,12
111431,1142914,1,3,6,2,0,14
111432,1142914,1,4,1,0,0,14
111433,1142914,1,4,2,0,0,14
111434,1142914,1,4,3,0,0,14
111435,1142914,1,4,4,4,0,18
111436,1142914,1,4,5,0,0,18
111437,1142914,1,4,6,0,0,18
111438,1142914,1,5,1,0,0,18
111439,1142914,1,5,2,1,0,19
111440,1142914,1,5,3,0,1,19
111441,1142914,1,5,4,0,0,19
111442,1142914,1,5,5,0,0,19
111443,1142914,1,5,6,0,0,19
111444,1142914,1,6,1,1,0,20
111445,1142914,1,6,2,0,0,20
111446,1142914,1,6,3,2,0,22
111447,1142914,1,6,4,0,0,22
111448,1142914,1,6,5,0,0,22
111449,1142914,1,6,6,1,0,23
111450,1142914,1,7,1,1,0,24
111451,1142914,1,7,2,0,1,24
111452,1142914,1,7,3,1,0,25
111453,1142914,1,7,4,0,0,25
111454,1142914,1,7,5,1,0,26
111455,1142914,1,7,6,0,0,26
111456,1142914,1,8,1,1,0,27
111457,1142914,1,8,2,1,0,28
111458,1142914,1,8,3,1,0,29
111459,1142914,1,8,4,1,0,30
111460,1142914,1,8,5,0,0,30
111461,1142914,1,8,6,1,0,31
111462,1142914,1,9,1,1,0,32
111463,1142914,1,9,2,1,0,33
111464,1142914,1,9,3,1,0,34
111465,1142914,1,9,4,4,0,38
111466,1142914,1,9,5,1,0,39
111467,1142914,1,9,6,6,0,45
111468,1142914,1,10,1,1,0,46
111469,1142914,1,10,2,0,0,46
111470,1142914,1,10,3,0,0,46
111471,1142914,1,10,4,1,1,47
111472,1142914,1,10,5,2,0,49
111473,1142914,1,10,6,1,0,50
111474,1142914,1,11,1,0,0,50
111475,1142914,1,11,2,1,0,51
111476,1142914,1,11,3,2,0,53
111477,1142914,1,11,4,1,0,54
111478,1142914,1,11,5,1,0,55
111479,1142914,1,11,6,0,0,55
111480,1142914,1,12,1,6,0,61
111481,1142914,1,12,2,0,0,61
111482,1142914,1,12,3,0,1,61
111483,1142914,1,12,4,0,0,61
111484,1142914,1,12,5,2,0,63
111485,1142914,1,12,6,0,0,63
111486,1142914,1,13,1,1,0,64
111487,1142914,1,13,2,0,0,64
111488,1142914,1,13,3,1,0,65
111489,1142914,1,13,4,0,0,65
111490,1142914,1,13,5,1,0,66
111491,1142914,1,13,6,0,0,66
111492,1142914,1,14,1,0,0,66
111493,1142914,1,14,2,1,0,67
111494,1142914,1,14,3,1,0,68
111495,1142914,1,14,4,1,0,69
111496,1142914,1,14,5,0,0,69
111497,1142914,1,14,6,0,0,69
111498,1142914,1,15,1,0,0,69
111499,1142914,1,15,2,1,0,70
111500,1142914,1,15,3,0,0,70
111501,1142914,1,15,4,6,0,76
111502,1142914,1,15,5,4,0,80
111503,1142914,1,15,6,4,0,84
111504,1142914,1,16,1,1,0,85
111505,1142914,1,16,2,1,0,86
111506,1142914,1,16,3,1,0,87
111507,1142914,1,16,4,1,0,88
111508,1142914,1,16,5,2,0,90
111509,1142914,1,16,6,0,0,90
111510,1142914,1,17,1,1,0,91
111511,1142914,1,17,2,1,0,92
111512,1142914,1,17,3,0,1,92
111513,1142914,1,17,4,1,0,93
111514,1142914,1,17,5,0,0,93
111515,1142914,1,17,6,0,0,93
111516,1142914,1,18,1,1,0,94
111517,1142914,1,18,2,1,0,95
111518,1142914,1,18,3,4,0,99
111519,1142914,1,18,4,1,0,100
111520,1142914,1,18,5,1,0,101
111521,1142914,1,18,6,2,0,103
111522,1142914,1,19,1,0,0,103
111523,1142914,1,19,2,0,0,103
111524,1142914,1,19,3,1,0,104
111525,1142914,1,19,4,1,0,105
111526,1142914,1,19,5,3,0,108
111527,1142914,1,19,6,0,0,108
111528,1142914,1,20,1,6,0,114
111529,1142914,1,20,2,0,1,114
111530,1142914,1,20,3,1,0,115
111531,1142914,1,20,4,1,1,116
111532,1142914,1,20,5,0,1,116
111598,1142915,1,1,1,1,0,1
111599,1142915,1,1,2,1,0,2
111600,1142915,1,1,3,1,0,3
111601,1142915,1,1,4,2,0,5
111602,1142915,1,1,5,1,0,6
111603,1142915,1,1,6,2,0,8
111604,1142915,1,2,1,0,0,8
111605,1142915,1,2,2,0,0,8
111606,1142915,1,2,3,1,0,9
111607,1142915,1,2,4,4,0,13
111608,1142915,1,2,5,0,0,13
111609,1142915,1,2,6,1,0,14
111610,1142915,1,3,1,4,0,18
111611,1142915,1,3,2,4,0,22
111612,1142915,1,3,3,4,0,26
111613,1142915,1,3,4,1,0,27
111614,1142915,1,3,5,0,0,27
111615,1142915,1,3,6,4,0,31
111616,1142915,1,4,1,0,0,31
111617,1142915,1,4,2,6,0,37
111618,1142915,1,4,3,0,0,37
111619,1142915,1,4,4,1,0,38
111620,1142915,1,4,5,1,0,39
111621,1142915,1,4,6,1,0,40
111622,1142915,1,5,1,4,0,44
111623,1142915,1,5,2,4,0,48
111624,1142915,1,5,3,6,0,54
111625,1142915,1,5,4,1,0,55
111626,1142915,1,5,5,1,0,56
111627,1142915,1,5,6,4,0,60
111628,1142915,1,6,1,4,0,64
111629,1142915,1,6,2,0,0,64
111630,1142915,1,6,3,6,0,70
111631,1142915,1,6,4,4,0,74
111632,1142915,1,6,5,1,0,75
111633,1142915,1,6,6,0,0,75
111634,1142915,1,7,1,1,0,76
111635,1142915,1,7,2,0,0,76
111636,1142915,1,7,3,2,0,78
111637,1142915,1,7,4,0,0,78
111638,1142915,1,7,5,0,0,78
111639,1142915,1,7,6,1,0,79
111640,1142915,1,8,1,0,0,79
111641,1142915,1,8,2,1,0,80
111642,1142915,1,8,3,6,0,86
111643,1142915,1,8,4,4,0,90
111644,1142915,1,8,5,2,0,92
111645,1142915,1,8,6,1,0,93
111646,1142915,1,9,1,1,0,94
111647,1142915,1,9,2,0,0,94
111648,1142915,1,9,3,1,0,95
111649,1142915,1,9,4,1,0,96
111650,1142915,1,9,5,0,0,96
111651,1142915,1,9,6,0,0,96
111652,1142915,1,10,1,1,0,97
111653,1142915,1,10,2,1,0,98
111654,1142915,1,10,3,2,0,100
111655,1142915,1,10,4,4,0,104
111656,1142915,1,10,5,1,0,105
111657,1142915,1,10,6,1,0,106
111658,1142915,1,11,1,0,0,106
111659,1142915,1,11,2,0,0,106
111660,1142915,1,11,3,1,0,107
111661,1142915,1,11,4,1,0,108
111662,1142915,1,11,5,1,0,109
111663,1142915,1,11,6,1,0,110
111664,1142915,1,12,1,2,0,112
111665,1142915,1,12,2,0,0,112
111666,1142915,1,12,3,2,0,114
111667,1142915,1,12,4,0,0,114
111668,1142915,1,12,5,4,0,118
111669,1142915,1,12,6,1,0,119
111670,1142915,1,13,1,0,0,119
111671,1142915,1,13,2,1,0,120
111672,1142915,1,13,3,1,0,121
111673,1142915,1,13,4,0,0,121
111674,1142915,1,13,5,6,0,127
111675,1142915,1,13,6,0,0,127
111676,1142915,1,14,1,6,0,133
111677,1142915,1,14,2,1,0,134
111678,1142915,1,14,3,1,0,135
111679,1142915,1,14,4,6,0,141
111680,1142915,1,14,5,1,0,142
111681,1142915,1,14,6,1,0,143
111682,1142915,1,15,1,6,0,149
111683,1142915,1,15,2,1,0,150
111684,1142915,1,15,3,4,0,154
111685,1142915,1,15,4,1,0,155
111686,1142915,1,15,5,6,0,161
111687,1142915,1,15,6,2,0,163
111688,1142915,1,16,1,1,0,164
111689,1142915,1,16,2,4,0,168
111690,1142915,1,16,3,6,0,174
111691,1142915,1,16,4,4,0,178
111692,1142915,1,16,5,4,0,182
111693,1142915,1,16,6,2,0,184
111694,1142915,1,17,1,1,0,185
111695,1142915,1,17,2,2,0,187
111696,1142915,1,17,3,4,0,191
111697,1142915,1,17,4,0,0,191
111698,1142915,1,17,5,0,0,191
111699,1142915,1,17,6,1,0,192
111700,1142915,1,18,1,0,0,192
111701,1142915,1,18,2,1,0,193
111702,1142915,1,18,3,1,0,194
111703,1142915,1,18,4,1,0,195
111704,1142915,1,18,5,1,0,196
111705,1142915,1,18,6,4,0,200
111706,1142915,1,19,1,4,0,204
111707,1142915,1,19,2,4,0,208
111708,1142915,1,19,3,6,0,214
111709,1142915,1,19,4,6,0,220
111710,1142915,1,19,5,1,0,221
111711,1142915,1,19,6,0,0,221
111712,1142915,1,20,1,1,0,222
111713,1142915,1,20,2,1,1,223
111714,1142915,1,20,3,2,0,225
111715,1142915,1,20,4,2,0,227
111716,1142915,1,20,5,2,1,229
111717,1142915,1,20,6,0,0,229
111838,1142916,1,1,1,1,0,1
111839,1142916,1,1,2,1,0,2
111840,1142916,1,1,3,0,0,2
111841,1142916,1,1,4,6,0,8
111842,1142916,1,1,5,0,0,8
111843,1142916,1,1,6,4,0,12
111844,1142916,1,2,1,1,0,13
111845,1142916,1,2,2,0,0,13
111846,1142916,1,2,3,0,0,13
111847,1142916,1,2,4,0,0,13
111848,1142916,1,2,5,0,0,13
111849,1142916,1,2,6,1,0,14
111850,1142916,1,3,1,4,0,18
111851,1142916,1,3,2,0,0,18
111852,1142916,1,3,3,0,0,18
111853,1142916,1,3,4,4,0,22
111854,1142916,1,3,5,1,0,23
111855,1142916,1,3,6,1,0,24
111856,1142916,1,4,1,0,0,24
111857,1142916,1,4,2,4,0,28
111858,1142916,1,4,3,0,0,28
111859,1142916,1,4,4,0,0,28
111860,1142916,1,4,5,1,0,29
111861,1142916,1,4,6,0,0,29
111862,1142916,1,5,1,4,0,33
111863,1142916,1,5,2,2,0,35
111864,1142916,1,5,3,2,0,37
111865,1142916,1,5,4,0,0,37
111866,1142916,1,5,5,1,0,38
111867,1142916,1,5,6,0,0,38
111868,1142916,1,6,1,0,0,38
111869,1142916,1,6,2,0,0,38
111870,1142916,1,6,3,0,0,38
111871,1142916,1,6,4,1,0,39
111872,1142916,1,6,5,1,0,40
111873,1142916,1,6,6,6,0,46
111874,1142916,1,7,1,0,0,46
111875,1142916,1,7,2,0,0,46
111876,1142916,1,7,3,0,0,46
111877,1142916,1,7,4,0,0,46
111878,1142916,1,7,5,1,0,47
111879,1142916,1,7,6,0,0,47
111880,1142916,1,8,1,1,0,48
111881,1142916,1,8,2,1,0,49
111882,1142916,1,8,3,0,0,49
111883,1142916,1,8,4,0,1,49
111884,1142916,1,8,5,0,0,49
111885,1142916,1,8,6,0,0,49
111886,1142916,1,9,1,0,0,49
111887,1142916,1,9,2,1,0,50
111888,1142916,1,9,3,1,0,51
111889,1142916,1,9,4,4,0,55
111890,1142916,1,9,5,0,0,55
111891,1142916,1,9,6,0,0,55
111892,1142916,1,10,1,1,0,56
111893,1142916,1,10,2,6,0,62
111894,1142916,1,10,3,2,0,64
111895,1142916,1,10,4,0,0,64
111896,1142916,1,10,5,7,0,71
111897,1142916,1,10,6,1,0,72
111898,1142916,1,11,1,0,0,72
111899,1142916,1,11,2,6,0,78
111900,1142916,1,11,3,4,0,82
111901,1142916,1,11,4,0,0,82
111902,1142916,1,11,5,0,0,82
111903,1142916,1,11,6,0,0,82
111904,1142916,1,12,1,0,1,82
111905,1142916,1,12,2,1,0,83
111906,1142916,1,12,3,0,0,83
111907,1142916,1,12,4,4,0,87
111908,1142916,1,12,5,4,0,91
111909,1142916,1,12,6,1,0,92
111910,1142916,1,13,1,1,0,93
111911,1142916,1,13,2,4,0,97
111912,1142916,1,13,3,2,0,99
111913,1142916,1,13,4,1,0,100
111914,1142916,1,13,5,1,0,101
111915,1142916,1,13,6,1,0,102
111916,1142916,1,14,1,1,0,103
111917,1142916,1,14,2,2,0,105
111918,1142916,1,14,3,1,0,106
111919,1142916,1,14,4,1,0,107
111920,1142916,1,14,5,0,0,107
111921,1142916,1,14,6,2,0,109
111922,1142916,1,15,1,1,0,110
111923,1142916,1,15,2,6,0,116
111924,1142916,1,15,3,0,0,116
111925,1142916,1,15,4,0,0,116
111926,1142916,1,15,5,2,0,118
111927,1142916,1,15,6,0,0,118
111928,1142916,1,16,1,1,0,119
111929,1142916,1,16,2,1,0,120
111930,1142916,1,16,3,0,0,120
111931,1142916,1,16,4,1,0,121
111932,1142916,1,16,5,6,0,127
111933,1142916,1,16,6,1,0,128
111934,1142916,1,17,1,2,0,130
111935,1142916,1,17,2,0,0,130
111936,1142916,1,17,3,0,0,130
111937,1142916,1,17,4,1,0,131
111938,1142916,1,17,5,0,0,131
111939,1142916,1,17,6,1,0,132
111940,1142916,1,18,1,4,0,136
111941,1142916,1,18,2,4,0,140
111942,1142916,1,18,3,1,0,141
111943,1142916,1,18,4,0,0,141
111944,1142916,1,18,5,2,0,143
111945,1142916,1,18,6,1,0,144
111946,1142916,1,19,1,2,0,146
111947,1142916,1,19,2,0,1,146
111948,1142916,1,19,3,2,0,148
111949,1142916,1,19,4,2,0,150
111950,1142916,1,19,5,2,0,152
111951,1142916,1,19,6,2,0,154
111952,1142916,1,20,1,1,0,155
111953,1142916,1,20,2,4,0,159
111954,1142916,1,20,3,2,0,161
111955,1142916,1,20,4,0,0,161
111956,1142916,1,20,5,0,1,161
111957,1142916,1,20,6,1,0,162
112073,1142917,1,1,1,4,0,4
112074,1142917,1,1,2,0,0,4
112075,1142917,1,1,3,0,0,4
112076,1142917,1,1,4,0,0,4
112077,1142917,1,1,5,0,0,4
112078,1142917,1,1,6,4,0,8
112079,1142917,1,2,1,0,1,8
112080,1142917,1,2,2,0,0,8
112081,1142917,1,2,3,1,0,9
112082,1142917,1,2,4,0,0,9
112083,1142917,1,2,5,1,0,10
112084,1142917,1,2,6,0,0,10
112085,1142917,1,3,1,4,0,14
112086,1142917,1,3,2,4,0,18
112087,1142917,1,3,3,4,0,22
112088,1142917,1,3,4,1,0,23
112089,1142917,1,3,5,0,0,23
112090,1142917,1,3,6,0,0,23
112091,1142917,1,4,1,4,0,27
112092,1142917,1,4,2,1,0,28
112093,1142917,1,4,3,4,0,32
112094,1142917,1,4,4,2,0,34
112095,1142917,1,4,5,5,0,39
112096,1142917,1,4,6,1,0,40
112097,1142917,1,5,1,1,0,41
112098,1142917,1,5,2,0,0,41
112099,1142917,1,5,3,1,0,42
112100,1142917,1,5,4,0,0,42
112101,1142917,1,5,5,0,0,42
112102,1142917,1,5,6,1,0,43
112103,1142917,1,6,1,4,0,47
112104,1142917,1,6,2,1,0,48
112105,1142917,1,6,3,0,0,48
112106,1142917,1,6,4,1,0,49
112107,1142917,1,6,5,0,0,49
112108,1142917,1,6,6,2,0,51
112109,1142917,1,7,1,1,0,52
112110,1142917,1,7,2,0,0,52
112111,1142917,1,7,3,0,0,52
112112,1142917,1,7,4,2,0,54
112113,1142917,1,7,5,4,0,58
112114,1142917,1,7,6,0,0,58
112115,1142917,1,8,1,0,0,58
112116,1142917,1,8,2,0,0,58
112117,1142917,1,8,3,4,0,62
112118,1142917,1,8,4,6,0,68
112119,1142917,1,8,5,2,0,70
112120,1142917,1,8,6,1,0,71
112121,1142917,1,9,1,1,0,72
112122,1142917,1,9,2,1,0,73
112123,1142917,1,9,3,1,0,74
112124,1142917,1,9,4,6,0,80
112125,1142917,1,9,5,0,0,80
112126,1142917,1,9,6,0,1,80
112127,1142917,1,10,1,0,0,80
112128,1142917,1,10,2,0,0,80
112129,1142917,1,10,3,1,0,81
112130,1142917,1,10,4,0,0,81
112131,1142917,1,10,5,0,0,81
112132,1142917,1,10,6,0,0,81
112133,1142917,1,11,1,1,0,82
112134,1142917,1,11,2,4,0,86
112135,1142917,1,11,3,1,0,87
112136,1142917,1,11,4,6,0,93
112137,1142917,1,11,5,1,0,94
112138,1142917,1,11,6,1,0,95
112139,1142917,1,12,1,0,0,95
112140,1142917,1,12,2,2,0,97
112141,1142917,1,12,3,0,0,97
112142,1142917,1,12,4,0,0,97
112143,1142917,1,12,5,6,0,103
112144,1142917,1,12,6,0,0,103
112145,1142917,1,13,1,0,0,103
112146,1142917,1,13,2,2,0,105
112147,1142917,1,13,3,1,0,106
112148,1142917,1,13,4,1,1,107
112149,1142917,1,13,5,1,0,108
112150,1142917,1,13,6,6,0,114
112151,1142917,1,14,1,0,0,114
112152,1142917,1,14,2,2,0,116
112153,1142917,1,14,3,6,0,122
112154,1142917,1,14,4,1,0,123
112155,1142917,1,14,5,4,0,127
112156,1142917,1,14,6,1,0,128
112157,1142917,1,15,1,4,0,132
112158,1142917,1,15,2,0,1,132
112159,1142917,1,15,3,1,0,133
112160,1142917,1,15,4,0,0,133
112161,1142917,1,15,5,0,0,133
112162,1142917,1,15,6,1,0,134
112163,1142917,1,16,1,2,0,136
112164,1142917,1,16,2,0,0,136
112165,1142917,1,16,3,2,0,138
112166,1142917,1,16,4,1,0,139
112167,1142917,1,16,5,0,0,139
112168,1142917,1,16,6,2,0,141
112169,1142917,1,17,1,1,0,142
112170,1142917,1,17,2,4,0,146
112171,1142917,1,17,3,0,0,146
112172,1142917,1,17,4,4,0,150
112173,1142917,1,17,5,4,0,154
112174,1142917,1,17,6,2,0,156
112175,1142917,1,18,1,1,0,157
112176,1142917,1,18,2,1,0,158
112177,1142917,1,18,3,0,1,158
112178,1142917,1,18,4,1,0,159
112179,1142917,1,18,5,0,0,159
112180,1142917,1,18,6,0,0,159
112181,1142917,1,19,1,6,0,165
112182,1142917,1,19,2,4,0,169
112183,1142917,1,19,3,4,0,173
112184,1142917,1,19,4,2,0,175
112185,1142917,1,19,5,1,0,176
112186,1142917,1,19,6,0,1,176
112187,1142917,1,20,1,1,0,177
112188,1142917,1,20,2,6,0,183
112189,1142917,1,20,3,1,0,184
112190,1142917,1,20,4,6,0,190
112191,1142917,1,20,5,0,1,190
112192,1142917,1,20,6,4,0,194
112313,1142918,1,1,1,0,1,0
112314,1142918,1,1,2,0,0,0
112315,1142918,1,1,3,0,0,0
112316,1142918,1,1,4,0,0,0
112317,1142918,1,1,5,0,0,0
112318,1142918,1,1,6,0,0,0
112319,1142918,1,2,1,1,0,1
112320,1142918,1,2,2,0,0,1
112321,1142918,1,2,3,1,0,2
112322,1142918,1,2,4,0,0,2
112323,1142918,1,2,5,1,0,3
112324,1142918,1,2,6,1,0,4
112325,1142918,1,3,1,4,0,8
112326,1142918,1,3,2,1,0,9
112327,1142918,1,3,3,0,0,9
112328,1142918,1,3,4,0,0,9
112329,1142918,1,3,5,4,0,13
112330,1142918,1,3,6,1,0,14
112331,1142918,1,4,1,1,0,15
112332,1142918,1,4,2,6,0,21
112333,1142918,1,4,3,0,1,21
112334,1142918,1,4,4,5,0,26
112335,1142918,1,4,5,0,0,26
112336,1142918,1,4,6,0,0,26
112337,1142918,1,5,1,1,0,27
112338,1142918,1,5,2,1,0,28
112339,1142918,1,5,3,0,0,28
112340,1142918,1,5,4,1,0,29
112341,1142918,1,5,5,1,0,30
112342,1142918,1,5,6,4,0,34
112343,1142918,1,6,1,0,0,34
112344,1142918,1,6,2,4,0,38
112345,1142918,1,6,3,0,0,38
112346,1142918,1,6,4,6,0,44
112347,1142918,1,6,5,0,1,44
112348,1142918,1,6,6,0,0,44
112349,1142918,1,7,1,0,0,44
112350,1142918,1,7,2,1,0,45
112351,1142918,1,7,3,0,0,45
112352,1142918,1,7,4,1,0,46
112353,1142918,1,7,5,2,0,48
112354,1142918,1,7,6,1,0,49
112355,1142918,1,8,1,0,0,49
112356,1142918,1,8,2,1,0,50
112357,1142918,1,8,3,0,0,50
112358,1142918,1,8,4,1,0,51
112359,1142918,1,8,5,1,0,52
112360,1142918,1,8,6,1,0,53
112361,1142918,1,9,1,1,0,54
112362,1142918,1,9,2,0,0,54
112363,1142918,1,9,3,2,0,56
112364,1142918,1,9,4,1,0,57
112365,1142918,1,9,5,1,0,58
112366,1142918,1,9,6,0,0,58
112367,1142918,1,10,1,1,0,59
112368,1142918,1,10,2,3,0,62
112369,1142918,1,10,3,1,0,63
112370,1142918,1,10,4,0,0,63
112371,1142918,1,10,5,1,0,64
112372,1142918,1,10,6,1,0,65
112373,1142918,1,11,1,1,0,66
112374,1142918,1,11,2,0,0,66
112375,1142918,1,11,3,0,0,66
112376,1142918,1,11,4,0,0,66
112377,1142918,1,11,5,2,0,68
112378,1142918,1,11,6,1,0,69
112379,1142918,1,12,1,0,0,69
112380,1142918,1,12,2,0,0,69
112381,1142918,1,12,3,0,0,69
112382,1142918,1,12,4,1,0,70
112383,1142918,1,12,5,0,0,70
112384,1142918,1,12,6,0,0,70
112385,1142918,1,13,1,2,0,72
112386,1142918,1,13,2,3,0,75
112387,1142918,1,13,3,0,0,75
112388,1142918,1,13,4,2,0,77
112389,1142918,1,13,5,2,0,79
112390,1142918,1,13,6,0,0,79
112391,1142918,1,14,1,6,0,85
112392,1142918,1,14,2,4,0,89
112393,1142918,1,14,3,4,0,93
112394,1142918,1,14,4,1,0,94
112395,1142918,1,14,5,4,0,98
112396,1142918,1,14,6,0,0,98
112397,1142918,1,15,1,1,0,99
112398,1142918,1,15,2,0,0,99
112399,1142918,1,15,3,1,0,100
112400,1142918,1,15,4,1,0,101
112401,1142918,1,15,5,4,0,105
112402,1142918,1,15,6,6,0,111
112403,1142918,1,16,1,0,0,111
112404,1142918,1,16,2,1,0,112
112405,1142918,1,16,3,0,1,112
112406,1142918,1,16,4,0,0,112
112407,1142918,1,16,5,1,0,113
112408,1142918,1,16,6,1,0,114
112409,1142918,1,17,1,1,0,115
112410,1142918,1,17,2,1,0,116
112411,1142918,1,17,3,0,0,116
112412,1142918,1,17,4,0,1,116
112413,1142918,1,17,5,4,0,120
112414,1142918,1,17,6,6,0,126
112415,1142918,1,18,1,1,0,127
112416,1142918,1,18,2,0,0,127
112417,1142918,1,18,3,1,0,128
112418,1142918,1,18,4,6,0,134
112419,1142918,1,18,5,4,0,138
112420,1142918,1,18,6,1,0,139
112421,1142918,1,19,1,1,0,140
112422,1142918,1,19,2,1,0,141
112423,1142918,1,19,3,0,1,141
112424,1142918,1,19,4,0,0,141
112425,1142918,1,19,5,1,1,142
112426,1142918,1,19,6,0,1,142
112427,1142918,1,20,1,4,0,146
112428,1142918,1,20,2,1,0,147
112429,1142918,1,20,3,2,0,149
112430,1142918,1,20,4,1,0,150
112431,1142918,1,20,5,1,0,151
112432,1142918,1,20,6,0,1,151
112552,1142919,1,1,1,4,0,4
112553,1142919,1,1,2,0,0,4
112554,1142919,1,1,3,4,0,8
112555,1142919,1,1,4,0,0,8
112556,1142919,1,1,5,0,0,8
112557,1142919,1,1,6,0,0,8
112558,1142919,1,2,1,3,0,11
112559,1142919,1,2,2,0,0,11
112560,1142919,1,2,3,0,0,11
112561,1142919,1,2,4,0,0,11
112562,1142919,1,2,5,1,0,12
112563,1142919,1,2,6,1,0,13
112564,1142919,1,3,1,2,0,15
112565,1142919,1,3,2,1,0,16
112566,1142919,1,3,3,4,0,20
112567,1142919,1,3,4,1,0,21
112568,1142919,1,3,5,1,0,22
112569,1142919,1,3,6,0,0,22
112570,1142919,1,4,1,0,0,22
112571,1142919,1,4,2,1,0,23
112572,1142919,1,4,3,0,0,23
112573,1142919,1,4,4,2,0,25
112574,1142919,1,4,5,0,0,25
112575,1142919,1,4,6,4,0,29
112576,1142919,1,5,1,4,0,33
112577,1142919,1,5,2,0,0,33
112578,1142919,1,5,3,0,0,33
112579,1142919,1,5,4,1,0,34
112580,1142919,1,5,5,2,0,36
112581,1142919,1,5,6,2,0,38
112582,1142919,1,6,1,6,0,44
112583,1142919,1,6,2,1,0,45
112584,1142919,1,6,3,1,0,46
112585,1142919,1,6,4,2,0,48
112586,1142919,1,6,5,6,0,54
112587,1142919,1,6,6,0,0,54
112588,1142919,1,7,1,1,0,55
112589,1142919,1,7,2,1,0,56
112590,1142919,1,7,3,6,0,62
112591,1142919,1,7,4,4,0,66
112592,1142919,1,7,5,1,0,67
112593,1142919,1,7,6,1,0,68
112594,1142919,1,8,1,2,0,70
112595,1142919,1,8,2,4,0,74
112596,1142919,1,8,3,0,0,74
112597,1142919,1,8,4,1,0,75
112598,1142919,1,8,5,0,0,75
112599,1142919,1,8,6,6,0,81
112600,1142919,1,9,1,1,0,82
112601,1142919,1,9,2,1,0,83
112602,1142919,1,9,3,1,0,84
112603,1142919,1,9,4,0,0,84
112604,1142919,1,9,5,0,0,84
112605,1142919,1,9,6,1,0,85
112606,1142919,1,10,1,0,0,85
112607,1142919,1,10,2,6,0,91
112608,1142919,1,10,3,2,0,93
112609,1142919,1,10,4,2,0,95
112610,1142919,1,10,5,0,1,95
112611,1142919,1,10,6,1,0,96
112612,1142919,1,11,1,1,0,97
112613,1142919,1,11,2,1,0,98
112614,1142919,1,11,3,2,0,100
112615,1142919,1,11,4,1,0,101
112616,1142919,1,11,5,0,0,101
112617,1142919,1,11,6,1,0,102
112618,1142919,1,12,1,0,0,102
112619,1142919,1,12,2,4,0,106
112620,1142919,1,12,3,0,0,106
112621,1142919,1,12,4,2,0,108
112622,1142919,1,12,5,1,0,109
112623,1142919,1,12,6,0,1,109
112624,1142919,1,13,1,0,0,109
112625,1142919,1,13,2,1,0,110
112626,1142919,1,13,3,0,0,110
112627,1142919,1,13,4,0,0,110
112628,1142919,1,13,5,2,0,112
112629,1142919,1,13,6,0,0,112
112630,1142919,1,14,1,0,0,112
112631,1142919,1,14,2,0,0,112
112632,1142919,1,14,3,1,0,113
112633,1142919,1,14,4,1,0,114
112634,1142919,1,14,5,4,0,118
112635,1142919,1,14,6,1,0,119
112636,1142919,1,15,1,2,0,121
112637,1142919,1,15,2,2,0,123
112638,1142919,1,15,3,1,0,124
112639,1142919,1,15,4,1,0,125
112640,1142919,1,15,5,6,0,131
112641,1142919,1,15,6,6,0,137
112642,1142919,1,16,1,6,0,143
112643,1142919,1,16,2,3,0,146
112644,1142919,1,16,3,0,0,146
112645,1142919,1,16,4,0,1,146
112646,1142919,1,16,5,0,0,146
112647,1142919,1,16,6,1,0,147
112648,1142919,1,17,1,1,0,148
112649,1142919,1,17,2,0,1,148
112650,1142919,1,17,3,1,0,149
112651,1142919,1,17,4,4,0,153
112652,1142919,1,17,5,4,0,157
112653,1142919,1,17,6,0,0,157
112654,1142919,1,18,1,1,0,158
112655,1142919,1,18,2,6,0,164
112656,1142919,1,18,3,2,0,166
112657,1142919,1,18,4,0,1,166
112658,1142919,1,18,5,0,0,166
112659,1142919,1,18,6,2,0,168
112660,1142919,1,19,1,1,0,169
112661,1142919,1,19,2,1,0,170
112662,1142919,1,19,3,1,0,171
112663,1142919,1,19,4,4,0,175
112664,1142919,1,19,5,1,0,176
112665,1142919,1,19,6,0,1,176
112666,1142919,1,20,1,0,1,176
112667,1142919,1,20,2,1,0,177
112668,1142919,1,20,3,0,0,177
112669,1142919,1,20,4,0,1,177
112670,1142919,1,20,5,2,0,179
112671,1142919,1,20,6,4,0,183
112788,1144149,1,1,1,0,0,0
112789,1144149,1,1,2,1,0,1
112790,1144149,1,1,3,0,0,1
112791,1144149,1,1,4,2,0,3
112792,1144149,1,1,5,0,1,3
112793,1144149,1,1,6,4,0,7
112794,1144149,1,2,1,4,0,11
112795,1144149,1,2,2,0,0,11
112796,1144149,1,2,3,0,1,11
112797,1144149,1,2,4,4,0,15
112798,1144149,1,2,5,0,0,15
112799,1144149,1,2,6,1,0,16
112800,1144149,1,3,1,0,0,16
112801,1144149,1,3,2,0,0,16
112802,1144149,1,3,3,0,0,16
112803,1144149,1,3,4,6,0,22
112804,1144149,1,3,5,0,0,22
112805,1144149,1,3,6,6,0,28
112806,1144149,1,4,1,2,0,30
112807,1144149,1,4,2,0,0,30
112808,1144149,1,4,3,0,0,30
112809,1144149,1,4,4,0,0,30
112810,1144149,1,4,5,0,0,30
112811,1144149,1,4,6,0,0,30
112812,1144149,1,5,1,4,0,34
112813,1144149,1,5,2,0,0,34
112814,1144149,1,5,3,0,0,34
112815,1144149,1,5,4,1,0,35
112816,1144149,1,5,5,4,0,39
112817,1144149,1,5,6,5,0,44
112818,1144149,1,6,1,6,0,50
112819,1144149,1,6,2,0,0,50
112820,1144149,1,6,3,1,0,51
112821,1144149,1,6,4,0,0,51
112822,1144149,1,6,5,0,0,51
112823,1144149,1,6,6,1,0,52
112824,1144149,1,7,1,0,1,52
112825,1144149,1,7,2,0,0,52
112826,1144149,1,7,3,1,0,53
112827,1144149,1,7,4,4,0,57
112828,1144149,1,7,5,0,0,57
112829,1144149,1,7,6,2,0,59
112830,1144149,1,8,1,0,0,59
112831,1144149,1,8,2,0,0,59
112832,1144149,1,8,3,1,0,60
112833,1144149,1,8,4,2,0,62
112834,1144149,1,8,5,1,0,63
112835,1144149,1,8,6,1,0,64
112836,1144149,1,9,1,1,0,65
112837,1144149,1,9,2,1,0,66
112838,1144149,1,9,3,0,0,66
112839,1144149,1,9,4,1,0,67
112840,1144149,1,9,5,2,0,69
112841,1144149,1,9,6,2,0,71
112842,1144149,1,10,1,2,0,73
112843,1144149,1,10,2,4,0,77
112844,1144149,1,10,3,1,0,78
112845,1144149,1,10,4,2,0,80
112846,1144149,1,10,5,1,0,81
112847,1144149,1,10,6,1,0,82
112848,1144149,1,11,1,0,0,82
112849,1144149,1,11,2,1,0,83
112850,1144149,1,11,3,1,0,84
112851,1144149,1,11,4,2,0,86
112852,1144149,1,11,5,1,0,87
112853,1144149,1,11,6,1,0,88
112854,1144149,1,12,1,0,0,88
112855,1144149,1,12,2,0,0,88
112856,1144149,1,12,3,1,0,89
112857,1144149,1,12,4,0,0,89
112858,1144149,1,12,5,1,0,90
112859,1144149,1,12,6,1,0,91
112860,1144149,1,13,1,0,0,91
112861,1144149,1,13,2,1,0,92
112862,1144149,1,13,3,3,0,95
112863,1144149,1,13,4,2,0,97
112864,1144149,1,13,5,1,0,98
112865,1144149,1,13,6,4,0,102
112866,1144149,1,14,1,0,0,102
112867,1144149,1,14,2,6,0,108
112868,1144149,1,14,3,1,0,109
112869,1144149,1,14,4,2,0,111
112870,1144149,1,14,5,1,0,112
112871,1144149,1,14,6,1,0,113
112872,1144149,1,15,1,1,0,114
112873,1144149,1,15,2,1,0,115
112874,1144149,1,15,3,1,0,116
112875,1144149,1,15,4,1,0,117
112876,1144149,1,15,5,0,0,117
112877,1144149,1,15,6,0,0,117
112878,1144149,1,16,1,0,0,117
112879,1144149,1,16,2,4,0,121
112880,1144149,1,16,3,1,0,122
112881,1144149,1,16,4,1,0,123
112882,1144149,1,16,5,0,0,123
112883,1144149,1,16,6,1,0,124
112884,1144149,1,17,1,4,0,128
112885,1144149,1,17,2,4,0,132
112886,1144149,1,17,3,1,0,133
112887,1144149,1,17,4,6,0,139
112888,1144149,1,17,5,0,0,139
112889,1144149,1,17,6,0,1,139
112890,1144149,1,18,1,1,0,140
112891,1144149,1,18,2,0,0,140
112892,1144149,1,18,3,1,0,141
112893,1144149,1,18,4,1,0,142
112894,1144149,1,18,5,2,0,144
112895,1144149,1,18,6,5,1,149
112896,1144149,1,19,1,0,0,149
112897,1144149,1,19,2,0,0,149
112898,1144149,1,19,3,1,0,150
112899,1144149,1,19,4,6,0,156
112900,1144149,1,19,5,0,0,156
112901,1144149,1,19,6,0,1,156
112902,1144149,1,20,1,0,0,156
112903,1144149,1,20,2,1,0,157
112904,1144149,1,20,3,1,0,158
112905,1144149,1,20,4,0,0,158
112906,1144149,1,20,5,0,0,158
112907,1144149,1,20,6,2,0,160
113012,1144150,1,1,1,0,0,0
113013,1144150,1,1,2,0,0,0
113014,1144150,1,1,3,0,0,0
113015,1144150,1,1,4,1,0,1
113016,1144150,1,1,5,2,0,3
113017,1144150,1,1,6,4,0,7
113018,1144150,1,2,1,0,0,7
113019,1144150,1,2,2,0,1,7
113020,1144150,1,2,3,0,0,7
113021,1144150,1,2,4,4,0,11
113022,1144150,1,2,5,0,0,11
113023,1144150,1,2,6,0,0,11
113024,1144150,1,3,1,0,0,11
113025,1144150,1,3,2,0,0,11
113026,1144150,1,3,3,6,0,17
113027,1144150,1,3,4,0,0,17
113028,1144150,1,3,5,6,0,23
113029,1144150,1,3,6,4,0,27
113030,1144150,1,4,1,0,0,27
113031,1144150,1,4,2,4,0,31
113032,1144150,1,4,3,0,0,31
113033,1144150,1,4,4,0,0,31
113034,1144150,1,4,5,0,0,31
113035,1144150,1,4,6,0,0,31
113036,1144150,1,5,1,0,0,31
113037,1144150,1,5,2,0,0,31
113038,1144150,1,5,3,0,0,31
113039,1144150,1,5,4,1,0,32
113040,1144150,1,5,5,1,0,33
113041,1144150,1,5,6,0,1,33
113042,1144150,1,6,1,0,0,33
113043,1144150,1,6,2,1,0,34
113044,1144150,1,6,3,0,0,34
113045,1144150,1,6,4,0,0,34
113046,1144150,1,6,5,0,0,34
113047,1144150,1,6,6,0,0,34
113048,1144150,1,7,1,1,0,35
113049,1144150,1,7,2,0,1,35
113050,1144150,1,7,3,1,0,36
113051,1144150,1,7,4,0,0,36
113052,1144150,1,7,5,2,0,38
113053,1144150,1,7,6,1,0,39
113054,1144150,1,8,1,1,0,40
113055,1144150,1,8,2,1,0,41
113056,1144150,1,8,3,1,0,42
113057,1144150,1,8,4,0,0,42
113058,1144150,1,8,5,0,0,42
113059,1144150,1,8,6,1,0,43
113060,1144150,1,9,1,1,0,44
113061,1144150,1,9,2,1,0,45
113062,1144150,1,9,3,0,0,45
113063,1144150,1,9,4,2,0,47
113064,1144150,1,9,5,1,0,48
113065,1144150,1,9,6,1,0,49
113066,1144150,1,10,1,0,0,49
113067,1144150,1,10,2,0,0,49
113068,1144150,1,10,3,6,0,55
113069,1144150,1,10,4,1,0,56
113070,1144150,1,10,5,0,0,56
113071,1144150,1,10,6,0,0,56
113072,1144150,1,11,1,0,0,56
113073,1144150,1,11,2,0,0,56
113074,1144150,1,11,3,1,0,57
113075,1144150,1,11,4,0,0,57
113076,1144150,1,11,5,1,0,58
113077,1144150,1,11,6,0,0,58
113078,1144150,1,12,1,1,0,59
113079,1144150,1,12,2,1,0,60
113080,1144150,1,12,3,1,0,61
113081,1144150,1,12,4,0,0,61
113082,1144150,1,12,5,0,0,61
113083,1144150,1,12,6,0,0,61
113084,1144150,1,13,1,1,0,62
113085,1144150,1,13,2,2,0,64
113086,1144150,1,13,3,0,1,64
113087,1144150,1,13,4,1,0,65
113088,1144150,1,13,5,1,0,66
113089,1144150,1,13,6,0,0,66
113090,1144150,1,14,1,0,0,66
113091,1144150,1,14,2,1,0,67
113092,1144150,1,14,3,0,0,67
113093,1144150,1,14,4,1,0,68
113094,1144150,1,14,5,4,0,72
113095,1144150,1,14,6,1,0,73
113096,1144150,1,15,1,6,0,79
113097,1144150,1,15,2,0,0,79
113098,1144150,1,15,3,6,0,85
113099,1144150,1,15,4,7,0,92
113100,1144150,1,15,5,1,0,93
113101,1144150,1,15,6,4,0,97
113102,1144150,1,16,1,4,0,101
113103,1144150,1,16,2,0,1,101
113104,1144150,1,16,3,0,0,101
113105,1144150,1,16,4,0,0,101
113106,1144150,1,16,5,0,0,101
113107,1144150,1,16,6,0,0,101
113108,1144150,1,17,1,1,0,102
113109,1144150,1,17,2,0,0,102
113110,1144150,1,17,3,6,0,108
113111,1144150,1,17,4,0,1,108
113112,1144150,1,17,5,0,0,108
113113,1144150,1,17,6,0,0,108
113114,1144150,1,18,1,1,0,109
113115,1144150,1,18,2,4,0,113
113116,1144150,1,18,3,0,0,113
113117,1144150,1,18,4,0,0,113
113118,1144150,1,18,5,1,0,114
113119,1144150,1,18,6,1,0,115
113120,1144150,1,19,1,0,1,115
113121,1144150,1,19,2,1,0,116
113122,1144150,1,19,3,1,0,117
113123,1144150,1,19,4,1,0,118
113124,1144150,1,19,5,2,0,120
113125,1144150,1,19,6,1,0,121
113126,1144150,1,20,1,1,0,122
113127,1144150,1,20,2,6,0,128
113128,1144150,1,20,3,0,0,128
113129,1144150,1,20,4,1,0,129
113130,1144150,1,20,5,2,0,131
113131,1144150,1,20,6,1,0,132
113226,1144161,1,1,1,0,0,0
113227,1144161,1,1,2,0,0,0
113228,1144161,1,1,3,1,0,1
113229,1144161,1,1,4,4,0,5
113230,1144161,1,1,5,1,0,6
113231,1144161,1,1,6,6,0,12
113232,1144161,1,2,1,0,0,12
113233,1144161,1,2,2,1,0,13
113234,1144161,1,2,3,1,0,14
113235,1144161,1,2,4,4,0,18
113236,1144161,1,2,5,0,0,18
113237,1144161,1,2,6,1,0,19
113238,1144161,1,3,1,0,0,19
113239,1144161,1,3,2,1,0,20
113240,1144161,1,3,3,4,0,24
113241,1144161,1,3,4,1,0,25
113242,1144161,1,3,5,0,0,25
113243,1144161,1,3,6,1,0,26
113244,1144161,1,4,1,0,1,26
113245,1144161,1,4,2,0,0,26
113246,1144161,1,4,3,0,0,26
113247,1144161,1,4,4,0,0,26
113248,1144161,1,4,5,1,0,27
113249,1144161,1,4,6,0,0,27
113250,1144161,1,5,1,2,0,29
113251,1144161,1,5,2,4,0,33
113252,1144161,1,5,3,4,0,37
113253,1144161,1,5,4,0,0,37
113254,1144161,1,5,5,1,0,38
113255,1144161,1,5,6,1,0,39
113256,1144161,1,6,1,1,0,40
113257,1144161,1,6,2,0,0,40
113258,1144161,1,6,3,1,0,41
113259,1144161,1,6,4,4,0,45
113260,1144161,1,6,5,1,0,46
113261,1144161,1,6,6,2,0,48
113262,1144161,1,7,1,2,0,50
113263,1144161,1,7,2,1,0,51
113264,1144161,1,7,3,6,0,57
113265,1144161,1,7,4,0,0,57
113266,1144161,1,7,5,4,0,61
113267,1144161,1,7,6,1,0,62
113268,1144161,1,8,1,1,0,63
113269,1144161,1,8,2,1,0,64
113270,1144161,1,8,3,2,0,66
113271,1144161,1,8,4,0,0,66
113272,1144161,1,8,5,1,0,67
113273,1144161,1,8,6,1,0,68
113274,1144161,1,9,1,1,0,69
113275,1144161,1,9,2,1,0,70
113276,1144161,1,9,3,1,0,71
113277,1144161,1,9,4,4,0,75
113278,1144161,1,9,5,2,0,77
113279,1144161,1,9,6,2,0,79
113280,1144161,1,10,1,1,0,80
113281,1144161,1,10,2,0,0,80
113282,1144161,1,10,3,1,0,81
113283,1144161,1,10,4,4,0,85
113284,1144161,1,10,5,2,0,87
113285,1144161,1,10,6,1,0,88
113286,1144161,1,11,1,0,0,88
113287,1144161,1,11,2,4,0,92
113288,1144161,1,11,3,1,0,93
113289,1144161,1,11,4,0,0,93
113290,1144161,1,11,5,6,0,99
113291,1144161,1,11,6,4,0,103
113292,1144161,1,12,1,6,0,109
113293,1144161,1,12,2,1,0,110
113294,1144161,1,12,3,0,0,110
113295,1144161,1,12,4,1,0,111
113296,1144161,1,12,5,4,0,115
113297,1144161,1,12,6,1,0,116
113298,1144161,1,13,1,1,0,117
113299,1144161,1,13,2,2,0,119
113300,1144161,1,13,3,0,0,119
113301,1144161,1,13,4,6,0,125
113302,1144161,1,13,5,2,0,127
113303,1144161,1,13,6,1,0,128
113304,1144161,1,14,1,5,0,133
113305,1144161,1,14,2,1,0,134
113306,1144161,1,14,3,1,0,135
113307,1144161,1,14,4,2,0,137
113308,1144161,1,14,5,1,0,138
113309,1144161,1,14,6,4,0,142
113310,1144161,1,15,1,6,0,148
113311,1144161,1,15,2,1,0,149
113312,1144161,1,15,3,1,0,150
113313,1144161,1,15,4,1,0,151
113314,1144161,1,15,5,4,0,155
113315,1144161,1,15,6,2,0,157
113316,1144161,1,16,1,0,0,157
113317,1144161,1,16,2,0,1,157
113318,1144161,1,16,3,0,0,157
113319,1144161,1,16,4,0,1,157
113320,1144161,1,16,5,0,0,157
113321,1144161,1,16,6,1,0,158
113322,1144161,1,17,1,0,0,158
113323,1144161,1,17,2,1,0,159
113324,1144161,1,17,3,2,0,161
113325,1144161,1,17,4,1,0,162
113326,1144161,1,17,5,2,0,164
113327,1144161,1,17,6,2,0,166
113328,1144161,1,18,1,2,0,168
113329,1144161,1,18,2,4,0,172
113330,1144161,1,18,3,4,0,176
113331,1144161,1,18,4,0,1,176
113332,1144161,1,18,5,1,0,177
113333,1144161,1,18,6,1,0,178
113334,1144161,1,19,1,0,1,178
113335,1144161,1,19,2,1,0,179
113336,1144161,1,19,3,1,0,180
113337,1144161,1,19,4,3,0,183
113338,1144161,1,19,5,1,0,184
113339,1144161,1,19,6,1,0,185
113340,1144161,1,20,1,1,0,186
113341,1144161,1,20,2,0,0,186
113342,1144161,1,20,3,0,1,186
113343,1144161,1,20,4,1,0,187
113344,1144161,1,20,5,1,0,188
113345,1144161,1,20,6,4,0,192
113466,1144162,1,1,1,0,0,0
113467,1144162,1,1,2,0,0,0
113468,1144162,1,1,3,0,0,0
113469,1144162,1,1,4,0,0,0
113470,1144162,1,1,5,1,0,1
113471,1144162,1,1,6,1,0,2
113472,1144162,1,2,1,1,0,3
113473,1144162,1,2,2,0,0,3
113474,1144162,1,2,3,0,0,3
113475,1144162,1,2,4,0,0,3
113476,1144162,1,2,5,1,0,4
113477,1144162,1,2,6,1,0,5
113478,1144162,1,3,1,0,0,5
113479,1144162,1,3,2,1,0,6
113480,1144162,1,3,3,0,0,6
113481,1144162,1,3,4,0,0,6
113482,1144162,1,3,5,1,0,7
113483,1144162,1,3,6,2,0,9
113484,1144162,1,4,1,4,0,13
113485,1144162,1,4,2,1,0,14
113486,1144162,1,4,3,0,0,14
113487,1144162,1,4,4,1,0,15
113488,1144162,1,4,5,1,0,16
113489,1144162,1,4,6,4,0,20
113490,1144162,1,5,1,6,0,26
113491,1144162,1,5,2,6,0,32
113492,1144162,1,5,3,0,0,32
113493,1144162,1,5,4,0,0,32
113494,1144162,1,5,5,1,0,33
113495,1144162,1,5,6,0,0,33
113496,1144162,1,6,1,4,0,37
113497,1144162,1,6,2,1,0,38
113498,1144162,1,6,3,4,0,42
113499,1144162,1,6,4,1,0,43
113500,1144162,1,6,5,0,0,43
113501,1144162,1,6,6,1,0,44
113502,1144162,1,7,1,0,0,44
113503,1144162,1,7,2,0,0,44
113504,1144162,1,7,3,0,0,44
113505,1144162,1,7,4,0,0,44
113506,1144162,1,7,5,0,0,44
113507,1144162,1,7,6,0,0,44
113508,1144162,1,8,1,1,0,45
113509,1144162,1,8,2,4,0,49
113510,1144162,1,8,3,1,0,50
113511,1144162,1,8,4,4,0,54
113512,1144162,1,8,5,0,0,54
113513,1144162,1,8,6,1,0,55
113514,1144162,1,9,1,2,0,57
113515,1144162,1,9,2,1,0,58
113516,1144162,1,9,3,0,0,58
113517,1144162,1,9,4,0,1,58
113518,1144162,1,9,5,0,0,58
113519,1144162,1,9,6,0,0,58
113520,1144162,1,10,1,1,0,59
113521,1144162,1,10,2,0,0,59
113522,1144162,1,10,3,1,0,60
113523,1144162,1,10,4,0,0,60
113524,1144162,1,10,5,1,0,61
113525,1144162,1,10,6,0,0,61
113526,1144162,1,11,1,1,0,62
113527,1144162,1,11,2,0,0,62
113528,1144162,1,11,3,4,0,66
113529,1144162,1,11,4,6,0,72
113530,1144162,1,11,5,1,0,73
113531,1144162,1,11,6,0,0,73
113532,1144162,1,12,1,6,0,79
113533,1144162,1,12,2,1,0,80
113534,1144162,1,12,3,1,0,81
113535,1144162,1,12,4,2,0,83
113536,1144162,1,12,5,0,0,83
113537,1144162,1,12,6,1,0,84
113538,1144162,1,13,1,6,0,90
113539,1144162,1,13,2,0,1,90
113540,1144162,1,13,3,1,0,91
113541,1144162,1,13,4,1,0,92
113542,1144162,1,13,5,0,0,92
113543,1144162,1,13,6,1,0,93
113544,1144162,1,14,1,1,0,94
113545,1144162,1,14,2,2,0,96
113546,1144162,1,14,3,2,0,98
113547,1144162,1,14,4,1,0,99
113548,1144162,1,14,5,1,0,100
113549,1144162,1,14,6,3,0,103
113550,1144162,1,15,1,0,0,103
113551,1144162,1,15,2,4,0,107
113552,1144162,1,15,3,4,0,111
113553,1144162,1,15,4,2,0,113
113554,1144162,1,15,5,1,0,114
113555,1144162,1,15,6,1,0,115
113556,1144162,1,16,1,2,0,117
113557,1144162,1,16,2,6,0,123
113558,1144162,1,16,3,1,0,124
113559,1144162,1,16,4,0,0,124
113560,1144162,1,16,5,1,0,125
113561,1144162,1,16,6,1,0,126
113562,1144162,1,17,1,0,1,126
113563,1144162,1,17,2,3,0,129
113564,1144162,1,17,3,1,0,130
113565,1144162,1,17,4,1,0,131
113566,1144162,1,17,5,2,0,133
113567,1144162,1,17,6,1,0,134
113568,1144162,1,18,1,6,0,140
113569,1144162,1,18,2,2,0,142
113570,1144162,1,18,3,2,0,144
113571,1144162,1,18,4,1,0,145
113572,1144162,1,18,5,1,0,146
113573,1144162,1,18,6,6,0,152
113574,1144162,1,19,1,1,0,153
113575,1144162,1,19,2,0,0,153
113576,1144162,1,19,3,2,0,155
113577,1144162,1,19,4,1,0,156
113578,1144162,1,19,5,1,0,157
113579,1144162,1,19,6,2,0,159
113580,1144162,1,20,1,6,0,165
113581,1144162,1,20,2,2,0,167
113582,1144162,1,20,3,7,0,174
113583,1144162,1,20,4,4,0,178
113584,1144162,1,20,5,6,0,184
113585,1144162,1,20,6,4,0,188
113706,1144163,1,1,1,0,0,0
113707,1144163,1,1,2,1,0,1
113708,1144163,1,1,3,0,0,1
113709,1144163,1,1,4,0,0,1
113710,1144163,1,1,5,0,0,1
113711,1144163,1,1,6,0,0,1
113712,1144163,1,2,1,4,0,5
113713,1144163,1,2,2,4,0,9
113714,1144163,1,2,3,0,0,9
113715,1144163,1,2,4,4,0,13
113716,1144163,1,2,5,4,0,17
113717,1144163,1,2,6,1,0,18
113718,1144163,1,3,1,4,0,22
113719,1144163,1,3,2,1,0,23
113720,1144163,1,3,3,1,0,24
113721,1144163,1,3,4,0,1,24
113722,1144163,1,3,5,0,0,24
113723,1144163,1,3,6,0,0,24
113724,1144163,1,4,1,4,0,28
113725,1144163,1,4,2,0,0,28
113726,1144163,1,4,3,6,0,34
113727,1144163,1,4,4,5,0,39
113728,1144163,1,4,5,4,0,43
113729,1144163,1,4,6,2,0,45
113730,1144163,1,5,1,0,0,45
113731,1144163,1,5,2,1,0,46
113732,1144163,1,5,3,0,0,46
113733,1144163,1,5,4,0,0,46
113734,1144163,1,5,5,0,0,46
113735,1144163,1,5,6,0,0,46
113736,1144163,1,6,1,0,0,46
113737,1144163,1,6,2,1,0,47
113738,1144163,1,6,3,0,0,47
113739,1144163,1,6,4,0,1,47
113740,1144163,1,6,5,1,0,48
113741,1144163,1,6,6,2,0,50
113742,1144163,1,7,1,1,0,51
113743,1144163,1,7,2,1,0,52
113744,1144163,1,7,3,1,0,53
113745,1144163,1,7,4,1,0,54
113746,1144163,1,7,5,1,0,55
113747,1144163,1,7,6,1,0,56
113748,1144163,1,8,1,1,0,57
113749,1144163,1,8,2,4,0,61
113750,1144163,1,8,3,4,0,65
113751,1144163,1,8,4,1,0,66
113752,1144163,1,8,5,1,0,67
113753,1144163,1,8,6,1,0,68
113754,1144163,1,9,1,1,0,69
113755,1144163,1,9,2,1,0,70
113756,1144163,1,9,3,4,0,74
113757,1144163,1,9,4,0,0,74
113758,1144163,1,9,5,4,0,78
113759,1144163,1,9,6,0,0,78
113760,1144163,1,10,1,1,0,79
113761,1144163,1,10,2,1,0,80
113762,1144163,1,10,3,1,0,81
113763,1144163,1,10,4,1,0,82
113764,1144163,1,10,5,1,0,83
113765,1144163,1,10,6,0,0,83
113766,1144163,1,11,1,0,0,83
113767,1144163,1,11,2,2,0,85
113768,1144163,1,11,3,4,0,89
113769,1144163,1,11,4,0,1,89
113770,1144163,1,11,5,1,0,90
113771,1144163,1,11,6,1,0,91
113772,1144163,1,12,1,1,0,92
113773,1144163,1,12,2,0,1,92
113774,1144163,1,12,3,1,0,93
113775,1144163,1,12,4,1,0,94
113776,1144163,1,12,5,0,0,94
113777,1144163,1,12,6,0,0,94
113778,1144163,1,13,1,0,1,94
113779,1144163,1,13,2,1,0,95
113780,1144163,1,13,3,1,0,96
113781,1144163,1,13,4,1,0,97
113782,1144163,1,13,5,3,0,100
113783,1144163,1,13,6,1,0,101
113784,1144163,1,14,1,1,0,102
113785,1144163,1,14,2,6,0,108
113786,1144163,1,14,3,1,0,109
113787,1144163,1,14,4,1,0,110
113788,1144163,1,14,5,0,0,110
113789,1144163,1,14,6,1,0,111
113790,1144163,1,15,1,1,0,112
113791,1144163,1,15,2,4,0,116
113792,1144163,1,15,3,4,0,120
113793,1144163,1,15,4,0,0,120
113794,1144163,1,15,5,1,0,121
113795,1144163,1,15,6,1,0,122
113796,1144163,1,16,1,1,0,123
113797,1144163,1,16,2,4,0,127
113798,1144163,1,16,3,1,0,128
113799,1144163,1,16,4,1,0,129
113800,1144163,1,16,5,0,0,129
113801,1144163,1,16,6,0,1,129
113802,1144163,1,17,1,3,0,132
113803,1144163,1,17,2,1,0,133
113804,1144163,1,17,3,0,0,133
113805,1144163,1,17,4,1,0,134
113806,1144163,1,17,5,1,0,135
113807,1144163,1,17,6,1,0,136
113808,1144163,1,18,1,6,0,142
113809,1144163,1,18,2,1,0,143
113810,1144163,1,18,3,0,0,143
113811,1144163,1,18,4,1,0,144
113812,1144163,1,18,5,0,1,144
113813,1144163,1,18,6,1,0,145
113814,1144163,1,19,1,0,1,145
113815,1144163,1,19,2,1,0,146
113816,1144163,1,19,3,0,1,146
113817,1144163,1,19,4,1,0,147
113818,1144163,1,19,5,0,0,147
113819,1144163,1,19,6,0,0,147
113820,1144163,1,20,1,0,0,147
113821,1144163,1,20,2,6,0,153
113822,1144163,1,20,3,2,0,155
113823,1144163,1,20,4,6,0,161
113824,1144163,1,20,5,1,0,162
113825,1144163,1,20,6,6,0,168
113946,1144173,1,1,1,1,0,1
113947,1144173,1,1,2,4,0,5
113948,1144173,1,1,3,0,0,5
113949,1144173,1,1,4,0,0,5
113950,1144173,1,1,5,1,0,6
113951,1144173,1,1,6,1,0,7
113952,1144173,1,2,1,0,0,7
113953,1144173,1,2,2,1,0,8
113954,1144173,1,2,3,0,0,8
113955,1144173,1,2,4,1,0,9
113956,1144173,1,2,5,0,1,9
113957,1144173,1,2,6,4,0,13
113958,1144173,1,3,1,0,0,13
113959,1144173,1,3,2,1,0,14
113960,1144173,1,3,3,0,0,14
113961,1144173,1,3,4,0,0,14
113962,1144173,1,3,5,0,0,14
113963,1144173,1,3,6,2,0,16
113964,1144173,1,4,1,0,0,16
113965,1144173,1,4,2,1,0,17
113966,1144173,1,4,3,1,0,18
113967,1144173,1,4,4,1,0,19
113968,1144173,1,4,5,1,0,20
113969,1144173,1,4,6,0,0,20
113970,1144173,1,5,1,1,0,21
113971,1144173,1,5,2,1,0,22
113972,1144173,1,5,3,4,0,26
113973,1144173,1,5,4,0,0,26
113974,1144173,1,5,5,1,0,27
113975,1144173,1,5,6,1,0,28
113976,1144173,1,6,1,0,0,28
113977,1144173,1,6,2,4,0,32
113978,1144173,1,6,3,4,0,36
113979,1144173,1,6,4,1,0,37
113980,1144173,1,6,5,1,0,38
113981,1144173,1,6,6,1,0,39
113982,1144173,1,7,1,0,0,39
113983,1144173,1,7,2,3,0,42
113984,1144173,1,7,3,1,0,43
113985,1144173,1,7,4,0,0,43
113986,1144173,1,7,5,1,0,44
113987,1144173,1,7,6,1,0,45
113988,1144173,1,8,1,1,0,46
113989,1144173,1,8,2,1,0,47
113990,1144173,1,8,3,1,0,48
113991,1144173,1,8,4,1,0,49
113992,1144173,1,8,5,6,0,55
113993,1144173,1,8,6,1,0,56
113994,1144173,1,9,1,1,0,57
113995,1144173,1,9,2,1,0,58
113996,1144173,1,9,3,1,0,59
113997,1144173,1,9,4,2,0,61
113998,1144173,1,9,5,2,0,63
113999,1144173,1,9,6,0,0,63
114000,1144173,1,10,1,6,0,69
114001,1144173,1,10,2,1,0,70
114002,1144173,1,10,3,1,0,71
114003,1144173,1,10,4,6,0,77
114004,1144173,1,10,5,1,0,78
114005,1144173,1,10,6,4,0,82
114006,1144173,1,11,1,1,0,83
114007,1144173,1,11,2,0,0,83
114008,1144173,1,11,3,4,0,87
114009,1144173,1,11,4,4,0,91
114010,1144173,1,11,5,1,0,92
114011,1144173,1,11,6,2,0,94
114012,1144173,1,12,1,1,0,95
114013,1144173,1,12,2,0,0,95
114014,1144173,1,12,3,0,0,95
114015,1144173,1,12,4,0,0,95
114016,1144173,1,12,5,1,0,96
114017,1144173,1,12,6,2,0,98
114018,1144173,1,13,1,1,0,99
114019,1144173,1,13,2,4,0,103
114020,1144173,1,13,3,4,0,107
114021,1144173,1,13,4,1,0,108
114022,1144173,1,13,5,1,0,109
114023,1144173,1,13,6,1,0,110
114024,1144173,1,14,1,1,0,111
114025,1144173,1,14,2,1,0,112
114026,1144173,1,14,3,0,0,112
114027,1144173,1,14,4,4,0,116
114028,1144173,1,14,5,1,0,117
114029,1144173,1,14,6,1,0,118
114030,1144173,1,15,1,4,0,122
114031,1144173,1,15,2,3,0,125
114032,1144173,1,15,3,0,1,125
114033,1144173,1,15,4,1,0,126
114034,1144173,1,15,5,1,0,127
114035,1144173,1,15,6,1,0,128
114036,1144173,1,16,1,1,0,129
114037,1144173,1,16,2,1,0,130
114038,1144173,1,16,3,1,0,131
114039,1144173,1,16,4,1,0,132
114040,1144173,1,16,5,4,0,136
114041,1144173,1,16,6,2,0,138
114042,1144173,1,17,1,0,1,138
114043,1144173,1,17,2,1,0,139
114044,1144173,1,17,3,1,0,140
114045,1144173,1,17,4,1,0,141
114046,1144173,1,17,5,0,0,141
114047,1144173,1,17,6,1,0,142
114048,1144173,1,18,1,1,0,143
114049,1144173,1,18,2,1,0,144
114050,1144173,1,18,3,4,0,148
114051,1144173,1,18,4,2,0,150
114052,1144173,1,18,5,1,0,151
114053,1144173,1,18,6,6,0,157
114054,1144173,1,19,1,1,0,158
114055,1144173,1,19,2,4,0,162
114056,1144173,1,19,3,1,0,163
114057,1144173,1,19,4,0,0,163
114058,1144173,1,19,5,1,0,164
114059,1144173,1,19,6,1,0,165
114060,1144173,1,20,1,6,0,171
114061,1144173,1,20,2,2,0,173
114062,1144173,1,20,3,1,0,174
114063,1144173,1,20,4,1,0,175
114064,1144173,1,20,5,1,0,176
114065,1144173,1,20,6,4,0,180
114186,1144174,1,1,1,1,0,1
114187,1144174,1,1,2,0,0,1
114188,1144174,1,1,3,0,0,1
114189,1144174,1,1,4,0,0,1
114190,1144174,1,1,5,0,0,1
114191,1144174,1,1,6,2,0,3
114192,1144174,1,2,1,0,0,3
114193,1144174,1,2,2,1,0,4
114194,1144174,1,2,3,5,0,9
114195,1144174,1,2,4,0,0,9
114196,1144174,1,2,5,0,0,9
114197,1144174,1,2,6,0,0,9
114198,1144174,1,3,1,0,0,9
114199,1144174,1,3,2,0,0,9
114200,1144174,1,3,3,4,0,13
114201,1144174,1,3,4,0,0,13
114202,1144174,1,3,5,0,0,13
114203,1144174,1,3,6,1,0,14
114204,1144174,1,4,1,0,0,14
114205,1144174,1,4,2,1,0,15
114206,1144174,1,4,3,1,0,16
114207,1144174,1,4,4,0,0,16
114208,1144174,1,4,5,4,0,20
114209,1144174,1,4,6,1,0,21
114210,1144174,1,5,1,4,0,25
114211,1144174,1,5,2,0,0,25
114212,1144174,1,5,3,1,0,26
114213,1144174,1,5,4,1,0,27
114214,1144174,1,5,5,1,0,28
114215,1144174,1,5,6,1,0,29
114216,1144174,1,6,1,0,0,29
114217,1144174,1,6,2,6,0,35
114218,1144174,1,6,3,1,0,36
114219,1144174,1,6,4,1,0,37
114220,1144174,1,6,5,0,1,37
114221,1144174,1,6,6,1,0,38
114222,1144174,1,7,1,1,0,39
114223,1144174,1,7,2,1,0,40
114224,1144174,1,7,3,1,0,41
114225,1144174,1,7,4,1,0,42
114226,1144174,1,7,5,1,0,43
114227,1144174,1,7,6,1,0,44
114228,1144174,1,8,1,0,0,44
114229,1144174,1,8,2,1,0,45
114230,1144174,1,8,3,1,0,46
114231,1144174,1,8,4,4,0,50
114232,1144174,1,8,5,0,0,50
114233,1144174,1,8,6,1,0,51
114234,1144174,1,9,1,1,0,52
114235,1144174,1,9,2,0,0,52
114236,1144174,1,9,3,4,0,56
114237,1144174,1,9,4,2,0,58
114238,1144174,1,9,5,1,0,59
114239,1144174,1,9,6,1,0,60
114240,1144174,1,10,1,1,0,61
114241,1144174,1,10,2,0,0,61
114242,1144174,1,10,3,0,0,61
114243,1144174,1,10,4,6,0,67
114244,1144174,1,10,5,2,0,69
114245,1144174,1,10,6,1,0,70
114246,1144174,1,11,1,1,0,71
114247,1144174,1,11,2,2,0,73
114248,1144174,1,11,3,0,0,73
114249,1144174,1,11,4,4,0,77
114250,1144174,1,11,5,4,0,81
114251,1144174,1,11,6,1,0,82
114252,1144174,1,12,1,0,0,82
114253,1144174,1,12,2,6,0,88
114254,1144174,1,12,3,1,0,89
114255,1144174,1,12,4,3,0,92
114256,1144174,1,12,5,4,0,96
114257,1144174,1,12,6,0,0,96
114258,1144174,1,13,1,1,0,97
114259,1144174,1,13,2,0,0,97
114260,1144174,1,13,3,4,0,101
114261,1144174,1,13,4,1,0,102
114262,1144174,1,13,5,6,0,108
114263,1144174,1,13,6,1,0,109
114264,1144174,1,14,1,1,0,110
114265,1144174,1,14,2,1,0,111
114266,1144174,1,14,3,0,0,111
114267,1144174,1,14,4,4,0,115
114268,1144174,1,14,5,1,0,116
114269,1144174,1,14,6,0,0,116
114270,1144174,1,15,1,2,0,118
114271,1144174,1,15,2,2,0,120
114272,1144174,1,15,3,1,0,121
114273,1144174,1,15,4,0,0,121
114274,1144174,1,15,5,6,0,127
114275,1144174,1,15,6,0,1,127
114276,1144174,1,16,1,4,0,131
114277,1144174,1,16,2,4,0,135
114278,1144174,1,16,3,4,0,139
114279,1144174,1,16,4,1,0,140
114280,1144174,1,16,5,1,0,141
114281,1144174,1,16,6,1,0,142
114282,1144174,1,17,1,4,0,146
114283,1144174,1,17,2,1,0,147
114284,1144174,1,17,3,1,0,148
114285,1144174,1,17,4,6,0,154
114286,1144174,1,17,5,1,0,155
114287,1144174,1,17,6,1,0,156
114288,1144174,1,18,1,2,0,158
114289,1144174,1,18,2,0,0,158
114290,1144174,1,18,3,4,0,162
114291,1144174,1,18,4,6,0,168
114292,1144174,1,18,5,4,0,172
114293,1144174,1,18,6,1,0,173
114294,1144174,1,19,1,1,0,174
114295,1144174,1,19,2,2,0,176
114296,1144174,1,19,3,0,0,176
114297,1144174,1,19,4,1,0,177
114298,1144174,1,19,5,6,0,183
114299,1144174,1,19,6,6,0,189
114300,1144174,1,20,1,1,0,190
114301,1144174,1,20,2,1,0,191
114302,1144174,1,20,3,4,0,195
114303,1144174,1,20,4,1,0,196
114304,1144174,1,20,5,1,0,197
114305,1144174,1,20,6,1,0,198
114400,1144989,1,1,1,2,0,2
114401,1144989,1,1,2,0,0,2
114402,1144989,1,1,3,6,0,8
114403,1144989,1,1,4,3,0,11
114404,1144989,1,1,5,4,0,15
114405,1144989,1,1,6,0,0,15
114406,1144989,1,2,1,1,0,16
114407,1144989,1,2,2,2,0,18
114408,1144989,1,2,3,0,0,18
114409,1144989,1,2,4,0,0,18
114410,1144989,1,2,5,0,0,18
114411,1144989,1,2,6,6,0,24
114412,1144989,1,3,1,4,0,28
114413,1144989,1,3,2,4,0,32
114414,1144989,1,3,3,6,0,38
114415,1144989,1,3,4,4,0,42
114416,1144989,1,3,5,0,1,42
114417,1144989,1,3,6,0,0,42
114418,1144989,1,4,1,1,0,43
114419,1144989,1,4,2,1,0,44
114420,1144989,1,4,3,2,0,46
114421,1144989,1,4,4,1,0,47
114422,1144989,1,4,5,0,0,47
114423,1144989,1,4,6,1,0,48
114424,1144989,1,5,1,3,0,51
114425,1144989,1,5,2,1,0,52
114426,1144989,1,5,3,1,0,53
114427,1144989,1,5,4,2,0,55
114428,1144989,1,5,5,4,0,59
114429,1144989,1,5,6,2,0,61
114430,1144989,1,6,1,0,1,61
114431,1144989,1,6,2,1,0,62
114432,1144989,1,6,3,4,0,66
114433,1144989,1,6,4,0,0,66
114434,1144989,1,6,5,0,0,66
114435,1144989,1,6,6,4,0,70
114436,1144989,1,7,1,2,0,72
114437,1144989,1,7,2,4,0,76
114438,1144989,1,7,3,2,0,78
114439,1144989,1,7,4,2,0,80
114440,1144989,1,7,5,4,0,84
114441,1144989,1,7,6,0,1,84
114442,1144989,1,8,1,2,0,86
114443,1144989,1,8,2,1,0,87
114444,1144989,1,8,3,2,0,89
114445,1144989,1,8,4,4,0,93
114446,1144989,1,8,5,1,0,94
114447,1144989,1,8,6,4,0,98
114448,1144989,1,9,1,1,0,99
114449,1144989,1,9,2,0,1,99
114450,1144989,1,9,3,2,0,101
114451,1144989,1,9,4,0,0,101
114452,1144989,1,9,5,1,0,102
114453,1144989,1,9,6,2,0,104
114454,1144989,1,10,1,0,1,104
114455,1144989,1,10,2,1,0,105
114456,1144989,1,10,3,1,1,106
114457,1144989,1,10,4,2,0,108
114458,1144989,1,10,5,0,0,108
114459,1144989,1,10,6,0,0,108
114520,1144990,1,1,1,0,0,0
114521,1144990,1,1,2,0,0,0
114522,1144990,1,1,3,0,0,0
114523,1144990,1,1,4,0,0,0
114524,1144990,1,1,5,0,0,0
114525,1144990,1,1,6,1,0,1
114526,1144990,1,2,1,0,0,1
114527,1144990,1,2,2,1,0,2
114528,1144990,1,2,3,0,0,2
114529,1144990,1,2,4,2,0,4
114530,1144990,1,2,5,1,0,5
114531,1144990,1,2,6,0,0,5
114532,1144990,1,3,1,0,0,5
114533,1144990,1,3,2,0,0,5
114534,1144990,1,3,3,0,0,5
114535,1144990,1,3,4,2,0,7
114536,1144990,1,3,5,1,0,8
114537,1144990,1,3,6,4,0,12
114538,1144990,1,4,1,1,0,13
114539,1144990,1,4,2,1,0,14
114540,1144990,1,4,3,4,0,18
114541,1144990,1,4,4,4,0,22
114542,1144990,1,4,5,0,0,22
114543,1144990,1,4,6,2,0,24
114544,1144990,1,5,1,0,1,24
114545,1144990,1,5,2,1,0,25
114546,1144990,1,5,3,4,0,29
114547,1144990,1,5,4,0,0,29
114548,1144990,1,5,5,1,0,30
114549,1144990,1,5,6,1,0,31
114550,1144990,1,6,1,4,0,35
114551,1144990,1,6,2,1,0,36
114552,1144990,1,6,3,0,0,36
114553,1144990,1,6,4,0,0,36
114554,1144990,1,6,5,1,0,37
114555,1144990,1,6,6,1,0,38
114556,1144990,1,7,1,1,0,39
114557,1144990,1,7,2,1,0,40
114558,1144990,1,7,3,1,0,41
114559,1144990,1,7,4,1,0,42
114560,1144990,1,7,5,0,0,42
114561,1144990,1,7,6,0,0,42
114562,1144990,1,8,1,6,0,48
114563,1144990,1,8,2,0,0,48
114564,1144990,1,8,3,2,0,50
114565,1144990,1,8,4,6,0,56
114566,1144990,1,8,5,6,0,62
114567,1144990,1,8,6,1,0,63
114568,1144990,1,9,1,1,0,64
114569,1144990,1,9,2,0,0,64
114570,1144990,1,9,3,0,1,64
114571,1144990,1,9,4,2,0,66
114572,1144990,1,9,5,1,0,67
114573,1144990,1,9,6,0,0,67
114574,1144990,1,10,1,0,0,67
114575,1144990,1,10,2,0,0,67
114576,1144990,1,10,3,1,0,68
114577,1144990,1,10,4,6,0,74
114578,1144990,1,10,5,0,0,74
114579,1144990,1,10,6,1,0,75
114580,1144990,1,11,1,0,1,75
114581,1144990,1,11,2,2,0,77
114582,1144990,1,11,3,4,0,81
114583,1144990,1,11,4,1,0,82
114584,1144990,1,11,5,0,0,82
114585,1144990,1,11,6,1,0,83
114586,1144990,1,12,1,2,0,85
114587,1144990,1,12,2,1,0,86
114588,1144990,1,12,3,2,0,88
114589,1144990,1,12,4,1,0,89
114590,1144990,1,12,5,0,0,89
114591,1144990,1,12,6,1,0,90
114592,1144990,1,13,1,1,0,91
114593,1144990,1,13,2,0,0,91
114594,1144990,1,13,3,4,0,95
114595,1144990,1,13,4,4,0,99
114596,1144990,1,13,5,1,0,100
114597,1144990,1,13,6,4,0,104
114598,1144990,1,14,1,2,0,106
114599,1144990,1,14,2,6,0,112
114600,1144990,1,14,3,6,0,118
114601,1144990,1,14,4,6,0,124
114602,1144990,1,14,5,2,0,126
114603,1144990,1,14,6,1,0,127
114604,1144990,1,15,1,3,0,130
114605,1144990,1,15,2,1,0,131
114606,1144990,1,15,3,0,0,131
114607,1144990,1,15,4,1,0,132
114608,1144990,1,15,5,1,0,133
114609,1144990,1,15,6,2,0,135
114610,1144990,1,16,1,6,0,141
114611,1144990,1,16,2,2,0,143
114612,1144990,1,16,3,0,0,143
114613,1144990,1,16,4,1,0,144
114614,1144990,1,16,5,6,0,150
114615,1144990,1,16,6,2,0,152
114616,1144990,1,17,1,1,0,153
114617,1144990,1,17,2,0,1,153
114618,1144990,1,17,3,2,0,155
114619,1144990,1,17,4,0,0,155
114620,1144990,1,17,5,1,0,156
114621,1144990,1,17,6,2,0,158
114724,1144992,1,1,1,1,0,1
114725,1144992,1,1,2,0,0,1
114726,1144992,1,1,3,1,0,2
114727,1144992,1,1,4,4,0,6
114728,1144992,1,1,5,1,0,7
114729,1144992,1,1,6,1,0,8
114730,1144992,1,2,1,0,0,8
114731,1144992,1,2,2,4,0,12
114732,1144992,1,2,3,3,0,15
114733,1144992,1,2,4,1,0,16
114734,1144992,1,2,5,0,0,16
114735,1144992,1,2,6,0,0,16
114736,1144992,1,3,1,4,0,20
114737,1144992,1,3,2,0,0,20
114738,1144992,1,3,3,0,0,20
114739,1144992,1,3,4,0,0,20
114740,1144992,1,3,5,0,0,20
114741,1144992,1,3,6,1,0,21
114742,1144992,1,4,1,4,0,25
114743,1144992,1,4,2,0,0,25
114744,1144992,1,4,3,1,0,26
114745,1144992,1,4,4,0,0,26
114746,1144992,1,4,5,1,0,27
114747,1144992,1,4,6,1,0,28
114748,1144992,1,5,1,1,0,29
114749,1144992,1,5,2,4,0,33
114750,1144992,1,5,3,2,0,35
114751,1144992,1,5,4,1,0,36
114752,1144992,1,5,5,1,0,37
114753,1144992,1,5,6,4,0,41
114754,1144992,1,6,1,1,0,42
114755,1144992,1,6,2,1,0,43
114756,1144992,1,6,3,1,0,44
114757,1144992,1,6,4,1,0,45
114758,1144992,1,6,5,0,0,45
114759,1144992,1,6,6,4,0,49
114760,1144992,1,7,1,0,0,49
114761,1144992,1,7,2,1,0,50
114762,1144992,1,7,3,0,0,50
114763,1144992,1,7,4,0,0,50
114764,1144992,1,7,5,2,0,52
114765,1144992,1,7,6,0,0,52
114766,1144992,1,8,1,1,0,53
114767,1144992,1,8,2,1,0,54
114768,1144992,1,8,3,1,0,55
114769,1144992,1,8,4,4,0,59
114770,1144992,1,8,5,1,0,60
114771,1144992,1,8,6,4,0,64
114772,1144992,1,9,1,1,0,65
114773,1144992,1,9,2,3,0,68
114774,1144992,1,9,3,0,1,68
114775,1144992,1,9,4,1,0,69
114776,1144992,1,9,5,4,0,73
114777,1144992,1,9,6,0,0,73
114778,1144992,1,10,1,0,1,73
114779,1144992,1,10,2,0,1,73
114780,1144992,1,10,3,1,0,74
114781,1144992,1,10,4,1,0,75
114782,1144992,1,10,5,1,0,76
114783,1144992,1,10,6,0,0,76
114784,1144992,1,11,1,1,0,77
114785,1144992,1,11,2,0,0,77
114786,1144992,1,11,3,0,0,77
114787,1144992,1,11,4,0,0,77
114788,1144992,1,11,5,1,0,78
114789,1144992,1,11,6,1,0,79
114790,1144992,1,12,1,0,0,79
114791,1144992,1,12,2,0,0,79
114792,1144992,1,12,3,1,0,80
114793,1144992,1,12,4,4,0,84
114794,1144992,1,12,5,0,0,84
114795,1144992,1,12,6,1,0,85
114796,1144992,1,13,1,1,0,86
114797,1144992,1,13,2,2,0,88
114798,1144992,1,13,3,0,0,88
114799,1144992,1,13,4,1,0,89
114800,1144992,1,13,5,0,0,89
114801,1144992,1,13,6,1,0,90
114802,1144992,1,14,1,0,1,90
114803,1144992,1,14,2,1,0,91
114804,1144992,1,14,3,1,0,92
114805,1144992,1,14,4,4,0,96
114806,1144992,1,14,5,1,0,97
114807,1144992,1,14,6,1,0,98
114808,1144992,1,15,1,2,0,100
114809,1144992,1,15,2,0,0,100
114810,1144992,1,15,3,4,0,104
114811,1144992,1,15,4,1,0,105
114812,1144992,1,15,5,0,0,105
114813,1144992,1,15,6,2,0,107
114814,1144992,1,16,1,2,0,109
114815,1144992,1,16,2,2,0,111
114816,1144992,1,16,3,4,0,115
114817,1144992,1,16,4,4,0,119
114818,1144992,1,16,5,0,1,119
114819,1144992,1,16,6,1,0,120
114820,1144992,1,17,1,1,0,121
114821,1144992,1,17,2,1,0,122
114822,1144992,1,17,3,1,0,123
114823,1144992,1,17,4,4,0,127
114824,1144992,1,17,5,1,0,128
114825,1144992,1,17,6,1,0,129
114826,1144992,1,18,1,2,0,131
114827,1144992,1,18,2,0,1,131
114828,1144992,1,18,3,0,0,131
114829,1144992,1,18,4,1,0,132
114830,1144992,1,18,5,1,0,133
114831,1144992,1,18,6,4,0,137
114832,1144992,1,19,1,2,0,139
114833,1144992,1,19,2,1,0,140
114834,1144992,1,19,3,1,0,141
114835,1144992,1,19,4,4,0,145
114836,1144992,1,19,5,0,0,145
114837,1144992,1,19,6,4,0,149
114838,1144992,1,20,1,4,0,153
114839,1144992,1,20,2,1,0,154
114840,1144992,1,20,3,1,0,155
114841,1144992,1,20,4,2,0,157
114842,1144992,1,20,5,2,0,159
114843,1144992,1,20,6,5,0,164
114962,1145982,1,1,1,0,0,0
114963,1145982,1,1,2,4,0,4
114964,1145982,1,1,3,0,0,4
114965,1145982,1,1,4,1,0,5
114966,1145982,1,1,5,0,0,5
114967,1145982,1,1,6,4,0,9
114968,1145982,1,2,1,0,0,9
114969,1145982,1,2,2,1,0,10
114970,1145982,1,2,3,0,0,10
114971,1145982,1,2,4,1,0,11
114972,1145982,1,2,5,1,0,12
114973,1145982,1,2,6,1,0,13
114974,1145982,1,3,1,4,0,17
114975,1145982,1,3,2,0,0,17
114976,1145982,1,3,3,4,0,21
114977,1145982,1,3,4,1,0,22
114978,1145982,1,3,5,0,0,22
114979,1145982,1,3,6,1,0,23
114980,1145982,1,4,1,0,0,23
114981,1145982,1,4,2,0,0,23
114982,1145982,1,4,3,1,0,24
114983,1145982,1,4,4,1,0,25
114984,1145982,1,4,5,1,0,26
114985,1145982,1,4,6,1,0,27
114986,1145982,1,5,1,0,0,27
114987,1145982,1,5,2,6,0,33
114988,1145982,1,5,3,1,0,34
114989,1145982,1,5,4,0,0,34
114990,1145982,1,5,5,4,0,38
114991,1145982,1,5,6,4,0,42
114992,1145982,1,6,1,1,0,43
114993,1145982,1,6,2,0,0,43
114994,1145982,1,6,3,0,0,43
114995,1145982,1,6,4,1,0,44
114996,1145982,1,6,5,0,0,44
114997,1145982,1,6,6,0,0,44
114998,1145982,1,7,1,0,0,44
114999,1145982,1,7,2,0,0,44
115000,1145982,1,7,3,0,0,44
115001,1145982,1,7,4,4,0,48
115002,1145982,1,7,5,1,0,49
115003,1145982,1,7,6,6,0,55
115004,1145982,1,8,1,1,0,56
115005,1145982,1,8,2,1,0,57
115006,1145982,1,8,3,1,0,58
115007,1145982,1,8,4,1,0,59
115008,1145982,1,8,5,0,0,59
115009,1145982,1,8,6,1,0,60
115010,1145982,1,9,1,1,0,61
115011,1145982,1,9,2,1,0,62
115012,1145982,1,9,3,0,1,62
115013,1145982,1,9,4,1,0,63
115014,1145982,1,9,5,1,0,64
115015,1145982,1,9,6,0,0,64
115016,1145982,1,10,1,2,0,66
115017,1145982,1,10,2,1,0,67
115018,1145982,1,10,3,1,0,68
115019,1145982,1,10,4,1,0,69
115020,1145982,1,10,5,2,0,71
115021,1145982,1,10,6,1,0,72
115022,1145982,1,11,1,0,0,72
115023,1145982,1,11,2,6,0,78
115024,1145982,1,11,3,1,0,79
115025,1145982,1,11,4,1,0,80
115026,1145982,1,11,5,1,0,81
115027,1145982,1,11,6,1,0,82
115028,1145982,1,12,1,1,0,83
115029,1145982,1,12,2,0,0,83
115030,1145982,1,12,3,1,0,84
115031,1145982,1,12,4,1,0,85
115032,1145982,1,12,5,1,0,86
115033,1145982,1,12,6,0,1,86
115034,1145982,1,13,1,1,0,87
115035,1145982,1,13,2,1,0,88
115036,1145982,1,13,3,1,0,89
115037,1145982,1,13,4,0,0,89
115038,1145982,1,13,5,1,0,90
115039,1145982,1,13,6,0,0,90
115040,1145982,1,14,1,0,0,90
115041,1145982,1,14,2,0,1,90
115042,1145982,1,14,3,1,0,91
115043,1145982,1,14,4,0,0,91
115044,1145982,1,14,5,0,1,91
115045,1145982,1,14,6,0,0,91
115046,1145982,1,15,1,2,0,93
115047,1145982,1,15,2,1,0,94
115048,1145982,1,15,3,0,0,94
115049,1145982,1,15,4,1,0,95
115050,1145982,1,15,5,1,0,96
115051,1145982,1,15,6,0,0,96
115052,1145982,1,16,1,1,0,97
115053,1145982,1,16,2,1,0,98
115054,1145982,1,16,3,1,0,99
115055,1145982,1,16,4,6,0,105
115056,1145982,1,16,5,0,0,105
115057,1145982,1,16,6,0,0,105
115058,1145982,1,17,1,1,0,106
115059,1145982,1,17,2,4,0,110
115060,1145982,1,17,3,2,0,112
115061,1145982,1,17,4,1,0,113
115062,1145982,1,17,5,1,0,114
115063,1145982,1,17,6,1,0,115
115064,1145982,1,18,1,6,0,121
115065,1145982,1,18,2,4,0,125
115066,1145982,1,18,3,0,0,125
115067,1145982,1,18,4,4,0,129
115068,1145982,1,18,5,6,0,135
115069,1145982,1,18,6,0,1,135
115070,1145982,1,19,1,6,0,141
115071,1145982,1,19,2,1,0,142
115072,1145982,1,19,3,1,0,143
115073,1145982,1,19,4,4,0,147
115074,1145982,1,19,5,0,0,147
115075,1145982,1,19,6,1,0,148
115076,1145982,1,20,1,6,0,154
115077,1145982,1,20,2,6,0,160
115078,1145982,1,20,3,0,1,160
115079,1145982,1,20,4,0,0,160
115080,1145982,1,20,5,1,2,161
115081,1145982,1,20,6,6,0,167
115196,1145983,1,1,1,0,0,0
115197,1145983,1,1,2,1,0,1
115198,1145983,1,1,3,0,0,1
115199,1145983,1,1,4,0,0,1
115200,1145983,1,1,5,0,0,1
115201,1145983,1,1,6,0,0,1
115202,1145983,1,2,1,0,1,1
115203,1145983,1,2,2,3,0,4
115204,1145983,1,2,3,4,0,8
115205,1145983,1,2,4,1,0,9
115206,1145983,1,2,5,0,0,9
115207,1145983,1,2,6,0,0,9
115208,1145983,1,3,1,1,0,10
115209,1145983,1,3,2,0,0,10
115210,1145983,1,3,3,0,0,10
115211,1145983,1,3,4,1,0,11
115212,1145983,1,3,5,0,0,11
115213,1145983,1,3,6,1,0,12
115214,1145983,1,4,1,4,0,16
115215,1145983,1,4,2,0,0,16
115216,1145983,1,4,3,1,0,17
115217,1145983,1,4,4,4,0,21
115218,1145983,1,4,5,4,0,25
115219,1145983,1,4,6,4,0,29
115220,1145983,1,5,1,0,0,29
115221,1145983,1,5,2,1,0,30
115222,1145983,1,5,3,0,1,30
115223,1145983,1,5,4,1,0,31
115224,1145983,1,5,5,1,0,32
115225,1145983,1,5,6,1,0,33
115226,1145983,1,6,1,0,0,33
115227,1145983,1,6,2,4,0,37
115228,1145983,1,6,3,0,0,37
115229,1145983,1,6,4,0,0,37
115230,1145983,1,6,5,1,0,38
115231,1145983,1,6,6,4,0,42
115232,1145983,1,7,1,2,0,44
115233,1145983,1,7,2,1,0,45
115234,1145983,1,7,3,1,0,46
115235,1145983,1,7,4,1,0,47
115236,1145983,1,7,5,0,0,47
115237,1145983,1,7,6,4,0,51
115238,1145983,1,8,1,0,0,51
115239,1145983,1,8,2,1,0,52
115240,1145983,1,8,3,1,0,53
115241,1145983,1,8,4,1,0,54
115242,1145983,1,8,5,0,0,54
115243,1145983,1,8,6,1,0,55
115244,1145983,1,9,1,0,0,55
115245,1145983,1,9,2,1,0,56
115246,1145983,1,9,3,6,0,62
115247,1145983,1,9,4,1,0,63
115248,1145983,1,9,5,4,0,67
115249,1145983,1,9,6,4,0,71
115250,1145983,1,10,1,1,0,72
115251,1145983,1,10,2,1,0,73
115252,1145983,1,10,3,1,0,74
115253,1145983,1,10,4,1,0,75
115254,1145983,1,10,5,0,1,75
115255,1145983,1,10,6,6,0,81
115256,1145983,1,11,1,1,0,82
115257,1145983,1,11,2,1,0,83
115258,1145983,1,11,3,1,0,84
115259,1145983,1,11,4,0,0,84
115260,1145983,1,11,5,1,0,85
115261,1145983,1,11,6,0,0,85
115262,1145983,1,12,1,1,0,86
115263,1145983,1,12,2,1,0,87
115264,1145983,1,12,3,1,0,88
115265,1145983,1,12,4,1,0,89
115266,1145983,1,12,5,4,0,93
115267,1145983,1,12,6,0,1,93
115268,1145983,1,13,1,0,0,93
115269,1145983,1,13,2,0,0,93
115270,1145983,1,13,3,0,0,93
115271,1145983,1,13,4,1,0,94
115272,1145983,1,13,5,0,0,94
115273,1145983,1,13,6,0,0,94
115274,1145983,1,14,1,1,0,95
115275,1145983,1,14,2,1,0,96
115276,1145983,1,14,3,1,0,97
115277,1145983,1,14,4,1,0,98
115278,1145983,1,14,5,0,0,98
115279,1145983,1,14,6,1,0,99
115280,1145983,1,15,1,0,0,99
115281,1145983,1,15,2,0,0,99
115282,1145983,1,15,3,1,0,100
115283,1145983,1,15,4,0,0,100
115284,1145983,1,15,5,1,0,101
115285,1145983,1,15,6,0,0,101
115286,1145983,1,16,1,0,1,101
115287,1145983,1,16,2,2,0,103
115288,1145983,1,16,3,0,0,103
115289,1145983,1,16,4,0,1,103
115290,1145983,1,16,5,0,1,103
115291,1145983,1,16,6,0,0,103
115292,1145983,1,17,1,1,0,104
115293,1145983,1,17,2,1,0,105
115294,1145983,1,17,3,0,0,105
115295,1145983,1,17,4,1,0,106
115296,1145983,1,17,5,1,0,107
115297,1145983,1,17,6,0,0,107
115298,1145983,1,18,1,1,0,108
115299,1145983,1,18,2,0,0,108
115300,1145983,1,18,3,0,0,108
115301,1145983,1,18,4,0,0,108
115302,1145983,1,18,5,0,1,108
115303,1145983,1,18,6,0,0,108
115304,1145983,1,19,1,1,0,109
115305,1145983,1,19,2,0,0,109
115306,1145983,1,19,3,2,0,111
115307,1145983,1,19,4,6,0,117
115308,1145983,1,19,5,4,0,121
115309,1145983,1,19,6,0,0,121
115310,1145983,1,20,1,4,0,125
115311,1145983,1,20,2,1,0,126
115312,1145983,1,20,3,2,0,128
115313,1145983,1,20,4,0,0,128
115314,1145983,1,20,5,6,0,134
115315,1145983,1,20,6,0,0,134
115429,1145984,1,1,1,0,0,0
115430,1145984,1,1,2,4,0,4
115431,1145984,1,1,3,3,0,7
115432,1145984,1,1,4,0,0,7
115433,1145984,1,1,5,5,0,12
115434,1145984,1,1,6,6,0,18
115435,1145984,1,2,1,0,0,18
115436,1145984,1,2,2,1,0,19
115437,1145984,1,2,3,1,0,20
115438,1145984,1,2,4,0,0,20
115439,1145984,1,2,5,0,0,20
115440,1145984,1,2,6,0,0,20
115441,1145984,1,3,1,1,0,21
115442,1145984,1,3,2,1,0,22
115443,1145984,1,3,3,0,0,22
115444,1145984,1,3,4,4,0,26
115445,1145984,1,3,5,0,0,26
115446,1145984,1,3,6,0,0,26
115447,1145984,1,4,1,0,0,26
115448,1145984,1,4,2,1,0,27
115449,1145984,1,4,3,1,0,28
115450,1145984,1,4,4,5,0,33
115451,1145984,1,4,5,0,0,33
115452,1145984,1,4,6,1,0,34
115453,1145984,1,5,1,0,0,34
115454,1145984,1,5,2,0,0,34
115455,1145984,1,5,3,1,0,35
115456,1145984,1,5,4,0,0,35
115457,1145984,1,5,5,0,0,35
115458,1145984,1,5,6,0,0,35
115459,1145984,1,6,1,2,0,37
115460,1145984,1,6,2,0,0,37
115461,1145984,1,6,3,6,0,43
115462,1145984,1,6,4,0,0,43
115463,1145984,1,6,5,0,0,43
115464,1145984,1,6,6,0,0,43
115465,1145984,1,7,1,1,0,44
115466,1145984,1,7,2,1,0,45
115467,1145984,1,7,3,0,0,45
115468,1145984,1,7,4,1,0,46
115469,1145984,1,7,5,5,0,51
115470,1145984,1,7,6,0,0,51
115471,1145984,1,8,1,2,0,53
115472,1145984,1,8,2,1,0,54
115473,1145984,1,8,3,1,0,55
115474,1145984,1,8,4,0,1,55
115475,1145984,1,8,5,0,0,55
115476,1145984,1,8,6,1,0,56
115477,1145984,1,9,1,1,0,57
115478,1145984,1,9,2,1,0,58
115479,1145984,1,9,3,0,0,58
115480,1145984,1,9,4,1,0,59
115481,1145984,1,9,5,0,1,59
115482,1145984,1,9,6,0,0,59
115483,1145984,1,10,1,1,0,60
115484,1145984,1,10,2,0,0,60
115485,1145984,1,10,3,1,0,61
115486,1145984,1,10,4,1,0,62
115487,1145984,1,10,5,1,0,63
115488,1145984,1,10,6,1,0,64
115489,1145984,1,11,1,6,0,70
115490,1145984,1,11,2,1,0,71
115491,1145984,1,11,3,1,0,72
115492,1145984,1,11,4,1,0,73
115493,1145984,1,11,5,0,0,73
115494,1145984,1,11,6,0,0,73
115495,1145984,1,12,1,0,0,73
115496,1145984,1,12,2,1,0,74
115497,1145984,1,12,3,0,0,74
115498,1145984,1,12,4,1,0,75
115499,1145984,1,12,5,7,0,82
115500,1145984,1,12,6,0,0,82
115501,1145984,1,13,1,0,0,82
115502,1145984,1,13,2,6,0,88
115503,1145984,1,13,3,1,0,89
115504,1145984,1,13,4,6,0,95
115505,1145984,1,13,5,0,1,95
115506,1145984,1,13,6,0,0,95
115507,1145984,1,14,1,1,0,96
115508,1145984,1,14,2,1,0,97
115509,1145984,1,14,3,0,0,97
115510,1145984,1,14,4,1,0,98
115511,1145984,1,14,5,2,0,100
115512,1145984,1,14,6,1,0,101
115513,1145984,1,15,1,0,1,101
115514,1145984,1,15,2,2,0,103
115515,1145984,1,15,3,1,0,104
115516,1145984,1,15,4,1,0,105
115517,1145984,1,15,5,1,0,106
115518,1145984,1,15,6,1,0,107
115519,1145984,1,16,1,1,0,108
115520,1145984,1,16,2,0,0,108
115521,1145984,1,16,3,0,0,108
115522,1145984,1,16,4,0,0,108
115523,1145984,1,16,5,0,0,108
115524,1145984,1,16,6,1,0,109
115525,1145984,1,17,1,0,0,109
115526,1145984,1,17,2,0,0,109
115527,1145984,1,17,3,6,0,115
115528,1145984,1,17,4,4,0,119
115529,1145984,1,17,5,1,0,120
115530,1145984,1,17,6,1,0,121
115531,1145984,1,18,1,4,0,125
115532,1145984,1,18,2,1,0,126
115533,1145984,1,18,3,1,0,127
115534,1145984,1,18,4,6,0,133
115535,1145984,1,18,5,1,0,134
115536,1145984,1,18,6,1,0,135
115537,1145984,1,19,1,0,1,135
115538,1145984,1,19,2,2,0,137
115539,1145984,1,19,3,1,0,138
115540,1145984,1,19,4,2,0,140
115541,1145984,1,19,5,1,0,141
115542,1145984,1,19,6,1,0,142
115543,1145984,1,20,1,0,0,142
115544,1145984,1,20,2,0,1,142
115545,1145984,1,20,3,1,0,143
115546,1145984,1,20,4,1,0,144
115547,1145984,1,20,5,0,0,144
115548,1145984,1,20,6,1,0,145
115669,1146723,1,1,1,0,1,0
115670,1146723,1,1,2,4,0,4
115671,1146723,1,1,3,1,0,5
115672,1146723,1,1,4,0,1,5
115673,1146723,1,1,5,1,0,6
115674,1146723,1,1,6,0,0,6
115675,1146723,1,2,1,1,0,7
115676,1146723,1,2,2,0,0,7
115677,1146723,1,2,3,0,0,7
115678,1146723,1,2,4,0,0,7
115679,1146723,1,2,5,0,0,7
115680,1146723,1,2,6,1,0,8
115681,1146723,1,3,1,0,0,8
115682,1146723,1,3,2,0,0,8
115683,1146723,1,3,3,4,0,12
115684,1146723,1,3,4,4,0,16
115685,1146723,1,3,5,0,0,16
115686,1146723,1,3,6,1,0,17
115687,1146723,1,4,1,0,0,17
115688,1146723,1,4,2,3,0,20
115689,1146723,1,4,3,4,0,24
115690,1146723,1,4,4,0,0,24
115691,1146723,1,4,5,4,0,28
115692,1146723,1,4,6,4,0,32
115693,1146723,1,5,1,1,0,33
115694,1146723,1,5,2,4,0,37
115695,1146723,1,5,3,0,0,37
115696,1146723,1,5,4,1,0,38
115697,1146723,1,5,5,2,0,40
115698,1146723,1,5,6,1,0,41
115699,1146723,1,6,1,2,0,43
115700,1146723,1,6,2,0,1,43
115701,1146723,1,6,3,0,1,43
115702,1146723,1,6,4,0,0,43
115703,1146723,1,6,5,0,0,43
115704,1146723,1,6,6,0,0,43
115705,1146723,1,7,1,1,0,44
115706,1146723,1,7,2,1,0,45
115707,1146723,1,7,3,1,0,46
115708,1146723,1,7,4,4,0,50
115709,1146723,1,7,5,4,0,54
115710,1146723,1,7,6,6,0,60
115711,1146723,1,8,1,2,0,62
115712,1146723,1,8,2,0,0,62
115713,1146723,1,8,3,2,0,64
115714,1146723,1,8,4,1,0,65
115715,1146723,1,8,5,1,0,66
115716,1146723,1,8,6,6,0,72
115717,1146723,1,9,1,1,0,73
115718,1146723,1,9,2,6,0,79
115719,1146723,1,9,3,2,0,81
115720,1146723,1,9,4,0,0,81
115721,1146723,1,9,5,0,0,81
115722,1146723,1,9,6,4,0,85
115723,1146723,1,10,1,1,0,86
115724,1146723,1,10,2,4,0,90
115725,1146723,1,10,3,0,1,90
115726,1146723,1,10,4,1,0,91
115727,1146723,1,10,5,4,0,95
115728,1146723,1,10,6,0,0,95
115729,1146723,1,11,1,1,0,96
115730,1146723,1,11,2,1,0,97
115731,1146723,1,11,3,1,0,98
115732,1146723,1,11,4,0,0,98
115733,1146723,1,11,5,1,0,99
115734,1146723,1,11,6,1,0,100
115735,1146723,1,12,1,1,0,101
115736,1146723,1,12,2,1,0,102
115737,1146723,1,12,3,2,0,104
115738,1146723,1,12,4,1,0,105
115739,1146723,1,12,5,1,0,106
115740,1146723,1,12,6,1,0,107
115741,1146723,1,13,1,0,0,107
115742,1146723,1,13,2,0,0,107
115743,1146723,1,13,3,0,0,107
115744,1146723,1,13,4,0,0,107
115745,1146723,1,13,5,1,0,108
115746,1146723,1,13,6,0,0,108
115747,1146723,1,14,1,4,0,112
115748,1146723,1,14,2,1,0,113
115749,1146723,1,14,3,1,0,114
115750,1146723,1,14,4,1,0,115
115751,1146723,1,14,5,1,0,116
115752,1146723,1,14,6,0,0,116
115753,1146723,1,15,1,0,1,116
115754,1146723,1,15,2,0,0,116
115755,1146723,1,15,3,4,0,120
115756,1146723,1,15,4,0,0,120
115757,1146723,1,15,5,1,0,121
115758,1146723,1,15,6,0,0,121
115759,1146723,1,16,1,0,0,121
115760,1146723,1,16,2,1,0,122
115761,1146723,1,16,3,1,0,123
115762,1146723,1,16,4,1,0,124
115763,1146723,1,16,5,1,0,125
115764,1146723,1,16,6,0,0,125
115765,1146723,1,17,1,0,1,125
115766,1146723,1,17,2,0,0,125
115767,1146723,1,17,3,1,0,126
115768,1146723,1,17,4,2,0,128
115769,1146723,1,17,5,1,0,129
115770,1146723,1,17,6,1,0,130
115771,1146723,1,18,1,0,0,130
115772,1146723,1,18,2,0,0,130
115773,1146723,1,18,3,0,0,130
115774,1146723,1,18,4,1,0,131
115775,1146723,1,18,5,0,0,131
115776,1146723,1,18,6,1,0,132
115777,1146723,1,19,1,0,1,132
115778,1146723,1,19,2,5,0,137
115779,1146723,1,19,3,0,1,137
115780,1146723,1,19,4,0,0,137
115781,1146723,1,19,5,1,0,138
115782,1146723,1,19,6,1,0,139
115783,1146723,1,20,1,1,0,140
115784,1146723,1,20,2,1,0,141
115785,1146723,1,20,3,0,0,141
115786,1146723,1,20,4,1,0,142
115787,1146723,1,20,5,0,0,142
115788,1146723,1,20,6,1,0,143
115844,1146724,1,1,1,0,0,0
115845,1146724,1,1,2,0,0,0
115846,1146724,1,1,3,1,0,1
115847,1146724,1,1,4,0,0,1
115848,1146724,1,1,5,0,0,1
115849,1146724,1,1,6,1,0,2
115850,1146724,1,2,1,0,0,2
115851,1146724,1,2,2,4,0,6
115852,1146724,1,2,3,1,0,7
115853,1146724,1,2,4,0,0,7
115854,1146724,1,2,5,0,1,7
115855,1146724,1,2,6,1,0,8
115856,1146724,1,3,1,1,0,9
115857,1146724,1,3,2,4,0,13
115858,1146724,1,3,3,0,0,13
115859,1146724,1,3,4,0,0,13
115860,1146724,1,3,5,6,0,19
115861,1146724,1,3,6,1,0,20
115862,1146724,1,4,1,2,0,22
115863,1146724,1,4,2,2,0,24
115864,1146724,1,4,3,0,1,24
115865,1146724,1,4,4,1,0,25
115866,1146724,1,4,5,1,0,26
115867,1146724,1,4,6,0,0,26
115868,1146724,1,5,1,0,0,26
115869,1146724,1,5,2,1,0,27
115870,1146724,1,5,3,0,0,27
115871,1146724,1,5,4,0,0,27
115872,1146724,1,5,5,0,0,27
115873,1146724,1,5,6,0,0,27
115874,1146724,1,6,1,1,0,28
115875,1146724,1,6,2,0,0,28
115876,1146724,1,6,3,0,0,28
115877,1146724,1,6,4,6,0,34
115878,1146724,1,6,5,0,0,34
115879,1146724,1,6,6,1,0,35
115880,1146724,1,7,1,1,0,36
115881,1146724,1,7,2,1,0,37
115882,1146724,1,7,3,2,0,39
115883,1146724,1,7,4,0,0,39
115884,1146724,1,7,5,0,0,39
115885,1146724,1,7,6,4,0,43
115886,1146724,1,8,1,4,0,47
115887,1146724,1,8,2,1,0,48
115888,1146724,1,8,3,0,0,48
115889,1146724,1,8,4,0,1,48
115890,1146724,1,8,5,0,0,48
115891,1146724,1,8,6,4,0,52
115892,1146724,1,9,1,1,0,53
115893,1146724,1,9,2,1,0,54
115894,1146724,1,9,3,1,0,55
115895,1146724,1,9,4,1,0,56
115896,1146724,1,9,5,0,0,56
115897,1146724,1,9,6,1,0,57
115898,1146724,1,10,1,4,0,61
115899,1146724,1,10,2,4,0,65
115900,1146724,1,10,3,0,0,65
115901,1146724,1,10,4,1,0,66
115902,1146724,1,10,5,1,0,67
115903,1146724,1,10,6,0,0,67
115904,1146724,1,11,1,0,0,67
115905,1146724,1,11,2,2,0,69
115906,1146724,1,11,3,1,0,70
115907,1146724,1,11,4,0,0,70
115908,1146724,1,11,5,4,0,74
115909,1146724,1,11,6,0,0,74
115910,1146724,1,12,1,1,0,75
115911,1146724,1,12,2,1,0,76
115912,1146724,1,12,3,1,0,77
115913,1146724,1,12,4,1,0,78
115914,1146724,1,12,5,3,0,81
115915,1146724,1,12,6,1,0,82
115916,1146724,1,13,1,4,0,86
115917,1146724,1,13,2,0,0,86
115918,1146724,1,13,3,4,0,90
115919,1146724,1,13,4,1,0,91
115920,1146724,1,13,5,1,0,92
115921,1146724,1,13,6,4,0,96
115922,1146724,1,14,1,4,0,100
115923,1146724,1,14,2,0,0,100
115924,1146724,1,14,3,1,0,101
115925,1146724,1,14,4,4,0,105
115926,1146724,1,14,5,0,0,105
115927,1146724,1,14,6,0,0,105
115928,1146724,1,15,1,2,0,107
115929,1146724,1,15,2,0,0,107
115930,1146724,1,15,3,1,0,108
115931,1146724,1,15,4,6,0,114
115932,1146724,1,15,5,1,0,115
115933,1146724,1,15,6,1,0,116
115934,1146724,1,16,1,6,0,122
115935,1146724,1,16,2,0,0,122
115936,1146724,1,16,3,6,0,128
115937,1146724,1,16,4,4,0,132
115938,1146724,1,16,5,6,0,138
115939,1146724,1,16,6,0,1,138
115940,1146724,1,17,1,1,0,139
115941,1146724,1,17,2,0,0,139
115942,1146724,1,17,3,1,0,140
115943,1146724,1,17,4,1,0,141
115944,1146724,1,17,5,4,0,145
115945,1146724,1,17,6,1,0,146
115946,1146724,1,18,1,1,0,147
115947,1146724,1,18,2,0,0,147
115948,1146724,1,18,3,1,0,148
115949,1146724,1,18,4,0,0,148
115950,1146724,1,18,5,1,0,149
115951,1146724,1,18,6,0,0,149
115952,1146724,1,19,1,4,0,153
115953,1146724,1,19,2,1,0,154
115954,1146724,1,19,3,4,0,158
115955,1146724,1,19,4,2,0,160
115956,1146724,1,19,5,1,0,161
115957,1146724,1,19,6,1,0,162
115958,1146724,1,20,1,2,0,164
115959,1146724,1,20,2,3,0,167
115960,1146724,1,20,3,0,1,167
115961,1146724,1,20,4,1,0,168
115962,1146724,1,20,5,1,0,169
115963,1146724,1,20,6,2,0,171
116084,1146725,1,1,1,4,0,4
116085,1146725,1,1,2,0,0,4
116086,1146725,1,1,3,1,0,5
116087,1146725,1,1,4,1,0,6
116088,1146725,1,1,5,0,0,6
116089,1146725,1,1,6,2,0,8
116090,1146725,1,2,1,0,0,8
116091,1146725,1,2,2,0,0,8
116092,1146725,1,2,3,1,0,9
116093,1146725,1,2,4,6,0,15
116094,1146725,1,2,5,6,0,21
116095,1146725,1,2,6,4,0,25
116096,1146725,1,3,1,1,0,26
116097,1146725,1,3,2,1,0,27
116098,1146725,1,3,3,4,0,31
116099,1146725,1,3,4,0,0,31
116100,1146725,1,3,5,0,0,31
116101,1146725,1,3,6,6,0,37
116102,1146725,1,4,1,4,0,41
116103,1146725,1,4,2,6,0,47
116104,1146725,1,4,3,1,0,48
116105,1146725,1,4,4,4,0,52
116106,1146725,1,4,5,0,0,52
116107,1146725,1,4,6,4,0,56
116108,1146725,1,5,1,0,0,56
116109,1146725,1,5,2,4,0,60
116110,1146725,1,5,3,1,0,61
116111,1146725,1,5,4,0,1,61
116112,1146725,1,5,5,4,0,65
116113,1146725,1,5,6,1,0,66
116114,1146725,1,6,1,0,0,66
116115,1146725,1,6,2,0,1,66
116116,1146725,1,6,3,4,0,70
116117,1146725,1,6,4,1,0,71
116118,1146725,1,6,5,0,0,71
116119,1146725,1,6,6,0,0,71
116120,1146725,1,7,1,1,0,72
116121,1146725,1,7,2,1,0,73
116122,1146725,1,7,3,1,0,74
116123,1146725,1,7,4,1,0,75
116124,1146725,1,7,5,1,0,76
116125,1146725,1,7,6,0,0,76
116126,1146725,1,8,1,0,0,76
116127,1146725,1,8,2,1,0,77
116128,1146725,1,8,3,1,0,78
116129,1146725,1,8,4,0,0,78
116130,1146725,1,8,5,1,0,79
116131,1146725,1,8,6,0,0,79
116132,1146725,1,9,1,1,0,80
116133,1146725,1,9,2,2,0,82
116134,1146725,1,9,3,1,0,83
116135,1146725,1,9,4,1,0,84
116136,1146725,1,9,5,4,0,88
116137,1146725,1,9,6,1,0,89
116138,1146725,1,10,1,1,0,90
116139,1146725,1,10,2,2,0,92
116140,1146725,1,10,3,4,0,96
116141,1146725,1,10,4,1,0,97
116142,1146725,1,10,5,0,0,97
116143,1146725,1,10,6,0,1,97
116144,1146725,1,11,1,1,0,98
116145,1146725,1,11,2,1,0,99
116146,1146725,1,11,3,1,0,100
116147,1146725,1,11,4,2,0,102
116148,1146725,1,11,5,0,1,102
116149,1146725,1,11,6,0,0,102
116150,1146725,1,12,1,0,0,102
116151,1146725,1,12,2,0,0,102
116152,1146725,1,12,3,1,0,103
116153,1146725,1,12,4,1,0,104
116154,1146725,1,12,5,1,0,105
116155,1146725,1,12,6,0,0,105
116156,1146725,1,13,1,0,0,105
116157,1146725,1,13,2,0,0,105
116158,1146725,1,13,3,4,0,109
116159,1146725,1,13,4,2,0,111
116160,1146725,1,13,5,2,0,113
116161,1146725,1,13,6,4,0,117
116162,1146725,1,14,1,1,0,118
116163,1146725,1,14,2,1,0,119
116164,1146725,1,14,3,1,0,120
116165,1146725,1,14,4,1,0,121
116166,1146725,1,14,5,1,0,122
116167,1146725,1,14,6,6,0,128
116168,1146725,1,15,1,1,0,129
116169,1146725,1,15,2,1,0,130
116170,1146725,1,15,3,3,0,133
116171,1146725,1,15,4,1,0,134
116172,1146725,1,15,5,2,0,136
116173,1146725,1,15,6,1,0,137
116174,1146725,1,16,1,1,0,138
116175,1146725,1,16,2,2,0,140
116176,1146725,1,16,3,1,0,141
116177,1146725,1,16,4,1,0,142
116178,1146725,1,16,5,4,0,146
116179,1146725,1,16,6,0,1,146
116180,1146725,1,17,1,1,0,147
116181,1146725,1,17,2,1,0,148
116182,1146725,1,17,3,1,0,149
116183,1146725,1,17,4,0,0,149
116184,1146725,1,17,5,0,0,149
116185,1146725,1,17,6,2,0,151
116186,1146725,1,18,1,4,0,155
116187,1146725,1,18,2,1,0,156
116188,1146725,1,18,3,2,0,158
116189,1146725,1,18,4,0,0,158
116190,1146725,1,18,5,2,0,160
116191,1146725,1,18,6,4,0,164
116192,1146725,1,19,1,1,0,165
116193,1146725,1,19,2,0,0,165
116194,1146725,1,19,3,0,0,165
116195,1146725,1,19,4,3,0,168
116196,1146725,1,19,5,0,0,168
116197,1146725,1,19,6,2,0,170
116198,1146725,1,20,1,4,0,174
116199,1146725,1,20,2,1,0,175
116200,1146725,1,20,3,6,0,181
116201,1146725,1,20,4,1,0,182
116202,1146725,1,20,5,0,0,182
116203,1146725,1,20,6,2,0,184
116307,1150143,1,1,1,1,0,1
116308,1150143,1,1,2,1,0,2
116309,1150143,1,1,3,1,0,3
116310,1150143,1,1,4,0,0,3
116311,1150143,1,1,5,7,0,10
116312,1150143,1,1,6,1,0,11
116313,1150143,1,2,1,4,0,15
116314,1150143,1,2,2,0,0,15
116315,1150143,1,2,3,0,0,15
116316,1150143,1,2,4,0,0,15
116317,1150143,1,2,5,0,0,15
116318,1150143,1,2,6,4,0,19
116319,1150143,1,3,1,0,0,19
116320,1150143,1,3,2,0,0,19
116321,1150143,1,3,3,1,0,20
116322,1150143,1,3,4,4,0,24
116323,1150143,1,3,5,4,0,28
116324,1150143,1,3,6,0,0,28
116325,1150143,1,4,1,1,0,29
116326,1150143,1,4,2,0,0,29
116327,1150143,1,4,3,4,0,33
116328,1150143,1,4,4,4,0,37
116329,1150143,1,4,5,4,0,41
116330,1150143,1,4,6,1,0,42
116331,1150143,1,5,1,6,0,48
116332,1150143,1,5,2,1,0,49
116333,1150143,1,5,3,4,0,53
116334,1150143,1,5,4,6,0,59
116335,1150143,1,5,5,0,0,59
116336,1150143,1,5,6,6,0,65
116337,1150143,1,6,1,4,0,69
116338,1150143,1,6,2,1,0,70
116339,1150143,1,6,3,0,0,70
116340,1150143,1,6,4,1,0,71
116341,1150143,1,6,5,0,0,71
116342,1150143,1,6,6,0,0,71
116343,1150143,1,7,1,6,0,77
116344,1150143,1,7,2,6,0,83
116345,1150143,1,7,3,0,0,83
116346,1150143,1,7,4,2,0,85
116347,1150143,1,7,5,1,0,86
116348,1150143,1,7,6,1,0,87
116349,1150143,1,8,1,0,0,87
116350,1150143,1,8,2,0,1,87
116351,1150143,1,8,3,0,0,87
116352,1150143,1,8,4,4,0,91
116353,1150143,1,8,5,0,0,91
116354,1150143,1,8,6,1,0,92
116355,1150143,1,9,1,1,0,93
116356,1150143,1,9,2,0,0,93
116357,1150143,1,9,3,4,0,97
116358,1150143,1,9,4,1,0,98
116359,1150143,1,9,5,1,0,99
116360,1150143,1,9,6,0,0,99
116361,1150143,1,10,1,0,0,99
116362,1150143,1,10,2,1,0,100
116363,1150143,1,10,3,6,0,106
116364,1150143,1,10,4,7,0,113
116365,1150143,1,10,5,2,0,115
116366,1150143,1,10,6,0,0,115
116367,1150143,1,11,1,1,0,116
116368,1150143,1,11,2,1,0,117
116369,1150143,1,11,3,0,0,117
116370,1150143,1,11,4,1,0,118
116371,1150143,1,11,5,1,0,119
116372,1150143,1,11,6,0,1,119
116373,1150143,1,12,1,1,0,120
116374,1150143,1,12,2,2,0,122
116375,1150143,1,12,3,1,0,123
116376,1150143,1,12,4,2,0,125
116377,1150143,1,12,5,0,0,125
116378,1150143,1,12,6,0,0,125
116379,1150143,1,13,1,1,0,126
116380,1150143,1,13,2,1,0,127
116381,1150143,1,13,3,2,0,129
116382,1150143,1,13,4,0,0,129
116383,1150143,1,13,5,0,0,129
116384,1150143,1,13,6,1,0,130
116385,1150143,1,14,1,1,0,131
116386,1150143,1,14,2,0,0,131
116387,1150143,1,14,3,1,0,132
116388,1150143,1,14,4,2,0,134
116389,1150143,1,14,5,0,0,134
116390,1150143,1,14,6,6,0,140
116391,1150143,1,15,1,1,0,141
116392,1150143,1,15,2,1,0,142
116393,1150143,1,15,3,1,0,143
116394,1150143,1,15,4,6,0,149
116395,1150143,1,15,5,0,0,149
116396,1150143,1,15,6,1,0,150
116397,1150143,1,16,1,1,0,151
116398,1150143,1,16,2,0,1,151
116399,1150143,1,16,3,1,0,152
116400,1150143,1,16,4,0,1,152
116401,1150143,1,16,5,0,0,152
116402,1150143,1,16,6,1,0,153
116403,1150143,1,17,1,0,0,153
116404,1150143,1,17,2,0,1,153
116405,1150143,1,17,3,0,0,153
116406,1150143,1,17,4,6,0,159
116407,1150143,1,17,5,0,0,159
116408,1150143,1,17,6,0,1,159
116409,1150143,1,18,1,0,0,159
116410,1150143,1,18,2,0,0,159
116411,1150143,1,18,3,0,1,159
116412,1150143,1,18,4,0,0,159
116413,1150143,1,18,5,1,0,160
116414,1150143,1,18,6,0,0,160
116523,1150144,1,1,1,1,0,1
116524,1150144,1,1,2,0,0,1
116525,1150144,1,1,3,0,0,1
116526,1150144,1,1,4,4,0,5
116527,1150144,1,1,5,0,0,5
116528,1150144,1,1,6,0,0,5
116529,1150144,1,2,1,0,0,5
116530,1150144,1,2,2,0,0,5
116531,1150144,1,2,3,0,0,5
116532,1150144,1,2,4,0,1,5
116533,1150144,1,2,5,1,0,6
116534,1150144,1,2,6,1,0,7
116535,1150144,1,3,1,0,0,7
116536,1150144,1,3,2,1,0,8
116537,1150144,1,3,3,0,0,8
116538,1150144,1,3,4,0,0,8
116539,1150144,1,3,5,0,1,8
116540,1150144,1,3,6,0,0,8
116541,1150144,1,4,1,0,0,8
116542,1150144,1,4,2,1,0,9
116543,1150144,1,4,3,1,0,10
116544,1150144,1,4,4,0,0,10
116545,1150144,1,4,5,0,0,10
116546,1150144,1,4,6,4,0,14
116547,1150144,1,5,1,0,0,14
116548,1150144,1,5,2,1,0,15
116549,1150144,1,5,3,5,0,20
116550,1150144,1,5,4,6,0,26
116551,1150144,1,5,5,1,0,27
116552,1150144,1,5,6,0,0,27
116553,1150144,1,6,1,0,0,27
116554,1150144,1,6,2,1,0,28
116555,1150144,1,6,3,6,0,34
116556,1150144,1,6,4,4,0,38
116557,1150144,1,6,5,4,0,42
116558,1150144,1,6,6,0,0,42
116559,1150144,1,7,1,0,0,42
116560,1150144,1,7,2,0,0,42
116561,1150144,1,7,3,1,0,43
116562,1150144,1,7,4,0,0,43
116563,1150144,1,7,5,1,0,44
116564,1150144,1,7,6,0,0,44
116565,1150144,1,8,1,1,0,45
116566,1150144,1,8,2,0,0,45
116567,1150144,1,8,3,1,0,46
116568,1150144,1,8,4,1,0,47
116569,1150144,1,8,5,4,0,51
116570,1150144,1,8,6,4,0,55
116571,1150144,1,9,1,0,0,55
116572,1150144,1,9,2,1,0,56
116573,1150144,1,9,3,1,0,57
116574,1150144,1,9,4,1,0,58
116575,1150144,1,9,5,0,0,58
116576,1150144,1,9,6,0,0,58
116577,1150144,1,10,1,6,0,64
116578,1150144,1,10,2,0,0,64
116579,1150144,1,10,3,2,0,66
116580,1150144,1,10,4,1,0,67
116581,1150144,1,10,5,4,0,71
116582,1150144,1,10,6,6,0,77
116583,1150144,1,11,1,1,0,78
116584,1150144,1,11,2,1,0,79
116585,1150144,1,11,3,1,0,80
116586,1150144,1,11,4,1,0,81
116587,1150144,1,11,5,0,0,81
116588,1150144,1,11,6,0,0,81
116589,1150144,1,12,1,6,0,87
116590,1150144,1,12,2,6,0,93
116591,1150144,1,12,3,0,0,93
116592,1150144,1,12,4,6,0,99
116593,1150144,1,12,5,1,0,100
116594,1150144,1,12,6,1,0,101
116595,1150144,1,13,1,1,0,102
116596,1150144,1,13,2,1,0,103
116597,1150144,1,13,3,1,0,104
116598,1150144,1,13,4,1,0,105
116599,1150144,1,13,5,0,0,105
116600,1150144,1,13,6,0,0,105
116601,1150144,1,14,1,0,0,105
116602,1150144,1,14,2,1,0,106
116603,1150144,1,14,3,0,0,106
116604,1150144,1,14,4,0,0,106
116605,1150144,1,14,5,1,0,107
116606,1150144,1,14,6,0,0,107
116607,1150144,1,15,1,6,0,113
116608,1150144,1,15,2,1,0,114
116609,1150144,1,15,3,1,0,115
116610,1150144,1,15,4,6,0,121
116611,1150144,1,15,5,0,0,121
116612,1150144,1,15,6,1,0,122
116613,1150144,1,16,1,0,0,122
116614,1150144,1,16,2,0,0,122
116615,1150144,1,16,3,0,0,122
116616,1150144,1,16,4,1,0,123
116617,1150144,1,16,5,1,0,124
116618,1150144,1,16,6,0,1,124
116619,1150144,1,17,1,0,1,124
116620,1150144,1,17,2,1,0,125
116621,1150144,1,17,3,1,0,126
116622,1150144,1,17,4,1,0,127
116623,1150144,1,17,5,4,0,131
116624,1150144,1,17,6,6,0,137
116625,1150144,1,18,1,0,1,137
116626,1150144,1,18,2,1,0,138
116627,1150144,1,18,3,4,0,142
116628,1150144,1,18,4,4,0,146
116629,1150144,1,18,5,0,0,146
116630,1150144,1,18,6,1,0,147
116631,1150144,1,19,1,1,0,148
116632,1150144,1,19,2,0,1,148
116633,1150144,1,19,3,1,0,149
116634,1150144,1,19,4,0,0,149
116635,1150144,1,19,5,0,1,149
116636,1150144,1,19,6,0,0,149
116637,1150144,1,20,1,1,0,150
116638,1150144,1,20,2,2,0,152
116639,1150144,1,20,3,7,0,159
116640,1150144,1,20,4,1,0,160
116641,1150144,1,20,5,0,0,160
116642,1150144,1,20,6,0,1,160
116733,1152840,1,1,1,1,0,1
116734,1152840,1,1,2,2,0,3
116735,1152840,1,1,3,1,0,4
116736,1152840,1,1,4,0,0,4
116737,1152840,1,1,5,2,0,6
116738,1152840,1,1,6,0,0,6
116739,1152840,1,2,1,4,0,10
116740,1152840,1,2,2,0,0,10
116741,1152840,1,2,3,1,0,11
116742,1152840,1,2,4,4,0,15
116743,1152840,1,2,5,1,0,16
116744,1152840,1,2,6,0,1,16
116745,1152840,1,3,1,0,0,16
116746,1152840,1,3,2,1,0,17
116747,1152840,1,3,3,1,0,18
116748,1152840,1,3,4,2,0,20
116749,1152840,1,3,5,0,0,20
116750,1152840,1,3,6,4,0,24
116751,1152840,1,4,1,0,0,24
116752,1152840,1,4,2,0,0,24
116753,1152840,1,4,3,0,0,24
116754,1152840,1,4,4,0,0,24
116755,1152840,1,4,5,1,0,25
116756,1152840,1,4,6,0,0,25
116757,1152840,1,5,1,2,0,27
116758,1152840,1,5,2,2,0,29
116759,1152840,1,5,3,1,0,30
116760,1152840,1,5,4,1,0,31
116761,1152840,1,5,5,0,1,31
116762,1152840,1,5,6,0,0,31
116763,1152840,1,6,1,1,0,32
116764,1152840,1,6,2,4,0,36
116765,1152840,1,6,3,0,0,36
116766,1152840,1,6,4,0,0,36
116767,1152840,1,6,5,0,0,36
116768,1152840,1,6,6,2,0,38
116769,1152840,1,7,1,0,0,38
116770,1152840,1,7,2,1,0,39
116771,1152840,1,7,3,1,0,40
116772,1152840,1,7,4,0,0,40
116773,1152840,1,7,5,1,0,41
116774,1152840,1,7,6,1,0,42
116775,1152840,1,8,1,0,0,42
116776,1152840,1,8,2,6,0,48
116777,1152840,1,8,3,0,0,48
116778,1152840,1,8,4,4,0,52
116779,1152840,1,8,5,1,0,53
116780,1152840,1,8,6,4,0,57
116781,1152840,1,9,1,1,0,58
116782,1152840,1,9,2,6,0,64
116783,1152840,1,9,3,1,0,65
116784,1152840,1,9,4,1,0,66
116785,1152840,1,9,5,1,0,67
116786,1152840,1,9,6,1,0,68
116787,1152840,1,10,1,2,0,70
116788,1152840,1,10,2,4,0,74
116789,1152840,1,10,3,0,0,74
116790,1152840,1,10,4,2,0,76
116791,1152840,1,10,5,4,0,80
116792,1152840,1,10,6,1,0,81
116793,1152840,1,11,1,1,0,82
116794,1152840,1,11,2,0,0,82
116795,1152840,1,11,3,1,0,83
116796,1152840,1,11,4,1,0,84
116797,1152840,1,11,5,4,0,88
116798,1152840,1,11,6,2,0,90
116799,1152840,1,12,1,2,0,92
116800,1152840,1,12,2,1,0,93
116801,1152840,1,12,3,0,0,93
116802,1152840,1,12,4,1,0,94
116803,1152840,1,12,5,2,0,96
116804,1152840,1,12,6,0,0,96
116805,1152840,1,13,1,6,0,102
116806,1152840,1,13,2,6,0,108
116807,1152840,1,13,3,1,0,109
116808,1152840,1,13,4,1,0,110
116809,1152840,1,13,5,0,0,110
116810,1152840,1,13,6,1,0,111
116811,1152840,1,14,1,2,0,113
116812,1152840,1,14,2,1,0,114
116813,1152840,1,14,3,1,0,115
116814,1152840,1,14,4,2,0,117
116815,1152840,1,14,5,1,0,118
116816,1152840,1,14,6,4,0,122
116817,1152840,1,15,1,1,0,123
116818,1152840,1,15,2,1,0,124
116819,1152840,1,15,3,4,0,128
116820,1152840,1,15,4,2,0,130
116821,1152840,1,15,5,2,0,132
116822,1152840,1,15,6,1,0,133
116823,1152840,1,16,1,1,0,134
116824,1152840,1,16,2,0,0,134
116825,1152840,1,16,3,0,1,134
116826,1152840,1,16,4,1,0,135
116827,1152840,1,16,5,0,1,135
116828,1152840,1,16,6,2,0,137
116829,1152840,1,17,1,1,0,138
116830,1152840,1,17,2,1,0,139
116831,1152840,1,17,3,0,0,139
116832,1152840,1,17,4,0,1,139
116833,1152840,1,17,5,1,0,140
116834,1152840,1,17,6,1,0,141
116835,1152840,1,18,1,1,0,142
116836,1152840,1,18,2,0,0,142
116837,1152840,1,18,3,1,0,143
116838,1152840,1,18,4,4,0,147
116839,1152840,1,18,5,1,0,148
116840,1152840,1,18,6,0,0,148
116841,1152840,1,19,1,1,0,149
116842,1152840,1,19,2,4,0,153
116843,1152840,1,19,3,1,0,154
116844,1152840,1,19,4,1,0,155
116845,1152840,1,19,5,1,0,156
116846,1152840,1,19,6,1,0,157
116847,1152840,1,20,1,1,0,158
116848,1152840,1,20,2,1,0,159
116849,1152840,1,20,3,6,0,165
116850,1152840,1,20,4,0,1,165
116851,1152840,1,20,5,4,0,169
116852,1152840,1,20,6,4,0,173
116969,1153317,1,1,1,0,0,0
116970,1153317,1,1,2,1,0,1
116971,1153317,1,1,3,4,0,5
116972,1153317,1,1,4,1,0,6
116973,1153317,1,1,5,0,0,6
116974,1153317,1,1,6,1,0,7
116975,1153317,1,2,1,2,0,9
116976,1153317,1,2,2,1,0,10
116977,1153317,1,2,3,1,0,11
116978,1153317,1,2,4,0,1,11
116979,1153317,1,2,5,4,0,15
116980,1153317,1,2,6,4,0,19
116981,1153317,1,3,1,0,0,19
116982,1153317,1,3,2,0,1,19
116983,1153317,1,3,3,0,0,19
116984,1153317,1,3,4,4,0,23
116985,1153317,1,3,5,4,0,27
116986,1153317,1,3,6,0,0,27
116987,1153317,1,4,1,1,0,28
116988,1153317,1,4,2,3,0,31
116989,1153317,1,4,3,0,1,31
116990,1153317,1,4,4,0,0,31
116991,1153317,1,4,5,4,0,35
116992,1153317,1,4,6,0,0,35
116993,1153317,1,5,1,4,0,39
116994,1153317,1,5,2,1,0,40
116995,1153317,1,5,3,4,0,44
116996,1153317,1,5,4,0,0,44
116997,1153317,1,5,5,0,0,44
116998,1153317,1,5,6,4,0,48
116999,1153317,1,6,1,0,1,48
117000,1153317,1,6,2,2,0,50
117001,1153317,1,6,3,0,0,50
117002,1153317,1,6,4,0,0,50
117003,1153317,1,6,5,4,0,54
117004,1153317,1,6,6,0,0,54
117005,1153317,1,7,1,1,0,55
117006,1153317,1,7,2,0,0,55
117007,1153317,1,7,3,1,0,56
117008,1153317,1,7,4,1,0,57
117009,1153317,1,7,5,1,0,58
117010,1153317,1,7,6,0,0,58
117011,1153317,1,8,1,1,0,59
117012,1153317,1,8,2,1,0,60
117013,1153317,1,8,3,1,0,61
117014,1153317,1,8,4,4,0,65
117015,1153317,1,8,5,0,0,65
117016,1153317,1,8,6,1,0,66
117017,1153317,1,9,1,1,0,67
117018,1153317,1,9,2,0,0,67
117019,1153317,1,9,3,0,0,67
117020,1153317,1,9,4,1,0,68
117021,1153317,1,9,5,1,0,69
117022,1153317,1,9,6,1,0,70
117023,1153317,1,10,1,1,0,71
117024,1153317,1,10,2,1,0,72
117025,1153317,1,10,3,0,0,72
117026,1153317,1,10,4,0,0,72
117027,1153317,1,10,5,1,0,73
117028,1153317,1,10,6,0,0,73
117029,1153317,1,11,1,0,0,73
117030,1153317,1,11,2,0,1,73
117031,1153317,1,11,3,2,0,75
117032,1153317,1,11,4,0,0,75
117033,1153317,1,11,5,1,0,76
117034,1153317,1,11,6,1,0,77
117035,1153317,1,12,1,1,0,78
117036,1153317,1,12,2,4,0,82
117037,1153317,1,12,3,1,0,83
117038,1153317,1,12,4,0,0,83
117039,1153317,1,12,5,2,0,85
117040,1153317,1,12,6,1,0,86
117041,1153317,1,13,1,4,0,90
117042,1153317,1,13,2,1,0,91
117043,1153317,1,13,3,0,0,91
117044,1153317,1,13,4,0,0,91
117045,1153317,1,13,5,1,0,92
117046,1153317,1,13,6,1,0,93
117047,1153317,1,14,1,1,0,94
117048,1153317,1,14,2,2,0,96
117049,1153317,1,14,3,0,0,96
117050,1153317,1,14,4,1,0,97
117051,1153317,1,14,5,1,0,98
117052,1153317,1,14,6,0,0,98
117053,1153317,1,15,1,0,0,98
117054,1153317,1,15,2,0,0,98
117055,1153317,1,15,3,0,0,98
117056,1153317,1,15,4,0,0,98
117057,1153317,1,15,5,0,0,98
117058,1153317,1,15,6,4,0,102
117059,1153317,1,16,1,0,0,102
117060,1153317,1,16,2,0,0,102
117061,1153317,1,16,3,1,0,103
117062,1153317,1,16,4,0,1,103
117063,1153317,1,16,5,1,0,104
117064,1153317,1,16,6,6,0,110
117065,1153317,1,17,1,0,1,110
117066,1153317,1,17,2,0,0,110
117067,1153317,1,17,3,0,0,110
117068,1153317,1,17,4,0,0,110
117069,1153317,1,17,5,1,0,111
117070,1153317,1,17,6,4,0,115
117071,1153317,1,18,1,1,0,116
117072,1153317,1,18,2,6,0,122
117073,1153317,1,18,3,0,1,122
117074,1153317,1,18,4,0,0,122
117075,1153317,1,18,5,1,0,123
117076,1153317,1,18,6,0,0,123
117077,1153317,1,19,1,4,0,127
117078,1153317,1,19,2,1,0,128
117079,1153317,1,19,3,1,0,129
117080,1153317,1,19,4,0,1,129
117081,1153317,1,19,5,0,0,129
117082,1153317,1,19,6,0,1,129
117148,1153318,1,1,1,0,0,0
117149,1153318,1,1,2,1,0,1
117150,1153318,1,1,3,2,0,3
117151,1153318,1,1,4,4,0,7
117152,1153318,1,1,5,2,0,9
117153,1153318,1,1,6,0,0,9
117154,1153318,1,2,1,1,0,10
117155,1153318,1,2,2,2,0,12
117156,1153318,1,2,3,2,0,14
117157,1153318,1,2,4,0,0,14
117158,1153318,1,2,5,1,0,15
117159,1153318,1,2,6,0,0,15
117160,1153318,1,3,1,1,0,16
117161,1153318,1,3,2,4,0,20
117162,1153318,1,3,3,0,0,20
117163,1153318,1,3,4,4,0,24
117164,1153318,1,3,5,4,0,28
117165,1153318,1,3,6,0,0,28
117166,1153318,1,4,1,0,0,28
117167,1153318,1,4,2,0,0,28
117168,1153318,1,4,3,1,0,29
117169,1153318,1,4,4,0,0,29
117170,1153318,1,4,5,6,0,35
117171,1153318,1,4,6,6,0,41
117172,1153318,1,5,1,1,1,42
117173,1153318,1,5,2,1,0,43
117174,1153318,1,5,3,0,0,43
117175,1153318,1,5,4,4,0,47
117176,1153318,1,5,5,0,0,47
117177,1153318,1,5,6,0,0,47
117178,1153318,1,6,1,0,0,47
117179,1153318,1,6,2,1,0,48
117180,1153318,1,6,3,6,0,54
117181,1153318,1,6,4,6,0,60
117182,1153318,1,6,5,0,0,60
117183,1153318,1,6,6,1,0,61
117184,1153318,1,7,1,1,0,62
117185,1153318,1,7,2,2,0,64
117186,1153318,1,7,3,0,0,64
117187,1153318,1,7,4,1,0,65
117188,1153318,1,7,5,0,0,65
117189,1153318,1,7,6,1,0,66
117190,1153318,1,8,1,1,0,67
117191,1153318,1,8,2,1,0,68
117192,1153318,1,8,3,1,0,69
117193,1153318,1,8,4,1,0,70
117194,1153318,1,8,5,4,0,74
117195,1153318,1,8,6,1,0,75
117196,1153318,1,9,1,0,0,75
117197,1153318,1,9,2,1,0,76
117198,1153318,1,9,3,1,0,77
117199,1153318,1,9,4,1,0,78
117200,1153318,1,9,5,4,0,82
117201,1153318,1,9,6,1,0,83
117202,1153318,1,10,1,1,0,84
117203,1153318,1,10,2,4,0,88
117204,1153318,1,10,3,1,0,89
117205,1153318,1,10,4,4,0,93
117206,1153318,1,10,5,5,0,98
117207,1153318,1,10,6,1,0,99
117208,1153318,1,11,1,1,0,100
117209,1153318,1,11,2,1,0,101
117210,1153318,1,11,3,1,0,102
117211,1153318,1,11,4,1,0,103
117212,1153318,1,11,5,6,0,109
117213,1153318,1,11,6,1,0,110
117214,1153318,1,12,1,0,1,110
117215,1153318,1,12,2,0,0,110
117216,1153318,1,12,3,1,0,111
117217,1153318,1,12,4,0,0,111
117218,1153318,1,12,5,2,0,113
117219,1153318,1,12,6,0,1,113
117220,1153318,1,13,1,4,0,117
117221,1153318,1,13,2,1,0,118
117222,1153318,1,13,3,1,0,119
117223,1153318,1,13,4,1,0,120
117224,1153318,1,13,5,0,0,120
117225,1153318,1,13,6,0,1,120
117226,1153318,1,14,1,4,0,124
117227,1153318,1,14,2,4,0,128
117228,1153318,1,14,3,4,0,132
117229,1153318,1,14,4,0,0,132
117230,1153318,1,14,5,0,0,132
117231,1153318,1,14,6,1,0,133
117232,1153318,1,15,1,1,0,134
117233,1153318,1,15,2,1,0,135
117234,1153318,1,15,3,1,0,136
117235,1153318,1,15,4,1,0,137
117236,1153318,1,15,5,1,0,138
117237,1153318,1,15,6,2,0,140
117238,1153318,1,16,1,4,0,144
117239,1153318,1,16,2,7,0,151
117240,1153318,1,16,3,0,0,151
117241,1153318,1,16,4,4,0,155
117242,1153318,1,16,5,2,0,157
117243,1153318,1,16,6,2,0,159
117244,1153318,1,17,1,7,0,166
117245,1153318,1,17,2,0,0,166
117246,1153318,1,17,3,5,0,171
117247,1153318,1,17,4,4,0,175
117248,1153318,1,17,5,1,0,176
117249,1153318,1,17,6,3,0,179
117250,1153318,1,18,1,2,0,181
117251,1153318,1,18,2,4,0,185
117252,1153318,1,18,3,4,0,189
117253,1153318,1,18,4,1,0,190
117254,1153318,1,18,5,1,0,191
117255,1153318,1,18,6,4,0,195
117256,1153318,1,19,1,1,0,196
117257,1153318,1,19,2,2,0,198
117258,1153318,1,19,3,1,0,199
117259,1153318,1,19,4,2,0,201
117260,1153318,1,19,5,1,0,202
117261,1153318,1,19,6,0,0,202
117262,1153318,1,20,1,2,0,204
117263,1153318,1,20,2,1,0,205
117264,1153318,1,20,3,1,0,206
117265,1153318,1,20,4,0,0,206
117266,1153318,1,20,5,1,0,207
117267,1153318,1,20,6,4,0,211
117384,1153319,1,1,1,0,0,0
117385,1153319,1,1,2,2,0,2
117386,1153319,1,1,3,5,0,7
117387,1153319,1,1,4,0,0,7
117388,1153319,1,1,5,4,0,11
117389,1153319,1,1,6,1,0,12
117390,1153319,1,2,1,2,0,14
117391,1153319,1,2,2,0,0,14
117392,1153319,1,2,3,0,0,14
117393,1153319,1,2,4,4,0,18
117394,1153319,1,2,5,2,0,20
117395,1153319,1,2,6,0,0,20
117396,1153319,1,3,1,6,0,26
117397,1153319,1,3,2,6,0,32
117398,1153319,1,3,3,7,0,39
117399,1153319,1,3,4,2,0,41
117400,1153319,1,3,5,0,0,41
117401,1153319,1,3,6,6,0,47
117402,1153319,1,4,1,4,0,51
117403,1153319,1,4,2,1,0,52
117404,1153319,1,4,3,0,0,52
117405,1153319,1,4,4,6,0,58
117406,1153319,1,4,5,4,0,62
117407,1153319,1,4,6,1,0,63
117408,1153319,1,5,1,1,0,64
117409,1153319,1,5,2,2,0,66
117410,1153319,1,5,3,6,0,72
117411,1153319,1,5,4,0,0,72
117412,1153319,1,5,5,4,0,76
117413,1153319,1,5,6,0,1,76
117414,1153319,1,6,1,0,0,76
117415,1153319,1,6,2,2,0,78
117416,1153319,1,6,3,0,0,78
117417,1153319,1,6,4,0,0,78
117418,1153319,1,6,5,4,0,82
117419,1153319,1,6,6,6,0,88
117420,1153319,1,7,1,2,0,90
117421,1153319,1,7,2,0,0,90
117422,1153319,1,7,3,0,1,90
117423,1153319,1,7,4,6,0,96
117424,1153319,1,7,5,1,0,97
117425,1153319,1,7,6,1,0,98
117426,1153319,1,8,1,2,0,100
117427,1153319,1,8,2,0,0,100
117428,1153319,1,8,3,0,0,100
117429,1153319,1,8,4,1,0,101
117430,1153319,1,8,5,6,0,107
117431,1153319,1,8,6,1,0,108
117432,1153319,1,9,1,5,0,113
117433,1153319,1,9,2,4,0,117
117434,1153319,1,9,3,0,0,117
117435,1153319,1,9,4,2,0,119
117436,1153319,1,9,5,0,0,119
117437,1153319,1,9,6,1,0,120
117438,1153319,1,10,1,2,0,122
117439,1153319,1,10,2,0,1,122
117440,1153319,1,10,3,0,1,122
117441,1153319,1,10,4,0,0,122
117442,1153319,1,10,5,0,0,122
117443,1153319,1,10,6,1,0,123
117444,1153319,1,11,1,6,0,129
117445,1153319,1,11,2,0,0,129
117446,1153319,1,11,3,0,0,129
117447,1153319,1,11,4,0,0,129
117448,1153319,1,11,5,0,0,129
117449,1153319,1,11,6,0,0,129
117450,1153319,1,12,1,0,0,129
117451,1153319,1,12,2,1,0,130
117452,1153319,1,12,3,1,0,131
117453,1153319,1,12,4,1,0,132
117454,1153319,1,12,5,1,0,133
117455,1153319,1,12,6,1,0,134
117456,1153319,1,13,1,0,0,134
117457,1153319,1,13,2,6,0,140
117458,1153319,1,13,3,0,0,140
117459,1153319,1,13,4,1,0,141
117460,1153319,1,13,5,6,0,147
117461,1153319,1,13,6,4,0,151
117462,1153319,1,14,1,5,0,156
117463,1153319,1,14,2,1,0,157
117464,1153319,1,14,3,1,0,158
117465,1153319,1,14,4,1,1,159
117466,1153319,1,14,5,1,0,160
117467,1153319,1,14,6,0,0,160
117468,1153319,1,15,1,1,0,161
117469,1153319,1,15,2,0,0,161
117470,1153319,1,15,3,0,0,161
117471,1153319,1,15,4,2,0,163
117472,1153319,1,15,5,4,0,167
117473,1153319,1,15,6,1,0,168
117474,1153319,1,16,1,0,0,168
117475,1153319,1,16,2,1,0,169
117476,1153319,1,16,3,2,0,171
117477,1153319,1,16,4,1,0,172
117478,1153319,1,16,5,4,0,176
117479,1153319,1,16,6,0,0,176
117480,1153319,1,17,1,0,1,176
117481,1153319,1,17,2,1,0,177
117482,1153319,1,17,3,0,0,177
117483,1153319,1,17,4,1,0,178
117484,1153319,1,17,5,0,1,178
117485,1153319,1,17,6,1,0,179
117486,1153319,1,18,1,0,0,179
117487,1153319,1,18,2,1,0,180
117488,1153319,1,18,3,1,0,181
117489,1153319,1,18,4,4,0,185
117490,1153319,1,18,5,0,0,185
117491,1153319,1,18,6,2,0,187
117492,1153319,1,19,1,1,0,188
117493,1153319,1,19,2,0,1,188
117494,1153319,1,19,3,1,0,189
117495,1153319,1,19,4,0,0,189
117496,1153319,1,19,5,0,1,189
117497,1153319,1,19,6,0,0,189
117498,1153319,1,20,1,1,0,190
117499,1153319,1,20,2,0,1,190
117602,1153696,1,1,1,0,0,0
117603,1153696,1,1,2,0,0,0
117604,1153696,1,1,3,1,0,1
117605,1153696,1,1,4,1,0,2
117606,1153696,1,1,5,1,0,3
117607,1153696,1,1,6,1,0,4
117608,1153696,1,2,1,0,0,4
117609,1153696,1,2,2,4,0,8
117610,1153696,1,2,3,4,0,12
117611,1153696,1,2,4,0,0,12
117612,1153696,1,2,5,0,0,12
117613,1153696,1,2,6,1,0,13
117614,1153696,1,3,1,2,0,15
117615,1153696,1,3,2,3,0,18
117616,1153696,1,3,3,6,0,24
117617,1153696,1,3,4,0,0,24
117618,1153696,1,3,5,4,0,28
117619,1153696,1,3,6,0,0,28
117620,1153696,1,4,1,6,0,34
117621,1153696,1,4,2,6,0,40
117622,1153696,1,4,3,1,0,41
117623,1153696,1,4,4,0,0,41
117624,1153696,1,4,5,2,0,43
117625,1153696,1,4,6,1,0,44
117626,1153696,1,5,1,0,0,44
117627,1153696,1,5,2,2,0,46
117628,1153696,1,5,3,0,0,46
117629,1153696,1,5,4,6,0,52
117630,1153696,1,5,5,1,0,53
117631,1153696,1,5,6,1,0,54
117632,1153696,1,6,1,2,0,56
117633,1153696,1,6,2,4,0,60
117634,1153696,1,6,3,0,0,60
117635,1153696,1,6,4,4,0,64
117636,1153696,1,6,5,1,0,65
117637,1153696,1,6,6,1,0,66
117638,1153696,1,7,1,1,0,67
117639,1153696,1,7,2,0,0,67
117640,1153696,1,7,3,4,0,71
117641,1153696,1,7,4,1,0,72
117642,1153696,1,7,5,1,0,73
117643,1153696,1,7,6,1,0,74
117644,1153696,1,8,1,0,0,74
117645,1153696,1,8,2,4,0,78
117646,1153696,1,8,3,6,0,84
117647,1153696,1,8,4,0,0,84
117648,1153696,1,8,5,1,0,85
117649,1153696,1,8,6,0,0,85
117650,1153696,1,9,1,1,0,86
117651,1153696,1,9,2,0,1,86
117652,1153696,1,9,3,0,0,86
117653,1153696,1,9,4,1,0,87
117654,1153696,1,9,5,0,0,87
117655,1153696,1,9,6,1,0,88
117656,1153696,1,10,1,0,0,88
117657,1153696,1,10,2,1,0,89
117658,1153696,1,10,3,4,0,93
117659,1153696,1,10,4,2,0,95
117660,1153696,1,10,5,1,0,96
117661,1153696,1,10,6,1,0,97
117662,1153696,1,11,1,1,0,98
117663,1153696,1,11,2,6,0,104
117664,1153696,1,11,3,6,0,110
117665,1153696,1,11,4,1,0,111
117666,1153696,1,11,5,1,0,112
117667,1153696,1,11,6,2,0,114
117668,1153696,1,12,1,0,0,114
117669,1153696,1,12,2,1,0,115
117670,1153696,1,12,3,1,0,116
117671,1153696,1,12,4,1,0,117
117672,1153696,1,12,5,4,0,121
117673,1153696,1,12,6,6,0,127
117674,1153696,1,13,1,0,0,127
117675,1153696,1,13,2,6,0,133
117676,1153696,1,13,3,1,0,134
117677,1153696,1,13,4,0,1,134
117678,1153696,1,13,5,0,0,134
117679,1153696,1,13,6,4,0,138
117680,1153696,1,14,1,2,0,140
117681,1153696,1,14,2,0,0,140
117682,1153696,1,14,3,1,0,141
117683,1153696,1,14,4,1,0,142
117684,1153696,1,14,5,2,0,144
117685,1153696,1,14,6,2,0,146
117686,1153696,1,15,1,2,0,148
117687,1153696,1,15,2,6,0,154
117688,1153696,1,15,3,6,0,160
117689,1153696,1,15,4,1,0,161
117690,1153696,1,15,5,2,0,163
117691,1153696,1,15,6,1,1,164
117692,1153696,1,16,1,0,1,164
117693,1153696,1,16,2,1,0,165
117694,1153696,1,16,3,1,0,166
117695,1153696,1,16,4,1,0,167
117696,1153696,1,16,5,1,0,168
117697,1153696,1,16,6,1,0,169
117698,1153696,1,17,1,0,0,169
117699,1153696,1,17,2,2,0,171
117700,1153696,1,17,3,6,0,177
117701,1153696,1,17,4,1,0,178
117702,1153696,1,17,5,1,0,179
117703,1153696,1,17,6,1,0,180
117704,1153696,1,18,1,6,0,186
117705,1153696,1,18,2,0,0,186
117706,1153696,1,18,3,2,0,188
117707,1153696,1,18,4,1,0,189
117708,1153696,1,18,5,0,1,189
117709,1153696,1,18,6,1,0,190
117710,1153696,1,19,1,1,1,191
117711,1153696,1,19,2,1,0,192
117712,1153696,1,19,3,4,0,196
117713,1153696,1,19,4,0,0,196
117714,1153696,1,19,5,4,0,200
117715,1153696,1,19,6,7,0,207
117716,1153696,1,20,1,1,0,208
117717,1153696,1,20,2,1,0,209
117718,1153696,1,20,3,1,0,210
117719,1153696,1,20,4,4,0,214
117720,1153696,1,20,5,1,0,215
117721,1153696,1,20,6,4,0,219
117838,1153697,1,1,1,0,0,0
117839,1153697,1,1,2,1,0,1
117840,1153697,1,1,3,0,0,1
117841,1153697,1,1,4,1,0,2
117842,1153697,1,1,5,0,0,2
117843,1153697,1,1,6,1,0,3
117844,1153697,1,2,1,1,0,4
117845,1153697,1,2,2,0,0,4
117846,1153697,1,2,3,0,0,4
117847,1153697,1,2,4,0,0,4
117848,1153697,1,2,5,0,0,4
117849,1153697,1,2,6,1,0,5
117850,1153697,1,3,1,4,0,9
117851,1153697,1,3,2,6,0,15
117852,1153697,1,3,3,0,1,15
117853,1153697,1,3,4,1,0,16
117854,1153697,1,3,5,1,0,17
117855,1153697,1,3,6,0,0,17
117856,1153697,1,4,1,2,0,19
117857,1153697,1,4,2,0,0,19
117858,1153697,1,4,3,0,0,19
117859,1153697,1,4,4,6,0,25
117860,1153697,1,4,5,1,0,26
117861,1153697,1,4,6,4,0,30
117862,1153697,1,5,1,1,0,31
117863,1153697,1,5,2,4,0,35
117864,1153697,1,5,3,0,0,35
117865,1153697,1,5,4,4,0,39
117866,1153697,1,5,5,1,0,40
117867,1153697,1,5,6,0,0,40
117868,1153697,1,6,1,1,0,41
117869,1153697,1,6,2,0,1,41
117870,1153697,1,6,3,1,0,42
117871,1153697,1,6,4,0,0,42
117872,1153697,1,6,5,1,0,43
117873,1153697,1,6,6,0,1,43
117874,1153697,1,7,1,1,0,44
117875,1153697,1,7,2,0,0,44
117876,1153697,1,7,3,1,0,45
117877,1153697,1,7,4,1,0,46
117878,1153697,1,7,5,1,0,47
117879,1153697,1,7,6,1,0,48
117880,1153697,1,8,1,0,0,48
117881,1153697,1,8,2,0,0,48
117882,1153697,1,8,3,1,0,49
117883,1153697,1,8,4,1,0,50
117884,1153697,1,8,5,0,1,50
117885,1153697,1,8,6,1,0,51
117886,1153697,1,9,1,0,0,51
117887,1153697,1,9,2,1,0,52
117888,1153697,1,9,3,1,0,53
117889,1153697,1,9,4,1,0,54
117890,1153697,1,9,5,1,0,55
117891,1153697,1,9,6,1,0,56
117892,1153697,1,10,1,0,0,56
117893,1153697,1,10,2,0,0,56
117894,1153697,1,10,3,1,0,57
117895,1153697,1,10,4,1,0,58
117896,1153697,1,10,5,1,0,59
117897,1153697,1,10,6,1,0,60
117898,1153697,1,11,1,6,0,66
117899,1153697,1,11,2,4,0,70
117900,1153697,1,11,3,6,0,76
117901,1153697,1,11,4,1,0,77
117902,1153697,1,11,5,2,0,79
117903,1153697,1,11,6,0,0,79
117904,1153697,1,12,1,2,0,81
117905,1153697,1,12,2,6,0,87
117906,1153697,1,12,3,6,0,93
117907,1153697,1,12,4,1,0,94
117908,1153697,1,12,5,2,0,96
117909,1153697,1,12,6,1,0,97
117910,1153697,1,13,1,0,0,97
117911,1153697,1,13,2,1,0,98
117912,1153697,1,13,3,1,0,99
117913,1153697,1,13,4,4,0,103
117914,1153697,1,13,5,1,0,104
117915,1153697,1,13,6,1,0,105
117916,1153697,1,14,1,2,0,107
117917,1153697,1,14,2,0,0,107
117918,1153697,1,14,3,3,0,110
117919,1153697,1,14,4,1,0,111
117920,1153697,1,14,5,2,0,113
117921,1153697,1,14,6,1,0,114
117922,1153697,1,15,1,0,0,114
117923,1153697,1,15,2,0,0,114
117924,1153697,1,15,3,1,0,115
117925,1153697,1,15,4,4,0,119
117926,1153697,1,15,5,1,0,120
117927,1153697,1,15,6,1,0,121
117928,1153697,1,16,1,1,0,122
117929,1153697,1,16,2,2,0,124
117930,1153697,1,16,3,3,0,127
117931,1153697,1,16,4,0,1,127
117932,1153697,1,16,5,1,0,128
117933,1153697,1,16,6,1,0,129
117934,1153697,1,17,1,2,0,131
117935,1153697,1,17,2,1,0,132
117936,1153697,1,17,3,1,0,133
117937,1153697,1,17,4,1,0,134
117938,1153697,1,17,5,1,0,135
117939,1153697,1,17,6,1,0,136
117940,1153697,1,18,1,4,0,140
117941,1153697,1,18,2,1,0,141
117942,1153697,1,18,3,1,0,142
117943,1153697,1,18,4,1,0,143
117944,1153697,1,18,5,1,0,144
117945,1153697,1,18,6,1,0,145
117946,1153697,1,19,1,1,0,146
117947,1153697,1,19,2,1,0,147
117948,1153697,1,19,3,2,0,149
117949,1153697,1,19,4,0,0,149
117950,1153697,1,19,5,3,0,152
117951,1153697,1,19,6,1,1,153
117952,1153697,1,20,1,1,0,154
117953,1153697,1,20,2,0,1,154
117954,1153697,1,20,3,1,0,155
117955,1153697,1,20,4,1,0,156
117956,1153697,1,20,5,2,0,158
117957,1153697,1,20,6,0,1,158
118071,1153698,1,1,1,2,0,2
118072,1153698,1,1,2,1,0,3
118073,1153698,1,1,3,6,0,9
118074,1153698,1,1,4,1,0,10
118075,1153698,1,1,5,0,0,10
118076,1153698,1,1,6,1,0,11
118077,1153698,1,2,1,1,0,12
118078,1153698,1,2,2,1,0,13
118079,1153698,1,2,3,0,0,13
118080,1153698,1,2,4,4,0,17
118081,1153698,1,2,5,1,0,18
118082,1153698,1,2,6,1,0,19
118083,1153698,1,3,1,0,0,19
118084,1153698,1,3,2,1,0,20
118085,1153698,1,3,3,1,0,21
118086,1153698,1,3,4,0,0,21
118087,1153698,1,3,5,0,0,21
118088,1153698,1,3,6,1,0,22
118089,1153698,1,4,1,0,0,22
118090,1153698,1,4,2,4,0,26
118091,1153698,1,4,3,6,0,32
118092,1153698,1,4,4,1,0,33
118093,1153698,1,4,5,1,0,34
118094,1153698,1,4,6,4,0,38
118095,1153698,1,5,1,1,0,39
118096,1153698,1,5,2,1,0,40
118097,1153698,1,5,3,4,0,44
118098,1153698,1,5,4,2,0,46
118099,1153698,1,5,5,0,0,46
118100,1153698,1,5,6,0,0,46
118101,1153698,1,6,1,1,0,47
118102,1153698,1,6,2,6,0,53
118103,1153698,1,6,3,4,0,57
118104,1153698,1,6,4,1,0,58
118105,1153698,1,6,5,6,0,64
118106,1153698,1,6,6,2,0,66
118107,1153698,1,7,1,4,0,70
118108,1153698,1,7,2,1,0,71
118109,1153698,1,7,3,6,0,77
118110,1153698,1,7,4,0,0,77
118111,1153698,1,7,5,1,0,78
118112,1153698,1,7,6,1,0,79
118113,1153698,1,8,1,0,0,79
118114,1153698,1,8,2,1,0,80
118115,1153698,1,8,3,0,0,80
118116,1153698,1,8,4,0,1,80
118117,1153698,1,8,5,2,0,82
118118,1153698,1,8,6,1,0,83
118119,1153698,1,9,1,1,0,84
118120,1153698,1,9,2,1,0,85
118121,1153698,1,9,3,1,0,86
118122,1153698,1,9,4,0,0,86
118123,1153698,1,9,5,1,0,87
118124,1153698,1,9,6,0,0,87
118125,1153698,1,10,1,1,0,88
118126,1153698,1,10,2,0,0,88
118127,1153698,1,10,3,1,0,89
118128,1153698,1,10,4,6,0,95
118129,1153698,1,10,5,1,0,96
118130,1153698,1,10,6,0,0,96
118131,1153698,1,11,1,6,0,102
118132,1153698,1,11,2,1,0,103
118133,1153698,1,11,3,1,0,104
118134,1153698,1,11,4,1,0,105
118135,1153698,1,11,5,1,0,106
118136,1153698,1,11,6,4,0,110
118137,1153698,1,12,1,1,0,111
118138,1153698,1,12,2,1,0,112
118139,1153698,1,12,3,1,0,113
118140,1153698,1,12,4,1,0,114
118141,1153698,1,12,5,4,0,118
118142,1153698,1,12,6,0,0,118
118143,1153698,1,13,1,1,0,119
118144,1153698,1,13,2,1,0,120
118145,1153698,1,13,3,4,0,124
118146,1153698,1,13,4,6,0,130
118147,1153698,1,13,5,4,0,134
118148,1153698,1,13,6,1,0,135
118149,1153698,1,14,1,0,0,135
118150,1153698,1,14,2,0,1,135
118151,1153698,1,14,3,1,0,136
118152,1153698,1,14,4,2,0,138
118153,1153698,1,14,5,1,0,139
118154,1153698,1,14,6,1,0,140
118155,1153698,1,15,1,4,0,144
118156,1153698,1,15,2,2,0,146
118157,1153698,1,15,3,4,0,150
118158,1153698,1,15,4,0,1,150
118159,1153698,1,15,5,1,0,151
118160,1153698,1,15,6,0,0,151
118161,1153698,1,16,1,1,0,152
118162,1153698,1,16,2,6,0,158
118163,1153698,1,16,3,1,0,159
118164,1153698,1,16,4,2,0,161
118165,1153698,1,16,5,4,0,165
118166,1153698,1,16,6,2,0,167
118167,1153698,1,17,1,4,0,171
118168,1153698,1,17,2,4,0,175
118169,1153698,1,17,3,1,0,176
118170,1153698,1,17,4,1,0,177
118171,1153698,1,17,5,1,0,178
118172,1153698,1,17,6,4,0,182
118173,1153698,1,18,1,1,0,183
118174,1153698,1,18,2,4,0,187
118175,1153698,1,18,3,1,0,188
118176,1153698,1,18,4,3,0,191
118177,1153698,1,18,5,1,0,192
118178,1153698,1,18,6,0,0,192
118179,1153698,1,19,1,1,0,193
118180,1153698,1,19,2,0,1,193
118181,1153698,1,19,3,2,0,195
118182,1153698,1,19,4,1,0,196
118183,1153698,1,19,5,4,0,200
118184,1153698,1,19,6,0,0,200
118185,1153698,1,20,1,6,0,206
118186,1153698,1,20,2,0,0,206
118187,1153698,1,20,3,0,0,206
118188,1153698,1,20,4,1,0,207
118189,1153698,1,20,5,1,0,208
118190,1153698,1,20,6,4,0,212
118311,1153843,1,1,1,0,0,0
118312,1153843,1,1,2,1,0,1
118313,1153843,1,1,3,1,0,2
118314,1153843,1,1,4,0,1,2
118315,1153843,1,1,5,7,0,9
118316,1153843,1,1,6,0,0,9
118317,1153843,1,2,1,2,0,11
118318,1153843,1,2,2,0,0,11
118319,1153843,1,2,3,0,1,11
118320,1153843,1,2,4,0,0,11
118321,1153843,1,2,5,1,0,12
118322,1153843,1,2,6,1,0,13
118323,1153843,1,3,1,1,0,14
118324,1153843,1,3,2,4,0,18
118325,1153843,1,3,3,1,0,19
118326,1153843,1,3,4,2,0,21
118327,1153843,1,3,5,0,1,21
118328,1153843,1,3,6,1,0,22
118329,1153843,1,4,1,1,0,23
118330,1153843,1,4,2,4,0,27
118331,1153843,1,4,3,0,1,27
118332,1153843,1,4,4,0,0,27
118333,1153843,1,4,5,0,0,27
118334,1153843,1,4,6,1,0,28
118335,1153843,1,5,1,0,0,28
118336,1153843,1,5,2,0,0,28
118337,1153843,1,5,3,1,0,29
118338,1153843,1,5,4,0,0,29
118339,1153843,1,5,5,0,0,29
118340,1153843,1,5,6,0,0,29
118341,1153843,1,6,1,1,0,30
118342,1153843,1,6,2,0,0,30
118343,1153843,1,6,3,2,0,32
118344,1153843,1,6,4,0,0,32
118345,1153843,1,6,5,0,0,32
118346,1153843,1,6,6,1,0,33
118347,1153843,1,7,1,0,0,33
118348,1153843,1,7,2,0,0,33
118349,1153843,1,7,3,0,0,33
118350,1153843,1,7,4,1,0,34
118351,1153843,1,7,5,1,0,35
118352,1153843,1,7,6,1,0,36
118353,1153843,1,8,1,1,0,37
118354,1153843,1,8,2,1,0,38
118355,1153843,1,8,3,1,0,39
118356,1153843,1,8,4,0,0,39
118357,1153843,1,8,5,4,0,43
118358,1153843,1,8,6,1,0,44
118359,1153843,1,9,1,1,0,45
118360,1153843,1,9,2,0,0,45
118361,1153843,1,9,3,1,0,46
118362,1153843,1,9,4,0,0,46
118363,1153843,1,9,5,1,0,47
118364,1153843,1,9,6,0,0,47
118365,1153843,1,10,1,1,0,48
118366,1153843,1,10,2,4,0,52
118367,1153843,1,10,3,0,0,52
118368,1153843,1,10,4,1,0,53
118369,1153843,1,10,5,2,0,55
118370,1153843,1,10,6,0,1,55
118371,1153843,1,11,1,0,0,55
118372,1153843,1,11,2,1,0,56
118373,1153843,1,11,3,1,0,57
118374,1153843,1,11,4,0,0,57
118375,1153843,1,11,5,0,0,57
118376,1153843,1,11,6,0,0,57
118377,1153843,1,12,1,1,0,58
118378,1153843,1,12,2,1,0,59
118379,1153843,1,12,3,1,0,60
118380,1153843,1,12,4,1,0,61
118381,1153843,1,12,5,1,0,62
118382,1153843,1,12,6,6,0,68
118383,1153843,1,13,1,1,0,69
118384,1153843,1,13,2,5,0,74
118385,1153843,1,13,3,2,0,76
118386,1153843,1,13,4,7,0,83
118387,1153843,1,13,5,1,0,84
118388,1153843,1,13,6,1,0,85
118389,1153843,1,14,1,6,0,91
118390,1153843,1,14,2,0,0,91
118391,1153843,1,14,3,1,0,92
118392,1153843,1,14,4,0,0,92
118393,1153843,1,14,5,0,0,92
118394,1153843,1,14,6,3,0,95
118395,1153843,1,15,1,1,0,96
118396,1153843,1,15,2,4,0,100
118397,1153843,1,15,3,1,0,101
118398,1153843,1,15,4,1,0,102
118399,1153843,1,15,5,0,1,102
118400,1153843,1,15,6,1,0,103
118401,1153843,1,16,1,2,0,105
118402,1153843,1,16,2,0,0,105
118403,1153843,1,16,3,3,0,108
118404,1153843,1,16,4,0,0,108
118405,1153843,1,16,5,6,0,114
118406,1153843,1,16,6,1,0,115
118407,1153843,1,17,1,1,0,116
118408,1153843,1,17,2,6,0,122
118409,1153843,1,17,3,6,0,128
118410,1153843,1,17,4,0,0,128
118411,1153843,1,17,5,6,0,134
118412,1153843,1,17,6,4,0,138
118413,1153843,1,18,1,4,0,142
118414,1153843,1,18,2,1,0,143
118415,1153843,1,18,3,0,1,143
118416,1153843,1,18,4,6,0,149
118417,1153843,1,18,5,6,0,155
118418,1153843,1,18,6,1,0,156
118419,1153843,1,19,1,1,0,157
118420,1153843,1,19,2,0,0,157
118421,1153843,1,19,3,1,0,158
118422,1153843,1,19,4,1,0,159
118423,1153843,1,19,5,2,0,161
118424,1153843,1,19,6,1,0,162
118425,1153843,1,20,1,1,0,163
118426,1153843,1,20,2,1,0,164
118427,1153843,1,20,3,2,0,166
118428,1153843,1,20,4,6,0,172
118429,1153843,1,20,5,1,0,173
118430,1153843,1,20,6,6,0,179
118532,1157372,1,1,1,0,0,0
118533,1157372,1,1,2,1,0,1
118534,1157372,1,1,3,3,0,4
118535,1157372,1,1,4,0,0,4
118536,1157372,1,1,5,1,0,5
118537,1157372,1,1,6,0,0,5
118538,1157372,1,2,1,1,0,6
118539,1157372,1,2,2,0,0,6
118540,1157372,1,2,3,0,0,6
118541,1157372,1,2,4,4,0,10
118542,1157372,1,2,5,1,0,11
118543,1157372,1,2,6,4,0,15
118544,1157372,1,3,1,0,0,15
118545,1157372,1,3,2,4,0,19
118546,1157372,1,3,3,1,0,20
118547,1157372,1,3,4,4,0,24
118548,1157372,1,3,5,1,0,25
118549,1157372,1,3,6,1,0,26
118550,1157372,1,4,1,0,0,26
118551,1157372,1,4,2,1,0,27
118552,1157372,1,4,3,0,0,27
118553,1157372,1,4,4,1,0,28
118554,1157372,1,4,5,1,0,29
118555,1157372,1,4,6,3,0,32
118556,1157372,1,5,1,0,1,32
118557,1157372,1,5,2,0,0,32
118558,1157372,1,5,3,2,0,34
118559,1157372,1,5,4,0,0,34
118560,1157372,1,5,5,4,0,38
118561,1157372,1,5,6,0,0,38
118562,1157372,1,6,1,4,0,42
118563,1157372,1,6,2,1,0,43
118564,1157372,1,6,3,0,0,43
118565,1157372,1,6,4,1,0,44
118566,1157372,1,6,5,0,0,44
118567,1157372,1,6,6,1,0,45
118568,1157372,1,7,1,1,0,46
118569,1157372,1,7,2,1,0,47
118570,1157372,1,7,3,1,0,48
118571,1157372,1,7,4,0,0,48
118572,1157372,1,7,5,0,0,48
118573,1157372,1,7,6,1,0,49
118574,1157372,1,8,1,1,0,50
118575,1157372,1,8,2,1,0,51
118576,1157372,1,8,3,2,0,53
118577,1157372,1,8,4,1,0,54
118578,1157372,1,8,5,1,0,55
118579,1157372,1,8,6,1,0,56
118580,1157372,1,9,1,1,0,57
118581,1157372,1,9,2,1,0,58
118582,1157372,1,9,3,6,0,64
118583,1157372,1,9,4,2,0,66
118584,1157372,1,9,5,1,0,67
118585,1157372,1,9,6,1,0,68
118586,1157372,1,10,1,1,0,69
118587,1157372,1,10,2,4,0,73
118588,1157372,1,10,3,1,0,74
118589,1157372,1,10,4,1,0,75
118590,1157372,1,10,5,1,0,76
118591,1157372,1,10,6,1,0,77
118592,1157372,1,11,1,1,0,78
118593,1157372,1,11,2,1,0,79
118594,1157372,1,11,3,0,0,79
118595,1157372,1,11,4,1,0,80
118596,1157372,1,11,5,1,0,81
118597,1157372,1,11,6,4,0,85
118598,1157372,1,12,1,1,0,86
118599,1157372,1,12,2,0,0,86
118600,1157372,1,12,3,1,0,87
118601,1157372,1,12,4,1,0,88
118602,1157372,1,12,5,4,0,92
118603,1157372,1,12,6,1,0,93
118604,1157372,1,13,1,1,0,94
118605,1157372,1,13,2,0,0,94
118606,1157372,1,13,3,6,0,100
118607,1157372,1,13,4,1,0,101
118608,1157372,1,13,5,0,0,101
118609,1157372,1,13,6,1,0,102
118610,1157372,1,14,1,1,0,103
118611,1157372,1,14,2,1,0,104
118612,1157372,1,14,3,1,0,105
118613,1157372,1,14,4,0,0,105
118614,1157372,1,14,5,0,1,105
118615,1157372,1,14,6,2,0,107
118616,1157372,1,15,1,2,0,109
118617,1157372,1,15,2,1,0,110
118618,1157372,1,15,3,0,0,110
118619,1157372,1,15,4,0,1,110
118620,1157372,1,15,5,0,0,110
118621,1157372,1,15,6,4,0,114
118622,1157372,1,16,1,6,0,120
118623,1157372,1,16,2,1,0,121
118624,1157372,1,16,3,1,0,122
118625,1157372,1,16,4,2,0,124
118626,1157372,1,16,5,0,0,124
118627,1157372,1,16,6,1,0,125
118628,1157372,1,17,1,1,0,126
118629,1157372,1,17,2,2,0,128
118630,1157372,1,17,3,2,0,130
118631,1157372,1,17,4,0,1,130
118632,1157372,1,17,5,0,1,130
118633,1157372,1,17,6,0,0,130
118634,1157372,1,18,1,1,0,131
118635,1157372,1,18,2,0,1,131
118636,1157372,1,18,3,1,0,132
118637,1157372,1,18,4,1,0,133
118638,1157372,1,18,5,0,1,133
118639,1157372,1,18,6,0,0,133
118640,1157372,1,19,1,0,1,133
118641,1157372,1,19,2,0,0,133
118642,1157372,1,19,3,1,0,134
118643,1157372,1,19,4,1,0,135
118644,1157372,1,19,5,1,0,136
118645,1157372,1,19,6,2,0,138
118646,1157372,1,20,1,4,0,142
118647,1157372,1,20,2,6,0,148
118648,1157372,1,20,3,4,0,152
118649,1157372,1,20,4,1,0,153
118650,1157372,1,20,5,1,0,154
118651,1157372,1,20,6,1,0,155
118753,1157373,1,1,1,1,0,1
118754,1157373,1,1,2,0,0,1
118755,1157373,1,1,3,1,0,2
118756,1157373,1,1,4,0,0,2
118757,1157373,1,1,5,2,0,4
118758,1157373,1,1,6,2,0,6
118759,1157373,1,2,1,4,0,10
118760,1157373,1,2,2,1,0,11
118761,1157373,1,2,3,2,0,13
118762,1157373,1,2,4,0,0,13
118763,1157373,1,2,5,0,0,13
118764,1157373,1,2,6,1,0,14
118765,1157373,1,3,1,4,0,18
118766,1157373,1,3,2,1,0,19
118767,1157373,1,3,3,0,0,19
118768,1157373,1,3,4,1,0,20
118769,1157373,1,3,5,1,0,21
118770,1157373,1,3,6,1,0,22
118771,1157373,1,4,1,4,0,26
118772,1157373,1,4,2,1,0,27
118773,1157373,1,4,3,1,0,28
118774,1157373,1,4,4,1,0,29
118775,1157373,1,4,5,0,1,29
118776,1157373,1,4,6,0,0,29
118777,1157373,1,5,1,1,0,30
118778,1157373,1,5,2,1,0,31
118779,1157373,1,5,3,4,0,35
118780,1157373,1,5,4,1,0,36
118781,1157373,1,5,5,4,0,40
118782,1157373,1,5,6,0,0,40
118783,1157373,1,6,1,1,0,41
118784,1157373,1,6,2,2,0,43
118785,1157373,1,6,3,2,0,45
118786,1157373,1,6,4,0,0,45
118787,1157373,1,6,5,0,0,45
118788,1157373,1,6,6,1,0,46
118789,1157373,1,7,1,0,0,46
118790,1157373,1,7,2,4,0,50
118791,1157373,1,7,3,1,0,51
118792,1157373,1,7,4,0,0,51
118793,1157373,1,7,5,0,0,51
118794,1157373,1,7,6,0,0,51
118795,1157373,1,8,1,6,0,57
118796,1157373,1,8,2,0,0,57
118797,1157373,1,8,3,1,0,58
118798,1157373,1,8,4,1,0,59
118799,1157373,1,8,5,0,0,59
118800,1157373,1,8,6,0,0,59
118801,1157373,1,9,1,1,0,60
118802,1157373,1,9,2,1,0,61
118803,1157373,1,9,3,1,0,62
118804,1157373,1,9,4,0,0,62
118805,1157373,1,9,5,1,0,63
118806,1157373,1,9,6,1,0,64
118807,1157373,1,10,1,1,0,65
118808,1157373,1,10,2,0,0,65
118809,1157373,1,10,3,1,0,66
118810,1157373,1,10,4,1,0,67
118811,1157373,1,10,5,1,0,68
118812,1157373,1,10,6,1,0,69
118813,1157373,1,11,1,1,0,70
118814,1157373,1,11,2,1,0,71
118815,1157373,1,11,3,2,0,73
118816,1157373,1,11,4,2,0,75
118817,1157373,1,11,5,1,0,76
118818,1157373,1,11,6,1,0,77
118819,1157373,1,12,1,4,0,81
118820,1157373,1,12,2,1,0,82
118821,1157373,1,12,3,1,0,83
118822,1157373,1,12,4,1,0,84
118823,1157373,1,12,5,1,0,85
118824,1157373,1,12,6,1,0,86
118825,1157373,1,13,1,1,0,87
118826,1157373,1,13,2,1,0,88
118827,1157373,1,13,3,1,0,89
118828,1157373,1,13,4,0,0,89
118829,1157373,1,13,5,0,0,89
118830,1157373,1,13,6,1,0,90
118831,1157373,1,14,1,0,0,90
118832,1157373,1,14,2,2,0,92
118833,1157373,1,14,3,1,0,93
118834,1157373,1,14,4,6,0,99
118835,1157373,1,14,5,0,0,99
118836,1157373,1,14,6,0,1,99
118837,1157373,1,15,1,1,0,100
118838,1157373,1,15,2,0,0,100
118839,1157373,1,15,3,1,0,101
118840,1157373,1,15,4,1,0,102
118841,1157373,1,15,5,1,0,103
118842,1157373,1,15,6,1,0,104
118843,1157373,1,16,1,1,0,105
118844,1157373,1,16,2,1,0,106
118845,1157373,1,16,3,0,0,106
118846,1157373,1,16,4,0,1,106
118847,1157373,1,16,5,0,0,106
118848,1157373,1,16,6,1,0,107
118849,1157373,1,17,1,1,0,108
118850,1157373,1,17,2,1,0,109
118851,1157373,1,17,3,6,0,115
118852,1157373,1,17,4,1,0,116
118853,1157373,1,17,5,1,0,117
118854,1157373,1,17,6,0,1,117
118855,1157373,1,18,1,4,0,121
118856,1157373,1,18,2,1,0,122
118857,1157373,1,18,3,1,0,123
118858,1157373,1,18,4,1,0,124
118859,1157373,1,18,5,2,0,126
118860,1157373,1,18,6,2,0,128
118861,1157373,1,19,1,1,0,129
118862,1157373,1,19,2,1,0,130
118863,1157373,1,19,3,1,0,131
118864,1157373,1,19,4,0,1,131
118865,1157373,1,19,5,0,1,131
118866,1157373,1,19,6,1,0,132
118867,1157373,1,20,1,4,0,136
118868,1157373,1,20,2,2,0,138
118869,1157373,1,20,3,1,0,139
118870,1157373,1,20,4,1,0,140
118871,1157373,1,20,5,6,0,146
118872,1157373,1,20,6,1,0,147
118993,1157374,1,1,1,0,0,0
118994,1157374,1,1,2,1,0,1
118995,1157374,1,1,3,0,0,1
118996,1157374,1,1,4,4,0,5
118997,1157374,1,1,5,1,0,6
118998,1157374,1,1,6,0,0,6
118999,1157374,1,2,1,0,0,6
119000,1157374,1,2,2,0,0,6
119001,1157374,1,2,3,4,0,10
119002,1157374,1,2,4,0,0,10
119003,1157374,1,2,5,0,0,10
119004,1157374,1,2,6,0,0,10
119005,1157374,1,3,1,0,0,10
119006,1157374,1,3,2,4,0,14
119007,1157374,1,3,3,1,0,15
119008,1157374,1,3,4,0,0,15
119009,1157374,1,3,5,0,0,15
119010,1157374,1,3,6,0,0,15
119011,1157374,1,4,1,4,0,19
119012,1157374,1,4,2,1,0,20
119013,1157374,1,4,3,1,0,21
119014,1157374,1,4,4,6,0,27
119015,1157374,1,4,5,2,0,29
119016,1157374,1,4,6,1,0,30
119017,1157374,1,5,1,4,0,34
119018,1157374,1,5,2,1,0,35
119019,1157374,1,5,3,6,0,41
119020,1157374,1,5,4,0,0,41
119021,1157374,1,5,5,4,0,45
119022,1157374,1,5,6,0,0,45
119023,1157374,1,6,1,0,0,45
119024,1157374,1,6,2,0,0,45
119025,1157374,1,6,3,1,0,46
119026,1157374,1,6,4,1,0,47
119027,1157374,1,6,5,1,0,48
119028,1157374,1,6,6,6,0,54
119029,1157374,1,7,1,4,0,58
119030,1157374,1,7,2,1,0,59
119031,1157374,1,7,3,0,0,59
119032,1157374,1,7,4,0,0,59
119033,1157374,1,7,5,1,0,60
119034,1157374,1,7,6,1,0,61
119035,1157374,1,8,1,1,0,62
119036,1157374,1,8,2,1,0,63
119037,1157374,1,8,3,1,0,64
119038,1157374,1,8,4,0,0,64
119039,1157374,1,8,5,1,0,65
119040,1157374,1,8,6,1,0,66
119041,1157374,1,9,1,0,0,66
119042,1157374,1,9,2,2,0,68
119043,1157374,1,9,3,0,0,68
119044,1157374,1,9,4,1,0,69
119045,1157374,1,9,5,0,0,69
119046,1157374,1,9,6,0,0,69
119047,1157374,1,10,1,0,0,69
119048,1157374,1,10,2,1,0,70
119049,1157374,1,10,3,2,0,72
119050,1157374,1,10,4,1,0,73
119051,1157374,1,10,5,0,0,73
119052,1157374,1,10,6,1,0,74
119053,1157374,1,11,1,1,0,75
119054,1157374,1,11,2,0,0,75
119055,1157374,1,11,3,2,0,77
119056,1157374,1,11,4,2,0,79
119057,1157374,1,11,5,0,0,79
119058,1157374,1,11,6,1,0,80
119059,1157374,1,12,1,0,0,80
119060,1157374,1,12,2,6,0,86
119061,1157374,1,12,3,0,0,86
119062,1157374,1,12,4,1,0,87
119063,1157374,1,12,5,1,0,88
119064,1157374,1,12,6,2,0,90
119065,1157374,1,13,1,1,0,91
119066,1157374,1,13,2,0,0,91
119067,1157374,1,13,3,1,0,92
119068,1157374,1,13,4,1,0,93
119069,1157374,1,13,5,0,1,93
119070,1157374,1,13,6,4,0,97
119071,1157374,1,14,1,0,1,97
119072,1157374,1,14,2,0,0,97
119073,1157374,1,14,3,1,0,98
119074,1157374,1,14,4,0,0,98
119075,1157374,1,14,5,1,0,99
119076,1157374,1,14,6,1,0,100
119077,1157374,1,15,1,1,0,101
119078,1157374,1,15,2,1,0,102
119079,1157374,1,15,3,1,0,103
119080,1157374,1,15,4,6,0,109
119081,1157374,1,15,5,1,0,110
119082,1157374,1,15,6,1,0,111
119083,1157374,1,16,1,4,0,115
119084,1157374,1,16,2,1,0,116
119085,1157374,1,16,3,0,0,116
119086,1157374,1,16,4,1,0,117
119087,1157374,1,16,5,2,0,119
119088,1157374,1,16,6,2,0,121
119089,1157374,1,17,1,0,0,121
119090,1157374,1,17,2,1,0,122
119091,1157374,1,17,3,4,0,126
119092,1157374,1,17,4,0,1,126
119093,1157374,1,17,5,0,0,126
119094,1157374,1,17,6,0,0,126
119095,1157374,1,18,1,4,0,130
119096,1157374,1,18,2,4,0,134
119097,1157374,1,18,3,0,0,134
119098,1157374,1,18,4,1,0,135
119099,1157374,1,18,5,0,0,135
119100,1157374,1,18,6,4,0,139
119101,1157374,1,19,1,1,0,140
119102,1157374,1,19,2,0,1,140
119103,1157374,1,19,3,1,0,141
119104,1157374,1,19,4,0,1,141
119105,1157374,1,19,5,2,0,143
119106,1157374,1,19,6,2,0,145
119107,1157374,1,20,1,0,0,145
119108,1157374,1,20,2,1,0,146
119109,1157374,1,20,3,1,0,147
119110,1157374,1,20,4,1,0,148
119111,1157374,1,20,5,1,0,149
119112,1157374,1,20,6,1,0,150
119228,1157375,1,1,1,4,0,4
119229,1157375,1,1,2,0,0,4
119230,1157375,1,1,3,0,0,4
119231,1157375,1,1,4,1,0,5
119232,1157375,1,1,5,0,0,5
119233,1157375,1,1,6,0,0,5
119234,1157375,1,2,1,0,0,5
119235,1157375,1,2,2,2,0,7
119236,1157375,1,2,3,1,0,8
119237,1157375,1,2,4,0,0,8
119238,1157375,1,2,5,0,0,8
119239,1157375,1,2,6,0,0,8
119240,1157375,1,3,1,0,0,8
119241,1157375,1,3,2,0,1,8
119242,1157375,1,3,3,0,0,8
119243,1157375,1,3,4,1,0,9
119244,1157375,1,3,5,0,0,9
119245,1157375,1,3,6,1,0,10
119246,1157375,1,4,1,0,1,10
119247,1157375,1,4,2,0,0,10
119248,1157375,1,4,3,0,0,10
119249,1157375,1,4,4,0,0,10
119250,1157375,1,4,5,4,0,14
119251,1157375,1,4,6,0,0,14
119252,1157375,1,5,1,4,0,18
119253,1157375,1,5,2,1,0,19
119254,1157375,1,5,3,0,0,19
119255,1157375,1,5,4,4,0,23
119256,1157375,1,5,5,0,0,23
119257,1157375,1,5,6,1,0,24
119258,1157375,1,6,1,0,0,24
119259,1157375,1,6,2,0,0,24
119260,1157375,1,6,3,0,0,24
119261,1157375,1,6,4,6,0,30
119262,1157375,1,6,5,1,0,31
119263,1157375,1,6,6,0,0,31
119264,1157375,1,7,1,0,0,31
119265,1157375,1,7,2,0,0,31
119266,1157375,1,7,3,2,0,33
119267,1157375,1,7,4,4,0,37
119268,1157375,1,7,5,1,0,38
119269,1157375,1,7,6,1,0,39
119270,1157375,1,8,1,1,0,40
119271,1157375,1,8,2,0,0,40
119272,1157375,1,8,3,0,0,40
119273,1157375,1,8,4,1,0,41
119274,1157375,1,8,5,1,0,42
119275,1157375,1,8,6,1,0,43
119276,1157375,1,9,1,0,0,43
119277,1157375,1,9,2,4,0,47
119278,1157375,1,9,3,1,0,48
119279,1157375,1,9,4,1,0,49
119280,1157375,1,9,5,1,0,50
119281,1157375,1,9,6,6,0,56
119282,1157375,1,10,1,1,0,57
119283,1157375,1,10,2,1,0,58
119284,1157375,1,10,3,1,0,59
119285,1157375,1,10,4,1,0,60
119286,1157375,1,10,5,1,0,61
119287,1157375,1,10,6,0,0,61
119288,1157375,1,11,1,1,0,62
119289,1157375,1,11,2,1,0,63
119290,1157375,1,11,3,1,0,64
119291,1157375,1,11,4,6,0,70
119292,1157375,1,11,5,1,0,71
119293,1157375,1,11,6,1,0,72
119294,1157375,1,12,1,1,0,73
119295,1157375,1,12,2,4,0,77
119296,1157375,1,12,3,0,0,77
119297,1157375,1,12,4,0,1,77
119298,1157375,1,12,5,1,0,78
119299,1157375,1,12,6,0,0,78
119300,1157375,1,13,1,0,0,78
119301,1157375,1,13,2,1,0,79
119302,1157375,1,13,3,1,0,80
119303,1157375,1,13,4,0,0,80
119304,1157375,1,13,5,4,0,84
119305,1157375,1,13,6,1,0,85
119306,1157375,1,14,1,4,0,89
119307,1157375,1,14,2,1,0,90
119308,1157375,1,14,3,1,0,91
119309,1157375,1,14,4,0,0,91
119310,1157375,1,14,5,0,0,91
119311,1157375,1,14,6,1,0,92
119312,1157375,1,15,1,1,0,93
119313,1157375,1,15,2,0,1,93
119314,1157375,1,15,3,2,0,95
119315,1157375,1,15,4,4,0,99
119316,1157375,1,15,5,1,0,100
119317,1157375,1,15,6,1,0,101
119318,1157375,1,16,1,0,0,101
119319,1157375,1,16,2,2,0,103
119320,1157375,1,16,3,0,0,103
119321,1157375,1,16,4,1,0,104
119322,1157375,1,16,5,1,0,105
119323,1157375,1,16,6,1,0,106
119324,1157375,1,17,1,0,0,106
119325,1157375,1,17,2,4,0,110
119326,1157375,1,17,3,2,0,112
119327,1157375,1,17,4,1,0,113
119328,1157375,1,17,5,0,0,113
119329,1157375,1,17,6,0,0,113
119330,1157375,1,18,1,1,0,114
119331,1157375,1,18,2,1,0,115
119332,1157375,1,18,3,6,0,121
119333,1157375,1,18,4,0,1,121
119334,1157375,1,18,5,1,0,122
119335,1157375,1,18,6,1,1,123
119336,1157375,1,19,1,1,0,124
119337,1157375,1,19,2,1,0,125
119338,1157375,1,19,3,0,0,125
119339,1157375,1,19,4,3,0,128
119340,1157375,1,19,5,0,0,128
119341,1157375,1,19,6,6,0,134
119342,1157375,1,20,1,2,0,136
119343,1157375,1,20,2,1,0,137
119344,1157375,1,20,3,0,0,137
119345,1157375,1,20,4,1,0,138
119346,1157375,1,20,5,4,0,142
119347,1157375,1,20,6,6,0,148
119468,1157376,1,1,1,6,0,6
119469,1157376,1,1,2,3,0,9
119470,1157376,1,1,3,1,0,10
119471,1157376,1,1,4,1,0,11
119472,1157376,1,1,5,1,0,12
119473,1157376,1,1,6,1,0,13
119474,1157376,1,2,1,0,0,13
119475,1157376,1,2,2,4,0,17
119476,1157376,1,2,3,4,0,21
119477,1157376,1,2,4,0,0,21
119478,1157376,1,2,5,1,0,22
119479,1157376,1,2,6,0,0,22
119480,1157376,1,3,1,0,0,22
119481,1157376,1,3,2,1,0,23
119482,1157376,1,3,3,0,0,23
119483,1157376,1,3,4,1,0,24
119484,1157376,1,3,5,4,0,28
119485,1157376,1,3,6,1,0,29
119486,1157376,1,4,1,0,0,29
119487,1157376,1,4,2,6,0,35
119488,1157376,1,4,3,1,0,36
119489,1157376,1,4,4,0,0,36
119490,1157376,1,4,5,0,0,36
119491,1157376,1,4,6,0,0,36
119492,1157376,1,5,1,0,0,36
119493,1157376,1,5,2,4,0,40
119494,1157376,1,5,3,1,0,41
119495,1157376,1,5,4,1,0,42
119496,1157376,1,5,5,4,0,46
119497,1157376,1,5,6,1,0,47
119498,1157376,1,6,1,2,0,49
119499,1157376,1,6,2,0,0,49
119500,1157376,1,6,3,1,0,50
119501,1157376,1,6,4,0,0,50
119502,1157376,1,6,5,0,1,50
119503,1157376,1,6,6,0,0,50
119504,1157376,1,7,1,1,0,51
119505,1157376,1,7,2,1,0,52
119506,1157376,1,7,3,1,0,53
119507,1157376,1,7,4,2,0,55
119508,1157376,1,7,5,1,0,56
119509,1157376,1,7,6,0,1,56
119510,1157376,1,8,1,2,0,58
119511,1157376,1,8,2,1,0,59
119512,1157376,1,8,3,1,0,60
119513,1157376,1,8,4,1,0,61
119514,1157376,1,8,5,1,0,62
119515,1157376,1,8,6,0,0,62
119516,1157376,1,9,1,0,0,62
119517,1157376,1,9,2,0,0,62
119518,1157376,1,9,3,1,0,63
119519,1157376,1,9,4,0,0,63
119520,1157376,1,9,5,2,0,65
119521,1157376,1,9,6,0,0,65
119522,1157376,1,10,1,0,0,65
119523,1157376,1,10,2,1,0,66
119524,1157376,1,10,3,1,0,67
119525,1157376,1,10,4,0,1,67
119526,1157376,1,10,5,1,0,68
119527,1157376,1,10,6,0,0,68
119528,1157376,1,11,1,0,0,68
119529,1157376,1,11,2,0,0,68
119530,1157376,1,11,3,0,0,68
119531,1157376,1,11,4,1,0,69
119532,1157376,1,11,5,1,0,70
119533,1157376,1,11,6,2,0,72
119534,1157376,1,12,1,1,0,73
119535,1157376,1,12,2,1,0,74
119536,1157376,1,12,3,1,0,75
119537,1157376,1,12,4,1,0,76
119538,1157376,1,12,5,0,0,76
119539,1157376,1,12,6,0,0,76
119540,1157376,1,13,1,1,0,77
119541,1157376,1,13,2,1,0,78
119542,1157376,1,13,3,4,0,82
119543,1157376,1,13,4,1,1,83
119544,1157376,1,13,5,1,0,84
119545,1157376,1,13,6,1,0,85
119546,1157376,1,14,1,1,0,86
119547,1157376,1,14,2,0,0,86
119548,1157376,1,14,3,1,0,87
119549,1157376,1,14,4,1,0,88
119550,1157376,1,14,5,1,0,89
119551,1157376,1,14,6,1,0,90
119552,1157376,1,15,1,2,0,92
119553,1157376,1,15,2,1,0,93
119554,1157376,1,15,3,0,0,93
119555,1157376,1,15,4,4,0,97
119556,1157376,1,15,5,0,0,97
119557,1157376,1,15,6,4,0,101
119558,1157376,1,16,1,4,0,105
119559,1157376,1,16,2,1,0,106
119560,1157376,1,16,3,0,0,106
119561,1157376,1,16,4,1,0,107
119562,1157376,1,16,5,1,0,108
119563,1157376,1,16,6,1,0,109
119564,1157376,1,17,1,1,0,110
119565,1157376,1,17,2,1,0,111
119566,1157376,1,17,3,0,0,111
119567,1157376,1,17,4,6,0,117
119568,1157376,1,17,5,4,0,121
119569,1157376,1,17,6,4,0,125
119570,1157376,1,18,1,0,1,125
119571,1157376,1,18,2,0,0,125
119572,1157376,1,18,3,1,0,126
119573,1157376,1,18,4,0,0,126
119574,1157376,1,18,5,0,0,126
119575,1157376,1,18,6,0,0,126
119576,1157376,1,19,1,1,0,127
119577,1157376,1,19,2,4,0,131
119578,1157376,1,19,3,1,0,132
119579,1157376,1,19,4,6,0,138
119580,1157376,1,19,5,2,0,140
119581,1157376,1,19,6,2,0,142
119582,1157376,1,20,1,6,0,148
119583,1157376,1,20,2,0,1,148
119584,1157376,1,20,3,1,0,149
119585,1157376,1,20,4,0,1,149
119586,1157376,1,20,5,2,0,151
119587,1157376,1,20,6,2,0,153
119706,1157377,1,1,1,0,0,0
119707,1157377,1,1,2,0,0,0
119708,1157377,1,1,3,0,0,0
119709,1157377,1,1,4,1,0,1
119710,1157377,1,1,5,0,0,1
119711,1157377,1,1,6,0,0,1
119712,1157377,1,2,1,0,0,1
119713,1157377,1,2,2,1,0,2
119714,1157377,1,2,3,0,0,2
119715,1157377,1,2,4,0,0,2
119716,1157377,1,2,5,4,0,6
119717,1157377,1,2,6,0,0,6
119718,1157377,1,3,1,0,0,6
119719,1157377,1,3,2,1,0,7
119720,1157377,1,3,3,0,0,7
119721,1157377,1,3,4,1,0,8
119722,1157377,1,3,5,1,0,9
119723,1157377,1,3,6,0,0,9
119724,1157377,1,4,1,0,0,9
119725,1157377,1,4,2,4,0,13
119726,1157377,1,4,3,1,0,14
119727,1157377,1,4,4,2,0,16
119728,1157377,1,4,5,2,0,18
119729,1157377,1,4,6,1,0,19
119730,1157377,1,5,1,4,0,23
119731,1157377,1,5,2,1,0,24
119732,1157377,1,5,3,1,0,25
119733,1157377,1,5,4,1,0,26
119734,1157377,1,5,5,1,0,27
119735,1157377,1,5,6,1,0,28
119736,1157377,1,6,1,1,0,29
119737,1157377,1,6,2,0,0,29
119738,1157377,1,6,3,0,1,29
119739,1157377,1,6,4,0,0,29
119740,1157377,1,6,5,0,0,29
119741,1157377,1,6,6,4,0,33
119742,1157377,1,7,1,1,0,34
119743,1157377,1,7,2,1,0,35
119744,1157377,1,7,3,1,0,36
119745,1157377,1,7,4,0,0,36
119746,1157377,1,7,5,1,0,37
119747,1157377,1,7,6,1,0,38
119748,1157377,1,8,1,1,0,39
119749,1157377,1,8,2,1,0,40
119750,1157377,1,8,3,2,0,42
119751,1157377,1,8,4,1,0,43
119752,1157377,1,8,5,1,0,44
119753,1157377,1,8,6,1,0,45
119754,1157377,1,9,1,4,0,49
119755,1157377,1,9,2,1,0,50
119756,1157377,1,9,3,2,0,52
119757,1157377,1,9,4,1,0,53
119758,1157377,1,9,5,4,0,57
119759,1157377,1,9,6,1,0,58
119760,1157377,1,10,1,2,0,60
119761,1157377,1,10,2,4,0,64
119762,1157377,1,10,3,1,0,65
119763,1157377,1,10,4,0,0,65
119764,1157377,1,10,5,1,0,66
119765,1157377,1,10,6,1,0,67
119766,1157377,1,11,1,0,0,67
119767,1157377,1,11,2,1,0,68
119768,1157377,1,11,3,6,0,74
119769,1157377,1,11,4,6,0,80
119770,1157377,1,11,5,1,0,81
119771,1157377,1,11,6,1,0,82
119772,1157377,1,12,1,0,0,82
119773,1157377,1,12,2,1,0,83
119774,1157377,1,12,3,1,0,84
119775,1157377,1,12,4,1,0,85
119776,1157377,1,12,5,1,0,86
119777,1157377,1,12,6,0,0,86
119778,1157377,1,13,1,1,0,87
119779,1157377,1,13,2,0,0,87
119780,1157377,1,13,3,0,0,87
119781,1157377,1,13,4,1,0,88
119782,1157377,1,13,5,1,0,89
119783,1157377,1,13,6,1,0,90
119784,1157377,1,14,1,1,0,91
119785,1157377,1,14,2,1,0,92
119786,1157377,1,14,3,0,0,92
119787,1157377,1,14,4,1,0,93
119788,1157377,1,14,5,1,0,94
119789,1157377,1,14,6,1,0,95
119790,1157377,1,15,1,6,0,101
119791,1157377,1,15,2,6,0,107
119792,1157377,1,15,3,1,0,108
119793,1157377,1,15,4,1,0,109
119794,1157377,1,15,5,2,0,111
119795,1157377,1,15,6,1,0,112
119796,1157377,1,16,1,1,0,113
119797,1157377,1,16,2,1,0,114
119798,1157377,1,16,3,4,0,118
119799,1157377,1,16,4,0,0,118
119800,1157377,1,16,5,4,0,122
119801,1157377,1,16,6,1,0,123
119802,1157377,1,17,1,0,1,123
119803,1157377,1,17,2,1,0,124
119804,1157377,1,17,3,4,0,128
119805,1157377,1,17,4,4,0,132
119806,1157377,1,17,5,2,0,134
119807,1157377,1,17,6,1,0,135
119808,1157377,1,18,1,1,0,136
119809,1157377,1,18,2,4,0,140
119810,1157377,1,18,3,1,0,141
119811,1157377,1,18,4,1,0,142
119812,1157377,1,18,5,1,0,143
119813,1157377,1,18,6,2,0,145
119814,1157377,1,19,1,4,0,149
119815,1157377,1,19,2,1,0,150
119816,1157377,1,19,3,4,0,154
119817,1157377,1,19,4,0,1,154
119818,1157377,1,19,5,2,0,156
119819,1157377,1,19,6,0,0,156
119820,1157377,1,20,1,4,0,160
119821,1157377,1,20,2,1,0,161
119822,1157377,1,20,3,1,0,162
119823,1157377,1,20,4,2,0,164
119824,1157377,1,20,5,1,0,165
119825,1157377,1,20,6,1,0,166
119927,1157759,1,1,1,0,0,0
119928,1157759,1,1,2,4,0,4
119929,1157759,1,1,3,0,0,4
119930,1157759,1,1,4,0,0,4
119931,1157759,1,1,5,4,0,8
119932,1157759,1,1,6,0,0,8
119933,1157759,1,2,1,1,0,9
119934,1157759,1,2,2,1,0,10
119935,1157759,1,2,3,1,0,11
119936,1157759,1,2,4,0,0,11
119937,1157759,1,2,5,1,0,12
119938,1157759,1,2,6,4,0,16
119939,1157759,1,3,1,0,1,16
119940,1157759,1,3,2,0,0,16
119941,1157759,1,3,3,4,0,20
119942,1157759,1,3,4,0,0,20
119943,1157759,1,3,5,1,0,21
119944,1157759,1,3,6,1,0,22
119945,1157759,1,4,1,0,1,22
119946,1157759,1,4,2,0,0,22
119947,1157759,1,4,3,0,0,22
119948,1157759,1,4,4,0,0,22
119949,1157759,1,4,5,0,0,22
119950,1157759,1,4,6,0,0,22
119951,1157759,1,5,1,1,0,23
119952,1157759,1,5,2,1,0,24
119953,1157759,1,5,3,4,0,28
119954,1157759,1,5,4,0,1,28
119955,1157759,1,5,5,1,0,29
119956,1157759,1,5,6,0,0,29
119957,1157759,1,6,1,2,0,31
119958,1157759,1,6,2,0,0,31
119959,1157759,1,6,3,0,0,31
119960,1157759,1,6,4,0,0,31
119961,1157759,1,6,5,0,0,31
119962,1157759,1,6,6,0,0,31
119963,1157759,1,7,1,1,0,32
119964,1157759,1,7,2,0,0,32
119965,1157759,1,7,3,1,0,33
119966,1157759,1,7,4,0,0,33
119967,1157759,1,7,5,1,0,34
119968,1157759,1,7,6,0,0,34
119969,1157759,1,8,1,1,0,35
119970,1157759,1,8,2,0,0,35
119971,1157759,1,8,3,8,0,43
119972,1157759,1,8,4,0,0,43
119973,1157759,1,8,5,1,0,44
119974,1157759,1,8,6,0,0,44
119975,1157759,1,9,1,1,0,45
119976,1157759,1,9,2,0,0,45
119977,1157759,1,9,3,1,0,46
119978,1157759,1,9,4,0,0,46
119979,1157759,1,9,5,0,0,46
119980,1157759,1,9,6,1,0,47
119981,1157759,1,10,1,0,0,47
119982,1157759,1,10,2,0,1,47
119983,1157759,1,10,3,0,0,47
119984,1157759,1,10,4,0,0,47
119985,1157759,1,10,5,1,0,48
119986,1157759,1,10,6,1,0,49
119987,1157759,1,11,1,0,1,49
119988,1157759,1,11,2,1,0,50
119989,1157759,1,11,3,0,0,50
119990,1157759,1,11,4,1,0,51
119991,1157759,1,11,5,0,0,51
119992,1157759,1,11,6,2,0,53
119993,1157759,1,12,1,0,0,53
119994,1157759,1,12,2,0,0,53
119995,1157759,1,12,3,0,0,53
119996,1157759,1,12,4,0,0,53
119997,1157759,1,12,5,0,0,53
119998,1157759,1,12,6,1,0,54
119999,1157759,1,13,1,1,0,55
120000,1157759,1,13,2,1,0,56
120001,1157759,1,13,3,0,1,56
120002,1157759,1,13,4,0,0,56
120003,1157759,1,13,5,0,0,56
120004,1157759,1,13,6,0,0,56
120005,1157759,1,14,1,0,0,56
120006,1157759,1,14,2,0,0,56
120007,1157759,1,14,3,0,0,56
120008,1157759,1,14,4,0,0,56
120009,1157759,1,14,5,1,0,57
120010,1157759,1,14,6,1,0,58
120011,1157759,1,15,1,4,0,62
120012,1157759,1,15,2,0,0,62
120013,1157759,1,15,3,1,0,63
120014,1157759,1,15,4,0,0,63
120015,1157759,1,15,5,0,1,63
120016,1157759,1,15,6,0,0,63
120017,1157759,1,16,1,4,0,67
120018,1157759,1,16,2,1,0,68
120019,1157759,1,16,3,0,0,68
120020,1157759,1,16,4,1,0,69
120021,1157759,1,16,5,0,0,69
120022,1157759,1,16,6,1,0,70
120023,1157759,1,17,1,4,0,74
120024,1157759,1,17,2,2,0,76
120025,1157759,1,17,3,3,0,79
120026,1157759,1,17,4,0,0,79
120027,1157759,1,17,5,1,0,80
120028,1157759,1,17,6,1,0,81
120029,1157759,1,18,1,0,0,81
120030,1157759,1,18,2,1,0,82
120031,1157759,1,18,3,1,0,83
120032,1157759,1,18,4,4,0,87
120033,1157759,1,18,5,0,0,87
120034,1157759,1,18,6,0,1,87
120035,1157759,1,19,1,1,0,88
120036,1157759,1,19,2,4,0,92
120037,1157759,1,19,3,1,0,93
120038,1157759,1,19,4,2,0,95
120039,1157759,1,19,5,4,0,99
120040,1157759,1,19,6,4,0,103
120041,1157759,1,20,1,1,0,104
120042,1157759,1,20,2,0,0,104
120043,1157759,1,20,3,0,0,104
120044,1157759,1,20,4,1,0,105
120045,1157759,1,20,5,0,0,105
120046,1157759,1,20,6,4,0,109
120154,1157760,1,1,1,0,0,0
120155,1157760,1,1,2,0,0,0
120156,1157760,1,1,3,0,0,0
120157,1157760,1,1,4,0,0,0
120158,1157760,1,1,5,0,0,0
120159,1157760,1,1,6,0,0,0
120160,1157760,1,2,1,1,0,1
120161,1157760,1,2,2,2,0,3
120162,1157760,1,2,3,1,0,4
120163,1157760,1,2,4,0,0,4
120164,1157760,1,2,5,2,0,6
120165,1157760,1,2,6,1,0,7
120166,1157760,1,3,1,1,0,8
120167,1157760,1,3,2,1,0,9
120168,1157760,1,3,3,0,0,9
120169,1157760,1,3,4,1,0,10
120170,1157760,1,3,5,1,0,11
120171,1157760,1,3,6,0,0,11
120172,1157760,1,4,1,4,0,15
120173,1157760,1,4,2,1,0,16
120174,1157760,1,4,3,2,0,18
120175,1157760,1,4,4,1,0,19
120176,1157760,1,4,5,0,0,19
120177,1157760,1,4,6,1,0,20
120178,1157760,1,5,1,0,0,20
120179,1157760,1,5,2,6,0,26
120180,1157760,1,5,3,6,0,32
120181,1157760,1,5,4,0,0,32
120182,1157760,1,5,5,4,0,36
120183,1157760,1,5,6,1,0,37
120184,1157760,1,6,1,1,0,38
120185,1157760,1,6,2,6,0,44
120186,1157760,1,6,3,1,0,45
120187,1157760,1,6,4,3,0,48
120188,1157760,1,6,5,0,0,48
120189,1157760,1,6,6,1,0,49
120190,1157760,1,7,1,1,0,50
120191,1157760,1,7,2,2,0,52
120192,1157760,1,7,3,2,0,54
120193,1157760,1,7,4,1,0,55
120194,1157760,1,7,5,1,0,56
120195,1157760,1,7,6,1,0,57
120196,1157760,1,8,1,2,0,59
120197,1157760,1,8,2,0,0,59
120198,1157760,1,8,3,1,0,60
120199,1157760,1,8,4,0,0,60
120200,1157760,1,8,5,1,0,61
120201,1157760,1,8,6,1,0,62
120202,1157760,1,9,1,4,0,66
120203,1157760,1,9,2,1,0,67
120204,1157760,1,9,3,6,0,73
120205,1157760,1,9,4,0,0,73
120206,1157760,1,9,5,4,0,77
120207,1157760,1,9,6,1,0,78
120208,1157760,1,10,1,1,0,79
120209,1157760,1,10,2,0,0,79
120210,1157760,1,10,3,1,0,80
120211,1157760,1,10,4,1,0,81
120212,1157760,1,10,5,1,0,82
120213,1157760,1,10,6,1,0,83
120214,1157760,1,11,1,1,0,84
120215,1157760,1,11,2,1,0,85
120216,1157760,1,11,3,0,0,85
120217,1157760,1,11,4,1,0,86
120218,1157760,1,11,5,3,0,89
120219,1157760,1,11,6,0,0,89
120220,1157760,1,12,1,4,0,93
120221,1157760,1,12,2,1,0,94
120222,1157760,1,12,3,0,0,94
120223,1157760,1,12,4,0,0,94
120224,1157760,1,12,5,2,0,96
120225,1157760,1,12,6,0,0,96
120226,1157760,1,13,1,2,0,98
120227,1157760,1,13,2,4,0,102
120228,1157760,1,13,3,1,0,103
120229,1157760,1,13,4,1,0,104
120230,1157760,1,13,5,2,0,106
120231,1157760,1,13,6,1,0,107
120232,1157760,1,14,1,6,0,113
120233,1157760,1,14,2,6,0,119
120234,1157760,1,14,3,1,0,120
120235,1157760,1,14,4,0,0,120
120236,1157760,1,14,5,2,0,122
120237,1157760,1,14,6,1,1,123
120238,1157760,1,15,1,4,0,127
120239,1157760,1,15,2,1,0,128
120240,1157760,1,15,3,0,0,128
120241,1157760,1,15,4,0,0,128
120242,1157760,1,15,5,0,0,128
120243,1157760,1,15,6,1,0,129
120244,1157760,1,16,1,4,0,133
120245,1157760,1,16,2,0,1,133
120246,1157760,1,16,3,1,0,134
120247,1157760,1,16,4,0,0,134
120248,1157760,1,16,5,1,0,135
120249,1157760,1,16,6,1,0,136
120250,1157760,1,17,1,1,0,137
120251,1157760,1,17,2,1,0,138
120252,1157760,1,17,3,4,0,142
120253,1157760,1,17,4,4,0,146
120254,1157760,1,17,5,1,0,147
120255,1157760,1,17,6,1,0,148
120256,1157760,1,18,1,0,0,148
120257,1157760,1,18,2,6,0,154
120258,1157760,1,18,3,4,0,158
120259,1157760,1,18,4,1,0,159
120260,1157760,1,18,5,8,0,167
120261,1157760,1,18,6,2,0,169
120262,1157760,1,19,1,1,0,170
120263,1157760,1,19,2,2,0,172
120264,1157760,1,19,3,0,0,172
120265,1157760,1,19,4,2,0,174
120266,1157760,1,19,5,0,0,174
120267,1157760,1,19,6,1,0,175
120268,1157760,1,20,1,1,0,176
120269,1157760,1,20,2,4,0,180
120270,1157760,1,20,3,4,0,184
120271,1157760,1,20,4,4,0,188
120272,1157760,1,20,5,6,0,194
120273,1157760,1,20,6,1,0,195
120394,1157761,1,1,1,0,0,0
120395,1157761,1,1,2,0,0,0
120396,1157761,1,1,3,0,0,0
120397,1157761,1,1,4,0,0,0
120398,1157761,1,1,5,1,0,1
120399,1157761,1,1,6,0,0,1
120400,1157761,1,2,1,0,0,1
120401,1157761,1,2,2,1,0,2
120402,1157761,1,2,3,4,0,6
120403,1157761,1,2,4,0,0,6
120404,1157761,1,2,5,0,0,6
120405,1157761,1,2,6,0,0,6
120406,1157761,1,3,1,0,0,6
120407,1157761,1,3,2,0,0,6
120408,1157761,1,3,3,4,0,10
120409,1157761,1,3,4,1,0,11
120410,1157761,1,3,5,4,0,15
120411,1157761,1,3,6,0,0,15
120412,1157761,1,4,1,1,0,16
120413,1157761,1,4,2,0,0,16
120414,1157761,1,4,3,4,0,20
120415,1157761,1,4,4,0,0,20
120416,1157761,1,4,5,4,0,24
120417,1157761,1,4,6,5,0,29
120418,1157761,1,5,1,4,0,33
120419,1157761,1,5,2,0,0,33
120420,1157761,1,5,3,0,0,33
120421,1157761,1,5,4,4,0,37
120422,1157761,1,5,5,0,0,37
120423,1157761,1,5,6,1,0,38
120424,1157761,1,6,1,0,0,38
120425,1157761,1,6,2,6,0,44
120426,1157761,1,6,3,1,0,45
120427,1157761,1,6,4,0,0,45
120428,1157761,1,6,5,0,0,45
120429,1157761,1,6,6,6,0,51
120430,1157761,1,7,1,0,1,51
120431,1157761,1,7,2,2,0,53
120432,1157761,1,7,3,1,0,54
120433,1157761,1,7,4,1,0,55
120434,1157761,1,7,5,0,0,55
120435,1157761,1,7,6,1,0,56
120436,1157761,1,8,1,1,0,57
120437,1157761,1,8,2,1,0,58
120438,1157761,1,8,3,0,0,58
120439,1157761,1,8,4,0,0,58
120440,1157761,1,8,5,1,0,59
120441,1157761,1,8,6,0,0,59
120442,1157761,1,9,1,0,0,59
120443,1157761,1,9,2,0,0,59
120444,1157761,1,9,3,1,0,60
120445,1157761,1,9,4,1,0,61
120446,1157761,1,9,5,1,0,62
120447,1157761,1,9,6,0,1,62
120448,1157761,1,10,1,0,0,62
120449,1157761,1,10,2,1,0,63
120450,1157761,1,10,3,1,0,64
120451,1157761,1,10,4,0,0,64
120452,1157761,1,10,5,2,0,66
120453,1157761,1,10,6,1,0,67
120454,1157761,1,11,1,1,0,68
120455,1157761,1,11,2,0,0,68
120456,1157761,1,11,3,4,0,72
120457,1157761,1,11,4,1,0,73
120458,1157761,1,11,5,1,0,74
120459,1157761,1,11,6,4,0,78
120460,1157761,1,12,1,1,0,79
120461,1157761,1,12,2,1,0,80
120462,1157761,1,12,3,1,0,81
120463,1157761,1,12,4,2,0,83
120464,1157761,1,12,5,0,0,83
120465,1157761,1,12,6,1,0,84
120466,1157761,1,13,1,3,0,87
120467,1157761,1,13,2,0,0,87
120468,1157761,1,13,3,6,0,93
120469,1157761,1,13,4,1,0,94
120470,1157761,1,13,5,0,1,94
120471,1157761,1,13,6,1,0,95
120472,1157761,1,14,1,0,0,95
120473,1157761,1,14,2,0,0,95
120474,1157761,1,14,3,0,0,95
120475,1157761,1,14,4,1,0,96
120476,1157761,1,14,5,1,0,97
120477,1157761,1,14,6,4,0,101
120478,1157761,1,15,1,3,0,104
120479,1157761,1,15,2,1,0,105
120480,1157761,1,15,3,4,0,109
120481,1157761,1,15,4,2,0,111
120482,1157761,1,15,5,6,0,117
120483,1157761,1,15,6,0,0,117
120484,1157761,1,16,1,0,0,117
120485,1157761,1,16,2,6,0,123
120486,1157761,1,16,3,6,0,129
120487,1157761,1,16,4,1,0,130
120488,1157761,1,16,5,1,0,131
120489,1157761,1,16,6,1,0,132
120490,1157761,1,17,1,6,0,138
120491,1157761,1,17,2,4,0,142
120492,1157761,1,17,3,1,0,143
120493,1157761,1,17,4,0,0,143
120494,1157761,1,17,5,1,0,144
120495,1157761,1,17,6,1,0,145
120496,1157761,1,18,1,1,0,146
120497,1157761,1,18,2,0,0,146
120498,1157761,1,18,3,0,0,146
120499,1157761,1,18,4,2,0,148
120500,1157761,1,18,5,0,0,148
120501,1157761,1,18,6,1,0,149
120502,1157761,1,19,1,1,0,150
120503,1157761,1,19,2,4,0,154
120504,1157761,1,19,3,1,0,155
120505,1157761,1,19,4,1,0,156
120506,1157761,1,19,5,1,0,157
120507,1157761,1,19,6,1,0,158
120508,1157761,1,20,1,6,0,164
120509,1157761,1,20,2,2,0,166
120510,1157761,1,20,3,4,0,170
120511,1157761,1,20,4,6,0,176
120512,1157761,1,20,5,4,0,180
120513,1157761,1,20,6,1,0,181
120634,1158071,1,1,1,4,0,4
120635,1158071,1,1,2,0,0,4
120636,1158071,1,1,3,1,0,5
120637,1158071,1,1,4,0,0,5
120638,1158071,1,1,5,0,0,5
120639,1158071,1,1,6,0,0,5
120640,1158071,1,2,1,1,0,6
120641,1158071,1,2,2,1,0,7
120642,1158071,1,2,3,0,1,7
120643,1158071,1,2,4,0,0,7
120644,1158071,1,2,5,0,0,7
120645,1158071,1,2,6,6,0,13
120646,1158071,1,3,1,1,0,14
120647,1158071,1,3,2,0,0,14
120648,1158071,1,3,3,6,0,20
120649,1158071,1,3,4,1,0,21
120650,1158071,1,3,5,1,0,22
120651,1158071,1,3,6,6,0,28
120652,1158071,1,4,1,1,0,29
120653,1158071,1,4,2,0,0,29
120654,1158071,1,4,3,1,0,30
120655,1158071,1,4,4,0,0,30
120656,1158071,1,4,5,1,0,31
120657,1158071,1,4,6,0,1,31
120658,1158071,1,5,1,1,0,32
120659,1158071,1,5,2,0,0,32
120660,1158071,1,5,3,1,0,33
120661,1158071,1,5,4,4,0,37
120662,1158071,1,5,5,0,0,37
120663,1158071,1,5,6,0,1,37
120664,1158071,1,6,1,1,0,38
120665,1158071,1,6,2,0,0,38
120666,1158071,1,6,3,0,0,38
120667,1158071,1,6,4,1,0,39
120668,1158071,1,6,5,0,0,39
120669,1158071,1,6,6,4,0,43
120670,1158071,1,7,1,0,0,43
120671,1158071,1,7,2,0,0,43
120672,1158071,1,7,3,0,0,43
120673,1158071,1,7,4,1,0,44
120674,1158071,1,7,5,1,0,45
120675,1158071,1,7,6,1,0,46
120676,1158071,1,8,1,2,0,48
120677,1158071,1,8,2,0,0,48
120678,1158071,1,8,3,0,0,48
120679,1158071,1,8,4,1,0,49
120680,1158071,1,8,5,1,0,50
120681,1158071,1,8,6,1,0,51
120682,1158071,1,9,1,0,0,51
120683,1158071,1,9,2,0,0,51
120684,1158071,1,9,3,1,0,52
120685,1158071,1,9,4,0,0,52
120686,1158071,1,9,5,1,0,53
120687,1158071,1,9,6,0,0,53
120688,1158071,1,10,1,4,0,57
120689,1158071,1,10,2,1,0,58
120690,1158071,1,10,3,6,0,64
120691,1158071,1,10,4,0,0,64
120692,1158071,1,10,5,1,0,65
120693,1158071,1,10,6,2,0,67
120694,1158071,1,11,1,0,0,67
120695,1158071,1,11,2,1,0,68
120696,1158071,1,11,3,6,0,74
120697,1158071,1,11,4,1,0,75
120698,1158071,1,11,5,1,0,76
120699,1158071,1,11,6,0,0,76
120700,1158071,1,12,1,1,0,77
120701,1158071,1,12,2,6,0,83
120702,1158071,1,12,3,0,0,83
120703,1158071,1,12,4,1,0,84
120704,1158071,1,12,5,0,0,84
120705,1158071,1,12,6,6,0,90
120706,1158071,1,13,1,1,0,91
120707,1158071,1,13,2,1,0,92
120708,1158071,1,13,3,0,0,92
120709,1158071,1,13,4,0,0,92
120710,1158071,1,13,5,1,0,93
120711,1158071,1,13,6,1,0,94
120712,1158071,1,14,1,4,0,98
120713,1158071,1,14,2,2,0,100
120714,1158071,1,14,3,1,1,101
120715,1158071,1,14,4,0,0,101
120716,1158071,1,14,5,0,0,101
120717,1158071,1,14,6,0,0,101
120718,1158071,1,15,1,1,0,102
120719,1158071,1,15,2,0,0,102
120720,1158071,1,15,3,0,0,102
120721,1158071,1,15,4,0,1,102
120722,1158071,1,15,5,0,0,102
120723,1158071,1,15,6,0,0,102
120724,1158071,1,16,1,4,0,106
120725,1158071,1,16,2,0,0,106
120726,1158071,1,16,3,2,0,108
120727,1158071,1,16,4,2,0,110
120728,1158071,1,16,5,1,0,111
120729,1158071,1,16,6,2,0,113
120730,1158071,1,17,1,1,0,114
120731,1158071,1,17,2,6,0,120
120732,1158071,1,17,3,1,0,121
120733,1158071,1,17,4,6,0,127
120734,1158071,1,17,5,0,1,127
120735,1158071,1,17,6,1,0,128
120736,1158071,1,18,1,1,0,129
120737,1158071,1,18,2,6,0,135
120738,1158071,1,18,3,0,0,135
120739,1158071,1,18,4,2,0,137
120740,1158071,1,18,5,0,1,137
120741,1158071,1,18,6,2,0,139
120742,1158071,1,19,1,1,0,140
120743,1158071,1,19,2,1,0,141
120744,1158071,1,19,3,5,0,146
120745,1158071,1,19,4,0,0,146
120746,1158071,1,19,5,1,0,147
120747,1158071,1,19,6,1,0,148
120748,1158071,1,20,1,4,0,152
120749,1158071,1,20,2,1,0,153
120750,1158071,1,20,3,2,0,155
120751,1158071,1,20,4,4,0,159
120752,1158071,1,20,5,1,0,160
120753,1158071,1,20,6,0,1,160
120867,1158072,1,1,1,0,0,0
120868,1158072,1,1,2,1,0,1
120869,1158072,1,1,3,3,0,4
120870,1158072,1,1,4,0,0,4
120871,1158072,1,1,5,1,0,5
120872,1158072,1,1,6,0,0,5
120873,1158072,1,2,1,1,0,6
120874,1158072,1,2,2,4,0,10
120875,1158072,1,2,3,0,0,10
120876,1158072,1,2,4,0,0,10
120877,1158072,1,2,5,4,0,14
120878,1158072,1,2,6,1,0,15
120879,1158072,1,3,1,0,1,15
120880,1158072,1,3,2,0,0,15
120881,1158072,1,3,3,0,0,15
120882,1158072,1,3,4,2,0,17
120883,1158072,1,3,5,0,0,17
120884,1158072,1,3,6,4,0,21
120885,1158072,1,4,1,6,0,27
120886,1158072,1,4,2,0,1,27
120887,1158072,1,4,3,0,0,27
120888,1158072,1,4,4,1,0,28
120889,1158072,1,4,5,0,0,28
120890,1158072,1,4,6,1,0,29
120891,1158072,1,5,1,0,1,29
120892,1158072,1,5,2,0,0,29
120893,1158072,1,5,3,1,0,30
120894,1158072,1,5,4,1,0,31
120895,1158072,1,5,5,0,0,31
120896,1158072,1,5,6,1,0,32
120897,1158072,1,6,1,0,0,32
120898,1158072,1,6,2,0,1,32
120899,1158072,1,6,3,1,0,33
120900,1158072,1,6,4,1,0,34
120901,1158072,1,6,5,1,0,35
120902,1158072,1,6,6,4,0,39
120903,1158072,1,7,1,0,0,39
120904,1158072,1,7,2,1,0,40
120905,1158072,1,7,3,1,0,41
120906,1158072,1,7,4,1,0,42
120907,1158072,1,7,5,1,0,43
120908,1158072,1,7,6,1,0,44
120909,1158072,1,8,1,1,0,45
120910,1158072,1,8,2,1,0,46
120911,1158072,1,8,3,1,0,47
120912,1158072,1,8,4,1,0,48
120913,1158072,1,8,5,1,0,49
120914,1158072,1,8,6,0,0,49
120915,1158072,1,9,1,1,0,50
120916,1158072,1,9,2,1,0,51
120917,1158072,1,9,3,1,0,52
120918,1158072,1,9,4,1,0,53
120919,1158072,1,9,5,1,0,54
120920,1158072,1,9,6,1,0,55
120921,1158072,1,10,1,1,0,56
120922,1158072,1,10,2,0,0,56
120923,1158072,1,10,3,1,0,57
120924,1158072,1,10,4,4,0,61
120925,1158072,1,10,5,1,0,62
120926,1158072,1,10,6,2,0,64
120927,1158072,1,11,1,0,0,64
120928,1158072,1,11,2,1,0,65
120929,1158072,1,11,3,4,0,69
120930,1158072,1,11,4,1,0,70
120931,1158072,1,11,5,4,0,74
120932,1158072,1,11,6,1,0,75
120933,1158072,1,12,1,1,0,76
120934,1158072,1,12,2,0,0,76
120935,1158072,1,12,3,0,0,76
120936,1158072,1,12,4,4,0,80
120937,1158072,1,12,5,0,0,80
120938,1158072,1,12,6,0,0,80
120939,1158072,1,13,1,0,0,80
120940,1158072,1,13,2,2,0,82
120941,1158072,1,13,3,1,0,83
120942,1158072,1,13,4,2,0,85
120943,1158072,1,13,5,1,0,86
120944,1158072,1,13,6,0,0,86
120945,1158072,1,14,1,1,0,87
120946,1158072,1,14,2,1,0,88
120947,1158072,1,14,3,0,0,88
120948,1158072,1,14,4,4,0,92
120949,1158072,1,14,5,1,0,93
120950,1158072,1,14,6,1,0,94
120951,1158072,1,15,1,4,0,98
120952,1158072,1,15,2,4,0,102
120953,1158072,1,15,3,2,0,104
120954,1158072,1,15,4,4,0,108
120955,1158072,1,15,5,1,0,109
120956,1158072,1,15,6,1,0,110
120957,1158072,1,16,1,1,0,111
120958,1158072,1,16,2,0,0,111
120959,1158072,1,16,3,1,0,112
120960,1158072,1,16,4,1,0,113
120961,1158072,1,16,5,1,1,114
120962,1158072,1,16,6,0,0,114
120963,1158072,1,17,1,4,0,118
120964,1158072,1,17,2,2,0,120
120965,1158072,1,17,3,4,0,124
120966,1158072,1,17,4,6,0,130
120967,1158072,1,17,5,1,0,131
120968,1158072,1,17,6,1,0,132
120969,1158072,1,18,1,0,0,132
120970,1158072,1,18,2,1,0,133
120971,1158072,1,18,3,1,0,134
120972,1158072,1,18,4,0,0,134
120973,1158072,1,18,5,2,0,136
120974,1158072,1,18,6,2,0,138
120975,1158072,1,19,1,4,0,142
120976,1158072,1,19,2,4,0,146
120977,1158072,1,19,3,3,0,149
120978,1158072,1,19,4,4,0,153
120979,1158072,1,19,5,1,0,154
120980,1158072,1,19,6,6,0,160
120981,1158072,1,20,1,6,0,166
120982,1158072,1,20,2,4,0,170
120983,1158072,1,20,3,2,0,172
120984,1158072,1,20,4,6,0,178
120985,1158072,1,20,5,4,0,182
120986,1158072,1,20,6,0,1,182
121058,1158073,1,1,1,0,1,0
121059,1158073,1,1,2,1,0,1
121060,1158073,1,1,3,0,0,1
121061,1158073,1,1,4,0,0,1
121062,1158073,1,1,5,0,0,1
121063,1158073,1,1,6,0,0,1
121064,1158073,1,2,1,4,0,5
121065,1158073,1,2,2,0,0,5
121066,1158073,1,2,3,1,0,6
121067,1158073,1,2,4,1,0,7
121068,1158073,1,2,5,2,0,9
121069,1158073,1,2,6,0,0,9
121070,1158073,1,3,1,0,0,9
121071,1158073,1,3,2,0,0,9
121072,1158073,1,3,3,1,0,10
121073,1158073,1,3,4,0,1,10
121074,1158073,1,3,5,0,0,10
121075,1158073,1,3,6,4,0,14
121076,1158073,1,4,1,0,0,14
121077,1158073,1,4,2,4,0,18
121078,1158073,1,4,3,0,0,18
121079,1158073,1,4,4,4,0,22
121080,1158073,1,4,5,1,0,23
121081,1158073,1,4,6,1,0,24
121082,1158073,1,5,1,0,1,24
121083,1158073,1,5,2,0,0,24
121084,1158073,1,5,3,0,1,24
121085,1158073,1,5,4,0,0,24
121086,1158073,1,5,5,1,0,25
121087,1158073,1,5,6,0,0,25
121088,1158073,1,6,1,1,0,26
121089,1158073,1,6,2,1,0,27
121090,1158073,1,6,3,0,0,27
121091,1158073,1,6,4,1,0,28
121092,1158073,1,6,5,1,0,29
121093,1158073,1,6,6,1,0,30
121094,1158073,1,7,1,1,0,31
121095,1158073,1,7,2,1,0,32
121096,1158073,1,7,3,0,0,32
121097,1158073,1,7,4,1,0,33
121098,1158073,1,7,5,0,0,33
121099,1158073,1,7,6,1,0,34
121100,1158073,1,8,1,0,0,34
121101,1158073,1,8,2,0,0,34
121102,1158073,1,8,3,0,0,34
121103,1158073,1,8,4,1,0,35
121104,1158073,1,8,5,0,0,35
121105,1158073,1,8,6,1,0,36
121106,1158073,1,9,1,1,0,37
121107,1158073,1,9,2,1,0,38
121108,1158073,1,9,3,1,0,39
121109,1158073,1,9,4,6,0,45
121110,1158073,1,9,5,0,1,45
121111,1158073,1,9,6,1,0,46
121112,1158073,1,10,1,1,0,47
121113,1158073,1,10,2,1,0,48
121114,1158073,1,10,3,0,0,48
121115,1158073,1,10,4,0,1,48
121116,1158073,1,10,5,0,0,48
121117,1158073,1,10,6,0,0,48
121118,1158073,1,11,1,0,0,48
121119,1158073,1,11,2,6,0,54
121120,1158073,1,11,3,0,1,54
121121,1158073,1,11,4,1,0,55
121122,1158073,1,11,5,0,0,55
121123,1158073,1,11,6,0,0,55
121124,1158073,1,12,1,1,0,56
121125,1158073,1,12,2,0,1,56
121126,1158073,1,12,3,4,0,60
121127,1158073,1,12,4,0,0,60
121128,1158073,1,12,5,0,1,60
121129,1158073,1,12,6,0,0,60
121130,1158073,1,13,1,1,0,61
121131,1158073,1,13,2,0,0,61
121132,1158073,1,13,3,6,0,67
121133,1158073,1,13,4,4,0,71
121134,1158073,1,13,5,0,0,71
121135,1158073,1,13,6,0,1,71
121199,1168112,1,1,1,0,0,0
121200,1168112,1,1,2,0,0,0
121201,1168112,1,1,3,1,0,1
121202,1168112,1,1,4,1,0,2
121203,1168112,1,1,5,0,0,2
121204,1168112,1,1,6,1,0,3
121205,1168112,1,2,1,1,0,4
121206,1168112,1,2,2,0,0,4
121207,1168112,1,2,3,0,0,4
121208,1168112,1,2,4,0,0,4
121209,1168112,1,2,5,1,0,5
121210,1168112,1,2,6,0,0,5
121211,1168112,1,3,1,1,0,6
121212,1168112,1,3,2,1,0,7
121213,1168112,1,3,3,2,0,9
121214,1168112,1,3,4,0,0,9
121215,1168112,1,3,5,1,0,10
121216,1168112,1,3,6,1,0,11
121217,1168112,1,4,1,4,0,15
121218,1168112,1,4,2,2,0,17
121219,1168112,1,4,3,0,0,17
121220,1168112,1,4,4,0,0,17
121221,1168112,1,4,5,4,0,21
121222,1168112,1,4,6,1,0,22
121223,1168112,1,5,1,0,0,22
121224,1168112,1,5,2,1,0,23
121225,1168112,1,5,3,0,1,23
121226,1168112,1,5,4,4,0,27
121227,1168112,1,5,5,0,0,27
121228,1168112,1,5,6,0,0,27
121229,1168112,1,6,1,1,0,28
121230,1168112,1,6,2,1,0,29
121231,1168112,1,6,3,4,0,33
121232,1168112,1,6,4,0,0,33
121233,1168112,1,6,5,0,1,33
121234,1168112,1,6,6,4,0,37
121235,1168112,1,7,1,1,0,38
121236,1168112,1,7,2,1,0,39
121237,1168112,1,7,3,0,0,39
121238,1168112,1,7,4,0,0,39
121239,1168112,1,7,5,0,1,39
121240,1168112,1,7,6,0,0,39
121241,1168112,1,8,1,0,0,39
121242,1168112,1,8,2,1,0,40
121243,1168112,1,8,3,1,0,41
121244,1168112,1,8,4,6,0,47
121245,1168112,1,8,5,1,0,48
121246,1168112,1,8,6,2,0,50
121247,1168112,1,9,1,0,0,50
121248,1168112,1,9,2,1,0,51
121249,1168112,1,9,3,1,0,52
121250,1168112,1,9,4,0,1,52
121251,1168112,1,9,5,0,0,52
121252,1168112,1,9,6,0,0,52
121253,1168112,1,10,1,4,0,56
121254,1168112,1,10,2,1,0,57
121255,1168112,1,10,3,1,0,58
121256,1168112,1,10,4,0,0,58
121257,1168112,1,10,5,2,0,60
121258,1168112,1,10,6,0,0,60
121259,1168112,1,11,1,0,0,60
121260,1168112,1,11,2,0,0,60
121261,1168112,1,11,3,0,0,60
121262,1168112,1,11,4,2,0,62
121263,1168112,1,11,5,1,0,63
121264,1168112,1,11,6,1,0,64
121265,1168112,1,12,1,1,0,65
121266,1168112,1,12,2,0,1,65
121267,1168112,1,12,3,0,0,65
121268,1168112,1,12,4,0,1,65
121269,1168112,1,12,5,0,0,65
121270,1168112,1,12,6,1,0,66
121271,1168112,1,13,1,0,0,66
121272,1168112,1,13,2,4,0,70
121273,1168112,1,13,3,1,0,71
121274,1168112,1,13,4,1,0,72
121275,1168112,1,13,5,1,0,73
121276,1168112,1,13,6,1,0,74
121277,1168112,1,14,1,0,0,74
121278,1168112,1,14,2,1,0,75
121279,1168112,1,14,3,0,0,75
121280,1168112,1,14,4,1,0,76
121281,1168112,1,14,5,2,0,78
121282,1168112,1,14,6,1,0,79
121283,1168112,1,15,1,0,0,79
121284,1168112,1,15,2,1,0,80
121285,1168112,1,15,3,0,0,80
121286,1168112,1,15,4,0,0,80
121287,1168112,1,15,5,4,0,84
121288,1168112,1,15,6,1,0,85
121289,1168112,1,16,1,1,0,86
121290,1168112,1,16,2,4,0,90
121291,1168112,1,16,3,1,0,91
121292,1168112,1,16,4,0,0,91
121293,1168112,1,16,5,1,0,92
121294,1168112,1,16,6,0,0,92
121295,1168112,1,17,1,1,0,93
121296,1168112,1,17,2,1,0,94
121297,1168112,1,17,3,4,0,98
121298,1168112,1,17,4,1,0,99
121299,1168112,1,17,5,1,0,100
121300,1168112,1,17,6,1,0,101
121301,1168112,1,18,1,1,0,102
121302,1168112,1,18,2,1,0,103
121303,1168112,1,18,3,1,0,104
121304,1168112,1,18,4,2,0,106
121305,1168112,1,18,5,1,0,107
121306,1168112,1,18,6,1,0,108
121307,1168112,1,19,1,1,0,109
121308,1168112,1,19,2,0,0,109
121309,1168112,1,19,3,1,0,110
121310,1168112,1,19,4,0,0,110
121311,1168112,1,19,5,6,0,116
121312,1168112,1,19,6,1,0,117
121313,1168112,1,20,1,1,0,118
121314,1168112,1,20,2,4,0,122
121315,1168112,1,20,3,2,0,124
121316,1168112,1,20,4,1,0,125
121317,1168112,1,20,5,1,0,126
121318,1168112,1,20,6,6,0,132
121435,1168113,1,1,1,0,0,0
121436,1168113,1,1,2,0,0,0
121437,1168113,1,1,3,4,0,4
121438,1168113,1,1,4,0,0,4
121439,1168113,1,1,5,0,0,4
121440,1168113,1,1,6,1,0,5
121441,1168113,1,2,1,1,0,6
121442,1168113,1,2,2,0,0,6
121443,1168113,1,2,3,0,0,6
121444,1168113,1,2,4,0,0,6
121445,1168113,1,2,5,0,0,6
121446,1168113,1,2,6,1,0,7
121447,1168113,1,3,1,0,0,7
121448,1168113,1,3,2,4,0,11
121449,1168113,1,3,3,1,0,12
121450,1168113,1,3,4,6,0,18
121451,1168113,1,3,5,4,0,22
121452,1168113,1,3,6,0,0,22
121453,1168113,1,4,1,6,0,28
121454,1168113,1,4,2,1,0,29
121455,1168113,1,4,3,1,0,30
121456,1168113,1,4,4,0,0,30
121457,1168113,1,4,5,1,0,31
121458,1168113,1,4,6,0,0,31
121459,1168113,1,5,1,4,0,35
121460,1168113,1,5,2,0,0,35
121461,1168113,1,5,3,1,0,36
121462,1168113,1,5,4,6,0,42
121463,1168113,1,5,5,4,0,46
121464,1168113,1,5,6,0,0,46
121465,1168113,1,6,1,6,0,52
121466,1168113,1,6,2,1,0,53
121467,1168113,1,6,3,4,0,57
121468,1168113,1,6,4,6,0,63
121469,1168113,1,6,5,0,0,63
121470,1168113,1,6,6,1,0,64
121471,1168113,1,7,1,1,0,65
121472,1168113,1,7,2,1,0,66
121473,1168113,1,7,3,1,0,67
121474,1168113,1,7,4,6,0,73
121475,1168113,1,7,5,1,0,74
121476,1168113,1,7,6,1,0,75
121477,1168113,1,8,1,1,0,76
121478,1168113,1,8,2,4,0,80
121479,1168113,1,8,3,1,0,81
121480,1168113,1,8,4,1,0,82
121481,1168113,1,8,5,6,0,88
121482,1168113,1,8,6,1,0,89
121483,1168113,1,9,1,4,0,93
121484,1168113,1,9,2,2,0,95
121485,1168113,1,9,3,2,0,97
121486,1168113,1,9,4,1,0,98
121487,1168113,1,9,5,0,0,98
121488,1168113,1,9,6,4,0,102
121489,1168113,1,10,1,1,0,103
121490,1168113,1,10,2,6,0,109
121491,1168113,1,10,3,2,0,111
121492,1168113,1,10,4,1,0,112
121493,1168113,1,10,5,6,0,118
121494,1168113,1,10,6,4,0,122
121495,1168113,1,11,1,1,0,123
121496,1168113,1,11,2,4,0,127
121497,1168113,1,11,3,1,0,128
121498,1168113,1,11,4,4,0,132
121499,1168113,1,11,5,5,0,137
121500,1168113,1,11,6,1,0,138
121501,1168113,1,12,1,4,0,142
121502,1168113,1,12,2,4,0,146
121503,1168113,1,12,3,1,0,147
121504,1168113,1,12,4,1,0,148
121505,1168113,1,12,5,1,0,149
121506,1168113,1,12,6,2,0,151
121507,1168113,1,13,1,6,0,157
121508,1168113,1,13,2,1,0,158
121509,1168113,1,13,3,9,0,167
121510,1168113,1,13,4,1,0,168
121511,1168113,1,13,5,6,0,174
121512,1168113,1,13,6,1,0,175
121513,1168113,1,14,1,1,0,176
121514,1168113,1,14,2,1,0,177
121515,1168113,1,14,3,1,0,178
121516,1168113,1,14,4,0,0,178
121517,1168113,1,14,5,1,0,179
121518,1168113,1,14,6,6,0,185
121519,1168113,1,15,1,0,0,185
121520,1168113,1,15,2,2,0,187
121521,1168113,1,15,3,2,0,189
121522,1168113,1,15,4,1,0,190
121523,1168113,1,15,5,1,0,191
121524,1168113,1,15,6,1,0,192
121525,1168113,1,16,1,1,0,193
121526,1168113,1,16,2,0,0,193
121527,1168113,1,16,3,7,0,200
121528,1168113,1,16,4,2,0,202
121529,1168113,1,16,5,4,0,206
121530,1168113,1,16,6,0,0,206
121531,1168113,1,17,1,6,0,212
121532,1168113,1,17,2,6,0,218
121533,1168113,1,17,3,6,0,224
121534,1168113,1,17,4,2,0,226
121535,1168113,1,17,5,2,0,228
121536,1168113,1,17,6,6,0,234
121537,1168113,1,18,1,1,0,235
121538,1168113,1,18,2,1,0,236
121539,1168113,1,18,3,0,1,236
121540,1168113,1,18,4,6,0,242
121541,1168113,1,18,5,2,0,244
121542,1168113,1,18,6,4,0,248
121543,1168113,1,19,1,6,0,254
121544,1168113,1,19,2,1,0,255
121545,1168113,1,19,3,1,0,256
121546,1168113,1,19,4,0,1,256
121547,1168113,1,19,5,4,0,260
121548,1168113,1,19,6,1,0,261
121549,1168113,1,20,1,6,0,267
121550,1168113,1,20,2,6,0,273
121551,1168113,1,20,3,0,1,273
121552,1168113,1,20,4,0,0,273
121553,1168113,1,20,5,1,0,274
121554,1168113,1,20,6,4,0,278
121675,1168114,1,1,1,2,0,2
121676,1168114,1,1,2,0,0,2
121677,1168114,1,1,3,0,0,2
121678,1168114,1,1,4,1,0,3
121679,1168114,1,1,5,1,0,4
121680,1168114,1,1,6,1,0,5
121681,1168114,1,2,1,1,0,6
121682,1168114,1,2,2,1,0,7
121683,1168114,1,2,3,1,0,8
121684,1168114,1,2,4,1,0,9
121685,1168114,1,2,5,4,0,13
121686,1168114,1,2,6,6,0,19
121687,1168114,1,3,1,0,0,19
121688,1168114,1,3,2,4,0,23
121689,1168114,1,3,3,4,0,27
121690,1168114,1,3,4,1,0,28
121691,1168114,1,3,5,4,0,32
121692,1168114,1,3,6,0,0,32
121693,1168114,1,4,1,1,0,33
121694,1168114,1,4,2,4,0,37
121695,1168114,1,4,3,4,0,41
121696,1168114,1,4,4,5,0,46
121697,1168114,1,4,5,0,0,46
121698,1168114,1,4,6,0,0,46
121699,1168114,1,5,1,0,1,46
121700,1168114,1,5,2,0,0,46
121701,1168114,1,5,3,4,0,50
121702,1168114,1,5,4,6,0,56
121703,1168114,1,5,5,1,0,57
121704,1168114,1,5,6,0,1,57
121705,1168114,1,6,1,1,0,58
121706,1168114,1,6,2,1,0,59
121707,1168114,1,6,3,4,0,63
121708,1168114,1,6,4,0,0,63
121709,1168114,1,6,5,0,0,63
121710,1168114,1,6,6,1,0,64
121711,1168114,1,7,1,1,0,65
121712,1168114,1,7,2,0,0,65
121713,1168114,1,7,3,0,0,65
121714,1168114,1,7,4,0,0,65
121715,1168114,1,7,5,0,0,65
121716,1168114,1,7,6,1,0,66
121717,1168114,1,8,1,1,0,67
121718,1168114,1,8,2,0,0,67
121719,1168114,1,8,3,0,0,67
121720,1168114,1,8,4,0,1,67
121721,1168114,1,8,5,0,0,67
121722,1168114,1,8,6,0,0,67
121723,1168114,1,9,1,0,0,67
121724,1168114,1,9,2,1,0,68
121725,1168114,1,9,3,2,0,70
121726,1168114,1,9,4,1,0,71
121727,1168114,1,9,5,4,0,75
121728,1168114,1,9,6,6,0,81
121729,1168114,1,10,1,0,0,81
121730,1168114,1,10,2,0,0,81
121731,1168114,1,10,3,1,0,82
121732,1168114,1,10,4,0,0,82
121733,1168114,1,10,5,1,0,83
121734,1168114,1,10,6,1,0,84
121735,1168114,1,11,1,4,0,88
121736,1168114,1,11,2,1,0,89
121737,1168114,1,11,3,4,0,93
121738,1168114,1,11,4,0,0,93
121739,1168114,1,11,5,2,0,95
121740,1168114,1,11,6,2,0,97
121741,1168114,1,12,1,1,0,98
121742,1168114,1,12,2,1,0,99
121743,1168114,1,12,3,6,0,105
121744,1168114,1,12,4,1,0,106
121745,1168114,1,12,5,1,0,107
121746,1168114,1,12,6,0,0,107
121747,1168114,1,13,1,0,1,107
121748,1168114,1,13,2,1,0,108
121749,1168114,1,13,3,1,0,109
121750,1168114,1,13,4,1,0,110
121751,1168114,1,13,5,1,0,111
121752,1168114,1,13,6,0,0,111
121753,1168114,1,14,1,0,0,111
121754,1168114,1,14,2,1,0,112
121755,1168114,1,14,3,4,0,116
121756,1168114,1,14,4,6,0,122
121757,1168114,1,14,5,1,0,123
121758,1168114,1,14,6,1,0,124
121759,1168114,1,15,1,7,0,131
121760,1168114,1,15,2,1,0,132
121761,1168114,1,15,3,1,0,133
121762,1168114,1,15,4,6,0,139
121763,1168114,1,15,5,0,0,139
121764,1168114,1,15,6,4,0,143
121765,1168114,1,16,1,0,1,143
121766,1168114,1,16,2,2,0,145
121767,1168114,1,16,3,4,0,149
121768,1168114,1,16,4,6,0,155
121769,1168114,1,16,5,6,0,161
121770,1168114,1,16,6,0,0,161
121771,1168114,1,17,1,4,0,165
121772,1168114,1,17,2,1,0,166
121773,1168114,1,17,3,6,0,172
121774,1168114,1,17,4,4,0,176
121775,1168114,1,17,5,6,0,182
121776,1168114,1,17,6,4,0,186
121777,1168114,1,18,1,1,0,187
121778,1168114,1,18,2,4,0,191
121779,1168114,1,18,3,0,1,191
121780,1168114,1,18,4,0,0,191
121781,1168114,1,18,5,1,0,192
121782,1168114,1,18,6,2,0,194
121783,1168114,1,19,1,8,0,202
121784,1168114,1,19,2,0,1,202
121785,1168114,1,19,3,1,0,203
121786,1168114,1,19,4,0,0,203
121787,1168114,1,19,5,1,0,204
121788,1168114,1,19,6,1,0,205
121789,1168114,1,20,1,0,0,205
121790,1168114,1,20,2,1,0,206
121791,1168114,1,20,3,1,0,207
121792,1168114,1,20,4,1,0,208
121793,1168114,1,20,5,1,0,209
121794,1168114,1,20,6,1,0,210
121915,1168247,1,1,1,0,0,0
121916,1168247,1,1,2,1,0,1
121917,1168247,1,1,3,0,0,1
121918,1168247,1,1,4,0,0,1
121919,1168247,1,1,5,0,0,1
121920,1168247,1,1,6,0,0,1
121921,1168247,1,2,1,1,0,2
121922,1168247,1,2,2,4,0,6
121923,1168247,1,2,3,1,0,7
121924,1168247,1,2,4,0,0,7
121925,1168247,1,2,5,1,0,8
121926,1168247,1,2,6,4,0,12
121927,1168247,1,3,1,2,0,14
121928,1168247,1,3,2,0,0,14
121929,1168247,1,3,3,0,1,14
121930,1168247,1,3,4,0,0,14
121931,1168247,1,3,5,1,0,15
121932,1168247,1,3,6,0,0,15
121933,1168247,1,4,1,4,0,19
121934,1168247,1,4,2,1,0,20
121935,1168247,1,4,3,0,0,20
121936,1168247,1,4,4,1,0,21
121937,1168247,1,4,5,4,0,25
121938,1168247,1,4,6,1,0,26
121939,1168247,1,5,1,1,0,27
121940,1168247,1,5,2,4,0,31
121941,1168247,1,5,3,1,0,32
121942,1168247,1,5,4,1,0,33
121943,1168247,1,5,5,4,0,37
121944,1168247,1,5,6,1,0,38
121945,1168247,1,6,1,4,0,42
121946,1168247,1,6,2,1,0,43
121947,1168247,1,6,3,1,0,44
121948,1168247,1,6,4,1,0,45
121949,1168247,1,6,5,0,0,45
121950,1168247,1,6,6,4,0,49
121951,1168247,1,7,1,1,0,50
121952,1168247,1,7,2,0,0,50
121953,1168247,1,7,3,4,0,54
121954,1168247,1,7,4,1,0,55
121955,1168247,1,7,5,1,0,56
121956,1168247,1,7,6,3,0,59
121957,1168247,1,8,1,1,0,60
121958,1168247,1,8,2,1,0,61
121959,1168247,1,8,3,1,0,62
121960,1168247,1,8,4,1,0,63
121961,1168247,1,8,5,0,0,63
121962,1168247,1,8,6,2,0,65
121963,1168247,1,9,1,2,0,67
121964,1168247,1,9,2,1,0,68
121965,1168247,1,9,3,1,0,69
121966,1168247,1,9,4,0,1,69
121967,1168247,1,9,5,1,0,70
121968,1168247,1,9,6,6,0,76
121969,1168247,1,10,1,1,0,77
121970,1168247,1,10,2,1,0,78
121971,1168247,1,10,3,0,0,78
121972,1168247,1,10,4,1,0,79
121973,1168247,1,10,5,1,0,80
121974,1168247,1,10,6,0,1,80
121975,1168247,1,11,1,1,0,81
121976,1168247,1,11,2,0,0,81
121977,1168247,1,11,3,0,0,81
121978,1168247,1,11,4,2,0,83
121979,1168247,1,11,5,1,0,84
121980,1168247,1,11,6,1,0,85
121981,1168247,1,12,1,1,0,86
121982,1168247,1,12,2,1,0,87
121983,1168247,1,12,3,0,0,87
121984,1168247,1,12,4,1,0,88
121985,1168247,1,12,5,2,0,90
121986,1168247,1,12,6,1,0,91
121987,1168247,1,13,1,1,0,92
121988,1168247,1,13,2,0,1,92
121989,1168247,1,13,3,0,0,92
121990,1168247,1,13,4,1,0,93
121991,1168247,1,13,5,1,0,94
121992,1168247,1,13,6,0,1,94
121993,1168247,1,14,1,0,0,94
121994,1168247,1,14,2,1,0,95
121995,1168247,1,14,3,0,0,95
121996,1168247,1,14,4,0,0,95
121997,1168247,1,14,5,0,0,95
121998,1168247,1,14,6,0,0,95
121999,1168247,1,15,1,0,0,95
122000,1168247,1,15,2,1,0,96
122001,1168247,1,15,3,1,0,97
122002,1168247,1,15,4,2,0,99
122003,1168247,1,15,5,1,0,100
122004,1168247,1,15,6,0,1,100
122005,1168247,1,16,1,2,0,102
122006,1168247,1,16,2,0,0,102
122007,1168247,1,16,3,0,0,102
122008,1168247,1,16,4,1,0,103
122009,1168247,1,16,5,1,0,104
122010,1168247,1,16,6,0,0,104
122011,1168247,1,17,1,2,0,106
122012,1168247,1,17,2,1,0,107
122013,1168247,1,17,3,1,0,108
122014,1168247,1,17,4,1,0,109
122015,1168247,1,17,5,0,1,109
122016,1168247,1,17,6,0,0,109
122017,1168247,1,18,1,0,0,109
122018,1168247,1,18,2,0,0,109
122019,1168247,1,18,3,0,0,109
122020,1168247,1,18,4,6,0,115
122021,1168247,1,18,5,0,0,115
122022,1168247,1,18,6,0,0,115
122023,1168247,1,19,1,0,0,115
122024,1168247,1,19,2,2,0,117
122025,1168247,1,19,3,0,0,117
122026,1168247,1,19,4,0,0,117
122027,1168247,1,19,5,1,0,118
122028,1168247,1,19,6,0,0,118
122029,1168247,1,20,1,0,0,118
122030,1168247,1,20,2,6,0,124
122031,1168247,1,20,3,0,0,124
122032,1168247,1,20,4,0,0,124
122033,1168247,1,20,5,0,0,124
122034,1168247,1,20,6,2,0,126
122155,1168248,1,1,1,1,0,1
122156,1168248,1,1,2,0,0,1
122157,1168248,1,1,3,1,0,2
122158,1168248,1,1,4,0,0,2
122159,1168248,1,1,5,1,0,3
122160,1168248,1,1,6,0,0,3
122161,1168248,1,2,1,0,0,3
122162,1168248,1,2,2,0,0,3
122163,1168248,1,2,3,1,0,4
122164,1168248,1,2,4,0,0,4
122165,1168248,1,2,5,0,0,4
122166,1168248,1,2,6,0,0,4
122167,1168248,1,3,1,4,0,8
122168,1168248,1,3,2,1,0,9
122169,1168248,1,3,3,4,0,13
122170,1168248,1,3,4,1,0,14
122171,1168248,1,3,5,1,0,15
122172,1168248,1,3,6,1,0,16
122173,1168248,1,4,1,0,0,16
122174,1168248,1,4,2,0,0,16
122175,1168248,1,4,3,3,0,19
122176,1168248,1,4,4,4,0,23
122177,1168248,1,4,5,0,0,23
122178,1168248,1,4,6,1,0,24
122179,1168248,1,5,1,0,0,24
122180,1168248,1,5,2,1,0,25
122181,1168248,1,5,3,1,0,26
122182,1168248,1,5,4,6,0,32
122183,1168248,1,5,5,6,0,38
122184,1168248,1,5,6,1,0,39
122185,1168248,1,6,1,1,0,40
122186,1168248,1,6,2,0,0,40
122187,1168248,1,6,3,1,0,41
122188,1168248,1,6,4,6,0,47
122189,1168248,1,6,5,6,0,53
122190,1168248,1,6,6,0,0,53
122191,1168248,1,7,1,1,0,54
122192,1168248,1,7,2,4,0,58
122193,1168248,1,7,3,1,0,59
122194,1168248,1,7,4,1,0,60
122195,1168248,1,7,5,0,0,60
122196,1168248,1,7,6,1,0,61
122197,1168248,1,8,1,0,1,61
122198,1168248,1,8,2,1,0,62
122199,1168248,1,8,3,0,0,62
122200,1168248,1,8,4,1,0,63
122201,1168248,1,8,5,1,0,64
122202,1168248,1,8,6,1,0,65
122203,1168248,1,9,1,1,0,66
122204,1168248,1,9,2,0,0,66
122205,1168248,1,9,3,0,0,66
122206,1168248,1,9,4,1,0,67
122207,1168248,1,9,5,1,0,68
122208,1168248,1,9,6,2,0,70
122209,1168248,1,10,1,0,0,70
122210,1168248,1,10,2,0,1,70
122211,1168248,1,10,3,1,0,71
122212,1168248,1,10,4,0,0,71
122213,1168248,1,10,5,1,0,72
122214,1168248,1,10,6,1,0,73
122215,1168248,1,11,1,1,0,74
122216,1168248,1,11,2,0,0,74
122217,1168248,1,11,3,0,0,74
122218,1168248,1,11,4,0,0,74
122219,1168248,1,11,5,0,1,74
122220,1168248,1,11,6,0,0,74
122221,1168248,1,12,1,1,0,75
122222,1168248,1,12,2,0,0,75
122223,1168248,1,12,3,0,0,75
122224,1168248,1,12,4,1,0,76
122225,1168248,1,12,5,4,0,80
122226,1168248,1,12,6,1,0,81
122227,1168248,1,13,1,1,0,82
122228,1168248,1,13,2,0,0,82
122229,1168248,1,13,3,6,0,88
122230,1168248,1,13,4,0,0,88
122231,1168248,1,13,5,1,0,89
122232,1168248,1,13,6,1,0,90
122233,1168248,1,14,1,2,0,92
122234,1168248,1,14,2,1,0,93
122235,1168248,1,14,3,0,0,93
122236,1168248,1,14,4,4,0,97
122237,1168248,1,14,5,1,0,98
122238,1168248,1,14,6,1,0,99
122239,1168248,1,15,1,1,0,100
122240,1168248,1,15,2,4,0,104
122241,1168248,1,15,3,1,0,105
122242,1168248,1,15,4,6,0,111
122243,1168248,1,15,5,2,0,113
122244,1168248,1,15,6,0,0,113
122245,1168248,1,16,1,2,0,115
122246,1168248,1,16,2,1,0,116
122247,1168248,1,16,3,6,0,122
122248,1168248,1,16,4,6,0,128
122249,1168248,1,16,5,6,0,134
122250,1168248,1,16,6,1,0,135
122251,1168248,1,17,1,1,0,136
122252,1168248,1,17,2,1,0,137
122253,1168248,1,17,3,0,0,137
122254,1168248,1,17,4,0,0,137
122255,1168248,1,17,5,1,0,138
122256,1168248,1,17,6,0,0,138
122257,1168248,1,18,1,1,0,139
122258,1168248,1,18,2,6,0,145
122259,1168248,1,18,3,1,0,146
122260,1168248,1,18,4,1,0,147
122261,1168248,1,18,5,6,0,153
122262,1168248,1,18,6,4,0,157
122263,1168248,1,19,1,0,0,157
122264,1168248,1,19,2,7,0,164
122265,1168248,1,19,3,1,0,165
122266,1168248,1,19,4,1,0,166
122267,1168248,1,19,5,2,0,168
122268,1168248,1,19,6,4,0,172
122269,1168248,1,20,1,2,1,174
122270,1168248,1,20,2,1,0,175
122271,1168248,1,20,3,4,0,179
122272,1168248,1,20,4,4,0,183
122273,1168248,1,20,5,1,0,184
122274,1168248,1,20,6,6,0,190
122393,1168521,1,1,1,0,0,0
122394,1168521,1,1,2,0,0,0
122395,1168521,1,1,3,4,0,4
122396,1168521,1,1,4,0,0,4
122397,1168521,1,1,5,1,0,5
122398,1168521,1,1,6,0,0,5
122399,1168521,1,2,1,0,0,5
122400,1168521,1,2,2,1,0,6
122401,1168521,1,2,3,1,0,7
122402,1168521,1,2,4,1,0,8
122403,1168521,1,2,5,4,0,12
122404,1168521,1,2,6,0,0,12
122405,1168521,1,3,1,0,1,12
122406,1168521,1,3,2,0,0,12
122407,1168521,1,3,3,0,0,12
122408,1168521,1,3,4,0,0,12
122409,1168521,1,3,5,4,0,16
122410,1168521,1,3,6,0,0,16
122411,1168521,1,4,1,4,0,20
122412,1168521,1,4,2,0,1,20
122413,1168521,1,4,3,4,0,24
122414,1168521,1,4,4,0,0,24
122415,1168521,1,4,5,1,0,25
122416,1168521,1,4,6,4,0,29
122417,1168521,1,5,1,4,0,33
122418,1168521,1,5,2,0,0,33
122419,1168521,1,5,3,1,0,34
122420,1168521,1,5,4,4,0,38
122421,1168521,1,5,5,1,0,39
122422,1168521,1,5,6,1,0,40
122423,1168521,1,6,1,0,0,40
122424,1168521,1,6,2,2,0,42
122425,1168521,1,6,3,6,0,48
122426,1168521,1,6,4,1,0,49
122427,1168521,1,6,5,0,0,49
122428,1168521,1,6,6,4,0,53
122429,1168521,1,7,1,1,0,54
122430,1168521,1,7,2,1,0,55
122431,1168521,1,7,3,6,0,61
122432,1168521,1,7,4,1,0,62
122433,1168521,1,7,5,6,0,68
122434,1168521,1,7,6,1,0,69
122435,1168521,1,8,1,6,0,75
122436,1168521,1,8,2,6,0,81
122437,1168521,1,8,3,1,0,82
122438,1168521,1,8,4,4,0,86
122439,1168521,1,8,5,1,0,87
122440,1168521,1,8,6,0,1,87
122441,1168521,1,9,1,1,0,88
122442,1168521,1,9,2,0,0,88
122443,1168521,1,9,3,1,0,89
122444,1168521,1,9,4,6,0,95
122445,1168521,1,9,5,0,0,95
122446,1168521,1,9,6,1,0,96
122447,1168521,1,10,1,4,0,100
122448,1168521,1,10,2,0,0,100
122449,1168521,1,10,3,1,0,101
122450,1168521,1,10,4,0,0,101
122451,1168521,1,10,5,1,0,102
122452,1168521,1,10,6,4,0,106
122453,1168521,1,11,1,2,0,108
122454,1168521,1,11,2,0,1,108
122455,1168521,1,11,3,2,0,110
122456,1168521,1,11,4,0,0,110
122457,1168521,1,11,5,2,0,112
122458,1168521,1,11,6,0,0,112
122459,1168521,1,12,1,0,0,112
122460,1168521,1,12,2,0,1,112
122461,1168521,1,12,3,1,0,113
122462,1168521,1,12,4,4,0,117
122463,1168521,1,12,5,0,1,117
122464,1168521,1,12,6,4,0,121
122465,1168521,1,13,1,4,0,125
122466,1168521,1,13,2,1,0,126
122467,1168521,1,13,3,1,0,127
122468,1168521,1,13,4,0,1,127
122469,1168521,1,13,5,4,0,131
122470,1168521,1,13,6,1,1,132
122536,1172509,1,1,1,1,0,1
122537,1172509,1,1,2,4,0,5
122538,1172509,1,1,3,0,0,5
122539,1172509,1,1,4,0,0,5
122540,1172509,1,1,5,1,0,6
122541,1172509,1,1,6,1,0,7
122542,1172509,1,2,1,0,0,7
122543,1172509,1,2,2,1,0,8
122544,1172509,1,2,3,4,0,12
122545,1172509,1,2,4,1,0,13
122546,1172509,1,2,5,0,0,13
122547,1172509,1,2,6,0,0,13
122548,1172509,1,3,1,3,0,16
122549,1172509,1,3,2,4,0,20
122550,1172509,1,3,3,6,0,26
122551,1172509,1,3,4,4,0,30
122552,1172509,1,3,5,5,0,35
122553,1172509,1,3,6,4,0,39
122554,1172509,1,4,1,0,0,39
122555,1172509,1,4,2,0,0,39
122556,1172509,1,4,3,4,0,43
122557,1172509,1,4,4,4,0,47
122558,1172509,1,4,5,4,0,51
122559,1172509,1,4,6,4,0,55
122560,1172509,1,5,1,4,0,59
122561,1172509,1,5,2,2,0,61
122562,1172509,1,5,3,0,0,61
122563,1172509,1,5,4,2,0,63
122564,1172509,1,5,5,0,0,63
122565,1172509,1,5,6,1,0,64
122566,1172509,1,6,1,1,0,65
122567,1172509,1,6,2,7,0,72
122568,1172509,1,6,3,0,0,72
122569,1172509,1,6,4,1,0,73
122570,1172509,1,6,5,4,0,77
122571,1172509,1,6,6,2,0,79
122572,1172509,1,7,1,1,0,80
122573,1172509,1,7,2,1,0,81
122574,1172509,1,7,3,4,0,85
122575,1172509,1,7,4,6,0,91
122576,1172509,1,7,5,4,0,95
122577,1172509,1,7,6,1,0,96
122578,1172509,1,8,1,1,0,97
122579,1172509,1,8,2,1,0,98
122580,1172509,1,8,3,0,0,98
122581,1172509,1,8,4,4,0,102
122582,1172509,1,8,5,1,0,103
122583,1172509,1,8,6,1,0,104
122584,1172509,1,9,1,0,0,104
122585,1172509,1,9,2,1,0,105
122586,1172509,1,9,3,4,0,109
122587,1172509,1,9,4,6,0,115
122588,1172509,1,9,5,1,0,116
122589,1172509,1,9,6,0,0,116
122590,1172509,1,10,1,0,0,116
122591,1172509,1,10,2,0,1,116
122592,1172509,1,10,3,0,0,116
122593,1172509,1,10,4,0,0,116
122594,1172509,1,10,5,1,0,117
122595,1172509,1,10,6,2,0,119
122596,1172509,1,11,1,0,0,119
122597,1172509,1,11,2,1,0,120
122598,1172509,1,11,3,0,0,120
122599,1172509,1,11,4,1,0,121
122600,1172509,1,11,5,1,0,122
122601,1172509,1,11,6,1,0,123
122602,1172509,1,12,1,4,0,127
122603,1172509,1,12,2,4,0,131
122604,1172509,1,12,3,0,1,131
122605,1172509,1,12,4,1,0,132
122606,1172509,1,12,5,0,0,132
122607,1172509,1,12,6,0,0,132
122608,1172509,1,13,1,1,0,133
122609,1172509,1,13,2,1,0,134
122610,1172509,1,13,3,1,0,135
122611,1172509,1,13,4,1,0,136
122612,1172509,1,13,5,0,1,136
122613,1172509,1,13,6,0,0,136
122614,1172509,1,14,1,0,1,136
122615,1172509,1,14,2,0,1,136
122616,1172509,1,14,3,4,0,140
122617,1172509,1,14,4,0,0,140
122618,1172509,1,14,5,0,1,140
122619,1172509,1,14,6,0,0,140
122620,1172509,1,15,1,0,0,140
122621,1172509,1,15,2,1,0,141
122622,1172509,1,15,3,1,0,142
122623,1172509,1,15,4,1,0,143
122624,1172509,1,15,5,1,0,144
122625,1172509,1,15,6,1,0,145
122626,1172509,1,16,1,2,0,147
122627,1172509,1,16,2,0,0,147
122628,1172509,1,16,3,0,0,147
122629,1172509,1,16,4,1,0,148
122630,1172509,1,16,5,1,0,149
122631,1172509,1,16,6,1,0,150
122632,1172509,1,17,1,0,0,150
122633,1172509,1,17,2,1,0,151
122634,1172509,1,17,3,1,0,152
122635,1172509,1,17,4,0,1,152
122636,1172509,1,17,5,1,0,153
122637,1172509,1,17,6,1,0,154
122638,1172509,1,18,1,0,0,154
122639,1172509,1,18,2,0,0,154
122640,1172509,1,18,3,4,0,158
122641,1172509,1,18,4,4,0,162
122642,1172509,1,18,5,1,0,163
122643,1172509,1,18,6,1,0,164
122644,1172509,1,19,1,4,0,168
122645,1172509,1,19,2,0,0,168
122646,1172509,1,19,3,1,0,169
122647,1172509,1,19,4,1,0,170
122648,1172509,1,19,5,1,0,171
122649,1172509,1,19,6,0,1,171
122650,1172509,1,20,1,1,0,172
122651,1172509,1,20,2,1,0,173
122652,1172509,1,20,3,1,0,174
122653,1172509,1,20,4,4,0,178
122654,1172509,1,20,5,4,0,182
122655,1172509,1,20,6,0,1,182
122776,1183524,1,1,1,0,0,0
122777,1183524,1,1,2,4,0,4
122778,1183524,1,1,3,0,0,4
122779,1183524,1,1,4,1,0,5
122780,1183524,1,1,5,2,0,7
122781,1183524,1,1,6,2,0,9
122782,1183524,1,2,1,2,0,11
122783,1183524,1,2,2,1,0,12
122784,1183524,1,2,3,0,0,12
122785,1183524,1,2,4,4,0,16
122786,1183524,1,2,5,0,0,16
122787,1183524,1,2,6,4,0,20
122788,1183524,1,3,1,1,0,21
122789,1183524,1,3,2,0,0,21
122790,1183524,1,3,3,0,0,21
122791,1183524,1,3,4,1,0,22
122792,1183524,1,3,5,0,0,22
122793,1183524,1,3,6,0,0,22
122794,1183524,1,4,1,0,0,22
122795,1183524,1,4,2,0,0,22
122796,1183524,1,4,3,4,0,26
122797,1183524,1,4,4,4,0,30
122798,1183524,1,4,5,1,0,31
122799,1183524,1,4,6,0,0,31
122800,1183524,1,5,1,1,0,32
122801,1183524,1,5,2,4,0,36
122802,1183524,1,5,3,11,0,47
122803,1183524,1,5,4,1,0,48
122804,1183524,1,5,5,4,0,52
122805,1183524,1,5,6,0,0,52
122806,1183524,1,6,1,1,0,53
122807,1183524,1,6,2,1,0,54
122808,1183524,1,6,3,0,0,54
122809,1183524,1,6,4,1,0,55
122810,1183524,1,6,5,1,0,56
122811,1183524,1,6,6,1,0,57
122812,1183524,1,7,1,2,0,59
122813,1183524,1,7,2,2,0,61
122814,1183524,1,7,3,0,0,61
122815,1183524,1,7,4,0,0,61
122816,1183524,1,7,5,0,0,61
122817,1183524,1,7,6,4,0,65
122818,1183524,1,8,1,1,0,66
122819,1183524,1,8,2,1,0,67
122820,1183524,1,8,3,0,0,67
122821,1183524,1,8,4,6,0,73
122822,1183524,1,8,5,6,0,79
122823,1183524,1,8,6,1,0,80
122824,1183524,1,9,1,0,0,80
122825,1183524,1,9,2,1,0,81
122826,1183524,1,9,3,0,0,81
122827,1183524,1,9,4,4,0,85
122828,1183524,1,9,5,1,0,86
122829,1183524,1,9,6,1,0,87
122830,1183524,1,10,1,2,0,89
122831,1183524,1,10,2,6,0,95
122832,1183524,1,10,3,1,0,96
122833,1183524,1,10,4,6,0,102
122834,1183524,1,10,5,6,0,108
122835,1183524,1,10,6,4,0,112
122836,1183524,1,11,1,4,0,116
122837,1183524,1,11,2,1,0,117
122838,1183524,1,11,3,1,0,118
122839,1183524,1,11,4,4,0,122
122840,1183524,1,11,5,0,1,122
122841,1183524,1,11,6,1,0,123
122842,1183524,1,12,1,1,0,124
122843,1183524,1,12,2,1,0,125
122844,1183524,1,12,3,0,0,125
122845,1183524,1,12,4,1,0,126
122846,1183524,1,12,5,1,0,127
122847,1183524,1,12,6,1,0,128
122848,1183524,1,13,1,6,0,134
122849,1183524,1,13,2,4,0,138
122850,1183524,1,13,3,1,0,139
122851,1183524,1,13,4,1,0,140
122852,1183524,1,13,5,2,0,142
122853,1183524,1,13,6,1,0,143
122854,1183524,1,14,1,4,0,147
122855,1183524,1,14,2,6,0,153
122856,1183524,1,14,3,1,0,154
122857,1183524,1,14,4,6,0,160
122858,1183524,1,14,5,4,0,164
122859,1183524,1,14,6,1,0,165
122860,1183524,1,15,1,1,0,166
122861,1183524,1,15,2,4,0,170
122862,1183524,1,15,3,2,0,172
122863,1183524,1,15,4,0,0,172
122864,1183524,1,15,5,4,0,176
122865,1183524,1,15,6,2,0,178
122866,1183524,1,16,1,1,0,179
122867,1183524,1,16,2,0,0,179
122868,1183524,1,16,3,0,0,179
122869,1183524,1,16,4,1,0,180
122870,1183524,1,16,5,4,0,184
122871,1183524,1,16,6,1,0,185
122872,1183524,1,17,1,2,0,187
122873,1183524,1,17,2,4,0,191
122874,1183524,1,17,3,0,0,191
122875,1183524,1,17,4,1,0,192
122876,1183524,1,17,5,2,0,194
122877,1183524,1,17,6,4,0,198
122878,1183524,1,18,1,0,0,198
122879,1183524,1,18,2,1,0,199
122880,1183524,1,18,3,4,0,203
122881,1183524,1,18,4,1,0,204
122882,1183524,1,18,5,6,0,210
122883,1183524,1,18,6,6,0,216
122884,1183524,1,19,1,0,0,216
122885,1183524,1,19,2,1,0,217
122886,1183524,1,19,3,0,0,217
122887,1183524,1,19,4,4,0,221
122888,1183524,1,19,5,0,0,221
122889,1183524,1,19,6,2,0,223
122890,1183524,1,20,1,5,0,228
122891,1183524,1,20,2,1,0,229
122892,1183524,1,20,3,0,1,229
122893,1183524,1,20,4,1,0,230
122894,1183524,1,20,5,2,0,232
122895,1183524,1,20,6,1,0,233
123016,1183525,1,1,1,1,0,1
123017,1183525,1,1,2,0,0,1
123018,1183525,1,1,3,0,0,1
123019,1183525,1,1,4,2,0,3
123020,1183525,1,1,5,1,0,4
123021,1183525,1,1,6,0,0,4
123022,1183525,1,2,1,1,0,5
123023,1183525,1,2,2,0,0,5
123024,1183525,1,2,3,0,0,5
123025,1183525,1,2,4,0,1,5
123026,1183525,1,2,5,1,0,6
123027,1183525,1,2,6,0,0,6
123028,1183525,1,3,1,0,0,6
123029,1183525,1,3,2,0,0,6
123030,1183525,1,3,3,0,0,6
123031,1183525,1,3,4,1,0,7
123032,1183525,1,3,5,0,0,7
123033,1183525,1,3,6,2,0,9
123034,1183525,1,4,1,0,0,9
123035,1183525,1,4,2,0,0,9
123036,1183525,1,4,3,4,0,13
123037,1183525,1,4,4,2,0,15
123038,1183525,1,4,5,6,0,21
123039,1183525,1,4,6,0,0,21
123040,1183525,1,5,1,1,0,22
123041,1183525,1,5,2,0,0,22
123042,1183525,1,5,3,0,0,22
123043,1183525,1,5,4,1,0,23
123044,1183525,1,5,5,1,0,24
123045,1183525,1,5,6,4,0,28
123046,1183525,1,6,1,1,0,29
123047,1183525,1,6,2,0,1,29
123048,1183525,1,6,3,4,0,33
123049,1183525,1,6,4,1,0,34
123050,1183525,1,6,5,2,0,36
123051,1183525,1,6,6,0,0,36
123052,1183525,1,7,1,1,0,37
123053,1183525,1,7,2,1,0,38
123054,1183525,1,7,3,1,0,39
123055,1183525,1,7,4,1,0,40
123056,1183525,1,7,5,0,0,40
123057,1183525,1,7,6,1,0,41
123058,1183525,1,8,1,1,0,42
123059,1183525,1,8,2,1,0,43
123060,1183525,1,8,3,0,0,43
123061,1183525,1,8,4,1,0,44
123062,1183525,1,8,5,4,0,48
123063,1183525,1,8,6,1,0,49
123064,1183525,1,9,1,1,0,50
123065,1183525,1,9,2,1,0,51
123066,1183525,1,9,3,1,0,52
123067,1183525,1,9,4,1,0,53
123068,1183525,1,9,5,0,1,53
123069,1183525,1,9,6,1,0,54
123070,1183525,1,10,1,4,0,58
123071,1183525,1,10,2,1,0,59
123072,1183525,1,10,3,4,0,63
123073,1183525,1,10,4,1,0,64
123074,1183525,1,10,5,1,0,65
123075,1183525,1,10,6,0,1,65
123076,1183525,1,11,1,1,0,66
123077,1183525,1,11,2,1,0,67
123078,1183525,1,11,3,6,0,73
123079,1183525,1,11,4,2,0,75
123080,1183525,1,11,5,0,1,75
123081,1183525,1,11,6,0,0,75
123082,1183525,1,12,1,0,0,75
123083,1183525,1,12,2,0,1,75
123084,1183525,1,12,3,0,0,75
123085,1183525,1,12,4,0,0,75
123086,1183525,1,12,5,1,0,76
123087,1183525,1,12,6,1,0,77
123088,1183525,1,13,1,0,0,77
123089,1183525,1,13,2,1,0,78
123090,1183525,1,13,3,0,0,78
123091,1183525,1,13,4,1,0,79
123092,1183525,1,13,5,2,0,81
123093,1183525,1,13,6,1,0,82
123094,1183525,1,14,1,1,0,83
123095,1183525,1,14,2,2,0,85
123096,1183525,1,14,3,1,0,86
123097,1183525,1,14,4,2,0,88
123098,1183525,1,14,5,1,0,89
123099,1183525,1,14,6,0,0,89
123100,1183525,1,15,1,1,0,90
123101,1183525,1,15,2,2,0,92
123102,1183525,1,15,3,1,0,93
123103,1183525,1,15,4,0,1,93
123104,1183525,1,15,5,0,0,93
123105,1183525,1,15,6,0,0,93
123106,1183525,1,16,1,0,0,93
123107,1183525,1,16,2,2,0,95
123108,1183525,1,16,3,0,0,95
123109,1183525,1,16,4,0,1,95
123110,1183525,1,16,5,0,0,95
123111,1183525,1,16,6,2,0,97
123112,1183525,1,17,1,4,0,101
123113,1183525,1,17,2,4,0,105
123114,1183525,1,17,3,1,0,106
123115,1183525,1,17,4,0,0,106
123116,1183525,1,17,5,0,0,106
123117,1183525,1,17,6,1,0,107
123118,1183525,1,18,1,1,0,108
123119,1183525,1,18,2,0,0,108
123120,1183525,1,18,3,0,1,108
123121,1183525,1,18,4,0,0,108
123122,1183525,1,18,5,1,0,109
123123,1183525,1,18,6,1,0,110
123124,1183525,1,19,1,4,0,114
123125,1183525,1,19,2,1,0,115
123126,1183525,1,19,3,1,0,116
123127,1183525,1,19,4,1,0,117
123128,1183525,1,19,5,0,0,117
123129,1183525,1,19,6,0,1,117
123209,1183526,1,1,1,2,0,2
123210,1183526,1,1,2,0,0,2
123211,1183526,1,1,3,0,0,2
123212,1183526,1,1,4,0,0,2
123213,1183526,1,1,5,1,0,3
123214,1183526,1,1,6,0,1,3
123215,1183526,1,2,1,0,0,3
123216,1183526,1,2,2,0,0,3
123217,1183526,1,2,3,0,0,3
123218,1183526,1,2,4,6,0,9
123219,1183526,1,2,5,0,0,9
123220,1183526,1,2,6,1,0,10
123221,1183526,1,3,1,1,0,11
123222,1183526,1,3,2,4,0,15
123223,1183526,1,3,3,1,0,16
123224,1183526,1,3,4,0,0,16
123225,1183526,1,3,5,4,0,20
123226,1183526,1,3,6,1,0,21
123227,1183526,1,4,1,1,0,22
123228,1183526,1,4,2,1,0,23
123229,1183526,1,4,3,1,0,24
123230,1183526,1,4,4,0,0,24
123231,1183526,1,4,5,1,0,25
123232,1183526,1,4,6,6,0,31
123233,1183526,1,5,1,1,0,32
123234,1183526,1,5,2,1,0,33
123235,1183526,1,5,3,0,0,33
123236,1183526,1,5,4,0,1,33
123237,1183526,1,5,5,1,0,34
123238,1183526,1,5,6,0,0,34
123239,1183526,1,6,1,0,0,34
123240,1183526,1,6,2,2,0,36
123241,1183526,1,6,3,0,0,36
123242,1183526,1,6,4,0,0,36
123243,1183526,1,6,5,1,0,37
123244,1183526,1,6,6,4,0,41
123245,1183526,1,7,1,1,0,42
123246,1183526,1,7,2,0,0,42
123247,1183526,1,7,3,1,0,43
123248,1183526,1,7,4,2,0,45
123249,1183526,1,7,5,1,0,46
123250,1183526,1,7,6,1,0,47
123251,1183526,1,8,1,0,0,47
123252,1183526,1,8,2,0,0,47
123253,1183526,1,8,3,1,0,48
123254,1183526,1,8,4,1,0,49
123255,1183526,1,8,5,1,0,50
123256,1183526,1,8,6,1,0,51
123257,1183526,1,9,1,1,0,52
123258,1183526,1,9,2,2,0,54
123259,1183526,1,9,3,1,0,55
123260,1183526,1,9,4,1,0,56
123261,1183526,1,9,5,2,0,58
123262,1183526,1,9,6,1,0,59
123263,1183526,1,10,1,1,0,60
123264,1183526,1,10,2,1,0,61
123265,1183526,1,10,3,1,0,62
123266,1183526,1,10,4,1,0,63
123267,1183526,1,10,5,1,0,64
123268,1183526,1,10,6,1,0,65
123269,1183526,1,11,1,1,0,66
123270,1183526,1,11,2,1,0,67
123271,1183526,1,11,3,0,0,67
123272,1183526,1,11,4,1,0,68
123273,1183526,1,11,5,1,0,69
123274,1183526,1,11,6,2,0,71
123275,1183526,1,12,1,0,0,71
123276,1183526,1,12,2,2,0,73
123277,1183526,1,12,3,1,0,74
123278,1183526,1,12,4,1,0,75
123279,1183526,1,12,5,1,0,76
123280,1183526,1,12,6,0,1,76
123281,1183526,1,13,1,2,0,78
123282,1183526,1,13,2,1,0,79
123283,1183526,1,13,3,1,0,80
123284,1183526,1,13,4,4,0,84
123285,1183526,1,13,5,0,0,84
123286,1183526,1,13,6,1,0,85
123287,1183526,1,14,1,4,0,89
123288,1183526,1,14,2,2,0,91
123289,1183526,1,14,3,1,0,92
123290,1183526,1,14,4,1,0,93
123291,1183526,1,14,5,1,0,94
123292,1183526,1,14,6,4,0,98
123293,1183526,1,15,1,1,0,99
123294,1183526,1,15,2,0,1,99
123295,1183526,1,15,3,0,0,99
123296,1183526,1,15,4,1,0,100
123297,1183526,1,15,5,3,0,103
123298,1183526,1,15,6,1,0,104
123299,1183526,1,16,1,1,0,105
123300,1183526,1,16,2,1,0,106
123301,1183526,1,16,3,1,0,107
123302,1183526,1,16,4,1,0,108
123303,1183526,1,16,5,0,0,108
123304,1183526,1,16,6,2,0,110
123305,1183526,1,17,1,0,1,110
123306,1183526,1,17,2,0,0,110
123307,1183526,1,17,3,0,0,110
123308,1183526,1,17,4,1,0,111
123309,1183526,1,17,5,0,0,111
123310,1183526,1,17,6,0,0,111
123311,1183526,1,18,1,1,0,112
123312,1183526,1,18,2,1,0,113
123313,1183526,1,18,3,2,0,115
123314,1183526,1,18,4,1,0,116
123315,1183526,1,18,5,0,0,116
123316,1183526,1,18,6,2,0,118
123317,1183526,1,19,1,1,0,119
123318,1183526,1,19,2,6,0,125
123319,1183526,1,19,3,4,0,129
123320,1183526,1,19,4,2,0,131
123321,1183526,1,19,5,1,0,132
123322,1183526,1,19,6,0,1,132
123323,1183526,1,20,1,1,0,133
123324,1183526,1,20,2,6,0,139
123325,1183526,1,20,3,1,0,140
123326,1183526,1,20,4,1,0,141
123327,1183526,1,20,5,0,0,141
123328,1183526,1,20,6,1,0,142
123435,1183528,1,1,1,0,0,0
123436,1183528,1,1,2,1,0,1
123437,1183528,1,1,3,0,0,1
123438,1183528,1,1,4,0,0,1
123439,1183528,1,1,5,2,0,3
123440,1183528,1,1,6,0,0,3
123441,1183528,1,2,1,4,0,7
123442,1183528,1,2,2,4,0,11
123443,1183528,1,2,3,0,0,11
123444,1183528,1,2,4,2,0,13
123445,1183528,1,2,5,1,0,14
123446,1183528,1,2,6,0,0,14
123447,1183528,1,3,1,4,0,18
123448,1183528,1,3,2,0,0,18
123449,1183528,1,3,3,0,0,18
123450,1183528,1,3,4,4,0,22
123451,1183528,1,3,5,0,0,22
123452,1183528,1,3,6,0,0,22
123453,1183528,1,4,1,0,0,22
123454,1183528,1,4,2,0,1,22
123455,1183528,1,4,3,0,0,22
123456,1183528,1,4,4,0,0,22
123457,1183528,1,4,5,2,0,24
123458,1183528,1,4,6,1,0,25
123459,1183528,1,5,1,1,0,26
123460,1183528,1,5,2,1,0,27
123461,1183528,1,5,3,0,0,27
123462,1183528,1,5,4,0,0,27
123463,1183528,1,5,5,2,0,29
123464,1183528,1,5,6,0,1,29
123465,1183528,1,6,1,1,0,30
123466,1183528,1,6,2,0,0,30
123467,1183528,1,6,3,0,0,30
123468,1183528,1,6,4,0,0,30
123469,1183528,1,6,5,1,0,31
123470,1183528,1,6,6,1,0,32
123471,1183528,1,7,1,1,0,33
123472,1183528,1,7,2,2,0,35
123473,1183528,1,7,3,1,0,36
123474,1183528,1,7,4,1,0,37
123475,1183528,1,7,5,1,0,38
123476,1183528,1,7,6,0,0,38
123477,1183528,1,8,1,0,0,38
123478,1183528,1,8,2,1,0,39
123479,1183528,1,8,3,1,0,40
123480,1183528,1,8,4,1,0,41
123481,1183528,1,8,5,1,0,42
123482,1183528,1,8,6,1,0,43
123483,1183528,1,9,1,4,0,47
123484,1183528,1,9,2,1,0,48
123485,1183528,1,9,3,4,0,52
123486,1183528,1,9,4,2,0,54
123487,1183528,1,9,5,1,0,55
123488,1183528,1,9,6,1,0,56
123489,1183528,1,10,1,1,0,57
123490,1183528,1,10,2,4,0,61
123491,1183528,1,10,3,0,0,61
123492,1183528,1,10,4,1,0,62
123493,1183528,1,10,5,0,1,62
123494,1183528,1,10,6,0,0,62
123495,1183528,1,11,1,1,0,63
123496,1183528,1,11,2,1,0,64
123497,1183528,1,11,3,1,0,65
123498,1183528,1,11,4,1,0,66
123499,1183528,1,11,5,1,0,67
123500,1183528,1,11,6,2,0,69
123501,1183528,1,12,1,1,0,70
123502,1183528,1,12,2,0,1,70
123503,1183528,1,12,3,1,0,71
123504,1183528,1,12,4,1,0,72
123505,1183528,1,12,5,0,0,72
123506,1183528,1,12,6,1,0,73
123507,1183528,1,13,1,1,0,74
123508,1183528,1,13,2,1,0,75
123509,1183528,1,13,3,0,0,75
123510,1183528,1,13,4,2,0,77
123511,1183528,1,13,5,0,0,77
123512,1183528,1,13,6,1,0,78
123513,1183528,1,14,1,1,0,79
123514,1183528,1,14,2,1,0,80
123515,1183528,1,14,3,0,0,80
123516,1183528,1,14,4,1,0,81
123517,1183528,1,14,5,1,0,82
123518,1183528,1,14,6,1,0,83
123519,1183528,1,15,1,0,0,83
123520,1183528,1,15,2,0,0,83
123521,1183528,1,15,3,4,0,87
123522,1183528,1,15,4,6,0,93
123523,1183528,1,15,5,2,0,95
123524,1183528,1,15,6,2,0,97
123525,1183528,1,16,1,1,0,98
123526,1183528,1,16,2,1,0,99
123527,1183528,1,16,3,1,0,100
123528,1183528,1,16,4,4,0,104
123529,1183528,1,16,5,1,0,105
123530,1183528,1,16,6,1,1,106
123531,1183528,1,17,1,1,0,107
123532,1183528,1,17,2,1,0,108
123533,1183528,1,17,3,4,0,112
123534,1183528,1,17,4,0,0,112
123535,1183528,1,17,5,1,0,113
123536,1183528,1,17,6,1,0,114
123537,1183528,1,18,1,0,0,114
123538,1183528,1,18,2,2,0,116
123539,1183528,1,18,3,0,0,116
123540,1183528,1,18,4,0,0,116
123541,1183528,1,18,5,4,0,120
123542,1183528,1,18,6,0,0,120
123543,1183528,1,19,1,6,0,126
123544,1183528,1,19,2,1,0,127
123545,1183528,1,19,3,1,0,128
123546,1183528,1,19,4,4,0,132
123547,1183528,1,19,5,4,0,136
123548,1183528,1,19,6,6,0,142
123549,1183528,1,20,1,1,0,143
123550,1183528,1,20,2,1,0,144
123551,1183528,1,20,3,1,0,145
123552,1183528,1,20,4,1,1,146
123553,1183528,1,20,5,2,0,148
123554,1183528,1,20,6,2,0,150
123666,1183529,1,1,1,1,0,1
123667,1183529,1,1,2,0,0,1
123668,1183529,1,1,3,0,0,1
123669,1183529,1,1,4,1,0,2
123670,1183529,1,1,5,0,0,2
123671,1183529,1,1,6,1,0,3
123672,1183529,1,2,1,1,0,4
123673,1183529,1,2,2,0,0,4
123674,1183529,1,2,3,1,0,5
123675,1183529,1,2,4,0,0,5
123676,1183529,1,2,5,0,0,5
123677,1183529,1,2,6,4,0,9
123678,1183529,1,3,1,6,0,15
123679,1183529,1,3,2,0,1,15
123680,1183529,1,3,3,0,1,15
123681,1183529,1,3,4,0,0,15
123682,1183529,1,3,5,0,0,15
123683,1183529,1,3,6,0,0,15
123684,1183529,1,4,1,0,0,15
123685,1183529,1,4,2,0,0,15
123686,1183529,1,4,3,2,0,17
123687,1183529,1,4,4,0,0,17
123688,1183529,1,4,5,1,0,18
123689,1183529,1,4,6,0,0,18
123690,1183529,1,5,1,0,0,18
123691,1183529,1,5,2,4,0,22
123692,1183529,1,5,3,0,1,22
123693,1183529,1,5,4,0,0,22
123694,1183529,1,5,5,0,0,22
123695,1183529,1,5,6,0,0,22
123696,1183529,1,6,1,0,0,22
123697,1183529,1,6,2,4,0,26
123698,1183529,1,6,3,4,0,30
123699,1183529,1,6,4,0,0,30
123700,1183529,1,6,5,0,0,30
123701,1183529,1,6,6,4,0,34
123702,1183529,1,7,1,1,0,35
123703,1183529,1,7,2,0,0,35
123704,1183529,1,7,3,2,0,37
123705,1183529,1,7,4,4,0,41
123706,1183529,1,7,5,0,0,41
123707,1183529,1,7,6,0,0,41
123708,1183529,1,8,1,2,0,43
123709,1183529,1,8,2,1,0,44
123710,1183529,1,8,3,2,0,46
123711,1183529,1,8,4,1,0,47
123712,1183529,1,8,5,1,0,48
123713,1183529,1,8,6,0,0,48
123714,1183529,1,9,1,1,0,49
123715,1183529,1,9,2,1,0,50
123716,1183529,1,9,3,0,0,50
123717,1183529,1,9,4,2,0,52
123718,1183529,1,9,5,1,0,53
123719,1183529,1,9,6,1,0,54
123720,1183529,1,10,1,0,1,54
123721,1183529,1,10,2,1,0,55
123722,1183529,1,10,3,1,0,56
123723,1183529,1,10,4,1,0,57
123724,1183529,1,10,5,1,0,58
123725,1183529,1,10,6,1,0,59
123726,1183529,1,11,1,1,0,60
123727,1183529,1,11,2,0,0,60
123728,1183529,1,11,3,1,0,61
123729,1183529,1,11,4,1,0,62
123730,1183529,1,11,5,1,0,63
123731,1183529,1,11,6,0,0,63
123732,1183529,1,12,1,1,0,64
123733,1183529,1,12,2,0,0,64
123734,1183529,1,12,3,2,0,66
123735,1183529,1,12,4,1,0,67
123736,1183529,1,12,5,1,0,68
123737,1183529,1,12,6,1,0,69
123738,1183529,1,13,1,0,1,69
123739,1183529,1,13,2,4,0,73
123740,1183529,1,13,3,0,0,73
123741,1183529,1,13,4,2,0,75
123742,1183529,1,13,5,0,0,75
123743,1183529,1,13,6,4,0,79
123744,1183529,1,14,1,1,0,80
123745,1183529,1,14,2,1,0,81
123746,1183529,1,14,3,2,0,83
123747,1183529,1,14,4,1,0,84
123748,1183529,1,14,5,1,0,85
123749,1183529,1,14,6,1,0,86
123750,1183529,1,15,1,1,0,87
123751,1183529,1,15,2,1,0,88
123752,1183529,1,15,3,0,1,88
123753,1183529,1,15,4,0,0,88
123754,1183529,1,15,5,1,0,89
123755,1183529,1,15,6,0,0,89
123756,1183529,1,16,1,1,0,90
123757,1183529,1,16,2,0,0,90
123758,1183529,1,16,3,1,0,91
123759,1183529,1,16,4,0,0,91
123760,1183529,1,16,5,1,0,92
123761,1183529,1,16,6,0,0,92
123762,1183529,1,17,1,0,1,92
123763,1183529,1,17,2,0,0,92
123764,1183529,1,17,3,0,0,92
123765,1183529,1,17,4,0,0,92
123766,1183529,1,17,5,0,1,92
123767,1183529,1,17,6,4,0,96
123768,1183529,1,18,1,1,0,97
123769,1183529,1,18,2,6,0,103
123770,1183529,1,18,3,0,0,103
123771,1183529,1,18,4,1,0,104
123772,1183529,1,18,5,0,0,104
123773,1183529,1,18,6,0,0,104
123774,1183529,1,19,1,1,0,105
123775,1183529,1,19,2,0,0,105
123776,1183529,1,19,3,0,0,105
123777,1183529,1,19,4,0,0,105
123778,1183529,1,19,5,0,0,105
123779,1183529,1,19,6,0,0,105
123780,1183529,1,20,1,0,0,105
123781,1183529,1,20,2,0,0,105
123782,1183529,1,20,3,0,0,105
123783,1183529,1,20,4,1,0,106
123784,1183529,1,20,5,0,0,106
123785,1183529,1,20,6,0,0,106
123857,1185313,1,1,1,1,0,1
123858,1185313,1,1,2,1,0,2
123859,1185313,1,1,3,1,0,3
123860,1185313,1,1,4,0,0,3
123861,1185313,1,1,5,1,0,4
123862,1185313,1,1,6,0,0,4
123863,1185313,1,2,1,0,0,4
123864,1185313,1,2,2,0,0,4
123865,1185313,1,2,3,4,0,8
123866,1185313,1,2,4,4,0,12
123867,1185313,1,2,5,6,0,18
123868,1185313,1,2,6,1,0,19
123869,1185313,1,3,1,2,0,21
123870,1185313,1,3,2,1,0,22
123871,1185313,1,3,3,2,0,24
123872,1185313,1,3,4,2,0,26
123873,1185313,1,3,5,2,0,28
123874,1185313,1,3,6,0,0,28
123875,1185313,1,4,1,11,0,39
123876,1185313,1,4,2,1,0,40
123877,1185313,1,4,3,2,0,42
123878,1185313,1,4,4,0,0,42
123879,1185313,1,4,5,2,0,44
123880,1185313,1,4,6,4,0,48
123881,1185313,1,5,1,0,1,48
123882,1185313,1,5,2,0,0,48
123883,1185313,1,5,3,0,0,48
123884,1185313,1,5,4,1,0,49
123885,1185313,1,5,5,4,0,53
123886,1185313,1,5,6,1,0,54
123887,1185313,1,6,1,1,0,55
123888,1185313,1,6,2,4,0,59
123889,1185313,1,6,3,0,0,59
123890,1185313,1,6,4,6,0,65
123891,1185313,1,6,5,2,0,67
123892,1185313,1,6,6,1,0,68
123893,1185313,1,7,1,1,0,69
123894,1185313,1,7,2,4,0,73
123895,1185313,1,7,3,2,0,75
123896,1185313,1,7,4,1,0,76
123897,1185313,1,7,5,0,0,76
123898,1185313,1,7,6,1,0,77
123899,1185313,1,8,1,1,0,78
123900,1185313,1,8,2,1,0,79
123901,1185313,1,8,3,1,0,80
123902,1185313,1,8,4,1,0,81
123903,1185313,1,8,5,1,0,82
123904,1185313,1,8,6,2,0,84
123905,1185313,1,9,1,0,0,84
123906,1185313,1,9,2,5,0,89
123907,1185313,1,9,3,2,0,91
123908,1185313,1,9,4,1,0,92
123909,1185313,1,9,5,4,0,96
123910,1185313,1,9,6,1,0,97
123911,1185313,1,10,1,1,0,98
123912,1185313,1,10,2,0,0,98
123913,1185313,1,10,3,4,0,102
123914,1185313,1,10,4,0,0,102
123915,1185313,1,10,5,2,0,104
123916,1185313,1,10,6,1,0,105
123917,1185313,1,11,1,0,0,105
123918,1185313,1,11,2,1,0,106
123919,1185313,1,11,3,4,0,110
123920,1185313,1,11,4,1,0,111
123921,1185313,1,11,5,0,1,111
123922,1185313,1,11,6,0,0,111
123923,1185313,1,12,1,1,0,112
123924,1185313,1,12,2,1,0,113
123925,1185313,1,12,3,0,1,113
123926,1185313,1,12,4,0,0,113
123927,1185313,1,12,5,0,0,113
123928,1185313,1,12,6,0,0,113
123929,1185313,1,13,1,0,0,113
123930,1185313,1,13,2,1,0,114
123931,1185313,1,13,3,1,0,115
123932,1185313,1,13,4,2,0,117
123933,1185313,1,13,5,1,0,118
123934,1185313,1,13,6,0,0,118
123935,1185313,1,14,1,4,0,122
123936,1185313,1,14,2,1,0,123
123937,1185313,1,14,3,1,0,124
123938,1185313,1,14,4,2,0,126
123939,1185313,1,14,5,1,0,127
123940,1185313,1,14,6,1,0,128
123941,1185313,1,15,1,1,0,129
123942,1185313,1,15,2,1,0,130
123943,1185313,1,15,3,1,0,131
123944,1185313,1,15,4,1,0,132
123945,1185313,1,15,5,2,0,134
123946,1185313,1,15,6,1,0,135
123947,1185313,1,16,1,0,1,135
123948,1185313,1,16,2,1,0,136
123949,1185313,1,16,3,6,0,142
123950,1185313,1,16,4,1,0,143
123951,1185313,1,16,5,4,0,147
123952,1185313,1,16,6,1,0,148
123953,1185313,1,17,1,1,0,149
123954,1185313,1,17,2,2,0,151
123955,1185313,1,17,3,4,0,155
123956,1185313,1,17,4,2,0,157
123957,1185313,1,17,5,1,0,158
123958,1185313,1,17,6,2,0,160
123959,1185313,1,18,1,1,0,161
123960,1185313,1,18,2,0,0,161
123961,1185313,1,18,3,1,0,162
123962,1185313,1,18,4,6,0,168
123963,1185313,1,18,5,0,0,168
123964,1185313,1,18,6,1,0,169
123965,1185313,1,19,1,0,0,169
123966,1185313,1,19,2,0,0,169
123967,1185313,1,19,3,1,0,170
123968,1185313,1,19,4,0,1,170
123969,1185313,1,19,5,1,0,171
123970,1185313,1,19,6,1,0,172
123971,1185313,1,20,1,0,1,172
123972,1185313,1,20,2,0,1,172
123973,1185313,1,20,3,4,0,176
123974,1185313,1,20,4,1,0,177
123975,1185313,1,20,5,0,0,177
123976,1185313,1,20,6,0,1,177
124097,1185314,1,1,1,0,0,0
124098,1185314,1,1,2,1,0,1
124099,1185314,1,1,3,1,0,2
124100,1185314,1,1,4,0,0,2
124101,1185314,1,1,5,6,0,8
124102,1185314,1,1,6,1,0,9
124103,1185314,1,2,1,0,0,9
124104,1185314,1,2,2,0,0,9
124105,1185314,1,2,3,4,0,13
124106,1185314,1,2,4,1,0,14
124107,1185314,1,2,5,1,0,15
124108,1185314,1,2,6,1,0,16
124109,1185314,1,3,1,0,0,16
124110,1185314,1,3,2,0,0,16
124111,1185314,1,3,3,1,0,17
124112,1185314,1,3,4,0,0,17
124113,1185314,1,3,5,0,1,17
124114,1185314,1,3,6,1,0,18
124115,1185314,1,4,1,0,0,18
124116,1185314,1,4,2,0,0,18
124117,1185314,1,4,3,0,0,18
124118,1185314,1,4,4,1,0,19
124119,1185314,1,4,5,1,0,20
124120,1185314,1,4,6,4,0,24
124121,1185314,1,5,1,4,0,28
124122,1185314,1,5,2,0,0,28
124123,1185314,1,5,3,1,0,29
124124,1185314,1,5,4,6,0,35
124125,1185314,1,5,5,2,0,37
124126,1185314,1,5,6,1,0,38
124127,1185314,1,6,1,4,0,42
124128,1185314,1,6,2,2,0,44
124129,1185314,1,6,3,1,0,45
124130,1185314,1,6,4,0,0,45
124131,1185314,1,6,5,6,0,51
124132,1185314,1,6,6,4,0,55
124133,1185314,1,7,1,0,0,55
124134,1185314,1,7,2,6,0,61
124135,1185314,1,7,3,6,0,67
124136,1185314,1,7,4,1,0,68
124137,1185314,1,7,5,1,0,69
124138,1185314,1,7,6,0,1,69
124139,1185314,1,8,1,1,0,70
124140,1185314,1,8,2,1,0,71
124141,1185314,1,8,3,1,0,72
124142,1185314,1,8,4,4,0,76
124143,1185314,1,8,5,1,0,77
124144,1185314,1,8,6,1,0,78
124145,1185314,1,9,1,2,0,80
124146,1185314,1,9,2,1,0,81
124147,1185314,1,9,3,0,0,81
124148,1185314,1,9,4,1,0,82
124149,1185314,1,9,5,1,0,83
124150,1185314,1,9,6,4,0,87
124151,1185314,1,10,1,1,0,88
124152,1185314,1,10,2,1,0,89
124153,1185314,1,10,3,1,1,90
124154,1185314,1,10,4,0,0,90
124155,1185314,1,10,5,0,0,90
124156,1185314,1,10,6,0,0,90
124157,1185314,1,11,1,1,0,91
124158,1185314,1,11,2,0,0,91
124159,1185314,1,11,3,1,0,92
124160,1185314,1,11,4,0,0,92
124161,1185314,1,11,5,0,0,92
124162,1185314,1,11,6,1,0,93
124163,1185314,1,12,1,0,0,93
124164,1185314,1,12,2,1,0,94
124165,1185314,1,12,3,6,0,100
124166,1185314,1,12,4,2,0,102
124167,1185314,1,12,5,1,0,103
124168,1185314,1,12,6,1,0,104
124169,1185314,1,13,1,1,0,105
124170,1185314,1,13,2,0,0,105
124171,1185314,1,13,3,0,0,105
124172,1185314,1,13,4,1,0,106
124173,1185314,1,13,5,1,0,107
124174,1185314,1,13,6,1,0,108
124175,1185314,1,14,1,0,0,108
124176,1185314,1,14,2,1,0,109
124177,1185314,1,14,3,4,0,113
124178,1185314,1,14,4,0,0,113
124179,1185314,1,14,5,1,0,114
124180,1185314,1,14,6,1,0,115
124181,1185314,1,15,1,1,0,116
124182,1185314,1,15,2,6,0,122
124183,1185314,1,15,3,1,0,123
124184,1185314,1,15,4,0,1,123
124185,1185314,1,15,5,1,0,124
124186,1185314,1,15,6,1,0,125
124187,1185314,1,16,1,0,1,125
124188,1185314,1,16,2,1,0,126
124189,1185314,1,16,3,1,0,127
124190,1185314,1,16,4,6,0,133
124191,1185314,1,16,5,1,0,134
124192,1185314,1,16,6,2,0,136
124193,1185314,1,17,1,1,0,137
124194,1185314,1,17,2,0,0,137
124195,1185314,1,17,3,1,0,138
124196,1185314,1,17,4,9,0,147
124197,1185314,1,17,5,4,0,151
124198,1185314,1,17,6,6,0,157
124199,1185314,1,18,1,4,0,161
124200,1185314,1,18,2,1,0,162
124201,1185314,1,18,3,6,0,168
124202,1185314,1,18,4,4,0,172
124203,1185314,1,18,5,4,0,176
124204,1185314,1,18,6,0,1,176
124205,1185314,1,19,1,4,0,180
124206,1185314,1,19,2,1,0,181
124207,1185314,1,19,3,1,0,182
124208,1185314,1,19,4,0,0,182
124209,1185314,1,19,5,1,0,183
124210,1185314,1,19,6,6,0,189
124211,1185314,1,20,1,4,0,193
124212,1185314,1,20,2,1,0,194
124213,1185314,1,20,3,0,1,194
124214,1185314,1,20,4,6,0,200
124215,1185314,1,20,5,2,0,202
124216,1185314,1,20,6,2,0,204
124337,1185315,1,1,1,4,0,4
124338,1185315,1,1,2,0,0,4
124339,1185315,1,1,3,1,0,5
124340,1185315,1,1,4,1,0,6
124341,1185315,1,1,5,4,0,10
124342,1185315,1,1,6,1,0,11
124343,1185315,1,2,1,1,0,12
124344,1185315,1,2,2,0,0,12
124345,1185315,1,2,3,0,0,12
124346,1185315,1,2,4,1,0,13
124347,1185315,1,2,5,0,0,13
124348,1185315,1,2,6,4,0,17
124349,1185315,1,3,1,6,0,23
124350,1185315,1,3,2,1,0,24
124351,1185315,1,3,3,1,0,25
124352,1185315,1,3,4,1,0,26
124353,1185315,1,3,5,6,0,32
124354,1185315,1,3,6,1,0,33
124355,1185315,1,4,1,1,0,34
124356,1185315,1,4,2,6,0,40
124357,1185315,1,4,3,6,0,46
124358,1185315,1,4,4,6,0,52
124359,1185315,1,4,5,0,0,52
124360,1185315,1,4,6,0,0,52
124361,1185315,1,5,1,2,0,54
124362,1185315,1,5,2,1,0,55
124363,1185315,1,5,3,4,0,59
124364,1185315,1,5,4,0,0,59
124365,1185315,1,5,5,0,0,59
124366,1185315,1,5,6,1,0,60
124367,1185315,1,6,1,1,0,61
124368,1185315,1,6,2,1,0,62
124369,1185315,1,6,3,0,0,62
124370,1185315,1,6,4,0,0,62
124371,1185315,1,6,5,1,0,63
124372,1185315,1,6,6,1,0,64
124373,1185315,1,7,1,6,0,70
124374,1185315,1,7,2,4,0,74
124375,1185315,1,7,3,1,0,75
124376,1185315,1,7,4,1,0,76
124377,1185315,1,7,5,1,0,77
124378,1185315,1,7,6,0,0,77
124379,1185315,1,8,1,6,0,83
124380,1185315,1,8,2,1,0,84
124381,1185315,1,8,3,0,0,84
124382,1185315,1,8,4,0,1,84
124383,1185315,1,8,5,1,0,85
124384,1185315,1,8,6,1,0,86
124385,1185315,1,9,1,0,1,86
124386,1185315,1,9,2,1,0,87
124387,1185315,1,9,3,1,0,88
124388,1185315,1,9,4,0,0,88
124389,1185315,1,9,5,1,0,89
124390,1185315,1,9,6,1,0,90
124391,1185315,1,10,1,4,0,94
124392,1185315,1,10,2,1,0,95
124393,1185315,1,10,3,2,0,97
124394,1185315,1,10,4,1,0,98
124395,1185315,1,10,5,1,0,99
124396,1185315,1,10,6,1,0,100
124397,1185315,1,11,1,1,0,101
124398,1185315,1,11,2,2,0,103
124399,1185315,1,11,3,6,0,109
124400,1185315,1,11,4,1,0,110
124401,1185315,1,11,5,1,0,111
124402,1185315,1,11,6,1,0,112
124403,1185315,1,12,1,1,0,113
124404,1185315,1,12,2,0,1,113
124405,1185315,1,12,3,1,0,114
124406,1185315,1,12,4,0,0,114
124407,1185315,1,12,5,1,0,115
124408,1185315,1,12,6,1,0,116
124409,1185315,1,13,1,1,0,117
124410,1185315,1,13,2,1,0,118
124411,1185315,1,13,3,2,0,120
124412,1185315,1,13,4,6,0,126
124413,1185315,1,13,5,2,0,128
124414,1185315,1,13,6,1,0,129
124415,1185315,1,14,1,7,0,136
124416,1185315,1,14,2,1,0,137
124417,1185315,1,14,3,1,0,138
124418,1185315,1,14,4,0,0,138
124419,1185315,1,14,5,2,0,140
124420,1185315,1,14,6,1,0,141
124421,1185315,1,15,1,4,0,145
124422,1185315,1,15,2,6,0,151
124423,1185315,1,15,3,2,0,153
124424,1185315,1,15,4,1,0,154
124425,1185315,1,15,5,5,0,159
124426,1185315,1,15,6,5,0,164
124427,1185315,1,16,1,2,0,166
124428,1185315,1,16,2,1,0,167
124429,1185315,1,16,3,5,0,172
124430,1185315,1,16,4,1,0,173
124431,1185315,1,16,5,1,0,174
124432,1185315,1,16,6,0,0,174
124433,1185315,1,17,1,1,0,175
124434,1185315,1,17,2,2,0,177
124435,1185315,1,17,3,0,1,177
124436,1185315,1,17,4,1,0,178
124437,1185315,1,17,5,0,0,178
124438,1185315,1,17,6,1,0,179
124439,1185315,1,18,1,4,0,183
124440,1185315,1,18,2,1,0,184
124441,1185315,1,18,3,0,0,184
124442,1185315,1,18,4,5,0,189
124443,1185315,1,18,5,6,0,195
124444,1185315,1,18,6,0,0,195
124445,1185315,1,19,1,1,0,196
124446,1185315,1,19,2,2,0,198
124447,1185315,1,19,3,4,0,202
124448,1185315,1,19,4,0,1,202
124449,1185315,1,19,5,1,0,203
124450,1185315,1,19,6,7,0,210
124451,1185315,1,20,1,4,0,214
124452,1185315,1,20,2,0,1,214
124453,1185315,1,20,3,0,0,214
124454,1185315,1,20,4,4,0,218
124455,1185315,1,20,5,0,0,218
124456,1185315,1,20,6,4,0,222
124572,1185316,1,1,1,4,0,4
124573,1185316,1,1,2,0,1,4
124574,1185316,1,1,3,4,0,8
124575,1185316,1,1,4,1,0,9
124576,1185316,1,1,5,0,0,9
124577,1185316,1,1,6,0,0,9
124578,1185316,1,2,1,4,0,13
124579,1185316,1,2,2,0,0,13
124580,1185316,1,2,3,3,0,16
124581,1185316,1,2,4,0,0,16
124582,1185316,1,2,5,0,0,16
124583,1185316,1,2,6,4,0,20
124584,1185316,1,3,1,0,0,20
124585,1185316,1,3,2,0,0,20
124586,1185316,1,3,3,1,0,21
124587,1185316,1,3,4,4,0,25
124588,1185316,1,3,5,1,0,26
124589,1185316,1,3,6,4,0,30
124590,1185316,1,4,1,6,0,36
124591,1185316,1,4,2,1,0,37
124592,1185316,1,4,3,4,0,41
124593,1185316,1,4,4,0,0,41
124594,1185316,1,4,5,0,0,41
124595,1185316,1,4,6,0,0,41
124596,1185316,1,5,1,1,0,42
124597,1185316,1,5,2,0,0,42
124598,1185316,1,5,3,4,0,46
124599,1185316,1,5,4,4,0,50
124600,1185316,1,5,5,2,0,52
124601,1185316,1,5,6,6,0,58
124602,1185316,1,6,1,4,0,62
124603,1185316,1,6,2,0,0,62
124604,1185316,1,6,3,0,0,62
124605,1185316,1,6,4,4,0,66
124606,1185316,1,6,5,0,0,66
124607,1185316,1,6,6,4,0,70
124608,1185316,1,7,1,1,0,71
124609,1185316,1,7,2,3,0,74
124610,1185316,1,7,3,1,0,75
124611,1185316,1,7,4,1,0,76
124612,1185316,1,7,5,1,0,77
124613,1185316,1,7,6,1,0,78
124614,1185316,1,8,1,2,0,80
124615,1185316,1,8,2,1,0,81
124616,1185316,1,8,3,0,0,81
124617,1185316,1,8,4,0,0,81
124618,1185316,1,8,5,1,0,82
124619,1185316,1,8,6,1,0,83
124620,1185316,1,9,1,1,0,84
124621,1185316,1,9,2,0,1,84
124622,1185316,1,9,3,2,0,86
124623,1185316,1,9,4,2,0,88
124624,1185316,1,9,5,1,0,89
124625,1185316,1,9,6,1,0,90
124626,1185316,1,10,1,1,0,91
124627,1185316,1,10,2,4,0,95
124628,1185316,1,10,3,1,0,96
124629,1185316,1,10,4,2,0,98
124630,1185316,1,10,5,1,0,99
124631,1185316,1,10,6,0,0,99
124632,1185316,1,11,1,0,0,99
124633,1185316,1,11,2,1,0,100
124634,1185316,1,11,3,3,0,103
124635,1185316,1,11,4,1,0,104
124636,1185316,1,11,5,1,0,105
124637,1185316,1,11,6,1,0,106
124638,1185316,1,12,1,1,0,107
124639,1185316,1,12,2,1,0,108
124640,1185316,1,12,3,4,0,112
124641,1185316,1,12,4,2,0,114
124642,1185316,1,12,5,0,1,114
124643,1185316,1,12,6,2,0,116
124644,1185316,1,13,1,2,1,118
124645,1185316,1,13,2,1,0,119
124646,1185316,1,13,3,0,0,119
124647,1185316,1,13,4,0,0,119
124648,1185316,1,13,5,6,0,125
124649,1185316,1,13,6,0,0,125
124650,1185316,1,14,1,1,0,126
124651,1185316,1,14,2,2,0,128
124652,1185316,1,14,3,0,0,128
124653,1185316,1,14,4,1,0,129
124654,1185316,1,14,5,1,0,130
124655,1185316,1,14,6,1,0,131
124656,1185316,1,15,1,1,0,132
124657,1185316,1,15,2,4,0,136
124658,1185316,1,15,3,4,0,140
124659,1185316,1,15,4,2,0,142
124660,1185316,1,15,5,4,0,146
124661,1185316,1,15,6,1,0,147
124662,1185316,1,16,1,1,0,148
124663,1185316,1,16,2,4,0,152
124664,1185316,1,16,3,0,0,152
124665,1185316,1,16,4,1,0,153
124666,1185316,1,16,5,1,0,154
124667,1185316,1,16,6,1,0,155
124668,1185316,1,17,1,1,0,156
124669,1185316,1,17,2,0,0,156
124670,1185316,1,17,3,1,0,157
124671,1185316,1,17,4,0,0,157
124672,1185316,1,17,5,2,0,159
124673,1185316,1,17,6,0,0,159
124674,1185316,1,18,1,0,0,159
124675,1185316,1,18,2,7,0,166
124676,1185316,1,18,3,1,0,167
124677,1185316,1,18,4,0,1,167
124678,1185316,1,18,5,1,0,168
124679,1185316,1,18,6,1,0,169
124680,1185316,1,19,1,0,0,169
124681,1185316,1,19,2,1,0,170
124682,1185316,1,19,3,1,1,171
124683,1185316,1,19,4,1,0,172
124684,1185316,1,19,5,0,0,172
124685,1185316,1,19,6,6,0,178
124686,1185316,1,20,1,4,0,182
124687,1185316,1,20,2,6,0,188
124688,1185316,1,20,3,2,0,190
124689,1185316,1,20,4,1,0,191
124690,1185316,1,20,5,1,0,192
124691,1185316,1,20,6,4,0,196
124779,1185317,1,1,1,0,0,0
124780,1185317,1,1,2,1,0,1
124781,1185317,1,1,3,1,0,2
124782,1185317,1,1,4,1,0,3
124783,1185317,1,1,5,1,0,4
124784,1185317,1,1,6,0,0,4
124785,1185317,1,2,1,0,0,4
124786,1185317,1,2,2,6,0,10
124787,1185317,1,2,3,0,0,10
124788,1185317,1,2,4,6,0,16
124789,1185317,1,2,5,1,0,17
124790,1185317,1,2,6,1,0,18
124791,1185317,1,3,1,0,0,18
124792,1185317,1,3,2,4,0,22
124793,1185317,1,3,3,1,0,23
124794,1185317,1,3,4,6,0,29
124795,1185317,1,3,5,0,0,29
124796,1185317,1,3,6,1,0,30
124797,1185317,1,4,1,4,0,34
124798,1185317,1,4,2,4,0,38
124799,1185317,1,4,3,1,0,39
124800,1185317,1,4,4,0,0,39
124801,1185317,1,4,5,0,0,39
124802,1185317,1,4,6,1,0,40
124803,1185317,1,5,1,0,0,40
124804,1185317,1,5,2,2,0,42
124805,1185317,1,5,3,0,0,42
124806,1185317,1,5,4,2,0,44
124807,1185317,1,5,5,1,0,45
124808,1185317,1,5,6,1,0,46
124809,1185317,1,6,1,0,0,46
124810,1185317,1,6,2,1,0,47
124811,1185317,1,6,3,1,0,48
124812,1185317,1,6,4,4,0,52
124813,1185317,1,6,5,6,0,58
124814,1185317,1,6,6,1,0,59
124815,1185317,1,7,1,0,0,59
124816,1185317,1,7,2,1,0,60
124817,1185317,1,7,3,0,1,60
124818,1185317,1,7,4,1,0,61
124819,1185317,1,7,5,0,0,61
124820,1185317,1,7,6,1,0,62
124821,1185317,1,8,1,3,0,65
124822,1185317,1,8,2,1,0,66
124823,1185317,1,8,3,1,0,67
124824,1185317,1,8,4,1,0,68
124825,1185317,1,8,5,2,0,70
124826,1185317,1,8,6,0,0,70
124827,1185317,1,9,1,1,0,71
124828,1185317,1,9,2,1,0,72
124829,1185317,1,9,3,1,0,73
124830,1185317,1,9,4,4,0,77
124831,1185317,1,9,5,0,0,77
124832,1185317,1,9,6,1,0,78
124833,1185317,1,10,1,1,0,79
124834,1185317,1,10,2,1,0,80
124835,1185317,1,10,3,0,0,80
124836,1185317,1,10,4,1,0,81
124837,1185317,1,10,5,0,0,81
124838,1185317,1,10,6,0,0,81
124839,1185317,1,11,1,0,1,81
124840,1185317,1,11,2,1,0,82
124841,1185317,1,11,3,1,0,83
124842,1185317,1,11,4,4,0,87
124843,1185317,1,11,5,1,0,88
124844,1185317,1,11,6,0,0,88
124845,1185317,1,12,1,1,0,89
124846,1185317,1,12,2,1,0,90
124847,1185317,1,12,3,1,0,91
124848,1185317,1,12,4,1,0,92
124849,1185317,1,12,5,2,0,94
124850,1185317,1,12,6,1,0,95
124851,1185317,1,13,1,0,0,95
124852,1185317,1,13,2,1,0,96
124853,1185317,1,13,3,1,0,97
124854,1185317,1,13,4,1,0,98
124855,1185317,1,13,5,1,0,99
124856,1185317,1,13,6,1,0,100
124857,1185317,1,14,1,0,0,100
124858,1185317,1,14,2,4,0,104
124859,1185317,1,14,3,1,0,105
124860,1185317,1,14,4,6,0,111
124861,1185317,1,14,5,1,0,112
124862,1185317,1,14,6,1,0,113
124863,1185317,1,15,1,1,0,114
124864,1185317,1,15,2,0,0,114
124865,1185317,1,15,3,6,0,120
124866,1185317,1,15,4,1,0,121
124867,1185317,1,15,5,0,1,121
124868,1185317,1,15,6,1,0,122
124869,1185317,1,16,1,1,0,123
124870,1185317,1,16,2,1,0,124
124871,1185317,1,16,3,1,0,125
124872,1185317,1,16,4,0,0,125
124873,1185317,1,16,5,1,0,126
124874,1185317,1,16,6,1,0,127
124875,1185317,1,17,1,1,0,128
124876,1185317,1,17,2,1,0,129
124877,1185317,1,17,3,4,0,133
124878,1185317,1,17,4,0,0,133
124879,1185317,1,17,5,4,0,137
124880,1185317,1,17,6,1,0,138
124881,1185317,1,18,1,1,0,139
124882,1185317,1,18,2,1,0,140
124883,1185317,1,18,3,1,0,141
124884,1185317,1,18,4,0,0,141
124885,1185317,1,18,5,1,0,142
124886,1185317,1,18,6,0,0,142
124887,1185317,1,19,1,1,0,143
124888,1185317,1,19,2,2,0,145
124889,1185317,1,19,3,1,0,146
124890,1185317,1,19,4,0,0,146
124891,1185317,1,19,5,1,0,147
124892,1185317,1,19,6,0,1,147
124893,1185317,1,20,1,2,0,149
124894,1185317,1,20,2,1,0,150
124895,1185317,1,20,3,4,0,154
124896,1185317,1,20,4,1,0,155
124897,1185317,1,20,5,1,0,156
124898,1185317,1,20,6,2,0,158
125019,1185318,1,1,1,1,0,1
125020,1185318,1,1,2,5,0,6
125021,1185318,1,1,3,2,0,8
125022,1185318,1,1,4,0,0,8
125023,1185318,1,1,5,1,0,9
125024,1185318,1,1,6,0,0,9
125025,1185318,1,2,1,3,0,12
125026,1185318,1,2,2,1,0,13
125027,1185318,1,2,3,0,0,13
125028,1185318,1,2,4,1,0,14
125029,1185318,1,2,5,1,0,15
125030,1185318,1,2,6,0,0,15
125031,1185318,1,3,1,1,0,16
125032,1185318,1,3,2,4,0,20
125033,1185318,1,3,3,6,0,26
125034,1185318,1,3,4,1,0,27
125035,1185318,1,3,5,4,0,31
125036,1185318,1,3,6,1,0,32
125037,1185318,1,4,1,1,0,33
125038,1185318,1,4,2,4,0,37
125039,1185318,1,4,3,1,0,38
125040,1185318,1,4,4,4,0,42
125041,1185318,1,4,5,4,0,46
125042,1185318,1,4,6,4,0,50
125043,1185318,1,5,1,4,0,54
125044,1185318,1,5,2,4,0,58
125045,1185318,1,5,3,1,0,59
125046,1185318,1,5,4,2,0,61
125047,1185318,1,5,5,1,0,62
125048,1185318,1,5,6,1,0,63
125049,1185318,1,6,1,6,0,69
125050,1185318,1,6,2,1,0,70
125051,1185318,1,6,3,2,0,72
125052,1185318,1,6,4,0,0,72
125053,1185318,1,6,5,1,0,73
125054,1185318,1,6,6,2,0,75
125055,1185318,1,7,1,1,0,76
125056,1185318,1,7,2,4,0,80
125057,1185318,1,7,3,0,0,80
125058,1185318,1,7,4,2,0,82
125059,1185318,1,7,5,1,0,83
125060,1185318,1,7,6,1,0,84
125061,1185318,1,8,1,1,0,85
125062,1185318,1,8,2,2,0,87
125063,1185318,1,8,3,2,0,89
125064,1185318,1,8,4,2,0,91
125065,1185318,1,8,5,1,0,92
125066,1185318,1,8,6,1,0,93
125067,1185318,1,9,1,0,0,93
125068,1185318,1,9,2,4,0,97
125069,1185318,1,9,3,1,0,98
125070,1185318,1,9,4,1,0,99
125071,1185318,1,9,5,2,0,101
125072,1185318,1,9,6,1,0,102
125073,1185318,1,10,1,1,0,103
125074,1185318,1,10,2,2,0,105
125075,1185318,1,10,3,1,0,106
125076,1185318,1,10,4,6,0,112
125077,1185318,1,10,5,1,0,113
125078,1185318,1,10,6,1,0,114
125079,1185318,1,11,1,1,0,115
125080,1185318,1,11,2,2,0,117
125081,1185318,1,11,3,1,0,118
125082,1185318,1,11,4,1,0,119
125083,1185318,1,11,5,0,0,119
125084,1185318,1,11,6,0,0,119
125085,1185318,1,12,1,1,0,120
125086,1185318,1,12,2,0,0,120
125087,1185318,1,12,3,0,1,120
125088,1185318,1,12,4,0,0,120
125089,1185318,1,12,5,0,0,120
125090,1185318,1,12,6,1,0,121
125091,1185318,1,13,1,1,0,122
125092,1185318,1,13,2,0,0,122
125093,1185318,1,13,3,1,0,123
125094,1185318,1,13,4,0,1,123
125095,1185318,1,13,5,1,0,124
125096,1185318,1,13,6,1,0,125
125097,1185318,1,14,1,0,0,125
125098,1185318,1,14,2,1,0,126
125099,1185318,1,14,3,0,0,126
125100,1185318,1,14,4,2,0,128
125101,1185318,1,14,5,6,0,134
125102,1185318,1,14,6,1,0,135
125103,1185318,1,15,1,1,0,136
125104,1185318,1,15,2,1,0,137
125105,1185318,1,15,3,0,0,137
125106,1185318,1,15,4,2,0,139
125107,1185318,1,15,5,0,0,139
125108,1185318,1,15,6,6,0,145
125109,1185318,1,16,1,1,0,146
125110,1185318,1,16,2,0,1,146
125111,1185318,1,16,3,4,0,150
125112,1185318,1,16,4,0,0,150
125113,1185318,1,16,5,0,0,150
125114,1185318,1,16,6,1,0,151
125115,1185318,1,17,1,2,0,153
125116,1185318,1,17,2,1,0,154
125117,1185318,1,17,3,1,0,155
125118,1185318,1,17,4,0,1,155
125119,1185318,1,17,5,3,0,158
125120,1185318,1,17,6,1,0,159
125121,1185318,1,18,1,2,0,161
125122,1185318,1,18,2,1,0,162
125123,1185318,1,18,3,0,0,162
125124,1185318,1,18,4,1,0,163
125125,1185318,1,18,5,1,0,164
125126,1185318,1,18,6,1,0,165
125127,1185318,1,19,1,3,0,168
125128,1185318,1,19,2,1,0,169
125129,1185318,1,19,3,2,0,171
125130,1185318,1,19,4,0,1,171
125131,1185318,1,19,5,1,0,172
125132,1185318,1,19,6,1,0,173
125133,1185318,1,20,1,6,0,179
125134,1185318,1,20,2,2,0,181
125135,1185318,1,20,3,2,0,183
125136,1185318,1,20,4,6,0,189
125137,1185318,1,20,5,2,0,191
125138,1185318,1,20,6,2,0,193
125232,1187005,1,1,1,0,0,0
125233,1187005,1,1,2,1,0,1
125234,1187005,1,1,3,4,0,5
125235,1187005,1,1,4,0,0,5
125236,1187005,1,1,5,1,0,6
125237,1187005,1,1,6,0,0,6
125238,1187005,1,2,1,1,0,7
125239,1187005,1,2,2,0,0,7
125240,1187005,1,2,3,0,0,7
125241,1187005,1,2,4,4,0,11
125242,1187005,1,2,5,0,0,11
125243,1187005,1,2,6,0,0,11
125244,1187005,1,3,1,4,0,15
125245,1187005,1,3,2,4,0,19
125246,1187005,1,3,3,4,0,23
125247,1187005,1,3,4,0,0,23
125248,1187005,1,3,5,1,0,24
125249,1187005,1,3,6,0,0,24
125250,1187005,1,4,1,4,0,28
125251,1187005,1,4,2,1,0,29
125252,1187005,1,4,3,1,0,30
125253,1187005,1,4,4,1,0,31
125254,1187005,1,4,5,0,1,31
125255,1187005,1,4,6,0,0,31
125256,1187005,1,5,1,0,0,31
125257,1187005,1,5,2,0,0,31
125258,1187005,1,5,3,0,0,31
125259,1187005,1,5,4,0,0,31
125260,1187005,1,5,5,1,0,32
125261,1187005,1,5,6,0,0,32
125262,1187005,1,6,1,2,0,34
125263,1187005,1,6,2,0,0,34
125264,1187005,1,6,3,4,0,38
125265,1187005,1,6,4,0,0,38
125266,1187005,1,6,5,1,0,39
125267,1187005,1,6,6,0,0,39
125268,1187005,1,7,1,1,0,40
125269,1187005,1,7,2,1,0,41
125270,1187005,1,7,3,1,0,42
125271,1187005,1,7,4,1,0,43
125272,1187005,1,7,5,1,0,44
125273,1187005,1,7,6,1,0,45
125274,1187005,1,8,1,1,0,46
125275,1187005,1,8,2,1,0,47
125276,1187005,1,8,3,1,0,48
125277,1187005,1,8,4,1,0,49
125278,1187005,1,8,5,6,0,55
125279,1187005,1,8,6,0,0,55
125280,1187005,1,9,1,1,0,56
125281,1187005,1,9,2,1,0,57
125282,1187005,1,9,3,1,0,58
125283,1187005,1,9,4,1,0,59
125284,1187005,1,9,5,4,0,63
125285,1187005,1,9,6,1,0,64
125286,1187005,1,10,1,1,0,65
125287,1187005,1,10,2,3,0,68
125288,1187005,1,10,3,1,0,69
125289,1187005,1,10,4,4,0,73
125290,1187005,1,10,5,4,0,77
125291,1187005,1,10,6,1,0,78
125292,1187005,1,11,1,1,0,79
125293,1187005,1,11,2,1,0,80
125294,1187005,1,11,3,1,0,81
125295,1187005,1,11,4,4,0,85
125296,1187005,1,11,5,1,0,86
125297,1187005,1,11,6,1,0,87
125298,1187005,1,12,1,1,0,88
125299,1187005,1,12,2,0,1,88
125300,1187005,1,12,3,0,0,88
125301,1187005,1,12,4,0,0,88
125302,1187005,1,12,5,1,0,89
125303,1187005,1,12,6,1,0,90
125304,1187005,1,13,1,0,1,90
125305,1187005,1,13,2,1,0,91
125306,1187005,1,13,3,4,0,95
125307,1187005,1,13,4,1,0,96
125308,1187005,1,13,5,1,0,97
125309,1187005,1,13,6,1,0,98
125310,1187005,1,14,1,0,0,98
125311,1187005,1,14,2,1,0,99
125312,1187005,1,14,3,1,0,100
125313,1187005,1,14,4,2,0,102
125314,1187005,1,14,5,2,0,104
125315,1187005,1,14,6,1,0,105
125316,1187005,1,15,1,0,0,105
125317,1187005,1,15,2,1,0,106
125318,1187005,1,15,3,1,0,107
125319,1187005,1,15,4,1,0,108
125320,1187005,1,15,5,1,0,109
125321,1187005,1,15,6,1,0,110
125322,1187005,1,16,1,1,0,111
125323,1187005,1,16,2,1,0,112
125324,1187005,1,16,3,1,0,113
125325,1187005,1,16,4,2,0,115
125326,1187005,1,16,5,6,0,121
125327,1187005,1,16,6,1,0,122
125328,1187005,1,17,1,1,0,123
125329,1187005,1,17,2,0,0,123
125330,1187005,1,17,3,0,0,123
125331,1187005,1,17,4,0,0,123
125332,1187005,1,17,5,2,0,125
125333,1187005,1,17,6,1,0,126
125334,1187005,1,18,1,0,1,126
125335,1187005,1,18,2,0,0,126
125336,1187005,1,18,3,1,0,127
125337,1187005,1,18,4,1,0,128
125338,1187005,1,18,5,0,0,128
125339,1187005,1,18,6,1,0,129
125340,1187005,1,19,1,0,1,129
125341,1187005,1,19,2,1,0,130
125342,1187005,1,19,3,1,0,131
125343,1187005,1,19,4,0,0,131
125344,1187005,1,19,5,1,0,132
125345,1187005,1,19,6,1,0,133
125346,1187005,1,20,1,0,0,133
125347,1187005,1,20,2,1,0,134
125348,1187005,1,20,3,6,0,140
125349,1187005,1,20,4,1,0,141
125350,1187005,1,20,5,2,0,143
125351,1187005,1,20,6,6,0,149
125466,1187006,1,1,1,4,0,4
125467,1187006,1,1,2,0,0,4
125468,1187006,1,1,3,0,0,4
125469,1187006,1,1,4,1,0,5
125470,1187006,1,1,5,0,0,5
125471,1187006,1,1,6,0,0,5
125472,1187006,1,2,1,7,0,12
125473,1187006,1,2,2,1,0,13
125474,1187006,1,2,3,4,0,17
125475,1187006,1,2,4,4,0,21
125476,1187006,1,2,5,0,0,21
125477,1187006,1,2,6,1,0,22
125478,1187006,1,3,1,0,0,22
125479,1187006,1,3,2,0,1,22
125480,1187006,1,3,3,0,0,22
125481,1187006,1,3,4,1,0,23
125482,1187006,1,3,5,1,0,24
125483,1187006,1,3,6,0,0,24
125484,1187006,1,4,1,1,0,25
125485,1187006,1,4,2,1,0,26
125486,1187006,1,4,3,4,0,30
125487,1187006,1,4,4,4,0,34
125488,1187006,1,4,5,1,0,35
125489,1187006,1,4,6,0,0,35
125490,1187006,1,5,1,3,0,38
125491,1187006,1,5,2,0,0,38
125492,1187006,1,5,3,1,0,39
125493,1187006,1,5,4,1,0,40
125494,1187006,1,5,5,0,0,40
125495,1187006,1,5,6,1,0,41
125496,1187006,1,6,1,6,0,47
125497,1187006,1,6,2,6,0,53
125498,1187006,1,6,3,0,0,53
125499,1187006,1,6,4,1,0,54
125500,1187006,1,6,5,0,0,54
125501,1187006,1,6,6,0,0,54
125502,1187006,1,7,1,1,0,55
125503,1187006,1,7,2,1,0,56
125504,1187006,1,7,3,4,0,60
125505,1187006,1,7,4,0,0,60
125506,1187006,1,7,5,1,0,61
125507,1187006,1,7,6,1,0,62
125508,1187006,1,8,1,1,0,63
125509,1187006,1,8,2,0,1,63
125510,1187006,1,8,3,1,0,64
125511,1187006,1,8,4,0,0,64
125512,1187006,1,8,5,1,0,65
125513,1187006,1,8,6,1,0,66
125514,1187006,1,9,1,1,0,67
125515,1187006,1,9,2,1,0,68
125516,1187006,1,9,3,0,1,68
125517,1187006,1,9,4,0,0,68
125518,1187006,1,9,5,4,0,72
125519,1187006,1,9,6,1,0,73
125520,1187006,1,10,1,0,0,73
125521,1187006,1,10,2,1,0,74
125522,1187006,1,10,3,1,0,75
125523,1187006,1,10,4,0,0,75
125524,1187006,1,10,5,1,0,76
125525,1187006,1,10,6,0,0,76
125526,1187006,1,11,1,0,0,76
125527,1187006,1,11,2,1,0,77
125528,1187006,1,11,3,1,0,78
125529,1187006,1,11,4,1,0,79
125530,1187006,1,11,5,0,0,79
125531,1187006,1,11,6,0,0,79
125532,1187006,1,12,1,1,0,80
125533,1187006,1,12,2,1,0,81
125534,1187006,1,12,3,0,0,81
125535,1187006,1,12,4,0,0,81
125536,1187006,1,12,5,0,0,81
125537,1187006,1,12,6,6,0,87
125538,1187006,1,13,1,1,0,88
125539,1187006,1,13,2,1,0,89
125540,1187006,1,13,3,1,0,90
125541,1187006,1,13,4,0,1,90
125542,1187006,1,13,5,1,0,91
125543,1187006,1,13,6,2,1,93
125544,1187006,1,14,1,2,0,95
125545,1187006,1,14,2,0,0,95
125546,1187006,1,14,3,1,0,96
125547,1187006,1,14,4,1,0,97
125548,1187006,1,14,5,0,0,97
125549,1187006,1,14,6,0,0,97
125550,1187006,1,15,1,0,0,97
125551,1187006,1,15,2,1,0,98
125552,1187006,1,15,3,0,1,98
125553,1187006,1,15,4,0,0,98
125554,1187006,1,15,5,0,0,98
125555,1187006,1,15,6,1,0,99
125556,1187006,1,16,1,4,0,103
125557,1187006,1,16,2,0,0,103
125558,1187006,1,16,3,0,0,103
125559,1187006,1,16,4,1,0,104
125560,1187006,1,16,5,0,0,104
125561,1187006,1,16,6,0,0,104
125562,1187006,1,17,1,1,0,105
125563,1187006,1,17,2,1,0,106
125564,1187006,1,17,3,1,0,107
125565,1187006,1,17,4,0,0,107
125566,1187006,1,17,5,1,0,108
125567,1187006,1,17,6,1,0,109
125568,1187006,1,18,1,0,0,109
125569,1187006,1,18,2,6,0,115
125570,1187006,1,18,3,1,0,116
125571,1187006,1,18,4,0,0,116
125572,1187006,1,18,5,1,0,117
125573,1187006,1,18,6,1,0,118
125574,1187006,1,19,1,1,0,119
125575,1187006,1,19,2,2,0,121
125576,1187006,1,19,3,0,0,121
125577,1187006,1,19,4,1,0,122
125578,1187006,1,19,5,1,0,123
125579,1187006,1,19,6,4,0,127
125580,1187006,1,20,1,0,1,127
125581,1187006,1,20,2,0,0,127
125582,1187006,1,20,3,1,0,128
125583,1187006,1,20,4,4,0,132
125584,1187006,1,20,5,1,2,133
125585,1187006,1,20,6,1,0,134
125687,1187013,1,1,1,4,0,4
125688,1187013,1,1,2,1,0,5
125689,1187013,1,1,3,1,0,6
125690,1187013,1,1,4,0,0,6
125691,1187013,1,1,5,4,0,10
125692,1187013,1,1,6,0,1,10
125693,1187013,1,2,1,0,0,10
125694,1187013,1,2,2,0,0,10
125695,1187013,1,2,3,0,0,10
125696,1187013,1,2,4,1,0,11
125697,1187013,1,2,5,1,0,12
125698,1187013,1,2,6,0,0,12
125699,1187013,1,3,1,1,0,13
125700,1187013,1,3,2,1,0,14
125701,1187013,1,3,3,4,0,18
125702,1187013,1,3,4,0,0,18
125703,1187013,1,3,5,0,0,18
125704,1187013,1,3,6,0,0,18
125705,1187013,1,4,1,1,0,19
125706,1187013,1,4,2,1,0,20
125707,1187013,1,4,3,1,0,21
125708,1187013,1,4,4,0,0,21
125709,1187013,1,4,5,0,0,21
125710,1187013,1,4,6,1,0,22
125711,1187013,1,5,1,1,0,23
125712,1187013,1,5,2,0,0,23
125713,1187013,1,5,3,0,0,23
125714,1187013,1,5,4,1,0,24
125715,1187013,1,5,5,1,0,25
125716,1187013,1,5,6,4,0,29
125717,1187013,1,6,1,0,0,29
125718,1187013,1,6,2,0,0,29
125719,1187013,1,6,3,4,0,33
125720,1187013,1,6,4,1,0,34
125721,1187013,1,6,5,0,0,34
125722,1187013,1,6,6,1,0,35
125723,1187013,1,7,1,0,0,35
125724,1187013,1,7,2,1,0,36
125725,1187013,1,7,3,0,1,36
125726,1187013,1,7,4,1,0,37
125727,1187013,1,7,5,1,0,38
125728,1187013,1,7,6,6,0,44
125729,1187013,1,8,1,1,0,45
125730,1187013,1,8,2,0,0,45
125731,1187013,1,8,3,1,0,46
125732,1187013,1,8,4,4,0,50
125733,1187013,1,8,5,1,0,51
125734,1187013,1,8,6,0,0,51
125735,1187013,1,9,1,1,0,52
125736,1187013,1,9,2,1,0,53
125737,1187013,1,9,3,0,0,53
125738,1187013,1,9,4,1,0,54
125739,1187013,1,9,5,0,0,54
125740,1187013,1,9,6,6,0,60
125741,1187013,1,10,1,1,0,61
125742,1187013,1,10,2,0,0,61
125743,1187013,1,10,3,1,0,62
125744,1187013,1,10,4,1,0,63
125745,1187013,1,10,5,4,0,67
125746,1187013,1,10,6,2,0,69
125747,1187013,1,11,1,1,0,70
125748,1187013,1,11,2,0,1,70
125749,1187013,1,11,3,1,0,71
125750,1187013,1,11,4,1,0,72
125751,1187013,1,11,5,1,0,73
125752,1187013,1,11,6,0,0,73
125753,1187013,1,12,1,0,0,73
125754,1187013,1,12,2,0,0,73
125755,1187013,1,12,3,1,0,74
125756,1187013,1,12,4,1,0,75
125757,1187013,1,12,5,0,0,75
125758,1187013,1,12,6,0,0,75
125759,1187013,1,13,1,0,0,75
125760,1187013,1,13,2,1,0,76
125761,1187013,1,13,3,4,0,80
125762,1187013,1,13,4,1,0,81
125763,1187013,1,13,5,1,0,82
125764,1187013,1,13,6,1,0,83
125765,1187013,1,14,1,1,0,84
125766,1187013,1,14,2,0,0,84
125767,1187013,1,14,3,0,0,84
125768,1187013,1,14,4,0,0,84
125769,1187013,1,14,5,1,0,85
125770,1187013,1,14,6,0,0,85
125771,1187013,1,15,1,1,0,86
125772,1187013,1,15,2,6,0,92
125773,1187013,1,15,3,0,0,92
125774,1187013,1,15,4,2,0,94
125775,1187013,1,15,5,1,1,95
125776,1187013,1,15,6,0,0,95
125777,1187013,1,16,1,1,0,96
125778,1187013,1,16,2,0,0,96
125779,1187013,1,16,3,1,0,97
125780,1187013,1,16,4,4,0,101
125781,1187013,1,16,5,1,0,102
125782,1187013,1,16,6,0,1,102
125783,1187013,1,17,1,2,0,104
125784,1187013,1,17,2,4,0,108
125785,1187013,1,17,3,0,0,108
125786,1187013,1,17,4,0,0,108
125787,1187013,1,17,5,1,0,109
125788,1187013,1,17,6,1,0,110
125789,1187013,1,18,1,1,0,111
125790,1187013,1,18,2,4,0,115
125791,1187013,1,18,3,0,0,115
125792,1187013,1,18,4,1,0,116
125793,1187013,1,18,5,1,0,117
125794,1187013,1,18,6,1,0,118
125795,1187013,1,19,1,2,0,120
125796,1187013,1,19,2,0,1,120
125797,1187013,1,19,3,1,0,121
125798,1187013,1,19,4,4,0,125
125799,1187013,1,19,5,1,0,126
125800,1187013,1,19,6,6,0,132
125801,1187013,1,20,1,1,0,133
125802,1187013,1,20,2,1,0,134
125803,1187013,1,20,3,1,0,135
125804,1187013,1,20,4,6,0,141
125805,1187013,1,20,5,1,0,142
125806,1187013,1,20,6,6,0,148
125924,1187014,1,1,1,0,0,0
125925,1187014,1,1,2,1,0,1
125926,1187014,1,1,3,0,0,1
125927,1187014,1,1,4,1,0,2
125928,1187014,1,1,5,0,0,2
125929,1187014,1,1,6,4,0,6
125930,1187014,1,2,1,4,0,10
125931,1187014,1,2,2,4,0,14
125932,1187014,1,2,3,4,0,18
125933,1187014,1,2,4,0,0,18
125934,1187014,1,2,5,1,0,19
125935,1187014,1,2,6,1,0,20
125936,1187014,1,3,1,3,0,23
125937,1187014,1,3,2,0,0,23
125938,1187014,1,3,3,0,0,23
125939,1187014,1,3,4,0,0,23
125940,1187014,1,3,5,0,0,23
125941,1187014,1,3,6,1,0,24
125942,1187014,1,4,1,1,0,25
125943,1187014,1,4,2,0,0,25
125944,1187014,1,4,3,0,0,25
125945,1187014,1,4,4,4,0,29
125946,1187014,1,4,5,1,0,30
125947,1187014,1,4,6,1,0,31
125948,1187014,1,5,1,4,0,35
125949,1187014,1,5,2,0,0,35
125950,1187014,1,5,3,4,0,39
125951,1187014,1,5,4,0,0,39
125952,1187014,1,5,5,1,0,40
125953,1187014,1,5,6,1,0,41
125954,1187014,1,6,1,2,0,43
125955,1187014,1,6,2,0,0,43
125956,1187014,1,6,3,5,0,48
125957,1187014,1,6,4,4,0,52
125958,1187014,1,6,5,1,0,53
125959,1187014,1,6,6,1,0,54
125960,1187014,1,7,1,1,0,55
125961,1187014,1,7,2,0,0,55
125962,1187014,1,7,3,2,0,57
125963,1187014,1,7,4,1,0,58
125964,1187014,1,7,5,0,0,58
125965,1187014,1,7,6,1,0,59
125966,1187014,1,8,1,1,0,60
125967,1187014,1,8,2,0,1,60
125968,1187014,1,8,3,1,0,61
125969,1187014,1,8,4,0,0,61
125970,1187014,1,8,5,1,0,62
125971,1187014,1,8,6,2,0,64
125972,1187014,1,9,1,1,0,65
125973,1187014,1,9,2,0,0,65
125974,1187014,1,9,3,0,0,65
125975,1187014,1,9,4,1,0,66
125976,1187014,1,9,5,1,0,67
125977,1187014,1,9,6,2,0,69
125978,1187014,1,10,1,2,0,71
125979,1187014,1,10,2,4,0,75
125980,1187014,1,10,3,1,0,76
125981,1187014,1,10,4,1,0,77
125982,1187014,1,10,5,0,0,77
125983,1187014,1,10,6,1,0,78
125984,1187014,1,11,1,4,0,82
125985,1187014,1,11,2,1,0,83
125986,1187014,1,11,3,0,1,83
125987,1187014,1,11,4,1,0,84
125988,1187014,1,11,5,1,0,85
125989,1187014,1,11,6,1,0,86
125990,1187014,1,12,1,1,0,87
125991,1187014,1,12,2,6,0,93
125992,1187014,1,12,3,2,0,95
125993,1187014,1,12,4,0,0,95
125994,1187014,1,12,5,2,0,97
125995,1187014,1,12,6,0,0,97
125996,1187014,1,13,1,0,1,97
125997,1187014,1,13,2,2,0,99
125998,1187014,1,13,3,2,0,101
125999,1187014,1,13,4,1,0,102
126000,1187014,1,13,5,1,0,103
126001,1187014,1,13,6,0,1,103
126002,1187014,1,14,1,1,0,104
126003,1187014,1,14,2,0,0,104
126004,1187014,1,14,3,1,0,105
126005,1187014,1,14,4,0,0,105
126006,1187014,1,14,5,0,0,105
126007,1187014,1,14,6,1,0,106
126008,1187014,1,15,1,1,0,107
126009,1187014,1,15,2,1,0,108
126010,1187014,1,15,3,1,0,109
126011,1187014,1,15,4,2,0,111
126012,1187014,1,15,5,1,0,112
126013,1187014,1,15,6,0,0,112
126014,1187014,1,16,1,2,0,114
126015,1187014,1,16,2,1,0,115
126016,1187014,1,16,3,2,0,117
126017,1187014,1,16,4,1,0,118
126018,1187014,1,16,5,4,0,122
126019,1187014,1,16,6,1,0,123
126020,1187014,1,17,1,4,0,127
126021,1187014,1,17,2,1,0,128
126022,1187014,1,17,3,0,1,128
126023,1187014,1,17,4,4,0,132
126024,1187014,1,17,5,4,0,136
126025,1187014,1,17,6,0,0,136
126026,1187014,1,18,1,1,0,137
126027,1187014,1,18,2,1,0,138
126028,1187014,1,18,3,0,0,138
126029,1187014,1,18,4,0,0,138
126030,1187014,1,18,5,1,0,139
126031,1187014,1,18,6,1,0,140
126032,1187014,1,19,1,1,0,141
126033,1187014,1,19,2,1,0,142
126034,1187014,1,19,3,0,1,142
126035,1187014,1,19,4,1,0,143
126036,1187014,1,19,5,1,0,144
126037,1187014,1,19,6,0,0,144
126038,1187014,1,20,1,0,0,144
126039,1187014,1,20,2,1,0,145
126040,1187014,1,20,3,1,0,146
126041,1187014,1,20,4,4,0,150
126042,1187014,1,20,5,1,0,151
126043,1187014,1,20,6,2,0,153
126138,1187015,1,1,1,0,0,0
126139,1187015,1,1,2,1,0,1
126140,1187015,1,1,3,0,0,1
126141,1187015,1,1,4,1,0,2
126142,1187015,1,1,5,1,0,3
126143,1187015,1,1,6,0,0,3
126144,1187015,1,2,1,0,0,3
126145,1187015,1,2,2,0,0,3
126146,1187015,1,2,3,0,1,3
126147,1187015,1,2,4,0,0,3
126148,1187015,1,2,5,0,0,3
126149,1187015,1,2,6,0,0,3
126150,1187015,1,3,1,0,0,3
126151,1187015,1,3,2,4,0,7
126152,1187015,1,3,3,4,0,11
126153,1187015,1,3,4,1,0,12
126154,1187015,1,3,5,1,0,13
126155,1187015,1,3,6,0,0,13
126156,1187015,1,4,1,4,0,17
126157,1187015,1,4,2,4,0,21
126158,1187015,1,4,3,2,0,23
126159,1187015,1,4,4,1,0,24
126160,1187015,1,4,5,1,0,25
126161,1187015,1,4,6,0,0,25
126162,1187015,1,5,1,5,0,30
126163,1187015,1,5,2,0,0,30
126164,1187015,1,5,3,0,0,30
126165,1187015,1,5,4,0,0,30
126166,1187015,1,5,5,0,0,30
126167,1187015,1,5,6,4,0,34
126168,1187015,1,6,1,1,0,35
126169,1187015,1,6,2,0,1,35
126170,1187015,1,6,3,1,0,36
126171,1187015,1,6,4,0,0,36
126172,1187015,1,6,5,1,0,37
126173,1187015,1,6,6,4,0,41
126174,1187015,1,7,1,0,0,41
126175,1187015,1,7,2,1,0,42
126176,1187015,1,7,3,4,0,46
126177,1187015,1,7,4,1,0,47
126178,1187015,1,7,5,1,0,48
126179,1187015,1,7,6,1,0,49
126180,1187015,1,8,1,1,0,50
126181,1187015,1,8,2,1,0,51
126182,1187015,1,8,3,1,0,52
126183,1187015,1,8,4,1,0,53
126184,1187015,1,8,5,0,0,53
126185,1187015,1,8,6,1,0,54
126186,1187015,1,9,1,0,0,54
126187,1187015,1,9,2,2,0,56
126188,1187015,1,9,3,1,0,57
126189,1187015,1,9,4,0,0,57
126190,1187015,1,9,5,1,0,58
126191,1187015,1,9,6,1,0,59
126192,1187015,1,10,1,4,0,63
126193,1187015,1,10,2,1,0,64
126194,1187015,1,10,3,1,0,65
126195,1187015,1,10,4,4,0,69
126196,1187015,1,10,5,1,0,70
126197,1187015,1,10,6,1,0,71
126198,1187015,1,11,1,1,0,72
126199,1187015,1,11,2,4,0,76
126200,1187015,1,11,3,1,0,77
126201,1187015,1,11,4,6,0,83
126202,1187015,1,11,5,4,0,87
126203,1187015,1,11,6,0,0,87
126204,1187015,1,12,1,1,0,88
126205,1187015,1,12,2,1,0,89
126206,1187015,1,12,3,0,0,89
126207,1187015,1,12,4,2,0,91
126208,1187015,1,12,5,2,0,93
126209,1187015,1,12,6,1,0,94
126210,1187015,1,13,1,0,1,94
126211,1187015,1,13,2,1,0,95
126212,1187015,1,13,3,0,0,95
126213,1187015,1,13,4,1,0,96
126214,1187015,1,13,5,0,0,96
126215,1187015,1,13,6,1,0,97
126216,1187015,1,14,1,1,0,98
126217,1187015,1,14,2,6,0,104
126218,1187015,1,14,3,2,0,106
126219,1187015,1,14,4,1,0,107
126220,1187015,1,14,5,1,0,108
126221,1187015,1,14,6,1,0,109
126222,1187015,1,15,1,6,0,115
126223,1187015,1,15,2,6,0,121
126224,1187015,1,15,3,6,0,127
126225,1187015,1,15,4,0,0,127
126226,1187015,1,15,5,1,0,128
126227,1187015,1,15,6,1,0,129
126228,1187015,1,16,1,0,0,129
126229,1187015,1,16,2,2,0,131
126230,1187015,1,16,3,2,0,133
126231,1187015,1,16,4,4,0,137
126232,1187015,1,16,5,2,0,139
126233,1187015,1,16,6,0,0,139
126234,1187015,1,17,1,0,1,139
126235,1187015,1,17,2,0,0,139
126236,1187015,1,17,3,1,0,140
126237,1187015,1,17,4,4,0,144
126238,1187015,1,17,5,0,1,144
126239,1187015,1,17,6,0,0,144
126240,1187015,1,18,1,1,0,145
126241,1187015,1,18,2,1,0,146
126242,1187015,1,18,3,1,0,147
126243,1187015,1,18,4,4,0,151
126244,1187015,1,18,5,4,0,155
126245,1187015,1,18,6,2,0,157
126246,1187015,1,19,1,0,0,157
126247,1187015,1,19,2,1,0,158
126248,1187015,1,19,3,1,0,159
126249,1187015,1,19,4,1,0,160
126250,1187015,1,19,5,1,0,161
126251,1187015,1,19,6,2,0,163
126252,1187015,1,20,1,2,0,165
126253,1187015,1,20,2,4,0,169
126254,1187015,1,20,3,1,0,170
126255,1187015,1,20,4,1,0,171
126256,1187015,1,20,5,1,0,172
126257,1187015,1,20,6,2,0,174
126374,1187018,1,1,1,1,0,1
126375,1187018,1,1,2,4,0,5
126376,1187018,1,1,3,6,0,11
126377,1187018,1,1,4,0,0,11
126378,1187018,1,1,5,1,0,12
126379,1187018,1,1,6,1,0,13
126380,1187018,1,2,1,0,0,13
126381,1187018,1,2,2,0,1,13
126382,1187018,1,2,3,2,0,15
126383,1187018,1,2,4,1,0,16
126384,1187018,1,2,5,4,0,20
126385,1187018,1,2,6,1,0,21
126386,1187018,1,3,1,1,0,22
126387,1187018,1,3,2,1,0,23
126388,1187018,1,3,3,1,0,24
126389,1187018,1,3,4,1,0,25
126390,1187018,1,3,5,2,0,27
126391,1187018,1,3,6,0,0,27
126392,1187018,1,4,1,6,0,33
126393,1187018,1,4,2,4,0,37
126394,1187018,1,4,3,2,0,39
126395,1187018,1,4,4,0,0,39
126396,1187018,1,4,5,6,0,45
126397,1187018,1,4,6,1,0,46
126398,1187018,1,5,1,0,0,46
126399,1187018,1,5,2,1,0,47
126400,1187018,1,5,3,0,0,47
126401,1187018,1,5,4,0,0,47
126402,1187018,1,5,5,6,0,53
126403,1187018,1,5,6,4,0,57
126404,1187018,1,6,1,1,0,58
126405,1187018,1,6,2,6,0,64
126406,1187018,1,6,3,0,0,64
126407,1187018,1,6,4,0,1,64
126408,1187018,1,6,5,2,0,66
126409,1187018,1,6,6,0,0,66
126410,1187018,1,7,1,1,0,67
126411,1187018,1,7,2,0,0,67
126412,1187018,1,7,3,1,0,68
126413,1187018,1,7,4,1,0,69
126414,1187018,1,7,5,0,0,69
126415,1187018,1,7,6,1,0,70
126416,1187018,1,8,1,1,0,71
126417,1187018,1,8,2,4,0,75
126418,1187018,1,8,3,5,0,80
126419,1187018,1,8,4,1,0,81
126420,1187018,1,8,5,1,0,82
126421,1187018,1,8,6,0,0,82
126422,1187018,1,9,1,6,0,88
126423,1187018,1,9,2,0,0,88
126424,1187018,1,9,3,1,0,89
126425,1187018,1,9,4,1,0,90
126426,1187018,1,9,5,1,0,91
126427,1187018,1,9,6,0,0,91
126428,1187018,1,10,1,0,0,91
126429,1187018,1,10,2,6,0,97
126430,1187018,1,10,3,2,0,99
126431,1187018,1,10,4,0,0,99
126432,1187018,1,10,5,1,0,100
126433,1187018,1,10,6,1,0,101
126434,1187018,1,11,1,0,1,101
126435,1187018,1,11,2,1,0,102
126436,1187018,1,11,3,4,0,106
126437,1187018,1,11,4,0,0,106
126438,1187018,1,11,5,0,0,106
126439,1187018,1,11,6,1,0,107
126440,1187018,1,12,1,1,0,108
126441,1187018,1,12,2,4,0,112
126442,1187018,1,12,3,6,0,118
126443,1187018,1,12,4,1,0,119
126444,1187018,1,12,5,0,0,119
126445,1187018,1,12,6,1,0,120
126446,1187018,1,13,1,1,0,121
126447,1187018,1,13,2,0,0,121
126448,1187018,1,13,3,1,0,122
126449,1187018,1,13,4,0,0,122
126450,1187018,1,13,5,6,0,128
126451,1187018,1,13,6,4,0,132
126452,1187018,1,14,1,0,0,132
126453,1187018,1,14,2,0,0,132
126454,1187018,1,14,3,0,0,132
126455,1187018,1,14,4,7,0,139
126456,1187018,1,14,5,1,0,140
126457,1187018,1,14,6,1,0,141
126458,1187018,1,15,1,0,0,141
126459,1187018,1,15,2,1,0,142
126460,1187018,1,15,3,1,0,143
126461,1187018,1,15,4,0,0,143
126462,1187018,1,15,5,1,0,144
126463,1187018,1,15,6,0,0,144
126464,1187018,1,16,1,1,0,145
126465,1187018,1,16,2,1,0,146
126466,1187018,1,16,3,6,0,152
126467,1187018,1,16,4,0,0,152
126468,1187018,1,16,5,2,0,154
126469,1187018,1,16,6,1,0,155
126470,1187018,1,17,1,1,0,156
126471,1187018,1,17,2,2,0,158
126472,1187018,1,17,3,6,0,164
126473,1187018,1,17,4,6,0,170
126474,1187018,1,17,5,1,0,171
126475,1187018,1,17,6,1,0,172
126476,1187018,1,18,1,0,1,172
126477,1187018,1,18,2,1,0,173
126478,1187018,1,18,3,0,1,173
126479,1187018,1,18,4,0,0,173
126480,1187018,1,18,5,4,0,177
126481,1187018,1,18,6,1,0,178
126482,1187018,1,19,1,1,0,179
126483,1187018,1,19,2,1,0,180
126484,1187018,1,19,3,1,0,181
126485,1187018,1,19,4,2,0,183
126486,1187018,1,19,5,6,0,189
126487,1187018,1,19,6,1,0,190
126488,1187018,1,20,1,4,0,194
126489,1187018,1,20,2,2,0,196
126490,1187018,1,20,3,6,0,202
126491,1187018,1,20,4,1,0,203
126492,1187018,1,20,5,2,0,205
126493,1187018,1,20,6,2,0,207
126606,1187019,1,1,1,1,0,1
126607,1187019,1,1,2,6,0,7
126608,1187019,1,1,3,0,0,7
126609,1187019,1,1,4,4,0,11
126610,1187019,1,1,5,0,0,11
126611,1187019,1,1,6,1,0,12
126612,1187019,1,2,1,1,0,13
126613,1187019,1,2,2,1,0,14
126614,1187019,1,2,3,4,0,18
126615,1187019,1,2,4,0,0,18
126616,1187019,1,2,5,0,0,18
126617,1187019,1,2,6,1,0,19
126618,1187019,1,3,1,1,0,20
126619,1187019,1,3,2,0,0,20
126620,1187019,1,3,3,1,0,21
126621,1187019,1,3,4,2,0,23
126622,1187019,1,3,5,0,0,23
126623,1187019,1,3,6,1,0,24
126624,1187019,1,4,1,0,1,24
126625,1187019,1,4,2,1,0,25
126626,1187019,1,4,3,2,0,27
126627,1187019,1,4,4,0,0,27
126628,1187019,1,4,5,1,0,28
126629,1187019,1,4,6,0,0,28
126630,1187019,1,5,1,0,0,28
126631,1187019,1,5,2,0,0,28
126632,1187019,1,5,3,4,0,32
126633,1187019,1,5,4,1,0,33
126634,1187019,1,5,5,0,0,33
126635,1187019,1,5,6,4,0,37
126636,1187019,1,6,1,1,0,38
126637,1187019,1,6,2,0,0,38
126638,1187019,1,6,3,1,0,39
126639,1187019,1,6,4,1,0,40
126640,1187019,1,6,5,0,0,40
126641,1187019,1,6,6,2,0,42
126642,1187019,1,7,1,1,0,43
126643,1187019,1,7,2,1,0,44
126644,1187019,1,7,3,0,0,44
126645,1187019,1,7,4,0,0,44
126646,1187019,1,7,5,0,0,44
126647,1187019,1,7,6,1,0,45
126648,1187019,1,8,1,6,0,51
126649,1187019,1,8,2,4,0,55
126650,1187019,1,8,3,1,0,56
126651,1187019,1,8,4,0,1,56
126652,1187019,1,8,5,1,0,57
126653,1187019,1,8,6,1,0,58
126654,1187019,1,9,1,2,0,60
126655,1187019,1,9,2,3,0,63
126656,1187019,1,9,3,6,0,69
126657,1187019,1,9,4,8,0,77
126658,1187019,1,9,5,6,0,83
126659,1187019,1,9,6,1,0,84
126660,1187019,1,10,1,2,0,86
126661,1187019,1,10,2,2,0,88
126662,1187019,1,10,3,3,0,91
126663,1187019,1,10,4,0,0,91
126664,1187019,1,10,5,1,0,92
126665,1187019,1,10,6,1,0,93
126666,1187019,1,11,1,4,0,97
126667,1187019,1,11,2,0,0,97
126668,1187019,1,11,3,0,1,97
126669,1187019,1,11,4,1,0,98
126670,1187019,1,11,5,0,0,98
126671,1187019,1,11,6,6,0,104
126672,1187019,1,12,1,0,0,104
126673,1187019,1,12,2,0,0,104
126674,1187019,1,12,3,1,0,105
126675,1187019,1,12,4,1,0,106
126676,1187019,1,12,5,2,0,108
126677,1187019,1,12,6,4,0,112
126678,1187019,1,13,1,1,0,113
126679,1187019,1,13,2,0,0,113
126680,1187019,1,13,3,0,0,113
126681,1187019,1,13,4,4,0,117
126682,1187019,1,13,5,2,0,119
126683,1187019,1,13,6,0,0,119
126684,1187019,1,14,1,1,0,120
126685,1187019,1,14,2,0,1,120
126686,1187019,1,14,3,6,0,126
126687,1187019,1,14,4,1,0,127
126688,1187019,1,14,5,0,0,127
126689,1187019,1,14,6,1,0,128
126690,1187019,1,15,1,0,0,128
126691,1187019,1,15,2,1,0,129
126692,1187019,1,15,3,0,0,129
126693,1187019,1,15,4,1,0,130
126694,1187019,1,15,5,1,0,131
126695,1187019,1,15,6,1,0,132
126696,1187019,1,16,1,1,0,133
126697,1187019,1,16,2,1,0,134
126698,1187019,1,16,3,1,0,135
126699,1187019,1,16,4,4,0,139
126700,1187019,1,16,5,1,0,140
126701,1187019,1,16,6,4,0,144
126702,1187019,1,17,1,0,0,144
126703,1187019,1,17,2,0,1,144
126704,1187019,1,17,3,1,0,145
126705,1187019,1,17,4,0,0,145
126706,1187019,1,17,5,1,0,146
126707,1187019,1,17,6,4,0,150
126708,1187019,1,18,1,2,0,152
126709,1187019,1,18,2,1,0,153
126710,1187019,1,18,3,1,0,154
126711,1187019,1,18,4,1,0,155
126712,1187019,1,18,5,1,0,156
126713,1187019,1,18,6,0,0,156
126714,1187019,1,19,1,2,0,158
126715,1187019,1,19,2,2,0,160
126716,1187019,1,19,3,2,0,162
126717,1187019,1,19,4,2,0,164
126718,1187019,1,19,5,0,0,164
126719,1187019,1,19,6,0,1,164
126720,1187019,1,20,1,0,0,164
126721,1187019,1,20,2,2,0,166
126722,1187019,1,20,3,1,0,167
126723,1187019,1,20,4,0,1,167
126724,1187019,1,20,5,1,0,168
126725,1187019,1,20,6,2,0,170
126837,1187020,1,1,1,0,0,0
126838,1187020,1,1,2,4,0,4
126839,1187020,1,1,3,0,0,4
126840,1187020,1,1,4,0,0,4
126841,1187020,1,1,5,1,0,5
126842,1187020,1,1,6,0,0,5
126843,1187020,1,2,1,0,0,5
126844,1187020,1,2,2,1,0,6
126845,1187020,1,2,3,4,0,10
126846,1187020,1,2,4,4,0,14
126847,1187020,1,2,5,0,0,14
126848,1187020,1,2,6,0,0,14
126849,1187020,1,3,1,6,0,20
126850,1187020,1,3,2,4,0,24
126851,1187020,1,3,3,1,0,25
126852,1187020,1,3,4,1,0,26
126853,1187020,1,3,5,0,0,26
126854,1187020,1,3,6,4,0,30
126855,1187020,1,4,1,2,0,32
126856,1187020,1,4,2,0,0,32
126857,1187020,1,4,3,2,0,34
126858,1187020,1,4,4,0,0,34
126859,1187020,1,4,5,4,0,38
126860,1187020,1,4,6,6,0,44
126861,1187020,1,5,1,6,0,50
126862,1187020,1,5,2,2,0,52
126863,1187020,1,5,3,4,0,56
126864,1187020,1,5,4,1,0,57
126865,1187020,1,5,5,1,0,58
126866,1187020,1,5,6,0,0,58
126867,1187020,1,6,1,4,0,62
126868,1187020,1,6,2,6,0,68
126869,1187020,1,6,3,4,0,72
126870,1187020,1,6,4,0,0,72
126871,1187020,1,6,5,0,0,72
126872,1187020,1,6,6,0,0,72
126873,1187020,1,7,1,2,0,74
126874,1187020,1,7,2,1,0,75
126875,1187020,1,7,3,0,0,75
126876,1187020,1,7,4,4,0,79
126877,1187020,1,7,5,1,0,80
126878,1187020,1,7,6,1,0,81
126879,1187020,1,8,1,1,0,82
126880,1187020,1,8,2,3,0,85
126881,1187020,1,8,3,1,0,86
126882,1187020,1,8,4,6,0,92
126883,1187020,1,8,5,6,0,98
126884,1187020,1,8,6,4,0,102
126885,1187020,1,9,1,0,0,102
126886,1187020,1,9,2,1,0,103
126887,1187020,1,9,3,1,0,104
126888,1187020,1,9,4,1,0,105
126889,1187020,1,9,5,1,0,106
126890,1187020,1,9,6,1,0,107
126891,1187020,1,10,1,1,0,108
126892,1187020,1,10,2,1,0,109
126893,1187020,1,10,3,0,0,109
126894,1187020,1,10,4,1,0,110
126895,1187020,1,10,5,4,0,114
126896,1187020,1,10,6,2,0,116
126897,1187020,1,11,1,6,0,122
126898,1187020,1,11,2,0,0,122
126899,1187020,1,11,3,1,0,123
126900,1187020,1,11,4,4,0,127
126901,1187020,1,11,5,4,0,131
126902,1187020,1,11,6,1,0,132
126903,1187020,1,12,1,1,0,133
126904,1187020,1,12,2,1,0,134
126905,1187020,1,12,3,1,0,135
126906,1187020,1,12,4,0,1,135
126907,1187020,1,12,5,1,0,136
126908,1187020,1,12,6,0,0,136
126909,1187020,1,13,1,2,0,138
126910,1187020,1,13,2,0,1,138
126911,1187020,1,13,3,1,0,139
126912,1187020,1,13,4,1,0,140
126913,1187020,1,13,5,1,0,141
126914,1187020,1,13,6,1,0,142
126915,1187020,1,14,1,1,0,143
126916,1187020,1,14,2,1,0,144
126917,1187020,1,14,3,0,0,144
126918,1187020,1,14,4,1,0,145
126919,1187020,1,14,5,0,0,145
126920,1187020,1,14,6,6,0,151
126921,1187020,1,15,1,6,0,157
126922,1187020,1,15,2,1,0,158
126923,1187020,1,15,3,4,0,162
126924,1187020,1,15,4,6,0,168
126925,1187020,1,15,5,4,0,172
126926,1187020,1,15,6,1,0,173
126927,1187020,1,16,1,0,0,173
126928,1187020,1,16,2,0,0,173
126929,1187020,1,16,3,1,0,174
126930,1187020,1,16,4,0,0,174
126931,1187020,1,16,5,1,0,175
126932,1187020,1,16,6,1,0,176
126933,1187020,1,17,1,1,0,177
126934,1187020,1,17,2,0,0,177
126935,1187020,1,17,3,1,0,178
126936,1187020,1,17,4,4,0,182
126937,1187020,1,17,5,1,0,183
126938,1187020,1,17,6,4,0,187
126939,1187020,1,18,1,1,0,188
126940,1187020,1,18,2,6,0,194
126941,1187020,1,18,3,1,0,195
126942,1187020,1,18,4,6,0,201
126943,1187020,1,18,5,1,0,202
126944,1187020,1,18,6,2,0,204
126945,1187020,1,19,1,6,0,210
126946,1187020,1,19,2,6,0,216
126947,1187020,1,19,3,7,0,223
126948,1187020,1,19,4,1,0,224
126949,1187020,1,19,5,1,0,225
126950,1187020,1,19,6,6,0,231
126951,1187020,1,20,1,1,0,232
126952,1187020,1,20,2,0,0,232
126953,1187020,1,20,3,1,0,233
126954,1187020,1,20,4,0,1,233
126955,1187020,1,20,5,0,0,233
126956,1187020,1,20,6,7,0,240
127077,1187665,1,1,1,0,0,0
127078,1187665,1,1,2,0,0,0
127079,1187665,1,1,3,1,0,1
127080,1187665,1,1,4,1,0,2
127081,1187665,1,1,5,1,0,3
127082,1187665,1,1,6,1,0,4
127083,1187665,1,2,1,0,0,4
127084,1187665,1,2,2,0,0,4
127085,1187665,1,2,3,0,0,4
127086,1187665,1,2,4,0,0,4
127087,1187665,1,2,5,0,0,4
127088,1187665,1,2,6,0,0,4
127089,1187665,1,3,1,0,0,4
127090,1187665,1,3,2,1,0,5
127091,1187665,1,3,3,0,0,5
127092,1187665,1,3,4,1,0,6
127093,1187665,1,3,5,0,1,6
127094,1187665,1,3,6,1,0,7
127095,1187665,1,4,1,0,0,7
127096,1187665,1,4,2,1,0,8
127097,1187665,1,4,3,5,0,13
127098,1187665,1,4,4,0,0,13
127099,1187665,1,4,5,1,0,14
127100,1187665,1,4,6,1,0,15
127101,1187665,1,5,1,1,0,16
127102,1187665,1,5,2,1,0,17
127103,1187665,1,5,3,6,0,23
127104,1187665,1,5,4,1,0,24
127105,1187665,1,5,5,6,0,30
127106,1187665,1,5,6,6,0,36
127107,1187665,1,6,1,1,0,37
127108,1187665,1,6,2,0,0,37
127109,1187665,1,6,3,1,0,38
127110,1187665,1,6,4,1,0,39
127111,1187665,1,6,5,0,0,39
127112,1187665,1,6,6,0,1,39
127113,1187665,1,7,1,1,0,40
127114,1187665,1,7,2,4,0,44
127115,1187665,1,7,3,1,0,45
127116,1187665,1,7,4,1,0,46
127117,1187665,1,7,5,1,0,47
127118,1187665,1,7,6,1,0,48
127119,1187665,1,8,1,3,0,51
127120,1187665,1,8,2,0,0,51
127121,1187665,1,8,3,0,0,51
127122,1187665,1,8,4,1,0,52
127123,1187665,1,8,5,0,0,52
127124,1187665,1,8,6,1,0,53
127125,1187665,1,9,1,4,0,57
127126,1187665,1,9,2,1,0,58
127127,1187665,1,9,3,1,0,59
127128,1187665,1,9,4,1,0,60
127129,1187665,1,9,5,1,0,61
127130,1187665,1,9,6,0,0,61
127131,1187665,1,10,1,2,0,63
127132,1187665,1,10,2,1,0,64
127133,1187665,1,10,3,1,0,65
127134,1187665,1,10,4,0,0,65
127135,1187665,1,10,5,6,0,71
127136,1187665,1,10,6,1,0,72
127137,1187665,1,11,1,0,1,72
127138,1187665,1,11,2,1,0,73
127139,1187665,1,11,3,0,0,73
127140,1187665,1,11,4,1,0,74
127141,1187665,1,11,5,1,0,75
127142,1187665,1,11,6,1,0,76
127143,1187665,1,12,1,2,0,78
127144,1187665,1,12,2,0,0,78
127145,1187665,1,12,3,1,0,79
127146,1187665,1,12,4,1,0,80
127147,1187665,1,12,5,2,0,82
127148,1187665,1,12,6,1,0,83
127149,1187665,1,13,1,2,0,85
127150,1187665,1,13,2,4,0,89
127151,1187665,1,13,3,1,0,90
127152,1187665,1,13,4,1,0,91
127153,1187665,1,13,5,1,0,92
127154,1187665,1,13,6,1,0,93
127155,1187665,1,14,1,0,1,93
127156,1187665,1,14,2,1,0,94
127157,1187665,1,14,3,1,0,95
127158,1187665,1,14,4,0,0,95
127159,1187665,1,14,5,1,0,96
127160,1187665,1,14,6,0,0,96
127161,1187665,1,15,1,1,0,97
127162,1187665,1,15,2,1,0,98
127163,1187665,1,15,3,4,0,102
127164,1187665,1,15,4,1,0,103
127165,1187665,1,15,5,2,0,105
127166,1187665,1,15,6,0,0,105
127167,1187665,1,16,1,1,0,106
127168,1187665,1,16,2,1,0,107
127169,1187665,1,16,3,1,0,108
127170,1187665,1,16,4,1,0,109
127171,1187665,1,16,5,1,0,110
127172,1187665,1,16,6,6,0,116
127173,1187665,1,17,1,0,0,116
127174,1187665,1,17,2,1,0,117
127175,1187665,1,17,3,1,0,118
127176,1187665,1,17,4,4,0,122
127177,1187665,1,17,5,1,0,123
127178,1187665,1,17,6,6,0,129
127179,1187665,1,18,1,1,0,130
127180,1187665,1,18,2,1,0,131
127181,1187665,1,18,3,1,0,132
127182,1187665,1,18,4,4,0,136
127183,1187665,1,18,5,1,0,137
127184,1187665,1,18,6,1,0,138
127185,1187665,1,19,1,0,0,138
127186,1187665,1,19,2,1,0,139
127187,1187665,1,19,3,1,0,140
127188,1187665,1,19,4,6,0,146
127189,1187665,1,19,5,0,0,146
127190,1187665,1,19,6,1,0,147
127191,1187665,1,20,1,1,0,148
127192,1187665,1,20,2,1,0,149
127193,1187665,1,20,3,0,1,149
127194,1187665,1,20,4,1,0,150
127195,1187665,1,20,5,1,0,151
127196,1187665,1,20,6,2,0,153
127308,1187666,1,1,1,0,0,0
127309,1187666,1,1,2,0,0,0
127310,1187666,1,1,3,0,0,0
127311,1187666,1,1,4,1,0,1
127312,1187666,1,1,5,1,0,2
127313,1187666,1,1,6,1,0,3
127314,1187666,1,2,1,0,0,3
127315,1187666,1,2,2,6,0,9
127316,1187666,1,2,3,1,0,10
127317,1187666,1,2,4,1,0,11
127318,1187666,1,2,5,1,0,12
127319,1187666,1,2,6,6,0,18
127320,1187666,1,3,1,1,0,19
127321,1187666,1,3,2,1,0,20
127322,1187666,1,3,3,1,0,21
127323,1187666,1,3,4,2,1,23
127324,1187666,1,3,5,0,0,23
127325,1187666,1,3,6,1,0,24
127326,1187666,1,4,1,0,0,24
127327,1187666,1,4,2,0,0,24
127328,1187666,1,4,3,0,0,24
127329,1187666,1,4,4,0,0,24
127330,1187666,1,4,5,0,0,24
127331,1187666,1,4,6,2,0,26
127332,1187666,1,5,1,4,0,30
127333,1187666,1,5,2,4,0,34
127334,1187666,1,5,3,1,0,35
127335,1187666,1,5,4,6,0,41
127336,1187666,1,5,5,1,0,42
127337,1187666,1,5,6,1,0,43
127338,1187666,1,6,1,0,0,43
127339,1187666,1,6,2,3,0,46
127340,1187666,1,6,3,1,0,47
127341,1187666,1,6,4,4,0,51
127342,1187666,1,6,5,1,0,52
127343,1187666,1,6,6,1,0,53
127344,1187666,1,7,1,4,0,57
127345,1187666,1,7,2,0,0,57
127346,1187666,1,7,3,0,1,57
127347,1187666,1,7,4,1,0,58
127348,1187666,1,7,5,1,0,59
127349,1187666,1,7,6,0,0,59
127350,1187666,1,8,1,0,0,59
127351,1187666,1,8,2,1,0,60
127352,1187666,1,8,3,2,0,62
127353,1187666,1,8,4,1,0,63
127354,1187666,1,8,5,6,0,69
127355,1187666,1,8,6,1,0,70
127356,1187666,1,9,1,1,0,71
127357,1187666,1,9,2,6,0,77
127358,1187666,1,9,3,6,0,83
127359,1187666,1,9,4,1,0,84
127360,1187666,1,9,5,0,0,84
127361,1187666,1,9,6,1,0,85
127362,1187666,1,10,1,0,1,85
127363,1187666,1,10,2,0,0,85
127364,1187666,1,10,3,4,0,89
127365,1187666,1,10,4,6,0,95
127366,1187666,1,10,5,1,0,96
127367,1187666,1,10,6,0,0,96
127368,1187666,1,11,1,0,1,96
127369,1187666,1,11,2,0,0,96
127370,1187666,1,11,3,1,0,97
127371,1187666,1,11,4,0,0,97
127372,1187666,1,11,5,1,0,98
127373,1187666,1,11,6,0,0,98
127374,1187666,1,12,1,0,0,98
127375,1187666,1,12,2,1,0,99
127376,1187666,1,12,3,1,0,100
127377,1187666,1,12,4,6,0,106
127378,1187666,1,12,5,4,0,110
127379,1187666,1,12,6,0,0,110
127380,1187666,1,13,1,1,0,111
127381,1187666,1,13,2,4,0,115
127382,1187666,1,13,3,1,0,116
127383,1187666,1,13,4,0,0,116
127384,1187666,1,13,5,1,0,117
127385,1187666,1,13,6,1,0,118
127386,1187666,1,14,1,0,0,118
127387,1187666,1,14,2,1,0,119
127388,1187666,1,14,3,1,0,120
127389,1187666,1,14,4,1,0,121
127390,1187666,1,14,5,0,1,121
127391,1187666,1,14,6,1,0,122
127392,1187666,1,15,1,0,0,122
127393,1187666,1,15,2,1,0,123
127394,1187666,1,15,3,0,0,123
127395,1187666,1,15,4,4,0,127
127396,1187666,1,15,5,0,0,127
127397,1187666,1,15,6,1,0,128
127398,1187666,1,16,1,1,0,129
127399,1187666,1,16,2,1,0,130
127400,1187666,1,16,3,6,0,136
127401,1187666,1,16,4,1,0,137
127402,1187666,1,16,5,1,0,138
127403,1187666,1,16,6,0,0,138
127404,1187666,1,17,1,1,0,139
127405,1187666,1,17,2,6,0,145
127406,1187666,1,17,3,1,0,146
127407,1187666,1,17,4,1,0,147
127408,1187666,1,17,5,1,0,148
127409,1187666,1,17,6,1,0,149
127410,1187666,1,18,1,1,0,150
127411,1187666,1,18,2,0,0,150
127412,1187666,1,18,3,1,0,151
127413,1187666,1,18,4,0,1,151
127414,1187666,1,18,5,0,0,151
127415,1187666,1,18,6,0,1,151
127416,1187666,1,19,1,1,0,152
127417,1187666,1,19,2,1,0,153
127418,1187666,1,19,3,6,0,159
127419,1187666,1,19,4,2,0,161
127420,1187666,1,19,5,4,0,165
127421,1187666,1,19,6,1,0,166
127422,1187666,1,20,1,0,0,166
127423,1187666,1,20,2,1,0,167
127424,1187666,1,20,3,2,0,169
127425,1187666,1,20,4,1,0,170
127426,1187666,1,20,5,6,0,176
127427,1187666,1,20,6,0,1,176
127547,1187667,1,1,1,1,0,1
127548,1187667,1,1,2,1,0,2
127549,1187667,1,1,3,1,0,3
127550,1187667,1,1,4,4,0,7
127551,1187667,1,1,5,1,0,8
127552,1187667,1,1,6,1,0,9
127553,1187667,1,2,1,1,0,10
127554,1187667,1,2,2,0,0,10
127555,1187667,1,2,3,0,0,10
127556,1187667,1,2,4,4,0,14
127557,1187667,1,2,5,4,0,18
127558,1187667,1,2,6,1,0,19
127559,1187667,1,3,1,4,0,23
127560,1187667,1,3,2,4,0,27
127561,1187667,1,3,3,4,0,31
127562,1187667,1,3,4,1,0,32
127563,1187667,1,3,5,1,0,33
127564,1187667,1,3,6,1,0,34
127565,1187667,1,4,1,1,0,35
127566,1187667,1,4,2,1,0,36
127567,1187667,1,4,3,0,0,36
127568,1187667,1,4,4,4,0,40
127569,1187667,1,4,5,0,1,40
127570,1187667,1,4,6,0,0,40
127571,1187667,1,5,1,1,0,41
127572,1187667,1,5,2,1,0,42
127573,1187667,1,5,3,0,1,42
127574,1187667,1,5,4,0,0,42
127575,1187667,1,5,5,4,0,46
127576,1187667,1,5,6,1,0,47
127577,1187667,1,6,1,0,0,47
127578,1187667,1,6,2,0,0,47
127579,1187667,1,6,3,4,0,51
127580,1187667,1,6,4,0,0,51
127581,1187667,1,6,5,0,0,51
127582,1187667,1,6,6,1,0,52
127583,1187667,1,7,1,1,0,53
127584,1187667,1,7,2,4,0,57
127585,1187667,1,7,3,4,0,61
127586,1187667,1,7,4,0,0,61
127587,1187667,1,7,5,0,0,61
127588,1187667,1,7,6,6,0,67
127589,1187667,1,8,1,0,0,67
127590,1187667,1,8,2,1,0,68
127591,1187667,1,8,3,0,0,68
127592,1187667,1,8,4,1,0,69
127593,1187667,1,8,5,0,1,69
127594,1187667,1,8,6,1,0,70
127595,1187667,1,9,1,1,0,71
127596,1187667,1,9,2,0,0,71
127597,1187667,1,9,3,1,0,72
127598,1187667,1,9,4,0,0,72
127599,1187667,1,9,5,0,0,72
127600,1187667,1,9,6,1,0,73
127601,1187667,1,10,1,1,0,74
127602,1187667,1,10,2,6,0,80
127603,1187667,1,10,3,1,0,81
127604,1187667,1,10,4,2,0,83
127605,1187667,1,10,5,0,0,83
127606,1187667,1,10,6,1,0,84
127607,1187667,1,11,1,1,0,85
127608,1187667,1,11,2,1,0,86
127609,1187667,1,11,3,4,0,90
127610,1187667,1,11,4,3,0,93
127611,1187667,1,11,5,2,0,95
127612,1187667,1,11,6,1,0,96
127613,1187667,1,12,1,1,0,97
127614,1187667,1,12,2,0,0,97
127615,1187667,1,12,3,1,0,98
127616,1187667,1,12,4,1,0,99
127617,1187667,1,12,5,1,0,100
127618,1187667,1,12,6,1,0,101
127619,1187667,1,13,1,4,0,105
127620,1187667,1,13,2,6,0,111
127621,1187667,1,13,3,1,0,112
127622,1187667,1,13,4,4,0,116
127623,1187667,1,13,5,1,0,117
127624,1187667,1,13,6,1,0,118
127625,1187667,1,14,1,0,0,118
127626,1187667,1,14,2,1,0,119
127627,1187667,1,14,3,12,0,131
127628,1187667,1,14,4,0,0,131
127629,1187667,1,14,5,1,0,132
127630,1187667,1,14,6,1,0,133
127631,1187667,1,15,1,0,0,133
127632,1187667,1,15,2,1,0,134
127633,1187667,1,15,3,0,0,134
127634,1187667,1,15,4,1,0,135
127635,1187667,1,15,5,0,1,135
127636,1187667,1,15,6,1,0,136
127637,1187667,1,16,1,1,0,137
127638,1187667,1,16,2,2,0,139
127639,1187667,1,16,3,1,0,140
127640,1187667,1,16,4,3,0,143
127641,1187667,1,16,5,0,0,143
127642,1187667,1,16,6,4,0,147
127643,1187667,1,17,1,1,0,148
127644,1187667,1,17,2,1,0,149
127645,1187667,1,17,3,1,0,150
127646,1187667,1,17,4,0,0,150
127647,1187667,1,17,5,4,0,154
127648,1187667,1,17,6,1,0,155
127649,1187667,1,18,1,0,0,155
127650,1187667,1,18,2,6,0,161
127651,1187667,1,18,3,1,0,162
127652,1187667,1,18,4,0,1,162
127653,1187667,1,18,5,1,0,163
127654,1187667,1,18,6,0,0,163
127655,1187667,1,19,1,1,0,164
127656,1187667,1,19,2,1,0,165
127657,1187667,1,19,3,4,0,169
127658,1187667,1,19,4,0,0,169
127659,1187667,1,19,5,1,0,170
127660,1187667,1,19,6,1,1,171
127661,1187667,1,20,1,1,0,172
127662,1187667,1,20,2,1,0,173
127663,1187667,1,20,3,2,0,175
127664,1187667,1,20,4,4,0,179
127665,1187667,1,20,5,1,0,180
127666,1187667,1,20,6,0,1,180
127787,1187668,1,1,1,4,0,4
127788,1187668,1,1,2,0,0,4
127789,1187668,1,1,3,0,0,4
127790,1187668,1,1,4,0,0,4
127791,1187668,1,1,5,0,0,4
127792,1187668,1,1,6,1,0,5
127793,1187668,1,2,1,2,0,7
127794,1187668,1,2,2,0,0,7
127795,1187668,1,2,3,1,0,8
127796,1187668,1,2,4,2,0,10
127797,1187668,1,2,5,0,0,10
127798,1187668,1,2,6,1,0,11
127799,1187668,1,3,1,0,0,11
127800,1187668,1,3,2,0,0,11
127801,1187668,1,3,3,0,0,11
127802,1187668,1,3,4,4,0,15
127803,1187668,1,3,5,1,0,16
127804,1187668,1,3,6,0,0,16
127805,1187668,1,4,1,0,1,16
127806,1187668,1,4,2,0,0,16
127807,1187668,1,4,3,0,0,16
127808,1187668,1,4,4,1,0,17
127809,1187668,1,4,5,0,0,17
127810,1187668,1,4,6,1,0,18
127811,1187668,1,5,1,1,0,19
127812,1187668,1,5,2,4,0,23
127813,1187668,1,5,3,1,0,24
127814,1187668,1,5,4,2,0,26
127815,1187668,1,5,5,4,0,30
127816,1187668,1,5,6,1,0,31
127817,1187668,1,6,1,1,0,32
127818,1187668,1,6,2,4,0,36
127819,1187668,1,6,3,0,0,36
127820,1187668,1,6,4,4,0,40
127821,1187668,1,6,5,6,0,46
127822,1187668,1,6,6,2,0,48
127823,1187668,1,7,1,1,0,49
127824,1187668,1,7,2,1,0,50
127825,1187668,1,7,3,1,0,51
127826,1187668,1,7,4,1,0,52
127827,1187668,1,7,5,4,0,56
127828,1187668,1,7,6,1,0,57
127829,1187668,1,8,1,1,0,58
127830,1187668,1,8,2,0,1,58
127831,1187668,1,8,3,1,0,59
127832,1187668,1,8,4,1,0,60
127833,1187668,1,8,5,0,0,60
127834,1187668,1,8,6,1,0,61
127835,1187668,1,9,1,0,0,61
127836,1187668,1,9,2,6,0,67
127837,1187668,1,9,3,2,0,69
127838,1187668,1,9,4,1,0,70
127839,1187668,1,9,5,1,0,71
127840,1187668,1,9,6,2,0,73
127841,1187668,1,10,1,0,0,73
127842,1187668,1,10,2,4,0,77
127843,1187668,1,10,3,1,0,78
127844,1187668,1,10,4,0,0,78
127845,1187668,1,10,5,6,0,84
127846,1187668,1,10,6,4,0,88
127847,1187668,1,11,1,2,0,90
127848,1187668,1,11,2,6,0,96
127849,1187668,1,11,3,4,0,100
127850,1187668,1,11,4,1,0,101
127851,1187668,1,11,5,6,0,107
127852,1187668,1,11,6,1,0,108
127853,1187668,1,12,1,4,0,112
127854,1187668,1,12,2,1,0,113
127855,1187668,1,12,3,1,0,114
127856,1187668,1,12,4,1,0,115
127857,1187668,1,12,5,1,0,116
127858,1187668,1,12,6,4,0,120
127859,1187668,1,13,1,1,0,121
127860,1187668,1,13,2,1,0,122
127861,1187668,1,13,3,1,0,123
127862,1187668,1,13,4,1,0,124
127863,1187668,1,13,5,4,0,128
127864,1187668,1,13,6,1,0,129
127865,1187668,1,14,1,4,0,133
127866,1187668,1,14,2,3,0,136
127867,1187668,1,14,3,4,0,140
127868,1187668,1,14,4,4,0,144
127869,1187668,1,14,5,1,0,145
127870,1187668,1,14,6,4,0,149
127871,1187668,1,15,1,3,0,152
127872,1187668,1,15,2,0,0,152
127873,1187668,1,15,3,0,0,152
127874,1187668,1,15,4,1,0,153
127875,1187668,1,15,5,2,0,155
127876,1187668,1,15,6,1,0,156
127877,1187668,1,16,1,1,0,157
127878,1187668,1,16,2,1,0,158
127879,1187668,1,16,3,0,0,158
127880,1187668,1,16,4,4,0,162
127881,1187668,1,16,5,2,0,164
127882,1187668,1,16,6,1,0,165
127883,1187668,1,17,1,4,0,169
127884,1187668,1,17,2,6,0,175
127885,1187668,1,17,3,6,0,181
127886,1187668,1,17,4,4,0,185
127887,1187668,1,17,5,6,0,191
127888,1187668,1,17,6,2,0,193
127889,1187668,1,18,1,1,0,194
127890,1187668,1,18,2,6,0,200
127891,1187668,1,18,3,0,0,200
127892,1187668,1,18,4,1,0,201
127893,1187668,1,18,5,1,0,202
127894,1187668,1,18,6,6,0,208
127895,1187668,1,19,1,2,0,210
127896,1187668,1,19,2,7,0,217
127897,1187668,1,19,3,6,0,223
127898,1187668,1,19,4,0,0,223
127899,1187668,1,19,5,6,0,229
127900,1187668,1,19,6,4,0,233
127901,1187668,1,20,1,0,0,233
127902,1187668,1,20,2,1,0,234
127903,1187668,1,20,3,6,0,240
127904,1187668,1,20,4,0,1,240
127905,1187668,1,20,5,1,0,241
127906,1187668,1,20,6,0,0,241
128008,1187677,1,1,1,0,0,0
128009,1187677,1,1,2,4,0,4
128010,1187677,1,1,3,1,0,5
128011,1187677,1,1,4,1,0,6
128012,1187677,1,1,5,1,0,7
128013,1187677,1,1,6,0,0,7
128014,1187677,1,2,1,1,0,8
128015,1187677,1,2,2,4,0,12
128016,1187677,1,2,3,1,0,13
128017,1187677,1,2,4,0,0,13
128018,1187677,1,2,5,0,0,13
128019,1187677,1,2,6,6,0,19
128020,1187677,1,3,1,0,0,19
128021,1187677,1,3,2,1,0,20
128022,1187677,1,3,3,0,0,20
128023,1187677,1,3,4,5,0,25
128024,1187677,1,3,5,0,0,25
128025,1187677,1,3,6,1,0,26
128026,1187677,1,4,1,2,0,28
128027,1187677,1,4,2,2,0,30
128028,1187677,1,4,3,4,0,34
128029,1187677,1,4,4,6,0,40
128030,1187677,1,4,5,0,0,40
128031,1187677,1,4,6,4,0,44
128032,1187677,1,5,1,4,0,48
128033,1187677,1,5,2,1,0,49
128034,1187677,1,5,3,1,0,50
128035,1187677,1,5,4,0,0,50
128036,1187677,1,5,5,0,0,50
128037,1187677,1,5,6,2,0,52
128038,1187677,1,6,1,4,0,56
128039,1187677,1,6,2,1,0,57
128040,1187677,1,6,3,0,0,57
128041,1187677,1,6,4,2,0,59
128042,1187677,1,6,5,3,0,62
128043,1187677,1,6,6,6,0,68
128044,1187677,1,7,1,1,0,69
128045,1187677,1,7,2,1,0,70
128046,1187677,1,7,3,2,0,72
128047,1187677,1,7,4,0,0,72
128048,1187677,1,7,5,1,0,73
128049,1187677,1,7,6,0,0,73
128050,1187677,1,8,1,4,0,77
128051,1187677,1,8,2,1,0,78
128052,1187677,1,8,3,1,0,79
128053,1187677,1,8,4,1,0,80
128054,1187677,1,8,5,0,1,80
128055,1187677,1,8,6,1,0,81
128056,1187677,1,9,1,1,0,82
128057,1187677,1,9,2,0,0,82
128058,1187677,1,9,3,0,0,82
128059,1187677,1,9,4,0,0,82
128060,1187677,1,9,5,1,0,83
128061,1187677,1,9,6,1,0,84
128062,1187677,1,10,1,0,0,84
128063,1187677,1,10,2,0,0,84
128064,1187677,1,10,3,0,0,84
128065,1187677,1,10,4,1,0,85
128066,1187677,1,10,5,0,0,85
128067,1187677,1,10,6,6,0,91
128068,1187677,1,11,1,4,0,95
128069,1187677,1,11,2,0,0,95
128070,1187677,1,11,3,1,0,96
128071,1187677,1,11,4,1,0,97
128072,1187677,1,11,5,4,0,101
128073,1187677,1,11,6,1,0,102
128074,1187677,1,12,1,1,0,103
128075,1187677,1,12,2,6,0,109
128076,1187677,1,12,3,6,0,115
128077,1187677,1,12,4,1,0,116
128078,1187677,1,12,5,0,1,116
128079,1187677,1,12,6,0,0,116
128080,1187677,1,13,1,1,0,117
128081,1187677,1,13,2,0,1,117
128082,1187677,1,13,3,1,0,118
128083,1187677,1,13,4,1,0,119
128084,1187677,1,13,5,1,0,120
128085,1187677,1,13,6,1,0,121
128086,1187677,1,14,1,1,0,122
128087,1187677,1,14,2,1,0,123
128088,1187677,1,14,3,6,0,129
128089,1187677,1,14,4,1,0,130
128090,1187677,1,14,5,0,0,130
128091,1187677,1,14,6,0,0,130
128092,1187677,1,15,1,0,0,130
128093,1187677,1,15,2,1,0,131
128094,1187677,1,15,3,1,0,132
128095,1187677,1,15,4,1,0,133
128096,1187677,1,15,5,4,0,137
128097,1187677,1,15,6,6,0,143
128098,1187677,1,16,1,4,0,147
128099,1187677,1,16,2,1,0,148
128100,1187677,1,16,3,4,0,152
128101,1187677,1,16,4,6,0,158
128102,1187677,1,16,5,6,0,164
128103,1187677,1,16,6,1,0,165
128104,1187677,1,17,1,1,0,166
128105,1187677,1,17,2,4,0,170
128106,1187677,1,17,3,4,0,174
128107,1187677,1,17,4,0,0,174
128108,1187677,1,17,5,4,0,178
128109,1187677,1,17,6,0,1,178
128110,1187677,1,18,1,0,0,178
128111,1187677,1,18,2,1,0,179
128112,1187677,1,18,3,1,0,180
128113,1187677,1,18,4,1,0,181
128114,1187677,1,18,5,0,1,181
128115,1187677,1,18,6,1,0,182
128116,1187677,1,19,1,4,0,186
128117,1187677,1,19,2,2,0,188
128118,1187677,1,19,3,0,0,188
128119,1187677,1,19,4,1,0,189
128120,1187677,1,19,5,1,0,190
128121,1187677,1,19,6,1,0,191
128122,1187677,1,20,1,4,0,195
128123,1187677,1,20,2,2,0,197
128124,1187677,1,20,3,2,0,199
128125,1187677,1,20,4,2,0,201
128126,1187677,1,20,5,1,0,202
128127,1187677,1,20,6,1,0,203
128242,1187678,1,1,1,0,0,0
128243,1187678,1,1,2,0,0,0
128244,1187678,1,1,3,6,0,6
128245,1187678,1,1,4,6,0,12
128246,1187678,1,1,5,0,0,12
128247,1187678,1,1,6,1,0,13
128248,1187678,1,2,1,0,0,13
128249,1187678,1,2,2,0,0,13
128250,1187678,1,2,3,1,0,14
128251,1187678,1,2,4,0,0,14
128252,1187678,1,2,5,0,0,14
128253,1187678,1,2,6,4,0,18
128254,1187678,1,3,1,1,0,19
128255,1187678,1,3,2,1,0,20
128256,1187678,1,3,3,0,0,20
128257,1187678,1,3,4,1,0,21
128258,1187678,1,3,5,2,0,23
128259,1187678,1,3,6,0,0,23
128260,1187678,1,4,1,0,0,23
128261,1187678,1,4,2,0,0,23
128262,1187678,1,4,3,1,0,24
128263,1187678,1,4,4,4,0,28
128264,1187678,1,4,5,1,0,29
128265,1187678,1,4,6,3,0,32
128266,1187678,1,5,1,4,0,36
128267,1187678,1,5,2,0,0,36
128268,1187678,1,5,3,1,0,37
128269,1187678,1,5,4,1,0,38
128270,1187678,1,5,5,1,0,39
128271,1187678,1,5,6,0,0,39
128272,1187678,1,6,1,0,0,39
128273,1187678,1,6,2,1,0,40
128274,1187678,1,6,3,4,0,44
128275,1187678,1,6,4,4,0,48
128276,1187678,1,6,5,0,0,48
128277,1187678,1,6,6,0,1,48
128278,1187678,1,7,1,1,0,49
128279,1187678,1,7,2,1,0,50
128280,1187678,1,7,3,6,0,56
128281,1187678,1,7,4,0,0,56
128282,1187678,1,7,5,1,0,57
128283,1187678,1,7,6,1,0,58
128284,1187678,1,8,1,0,0,58
128285,1187678,1,8,2,2,0,60
128286,1187678,1,8,3,1,0,61
128287,1187678,1,8,4,1,0,62
128288,1187678,1,8,5,1,0,63
128289,1187678,1,8,6,0,0,63
128290,1187678,1,9,1,1,0,64
128291,1187678,1,9,2,0,0,64
128292,1187678,1,9,3,4,0,68
128293,1187678,1,9,4,0,1,68
128294,1187678,1,9,5,0,0,68
128295,1187678,1,9,6,1,0,69
128296,1187678,1,10,1,1,0,70
128297,1187678,1,10,2,0,0,70
128298,1187678,1,10,3,0,0,70
128299,1187678,1,10,4,1,0,71
128300,1187678,1,10,5,1,0,72
128301,1187678,1,10,6,1,0,73
128302,1187678,1,11,1,1,0,74
128303,1187678,1,11,2,0,1,74
128304,1187678,1,11,3,0,0,74
128305,1187678,1,11,4,0,0,74
128306,1187678,1,11,5,1,0,75
128307,1187678,1,11,6,1,0,76
128308,1187678,1,12,1,0,0,76
128309,1187678,1,12,2,0,0,76
128310,1187678,1,12,3,0,0,76
128311,1187678,1,12,4,1,0,77
128312,1187678,1,12,5,1,0,78
128313,1187678,1,12,6,1,0,79
128314,1187678,1,13,1,1,0,80
128315,1187678,1,13,2,1,0,81
128316,1187678,1,13,3,0,1,81
128317,1187678,1,13,4,1,0,82
128318,1187678,1,13,5,1,0,83
128319,1187678,1,13,6,1,0,84
128320,1187678,1,14,1,2,0,86
128321,1187678,1,14,2,1,0,87
128322,1187678,1,14,3,1,0,88
128323,1187678,1,14,4,0,0,88
128324,1187678,1,14,5,1,0,89
128325,1187678,1,14,6,1,0,90
128326,1187678,1,15,1,0,0,90
128327,1187678,1,15,2,1,0,91
128328,1187678,1,15,3,0,0,91
128329,1187678,1,15,4,1,0,92
128330,1187678,1,15,5,1,0,93
128331,1187678,1,15,6,1,0,94
128332,1187678,1,16,1,1,0,95
128333,1187678,1,16,2,1,0,96
128334,1187678,1,16,3,4,0,100
128335,1187678,1,16,4,6,0,106
128336,1187678,1,16,5,2,0,108
128337,1187678,1,16,6,1,0,109
128338,1187678,1,17,1,1,0,110
128339,1187678,1,17,2,0,0,110
128340,1187678,1,17,3,1,0,111
128341,1187678,1,17,4,0,0,111
128342,1187678,1,17,5,1,0,112
128343,1187678,1,17,6,3,0,115
128344,1187678,1,18,1,0,0,115
128345,1187678,1,18,2,0,0,115
128346,1187678,1,18,3,1,0,116
128347,1187678,1,18,4,1,0,117
128348,1187678,1,18,5,1,0,118
128349,1187678,1,18,6,0,0,118
128350,1187678,1,19,1,2,0,120
128351,1187678,1,19,2,1,0,121
128352,1187678,1,19,3,0,0,121
128353,1187678,1,19,4,1,0,122
128354,1187678,1,19,5,1,0,123
128355,1187678,1,19,6,0,0,123
128356,1187678,1,20,1,1,0,124
128357,1187678,1,20,2,0,0,124
128358,1187678,1,20,3,1,0,125
128359,1187678,1,20,4,0,1,125
128360,1187678,1,20,5,6,0,131
128361,1187678,1,20,6,1,0,132
128467,1187681,1,1,1,0,0,0
128468,1187681,1,1,2,4,0,4
128469,1187681,1,1,3,1,0,5
128470,1187681,1,1,4,1,0,6
128471,1187681,1,1,5,1,0,7
128472,1187681,1,1,6,1,0,8
128473,1187681,1,2,1,0,0,8
128474,1187681,1,2,2,0,0,8
128475,1187681,1,2,3,0,1,8
128476,1187681,1,2,4,0,0,8
128477,1187681,1,2,5,0,0,8
128478,1187681,1,2,6,2,0,10
128479,1187681,1,3,1,6,0,16
128480,1187681,1,3,2,0,0,16
128481,1187681,1,3,3,4,0,20
128482,1187681,1,3,4,4,0,24
128483,1187681,1,3,5,1,0,25
128484,1187681,1,3,6,0,0,25
128485,1187681,1,4,1,0,0,25
128486,1187681,1,4,2,2,0,27
128487,1187681,1,4,3,1,0,28
128488,1187681,1,4,4,0,0,28
128489,1187681,1,4,5,1,0,29
128490,1187681,1,4,6,5,0,34
128491,1187681,1,5,1,0,0,34
128492,1187681,1,5,2,1,0,35
128493,1187681,1,5,3,1,0,36
128494,1187681,1,5,4,2,0,38
128495,1187681,1,5,5,2,0,40
128496,1187681,1,5,6,4,0,44
128497,1187681,1,6,1,6,0,50
128498,1187681,1,6,2,1,0,51
128499,1187681,1,6,3,0,0,51
128500,1187681,1,6,4,0,0,51
128501,1187681,1,6,5,1,0,52
128502,1187681,1,6,6,1,0,53
128503,1187681,1,7,1,0,0,53
128504,1187681,1,7,2,0,0,53
128505,1187681,1,7,3,0,0,53
128506,1187681,1,7,4,1,0,54
128507,1187681,1,7,5,0,0,54
128508,1187681,1,7,6,1,0,55
128509,1187681,1,8,1,2,0,57
128510,1187681,1,8,2,1,0,58
128511,1187681,1,8,3,1,0,59
128512,1187681,1,8,4,1,0,60
128513,1187681,1,8,5,1,0,61
128514,1187681,1,8,6,1,0,62
128515,1187681,1,9,1,1,0,63
128516,1187681,1,9,2,0,0,63
128517,1187681,1,9,3,1,0,64
128518,1187681,1,9,4,4,0,68
128519,1187681,1,9,5,1,0,69
128520,1187681,1,9,6,0,0,69
128521,1187681,1,10,1,1,0,70
128522,1187681,1,10,2,1,0,71
128523,1187681,1,10,3,2,0,73
128524,1187681,1,10,4,6,0,79
128525,1187681,1,10,5,1,0,80
128526,1187681,1,10,6,4,0,84
128527,1187681,1,11,1,6,0,90
128528,1187681,1,11,2,1,0,91
128529,1187681,1,11,3,0,0,91
128530,1187681,1,11,4,1,0,92
128531,1187681,1,11,5,1,0,93
128532,1187681,1,11,6,1,0,94
128533,1187681,1,12,1,1,0,95
128534,1187681,1,12,2,1,0,96
128535,1187681,1,12,3,0,1,96
128536,1187681,1,12,4,0,0,96
128537,1187681,1,12,5,4,0,100
128538,1187681,1,12,6,1,0,101
128539,1187681,1,13,1,0,0,101
128540,1187681,1,13,2,0,0,101
128541,1187681,1,13,3,0,0,101
128542,1187681,1,13,4,0,0,101
128543,1187681,1,13,5,2,0,103
128544,1187681,1,13,6,1,0,104
128545,1187681,1,14,1,0,0,104
128546,1187681,1,14,2,0,0,104
128547,1187681,1,14,3,0,0,104
128548,1187681,1,14,4,0,0,104
128549,1187681,1,14,5,1,0,105
128550,1187681,1,14,6,1,0,106
128551,1187681,1,15,1,1,0,107
128552,1187681,1,15,2,1,0,108
128553,1187681,1,15,3,1,0,109
128554,1187681,1,15,4,2,0,111
128555,1187681,1,15,5,0,0,111
128556,1187681,1,15,6,6,0,117
128557,1187681,1,16,1,4,0,121
128558,1187681,1,16,2,1,0,122
128559,1187681,1,16,3,6,0,128
128560,1187681,1,16,4,1,0,129
128561,1187681,1,16,5,2,0,131
128562,1187681,1,16,6,0,0,131
128563,1187681,1,17,1,1,0,132
128564,1187681,1,17,2,6,0,138
128565,1187681,1,17,3,0,0,138
128566,1187681,1,17,4,0,1,138
128567,1187681,1,17,5,1,0,139
128568,1187681,1,17,6,1,0,140
128569,1187681,1,18,1,0,0,140
128570,1187681,1,18,2,0,0,140
128571,1187681,1,18,3,1,0,141
128572,1187681,1,18,4,1,0,142
128573,1187681,1,18,5,0,0,142
128574,1187681,1,18,6,1,0,143
128575,1187681,1,19,1,1,0,144
128576,1187681,1,19,2,0,0,144
128577,1187681,1,19,3,0,0,144
128578,1187681,1,19,4,4,0,148
128579,1187681,1,19,5,0,1,148
128580,1187681,1,19,6,0,0,148
128581,1187681,1,20,1,0,0,148
128582,1187681,1,20,2,6,0,154
128583,1187681,1,20,3,4,0,158
128584,1187681,1,20,4,2,0,160
128585,1187681,1,20,5,2,0,162
128586,1187681,1,20,6,1,0,163
128707,1188379,1,1,1,0,0,0
128708,1188379,1,1,2,0,0,0
128709,1188379,1,1,3,4,0,4
128710,1188379,1,1,4,1,0,5
128711,1188379,1,1,5,1,0,6
128712,1188379,1,1,6,0,1,6
128713,1188379,1,2,1,0,0,6
128714,1188379,1,2,2,1,0,7
128715,1188379,1,2,3,4,0,11
128716,1188379,1,2,4,1,0,12
128717,1188379,1,2,5,0,0,12
128718,1188379,1,2,6,2,0,14
128719,1188379,1,3,1,0,0,14
128720,1188379,1,3,2,2,0,16
128721,1188379,1,3,3,2,0,18
128722,1188379,1,3,4,0,0,18
128723,1188379,1,3,5,0,0,18
128724,1188379,1,3,6,1,0,19
128725,1188379,1,4,1,4,0,23
128726,1188379,1,4,2,4,0,27
128727,1188379,1,4,3,1,0,28
128728,1188379,1,4,4,4,0,32
128729,1188379,1,4,5,2,0,34
128730,1188379,1,4,6,4,0,38
128731,1188379,1,5,1,1,0,39
128732,1188379,1,5,2,6,0,45
128733,1188379,1,5,3,1,0,46
128734,1188379,1,5,4,0,0,46
128735,1188379,1,5,5,3,0,49
128736,1188379,1,5,6,6,0,55
128737,1188379,1,6,1,4,0,59
128738,1188379,1,6,2,4,0,63
128739,1188379,1,6,3,4,0,67
128740,1188379,1,6,4,2,0,69
128741,1188379,1,6,5,1,0,70
128742,1188379,1,6,6,0,0,70
128743,1188379,1,7,1,2,0,72
128744,1188379,1,7,2,1,0,73
128745,1188379,1,7,3,1,0,74
128746,1188379,1,7,4,2,0,76
128747,1188379,1,7,5,0,0,76
128748,1188379,1,7,6,2,0,78
128749,1188379,1,8,1,1,0,79
128750,1188379,1,8,2,6,0,85
128751,1188379,1,8,3,0,0,85
128752,1188379,1,8,4,0,0,85
128753,1188379,1,8,5,2,0,87
128754,1188379,1,8,6,0,1,87
128755,1188379,1,9,1,1,0,88
128756,1188379,1,9,2,2,0,90
128757,1188379,1,9,3,1,0,91
128758,1188379,1,9,4,0,1,91
128759,1188379,1,9,5,0,0,91
128760,1188379,1,9,6,0,0,91
128761,1188379,1,10,1,1,0,92
128762,1188379,1,10,2,1,0,93
128763,1188379,1,10,3,0,1,93
128764,1188379,1,10,4,1,0,94
128765,1188379,1,10,5,0,0,94
128766,1188379,1,10,6,2,0,96
128767,1188379,1,11,1,1,0,97
128768,1188379,1,11,2,1,0,98
128769,1188379,1,11,3,0,0,98
128770,1188379,1,11,4,2,0,100
128771,1188379,1,11,5,0,0,100
128772,1188379,1,11,6,1,0,101
128773,1188379,1,12,1,1,0,102
128774,1188379,1,12,2,2,0,104
128775,1188379,1,12,3,0,0,104
128776,1188379,1,12,4,1,0,105
128777,1188379,1,12,5,2,0,107
128778,1188379,1,12,6,1,0,108
128779,1188379,1,13,1,11,0,119
128780,1188379,1,13,2,1,0,120
128781,1188379,1,13,3,0,0,120
128782,1188379,1,13,4,0,0,120
128783,1188379,1,13,5,0,0,120
128784,1188379,1,13,6,0,0,120
128785,1188379,1,14,1,1,0,121
128786,1188379,1,14,2,1,0,122
128787,1188379,1,14,3,3,0,125
128788,1188379,1,14,4,1,0,126
128789,1188379,1,14,5,0,0,126
128790,1188379,1,14,6,2,0,128
128791,1188379,1,15,1,0,0,128
128792,1188379,1,15,2,1,0,129
128793,1188379,1,15,3,2,0,131
128794,1188379,1,15,4,0,0,131
128795,1188379,1,15,5,2,0,133
128796,1188379,1,15,6,4,0,137
128797,1188379,1,16,1,0,1,137
128798,1188379,1,16,2,1,0,138
128799,1188379,1,16,3,1,0,139
128800,1188379,1,16,4,0,0,139
128801,1188379,1,16,5,1,0,140
128802,1188379,1,16,6,0,0,140
128803,1188379,1,17,1,3,0,143
128804,1188379,1,17,2,3,0,146
128805,1188379,1,17,3,4,0,150
128806,1188379,1,17,4,0,0,150
128807,1188379,1,17,5,4,0,154
128808,1188379,1,17,6,4,0,158
128809,1188379,1,18,1,1,0,159
128810,1188379,1,18,2,1,0,160
128811,1188379,1,18,3,1,0,161
128812,1188379,1,18,4,0,0,161
128813,1188379,1,18,5,4,0,165
128814,1188379,1,18,6,1,0,166
128815,1188379,1,19,1,4,0,170
128816,1188379,1,19,2,6,0,176
128817,1188379,1,19,3,1,0,177
128818,1188379,1,19,4,2,0,179
128819,1188379,1,19,5,4,0,183
128820,1188379,1,19,6,1,0,184
128821,1188379,1,20,1,1,1,185
128822,1188379,1,20,2,1,0,186
128823,1188379,1,20,3,1,0,187
128824,1188379,1,20,4,6,0,193
128825,1188379,1,20,5,4,0,197
128826,1188379,1,20,6,2,0,199
128946,1188621,1,1,1,0,0,0
128947,1188621,1,1,2,0,1,0
128948,1188621,1,1,3,0,0,0
128949,1188621,1,1,4,1,0,1
128950,1188621,1,1,5,0,0,1
128951,1188621,1,1,6,5,0,6
128952,1188621,1,2,1,0,0,6
128953,1188621,1,2,2,1,0,7
128954,1188621,1,2,3,0,0,7
128955,1188621,1,2,4,1,0,8
128956,1188621,1,2,5,0,0,8
128957,1188621,1,2,6,0,1,8
128958,1188621,1,3,1,4,0,12
128959,1188621,1,3,2,6,0,18
128960,1188621,1,3,3,0,0,18
128961,1188621,1,3,4,0,0,18
128962,1188621,1,3,5,0,0,18
128963,1188621,1,3,6,2,0,20
128964,1188621,1,4,1,0,0,20
128965,1188621,1,4,2,2,0,22
128966,1188621,1,4,3,0,0,22
128967,1188621,1,4,4,0,0,22
128968,1188621,1,4,5,0,0,22
128969,1188621,1,4,6,0,0,22
128970,1188621,1,5,1,0,0,22
128971,1188621,1,5,2,6,0,28
128972,1188621,1,5,3,0,0,28
128973,1188621,1,5,4,0,1,28
128974,1188621,1,5,5,0,1,28
128975,1188621,1,5,6,0,0,28
128976,1188621,1,6,1,0,0,28
128977,1188621,1,6,2,1,0,29
128978,1188621,1,6,3,0,0,29
128979,1188621,1,6,4,4,0,33
128980,1188621,1,6,5,0,0,33
128981,1188621,1,6,6,0,1,33
128982,1188621,1,7,1,0,0,33
128983,1188621,1,7,2,0,0,33
128984,1188621,1,7,3,0,0,33
128985,1188621,1,7,4,0,0,33
128986,1188621,1,7,5,0,0,33
128987,1188621,1,7,6,1,0,34
128988,1188621,1,8,1,0,0,34
128989,1188621,1,8,2,1,0,35
128990,1188621,1,8,3,1,0,36
128991,1188621,1,8,4,1,0,37
128992,1188621,1,8,5,0,0,37
128993,1188621,1,8,6,0,0,37
128994,1188621,1,9,1,0,0,37
128995,1188621,1,9,2,0,0,37
128996,1188621,1,9,3,0,0,37
128997,1188621,1,9,4,1,0,38
128998,1188621,1,9,5,4,0,42
128999,1188621,1,9,6,1,0,43
129000,1188621,1,10,1,0,0,43
129001,1188621,1,10,2,1,0,44
129002,1188621,1,10,3,0,0,44
129003,1188621,1,10,4,0,0,44
129004,1188621,1,10,5,0,0,44
129005,1188621,1,10,6,1,0,45
129006,1188621,1,11,1,0,0,45
129007,1188621,1,11,2,0,0,45
129008,1188621,1,11,3,0,0,45
129009,1188621,1,11,4,0,0,45
129010,1188621,1,11,5,0,0,45
129011,1188621,1,11,6,0,0,45
129012,1188621,1,12,1,1,0,46
129013,1188621,1,12,2,1,0,47
129014,1188621,1,12,3,0,0,47
129015,1188621,1,12,4,6,0,53
129016,1188621,1,12,5,1,0,54
129017,1188621,1,12,6,0,0,54
129018,1188621,1,13,1,0,0,54
129019,1188621,1,13,2,1,0,55
129020,1188621,1,13,3,1,0,56
129021,1188621,1,13,4,0,0,56
129022,1188621,1,13,5,6,0,62
129023,1188621,1,13,6,1,0,63
129024,1188621,1,14,1,0,0,63
129025,1188621,1,14,2,0,0,63
129026,1188621,1,14,3,0,0,63
129027,1188621,1,14,4,1,0,64
129028,1188621,1,14,5,0,0,64
129029,1188621,1,14,6,1,0,65
129030,1188621,1,15,1,2,0,67
129031,1188621,1,15,2,0,1,67
129032,1188621,1,15,3,0,0,67
129033,1188621,1,15,4,1,0,68
129034,1188621,1,15,5,1,0,69
129035,1188621,1,15,6,1,0,70
129036,1188621,1,16,1,0,1,70
129037,1188621,1,16,2,0,0,70
129038,1188621,1,16,3,0,0,70
129039,1188621,1,16,4,0,0,70
129040,1188621,1,16,5,0,0,70
129041,1188621,1,16,6,0,0,70
129042,1188621,1,17,1,1,0,71
129043,1188621,1,17,2,1,0,72
129044,1188621,1,17,3,0,0,72
129045,1188621,1,17,4,2,0,74
129046,1188621,1,17,5,4,0,78
129047,1188621,1,17,6,0,0,78
129048,1188621,1,18,1,0,0,78
129049,1188621,1,18,2,0,0,78
129050,1188621,1,18,3,1,0,79
129051,1188621,1,18,4,6,0,85
129052,1188621,1,18,5,1,0,86
129053,1188621,1,18,6,2,0,88
129054,1188621,1,19,1,0,1,88
129055,1188621,1,19,2,0,0,88
129056,1188621,1,19,3,0,0,88
129057,1188621,1,19,4,6,0,94
129058,1188621,1,19,5,1,0,95
129059,1188621,1,19,6,0,0,95
129060,1188621,1,20,1,0,0,95
129061,1188621,1,20,2,0,0,95
129062,1188621,1,20,3,0,1,95
129063,1188621,1,20,4,0,0,95
129064,1188621,1,20,5,0,0,95
129065,1188621,1,20,6,0,0,95
129170,1188622,1,1,1,4,0,4
129171,1188622,1,1,2,0,0,4
129172,1188622,1,1,3,2,0,6
129173,1188622,1,1,4,0,0,6
129174,1188622,1,1,5,0,0,6
129175,1188622,1,1,6,0,0,6
129176,1188622,1,2,1,1,0,7
129177,1188622,1,2,2,0,0,7
129178,1188622,1,2,3,1,0,8
129179,1188622,1,2,4,0,0,8
129180,1188622,1,2,5,1,0,9
129181,1188622,1,2,6,0,0,9
129182,1188622,1,3,1,1,0,10
129183,1188622,1,3,2,4,0,14
129184,1188622,1,3,3,1,0,15
129185,1188622,1,3,4,1,0,16
129186,1188622,1,3,5,1,0,17
129187,1188622,1,3,6,4,0,21
129188,1188622,1,4,1,4,0,25
129189,1188622,1,4,2,2,0,27
129190,1188622,1,4,3,4,0,31
129191,1188622,1,4,4,0,0,31
129192,1188622,1,4,5,1,0,32
129193,1188622,1,4,6,2,0,34
129194,1188622,1,5,1,0,0,34
129195,1188622,1,5,2,0,0,34
129196,1188622,1,5,3,0,0,34
129197,1188622,1,5,4,1,0,35
129198,1188622,1,5,5,0,0,35
129199,1188622,1,5,6,4,0,39
129200,1188622,1,6,1,0,0,39
129201,1188622,1,6,2,0,0,39
129202,1188622,1,6,3,6,0,45
129203,1188622,1,6,4,2,0,47
129204,1188622,1,6,5,4,0,51
129205,1188622,1,6,6,1,0,52
129206,1188622,1,7,1,1,0,53
129207,1188622,1,7,2,1,0,54
129208,1188622,1,7,3,1,0,55
129209,1188622,1,7,4,5,0,60
129210,1188622,1,7,5,1,0,61
129211,1188622,1,7,6,0,0,61
129212,1188622,1,8,1,2,0,63
129213,1188622,1,8,2,1,0,64
129214,1188622,1,8,3,1,0,65
129215,1188622,1,8,4,2,0,67
129216,1188622,1,8,5,0,1,67
129217,1188622,1,8,6,1,0,68
129218,1188622,1,9,1,1,0,69
129219,1188622,1,9,2,1,0,70
129220,1188622,1,9,3,0,0,70
129221,1188622,1,9,4,1,0,71
129222,1188622,1,9,5,0,0,71
129223,1188622,1,9,6,1,0,72
129224,1188622,1,10,1,0,0,72
129225,1188622,1,10,2,2,0,74
129226,1188622,1,10,3,1,0,75
129227,1188622,1,10,4,1,0,76
129228,1188622,1,10,5,0,0,76
129229,1188622,1,10,6,1,0,77
129230,1188622,1,11,1,1,0,78
129231,1188622,1,11,2,6,0,84
129232,1188622,1,11,3,0,0,84
129233,1188622,1,11,4,1,0,85
129234,1188622,1,11,5,1,0,86
129235,1188622,1,11,6,1,0,87
129236,1188622,1,12,1,1,0,88
129237,1188622,1,12,2,6,0,94
129238,1188622,1,12,3,1,0,95
129239,1188622,1,12,4,2,0,97
129240,1188622,1,12,5,1,0,98
129241,1188622,1,12,6,0,0,98
129242,1188622,1,13,1,6,0,104
129243,1188622,1,13,2,0,0,104
129244,1188622,1,13,3,4,0,108
129245,1188622,1,13,4,1,0,109
129246,1188622,1,13,5,2,0,111
129247,1188622,1,13,6,0,0,111
129248,1188622,1,14,1,1,0,112
129249,1188622,1,14,2,1,0,113
129250,1188622,1,14,3,1,0,114
129251,1188622,1,14,4,1,0,115
129252,1188622,1,14,5,0,1,115
129253,1188622,1,14,6,2,0,117
129254,1188622,1,15,1,1,0,118
129255,1188622,1,15,2,4,0,122
129256,1188622,1,15,3,1,0,123
129257,1188622,1,15,4,1,0,124
129258,1188622,1,15,5,1,0,125
129259,1188622,1,15,6,1,0,126
129260,1188622,1,16,1,0,1,126
129261,1188622,1,16,2,0,0,126
129262,1188622,1,16,3,1,0,127
129263,1188622,1,16,4,1,0,128
129264,1188622,1,16,5,1,0,129
129265,1188622,1,16,6,1,0,130
129266,1188622,1,17,1,2,0,132
129267,1188622,1,17,2,0,1,132
129268,1188622,1,17,3,0,0,132
129269,1188622,1,17,4,1,0,133
129270,1188622,1,17,5,1,0,134
129271,1188622,1,17,6,1,0,135
129272,1188622,1,18,1,0,0,135
129273,1188622,1,18,2,2,0,137
129274,1188622,1,18,3,1,0,138
129275,1188622,1,18,4,1,0,139
129276,1188622,1,18,5,1,0,140
129277,1188622,1,18,6,1,0,141
129278,1188622,1,19,1,1,0,142
129279,1188622,1,19,2,1,0,143
129280,1188622,1,19,3,0,1,143
129281,1188622,1,19,4,2,0,145
129282,1188622,1,19,5,1,0,146
129283,1188622,1,19,6,1,0,147
129284,1188622,1,20,1,6,0,153
129285,1188622,1,20,2,6,0,159
129286,1188622,1,20,3,0,0,159
129287,1188622,1,20,4,1,0,160
129288,1188622,1,20,5,6,0,166
129289,1188622,1,20,6,1,0,167
129383,1188623,1,1,1,0,0,0
129384,1188623,1,1,2,0,0,0
129385,1188623,1,1,3,0,0,0
129386,1188623,1,1,4,1,0,1
129387,1188623,1,1,5,0,0,1
129388,1188623,1,1,6,0,0,1
129389,1188623,1,2,1,1,0,2
129390,1188623,1,2,2,2,0,4
129391,1188623,1,2,3,0,0,4
129392,1188623,1,2,4,0,0,4
129393,1188623,1,2,5,0,1,4
129394,1188623,1,2,6,0,0,4
129395,1188623,1,3,1,0,0,4
129396,1188623,1,3,2,0,0,4
129397,1188623,1,3,3,4,0,8
129398,1188623,1,3,4,3,0,11
129399,1188623,1,3,5,1,0,12
129400,1188623,1,3,6,1,0,13
129401,1188623,1,4,1,0,1,13
129402,1188623,1,4,2,0,0,13
129403,1188623,1,4,3,0,0,13
129404,1188623,1,4,4,1,0,14
129405,1188623,1,4,5,0,1,14
129406,1188623,1,4,6,0,0,14
129407,1188623,1,5,1,0,0,14
129408,1188623,1,5,2,6,0,20
129409,1188623,1,5,3,1,0,21
129410,1188623,1,5,4,0,0,21
129411,1188623,1,5,5,0,0,21
129412,1188623,1,5,6,0,0,21
129413,1188623,1,6,1,0,0,21
129414,1188623,1,6,2,0,0,21
129415,1188623,1,6,3,0,0,21
129416,1188623,1,6,4,0,0,21
129417,1188623,1,6,5,1,0,22
129418,1188623,1,6,6,0,0,22
129419,1188623,1,7,1,1,0,23
129420,1188623,1,7,2,4,0,27
129421,1188623,1,7,3,2,0,29
129422,1188623,1,7,4,0,0,29
129423,1188623,1,7,5,1,0,30
129424,1188623,1,7,6,0,0,30
129425,1188623,1,8,1,1,0,31
129426,1188623,1,8,2,0,0,31
129427,1188623,1,8,3,2,0,33
129428,1188623,1,8,4,0,0,33
129429,1188623,1,8,5,0,0,33
129430,1188623,1,8,6,0,0,33
129431,1188623,1,9,1,6,0,39
129432,1188623,1,9,2,0,0,39
129433,1188623,1,9,3,0,0,39
129434,1188623,1,9,4,0,0,39
129435,1188623,1,9,5,6,0,45
129436,1188623,1,9,6,1,0,46
129437,1188623,1,10,1,6,0,52
129438,1188623,1,10,2,2,0,54
129439,1188623,1,10,3,2,0,56
129440,1188623,1,10,4,1,0,57
129441,1188623,1,10,5,0,0,57
129442,1188623,1,10,6,1,0,58
129443,1188623,1,11,1,0,0,58
129444,1188623,1,11,2,0,0,58
129445,1188623,1,11,3,1,0,59
129446,1188623,1,11,4,0,0,59
129447,1188623,1,11,5,0,0,59
129448,1188623,1,11,6,6,0,65
129449,1188623,1,12,1,1,0,66
129450,1188623,1,12,2,1,0,67
129451,1188623,1,12,3,5,0,72
129452,1188623,1,12,4,0,0,72
129453,1188623,1,12,5,1,0,73
129454,1188623,1,12,6,0,0,73
129455,1188623,1,13,1,1,0,74
129456,1188623,1,13,2,2,0,76
129457,1188623,1,13,3,1,0,77
129458,1188623,1,13,4,1,0,78
129459,1188623,1,13,5,1,0,79
129460,1188623,1,13,6,1,0,80
129461,1188623,1,14,1,0,1,80
129462,1188623,1,14,2,1,0,81
129463,1188623,1,14,3,1,0,82
129464,1188623,1,14,4,1,0,83
129465,1188623,1,14,5,0,0,83
129466,1188623,1,14,6,1,0,84
129467,1188623,1,15,1,6,0,90
129468,1188623,1,15,2,1,0,91
129469,1188623,1,15,3,1,0,92
129470,1188623,1,15,4,6,0,98
129471,1188623,1,15,5,1,0,99
129472,1188623,1,15,6,1,0,100
129473,1188623,1,16,1,4,0,104
129474,1188623,1,16,2,1,0,105
129475,1188623,1,16,3,0,0,105
129476,1188623,1,16,4,0,1,105
129477,1188623,1,16,5,1,0,106
129478,1188623,1,16,6,2,0,108
129479,1188623,1,17,1,1,0,109
129480,1188623,1,17,2,1,0,110
129481,1188623,1,17,3,0,0,110
129482,1188623,1,17,4,1,0,111
129483,1188623,1,17,5,1,0,112
129484,1188623,1,17,6,1,0,113
129485,1188623,1,18,1,6,0,119
129486,1188623,1,18,2,0,1,119
129487,1188623,1,18,3,0,0,119
129488,1188623,1,18,4,0,0,119
129489,1188623,1,18,5,1,0,120
129490,1188623,1,18,6,1,0,121
129491,1188623,1,19,1,0,0,121
129492,1188623,1,19,2,0,0,121
129493,1188623,1,19,3,0,0,121
129494,1188623,1,19,4,2,0,123
129495,1188623,1,19,5,1,0,124
129496,1188623,1,19,6,6,0,130
129497,1188623,1,20,1,0,0,130
129498,1188623,1,20,2,6,0,136
129499,1188623,1,20,3,1,0,137
129500,1188623,1,20,4,1,0,138
129501,1188623,1,20,5,6,0,144
129502,1188623,1,20,6,2,0,146
129618,1192875,1,1,1,1,0,1
129619,1192875,1,1,2,0,0,1
129620,1192875,1,1,3,0,0,1
129621,1192875,1,1,4,1,0,2
129622,1192875,1,1,5,0,0,2
129623,1192875,1,1,6,0,0,2
129624,1192875,1,2,1,1,0,3
129625,1192875,1,2,2,1,0,4
129626,1192875,1,2,3,1,0,5
129627,1192875,1,2,4,2,0,7
129628,1192875,1,2,5,0,0,7
129629,1192875,1,2,6,4,0,11
129630,1192875,1,3,1,5,0,16
129631,1192875,1,3,2,0,0,16
129632,1192875,1,3,3,1,0,17
129633,1192875,1,3,4,0,0,17
129634,1192875,1,3,5,0,0,17
129635,1192875,1,3,6,1,0,18
129636,1192875,1,4,1,4,0,22
129637,1192875,1,4,2,4,0,26
129638,1192875,1,4,3,6,0,32
129639,1192875,1,4,4,0,0,32
129640,1192875,1,4,5,1,0,33
129641,1192875,1,4,6,4,0,37
129642,1192875,1,5,1,1,0,38
129643,1192875,1,5,2,3,0,41
129644,1192875,1,5,3,0,1,41
129645,1192875,1,5,4,1,0,42
129646,1192875,1,5,5,1,0,43
129647,1192875,1,5,6,1,0,44
129648,1192875,1,6,1,0,0,44
129649,1192875,1,6,2,1,0,45
129650,1192875,1,6,3,4,0,49
129651,1192875,1,6,4,0,0,49
129652,1192875,1,6,5,1,0,50
129653,1192875,1,6,6,0,0,50
129654,1192875,1,7,1,1,0,51
129655,1192875,1,7,2,1,0,52
129656,1192875,1,7,3,1,0,53
129657,1192875,1,7,4,1,0,54
129658,1192875,1,7,5,1,0,55
129659,1192875,1,7,6,1,0,56
129660,1192875,1,8,1,1,0,57
129661,1192875,1,8,2,1,0,58
129662,1192875,1,8,3,0,0,58
129663,1192875,1,8,4,0,0,58
129664,1192875,1,8,5,1,0,59
129665,1192875,1,8,6,2,0,61
129666,1192875,1,9,1,1,0,62
129667,1192875,1,9,2,3,0,65
129668,1192875,1,9,3,0,0,65
129669,1192875,1,9,4,1,0,66
129670,1192875,1,9,5,1,0,67
129671,1192875,1,9,6,1,0,68
129672,1192875,1,10,1,0,1,68
129673,1192875,1,10,2,0,0,68
129674,1192875,1,10,3,1,0,69
129675,1192875,1,10,4,1,0,70
129676,1192875,1,10,5,2,0,72
129677,1192875,1,10,6,1,0,73
129678,1192875,1,11,1,2,0,75
129679,1192875,1,11,2,1,0,76
129680,1192875,1,11,3,1,0,77
129681,1192875,1,11,4,1,0,78
129682,1192875,1,11,5,4,0,82
129683,1192875,1,11,6,1,0,83
129684,1192875,1,12,1,0,0,83
129685,1192875,1,12,2,0,0,83
129686,1192875,1,12,3,4,0,87
129687,1192875,1,12,4,1,0,88
129688,1192875,1,12,5,0,0,88
129689,1192875,1,12,6,1,0,89
129690,1192875,1,13,1,1,0,90
129691,1192875,1,13,2,0,0,90
129692,1192875,1,13,3,2,0,92
129693,1192875,1,13,4,1,0,93
129694,1192875,1,13,5,1,0,94
129695,1192875,1,13,6,1,0,95
129696,1192875,1,14,1,4,0,99
129697,1192875,1,14,2,1,0,100
129698,1192875,1,14,3,1,0,101
129699,1192875,1,14,4,1,0,102
129700,1192875,1,14,5,1,0,103
129701,1192875,1,14,6,0,0,103
129702,1192875,1,15,1,1,0,104
129703,1192875,1,15,2,2,0,106
129704,1192875,1,15,3,2,0,108
129705,1192875,1,15,4,4,0,112
129706,1192875,1,15,5,1,0,113
129707,1192875,1,15,6,1,0,114
129708,1192875,1,16,1,4,0,118
129709,1192875,1,16,2,6,0,124
129710,1192875,1,16,3,2,0,126
129711,1192875,1,16,4,0,0,126
129712,1192875,1,16,5,1,0,127
129713,1192875,1,16,6,4,0,131
129714,1192875,1,17,1,0,1,131
129715,1192875,1,17,2,1,0,132
129716,1192875,1,17,3,1,0,133
129717,1192875,1,17,4,1,0,134
129718,1192875,1,17,5,1,0,135
129719,1192875,1,17,6,1,0,136
129720,1192875,1,18,1,2,0,138
129721,1192875,1,18,2,1,0,139
129722,1192875,1,18,3,1,0,140
129723,1192875,1,18,4,1,0,141
129724,1192875,1,18,5,1,0,142
129725,1192875,1,18,6,2,0,144
129726,1192875,1,19,1,0,0,144
129727,1192875,1,19,2,2,0,146
129728,1192875,1,19,3,1,0,147
129729,1192875,1,19,4,1,0,148
129730,1192875,1,19,5,2,0,150
129731,1192875,1,19,6,1,0,151
129732,1192875,1,20,1,2,0,153
129733,1192875,1,20,2,6,0,159
129734,1192875,1,20,3,0,1,159
129735,1192875,1,20,4,6,0,165
129736,1192875,1,20,5,6,0,171
129737,1192875,1,20,6,3,0,174
129855,1192876,1,1,1,0,0,0
129856,1192876,1,1,2,4,0,4
129857,1192876,1,1,3,0,0,4
129858,1192876,1,1,4,0,0,4
129859,1192876,1,1,5,0,0,4
129860,1192876,1,1,6,0,0,4
129861,1192876,1,2,1,1,0,5
129862,1192876,1,2,2,0,0,5
129863,1192876,1,2,3,6,0,11
129864,1192876,1,2,4,0,0,11
129865,1192876,1,2,5,2,0,13
129866,1192876,1,2,6,1,0,14
129867,1192876,1,3,1,0,0,14
129868,1192876,1,3,2,1,0,15
129869,1192876,1,3,3,1,0,16
129870,1192876,1,3,4,0,0,16
129871,1192876,1,3,5,1,0,17
129872,1192876,1,3,6,1,0,18
129873,1192876,1,4,1,3,0,21
129874,1192876,1,4,2,0,0,21
129875,1192876,1,4,3,0,0,21
129876,1192876,1,4,4,6,0,27
129877,1192876,1,4,5,1,0,28
129878,1192876,1,4,6,0,0,28
129879,1192876,1,5,1,4,0,32
129880,1192876,1,5,2,0,0,32
129881,1192876,1,5,3,1,0,33
129882,1192876,1,5,4,1,0,34
129883,1192876,1,5,5,0,0,34
129884,1192876,1,5,6,0,1,34
129885,1192876,1,6,1,1,0,35
129886,1192876,1,6,2,1,0,36
129887,1192876,1,6,3,1,0,37
129888,1192876,1,6,4,1,0,38
129889,1192876,1,6,5,0,0,38
129890,1192876,1,6,6,0,0,38
129891,1192876,1,7,1,2,0,40
129892,1192876,1,7,2,0,1,40
129893,1192876,1,7,3,1,0,41
129894,1192876,1,7,4,0,0,41
129895,1192876,1,7,5,1,0,42
129896,1192876,1,7,6,0,0,42
129897,1192876,1,8,1,1,0,43
129898,1192876,1,8,2,0,0,43
129899,1192876,1,8,3,1,0,44
129900,1192876,1,8,4,2,0,46
129901,1192876,1,8,5,1,0,47
129902,1192876,1,8,6,1,0,48
129903,1192876,1,9,1,1,0,49
129904,1192876,1,9,2,4,0,53
129905,1192876,1,9,3,1,0,54
129906,1192876,1,9,4,4,0,58
129907,1192876,1,9,5,0,0,58
129908,1192876,1,9,6,1,0,59
129909,1192876,1,10,1,2,0,61
129910,1192876,1,10,2,1,0,62
129911,1192876,1,10,3,0,0,62
129912,1192876,1,10,4,1,0,63
129913,1192876,1,10,5,6,0,69
129914,1192876,1,10,6,0,0,69
129915,1192876,1,11,1,1,0,70
129916,1192876,1,11,2,0,0,70
129917,1192876,1,11,3,4,0,74
129918,1192876,1,11,4,1,0,75
129919,1192876,1,11,5,4,0,79
129920,1192876,1,11,6,1,0,80
129921,1192876,1,12,1,1,0,81
129922,1192876,1,12,2,4,0,85
129923,1192876,1,12,3,1,0,86
129924,1192876,1,12,4,1,0,87
129925,1192876,1,12,5,1,0,88
129926,1192876,1,12,6,1,0,89
129927,1192876,1,13,1,1,0,90
129928,1192876,1,13,2,2,0,92
129929,1192876,1,13,3,1,0,93
129930,1192876,1,13,4,2,0,95
129931,1192876,1,13,5,6,0,101
129932,1192876,1,13,6,2,0,103
129933,1192876,1,14,1,0,0,103
129934,1192876,1,14,2,1,0,104
129935,1192876,1,14,3,4,0,108
129936,1192876,1,14,4,0,1,108
129937,1192876,1,14,5,2,0,110
129938,1192876,1,14,6,0,0,110
129939,1192876,1,15,1,0,1,110
129940,1192876,1,15,2,0,0,110
129941,1192876,1,15,3,1,0,111
129942,1192876,1,15,4,1,0,112
129943,1192876,1,15,5,4,0,116
129944,1192876,1,15,6,0,0,116
129945,1192876,1,16,1,2,0,118
129946,1192876,1,16,2,1,0,119
129947,1192876,1,16,3,1,0,120
129948,1192876,1,16,4,2,0,122
129949,1192876,1,16,5,0,1,122
129950,1192876,1,16,6,2,0,124
129951,1192876,1,17,1,1,0,125
129952,1192876,1,17,2,2,0,127
129953,1192876,1,17,3,4,0,131
129954,1192876,1,17,4,2,0,133
129955,1192876,1,17,5,1,0,134
129956,1192876,1,17,6,1,0,135
129957,1192876,1,18,1,4,0,139
129958,1192876,1,18,2,6,0,145
129959,1192876,1,18,3,1,0,146
129960,1192876,1,18,4,0,0,146
129961,1192876,1,18,5,0,1,146
129962,1192876,1,18,6,2,0,148
129963,1192876,1,19,1,0,0,148
129964,1192876,1,19,2,2,0,150
129965,1192876,1,19,3,0,1,150
129966,1192876,1,19,4,0,0,150
129967,1192876,1,19,5,1,0,151
129968,1192876,1,19,6,0,0,151
129969,1192876,1,20,1,2,0,153
129970,1192876,1,20,2,2,0,155
129971,1192876,1,20,3,2,0,157
129972,1192876,1,20,4,4,0,161
129973,1192876,1,20,5,0,1,161
129974,1192876,1,20,6,0,1,161
130093,1192877,1,1,1,1,0,1
130094,1192877,1,1,2,0,0,1
130095,1192877,1,1,3,4,0,5
130096,1192877,1,1,4,0,0,5
130097,1192877,1,1,5,0,0,5
130098,1192877,1,1,6,1,0,6
130099,1192877,1,2,1,0,0,6
130100,1192877,1,2,2,0,0,6
130101,1192877,1,2,3,1,0,7
130102,1192877,1,2,4,0,0,7
130103,1192877,1,2,5,0,0,7
130104,1192877,1,2,6,2,0,9
130105,1192877,1,3,1,1,0,10
130106,1192877,1,3,2,0,0,10
130107,1192877,1,3,3,2,0,12
130108,1192877,1,3,4,1,0,13
130109,1192877,1,3,5,0,0,13
130110,1192877,1,3,6,0,0,13
130111,1192877,1,4,1,4,0,17
130112,1192877,1,4,2,4,0,21
130113,1192877,1,4,3,4,0,25
130114,1192877,1,4,4,0,0,25
130115,1192877,1,4,5,4,0,29
130116,1192877,1,4,6,2,0,31
130117,1192877,1,5,1,0,1,31
130118,1192877,1,5,2,0,0,31
130119,1192877,1,5,3,0,0,31
130120,1192877,1,5,4,0,0,31
130121,1192877,1,5,5,0,0,31
130122,1192877,1,5,6,0,0,31
130123,1192877,1,6,1,1,0,32
130124,1192877,1,6,2,4,0,36
130125,1192877,1,6,3,0,0,36
130126,1192877,1,6,4,0,0,36
130127,1192877,1,6,5,0,0,36
130128,1192877,1,6,6,0,0,36
130129,1192877,1,7,1,0,0,36
130130,1192877,1,7,2,1,0,37
130131,1192877,1,7,3,2,0,39
130132,1192877,1,7,4,0,1,39
130133,1192877,1,7,5,2,0,41
130134,1192877,1,7,6,0,0,41
130135,1192877,1,8,1,2,0,43
130136,1192877,1,8,2,0,0,43
130137,1192877,1,8,3,0,0,43
130138,1192877,1,8,4,1,0,44
130139,1192877,1,8,5,1,0,45
130140,1192877,1,8,6,1,0,46
130141,1192877,1,9,1,2,0,48
130142,1192877,1,9,2,1,0,49
130143,1192877,1,9,3,1,0,50
130144,1192877,1,9,4,0,0,50
130145,1192877,1,9,5,0,1,50
130146,1192877,1,9,6,0,0,50
130147,1192877,1,10,1,0,0,50
130148,1192877,1,10,2,1,0,51
130149,1192877,1,10,3,1,0,52
130150,1192877,1,10,4,1,0,53
130151,1192877,1,10,5,1,0,54
130152,1192877,1,10,6,2,0,56
130153,1192877,1,11,1,0,0,56
130154,1192877,1,11,2,1,0,57
130155,1192877,1,11,3,4,0,61
130156,1192877,1,11,4,4,0,65
130157,1192877,1,11,5,2,0,67
130158,1192877,1,11,6,2,0,69
130159,1192877,1,12,1,0,0,69
130160,1192877,1,12,2,2,0,71
130161,1192877,1,12,3,0,0,71
130162,1192877,1,12,4,1,0,72
130163,1192877,1,12,5,0,0,72
130164,1192877,1,12,6,4,0,76
130165,1192877,1,13,1,1,0,77
130166,1192877,1,13,2,0,1,77
130167,1192877,1,13,3,1,0,78
130168,1192877,1,13,4,2,0,80
130169,1192877,1,13,5,0,0,80
130170,1192877,1,13,6,1,0,81
130171,1192877,1,14,1,1,0,82
130172,1192877,1,14,2,1,0,83
130173,1192877,1,14,3,1,0,84
130174,1192877,1,14,4,4,0,88
130175,1192877,1,14,5,2,0,90
130176,1192877,1,14,6,1,0,91
130177,1192877,1,15,1,1,0,92
130178,1192877,1,15,2,4,0,96
130179,1192877,1,15,3,1,0,97
130180,1192877,1,15,4,1,0,98
130181,1192877,1,15,5,0,1,98
130182,1192877,1,15,6,2,0,100
130183,1192877,1,16,1,1,0,101
130184,1192877,1,16,2,0,0,101
130185,1192877,1,16,3,0,0,101
130186,1192877,1,16,4,0,1,101
130187,1192877,1,16,5,0,0,101
130188,1192877,1,16,6,0,0,101
130189,1192877,1,17,1,2,0,103
130190,1192877,1,17,2,1,0,104
130191,1192877,1,17,3,1,0,105
130192,1192877,1,17,4,2,0,107
130193,1192877,1,17,5,1,0,108
130194,1192877,1,17,6,1,1,109
130195,1192877,1,18,1,0,0,109
130196,1192877,1,18,2,0,1,109
130197,1192877,1,18,3,0,0,109
130198,1192877,1,18,4,0,0,109
130199,1192877,1,18,5,2,0,111
130200,1192877,1,18,6,0,0,111
130201,1192877,1,19,1,1,0,112
130202,1192877,1,19,2,0,0,112
130203,1192877,1,19,3,2,0,114
130204,1192877,1,19,4,0,0,114
130205,1192877,1,19,5,1,0,115
130206,1192877,1,19,6,1,0,116
130207,1192877,1,20,1,1,0,117
130208,1192877,1,20,2,1,0,118
130209,1192877,1,20,3,2,0,120
130210,1192877,1,20,4,2,0,122
130211,1192877,1,20,5,1,0,123
130212,1192877,1,20,6,2,0,125
130309,1193494,1,1,1,0,0,0
130310,1193494,1,1,2,0,0,0
130311,1193494,1,1,3,4,0,4
130312,1193494,1,1,4,0,1,4
130313,1193494,1,1,5,1,0,5
130314,1193494,1,1,6,0,0,5
130315,1193494,1,2,1,1,0,6
130316,1193494,1,2,2,0,0,6
130317,1193494,1,2,3,0,0,6
130318,1193494,1,2,4,0,0,6
130319,1193494,1,2,5,0,0,6
130320,1193494,1,2,6,0,0,6
130321,1193494,1,3,1,0,0,6
130322,1193494,1,3,2,0,0,6
130323,1193494,1,3,3,2,0,8
130324,1193494,1,3,4,1,0,9
130325,1193494,1,3,5,0,0,9
130326,1193494,1,3,6,1,0,10
130327,1193494,1,4,1,0,0,10
130328,1193494,1,4,2,4,0,14
130329,1193494,1,4,3,0,0,14
130330,1193494,1,4,4,4,0,18
130331,1193494,1,4,5,1,0,19
130332,1193494,1,4,6,0,0,19
130333,1193494,1,5,1,6,0,25
130334,1193494,1,5,2,0,0,25
130335,1193494,1,5,3,0,0,25
130336,1193494,1,5,4,0,0,25
130337,1193494,1,5,5,6,0,31
130338,1193494,1,5,6,4,0,35
130339,1193494,1,6,1,2,0,37
130340,1193494,1,6,2,1,0,38
130341,1193494,1,6,3,6,0,44
130342,1193494,1,6,4,1,0,45
130343,1193494,1,6,5,1,0,46
130344,1193494,1,6,6,6,0,52
130345,1193494,1,7,1,0,0,52
130346,1193494,1,7,2,1,0,53
130347,1193494,1,7,3,6,0,59
130348,1193494,1,7,4,1,0,60
130349,1193494,1,7,5,1,0,61
130350,1193494,1,7,6,1,0,62
130351,1193494,1,8,1,4,0,66
130352,1193494,1,8,2,1,0,67
130353,1193494,1,8,3,2,0,69
130354,1193494,1,8,4,2,0,71
130355,1193494,1,8,5,0,0,71
130356,1193494,1,8,6,6,0,77
130357,1193494,1,9,1,0,0,77
130358,1193494,1,9,2,6,0,83
130359,1193494,1,9,3,1,0,84
130360,1193494,1,9,4,2,0,86
130361,1193494,1,9,5,1,0,87
130362,1193494,1,9,6,1,0,88
130363,1193494,1,10,1,0,0,88
130364,1193494,1,10,2,2,0,90
130365,1193494,1,10,3,1,0,91
130366,1193494,1,10,4,0,0,91
130367,1193494,1,10,5,0,1,91
130368,1193494,1,10,6,1,0,92
130369,1193494,1,11,1,1,0,93
130370,1193494,1,11,2,2,0,95
130371,1193494,1,11,3,2,0,97
130372,1193494,1,11,4,1,0,98
130373,1193494,1,11,5,1,0,99
130374,1193494,1,11,6,0,0,99
130375,1193494,1,12,1,1,0,100
130376,1193494,1,12,2,0,0,100
130377,1193494,1,12,3,0,0,100
130378,1193494,1,12,4,0,1,100
130379,1193494,1,12,5,0,0,100
130380,1193494,1,12,6,1,0,101
130381,1193494,1,13,1,1,0,102
130382,1193494,1,13,2,1,0,103
130383,1193494,1,13,3,1,0,104
130384,1193494,1,13,4,1,0,105
130385,1193494,1,13,5,1,0,106
130386,1193494,1,13,6,0,0,106
130387,1193494,1,14,1,2,0,108
130388,1193494,1,14,2,1,0,109
130389,1193494,1,14,3,0,0,109
130390,1193494,1,14,4,1,0,110
130391,1193494,1,14,5,0,0,110
130392,1193494,1,14,6,1,0,111
130393,1193494,1,15,1,0,0,111
130394,1193494,1,15,2,6,0,117
130395,1193494,1,15,3,1,0,118
130396,1193494,1,15,4,0,0,118
130397,1193494,1,15,5,1,0,119
130398,1193494,1,15,6,1,0,120
130399,1193494,1,16,1,0,0,120
130400,1193494,1,16,2,0,1,120
130401,1193494,1,16,3,4,0,124
130402,1193494,1,16,4,1,0,125
130403,1193494,1,16,5,2,0,127
130404,1193494,1,16,6,2,0,129
130405,1193494,1,17,1,1,0,130
130406,1193494,1,17,2,1,0,131
130407,1193494,1,17,3,2,0,133
130408,1193494,1,17,4,1,0,134
130409,1193494,1,17,5,0,0,134
130410,1193494,1,17,6,1,0,135
130411,1193494,1,18,1,4,0,139
130412,1193494,1,18,2,1,0,140
130413,1193494,1,18,3,0,1,140
130414,1193494,1,18,4,0,0,140
130415,1193494,1,18,5,1,0,141
130416,1193494,1,18,6,1,0,142
130417,1193494,1,19,1,0,0,142
130418,1193494,1,19,2,1,0,143
130419,1193494,1,19,3,2,0,145
130420,1193494,1,19,4,2,0,147
130421,1193494,1,19,5,1,0,148
130422,1193494,1,19,6,2,0,150
130423,1193494,1,20,1,0,0,150
130424,1193494,1,20,2,1,0,151
130425,1193494,1,20,3,1,0,152
130426,1193494,1,20,4,2,0,154
130427,1193494,1,20,5,6,0,160
130428,1193494,1,20,6,4,0,164
130549,1193495,1,1,1,6,0,6
130550,1193495,1,1,2,0,0,6
130551,1193495,1,1,3,0,0,6
130552,1193495,1,1,4,4,0,10
130553,1193495,1,1,5,2,0,12
130554,1193495,1,1,6,4,0,16
130555,1193495,1,2,1,1,0,17
130556,1193495,1,2,2,1,0,18
130557,1193495,1,2,3,1,0,19
130558,1193495,1,2,4,0,0,19
130559,1193495,1,2,5,0,0,19
130560,1193495,1,2,6,2,0,21
130561,1193495,1,3,1,0,0,21
130562,1193495,1,3,2,0,0,21
130563,1193495,1,3,3,4,0,25
130564,1193495,1,3,4,1,0,26
130565,1193495,1,3,5,1,0,27
130566,1193495,1,3,6,0,0,27
130567,1193495,1,4,1,1,0,28
130568,1193495,1,4,2,3,0,31
130569,1193495,1,4,3,0,0,31
130570,1193495,1,4,4,2,0,33
130571,1193495,1,4,5,4,0,37
130572,1193495,1,4,6,4,0,41
130573,1193495,1,5,1,1,0,42
130574,1193495,1,5,2,0,1,42
130575,1193495,1,5,3,0,1,42
130576,1193495,1,5,4,1,0,43
130577,1193495,1,5,5,0,0,43
130578,1193495,1,5,6,4,0,47
130579,1193495,1,6,1,0,0,47
130580,1193495,1,6,2,1,0,48
130581,1193495,1,6,3,0,0,48
130582,1193495,1,6,4,0,0,48
130583,1193495,1,6,5,4,0,52
130584,1193495,1,6,6,0,0,52
130585,1193495,1,7,1,0,0,52
130586,1193495,1,7,2,1,0,53
130587,1193495,1,7,3,1,0,54
130588,1193495,1,7,4,1,0,55
130589,1193495,1,7,5,1,0,56
130590,1193495,1,7,6,1,0,57
130591,1193495,1,8,1,2,0,59
130592,1193495,1,8,2,1,0,60
130593,1193495,1,8,3,0,0,60
130594,1193495,1,8,4,1,0,61
130595,1193495,1,8,5,0,0,61
130596,1193495,1,8,6,0,0,61
130597,1193495,1,9,1,1,0,62
130598,1193495,1,9,2,0,0,62
130599,1193495,1,9,3,0,0,62
130600,1193495,1,9,4,0,1,62
130601,1193495,1,9,5,0,0,62
130602,1193495,1,9,6,0,0,62
130603,1193495,1,10,1,4,0,66
130604,1193495,1,10,2,0,0,66
130605,1193495,1,10,3,0,0,66
130606,1193495,1,10,4,4,0,70
130607,1193495,1,10,5,4,0,74
130608,1193495,1,10,6,2,0,76
130609,1193495,1,11,1,0,0,76
130610,1193495,1,11,2,0,0,76
130611,1193495,1,11,3,1,0,77
130612,1193495,1,11,4,0,1,77
130613,1193495,1,11,5,0,0,77
130614,1193495,1,11,6,0,0,77
130615,1193495,1,12,1,1,0,78
130616,1193495,1,12,2,0,0,78
130617,1193495,1,12,3,1,0,79
130618,1193495,1,12,4,2,0,81
130619,1193495,1,12,5,0,0,81
130620,1193495,1,12,6,1,0,82
130621,1193495,1,13,1,6,0,88
130622,1193495,1,13,2,0,0,88
130623,1193495,1,13,3,0,1,88
130624,1193495,1,13,4,1,0,89
130625,1193495,1,13,5,3,0,92
130626,1193495,1,13,6,0,0,92
130627,1193495,1,14,1,0,0,92
130628,1193495,1,14,2,2,0,94
130629,1193495,1,14,3,1,0,95
130630,1193495,1,14,4,1,0,96
130631,1193495,1,14,5,0,0,96
130632,1193495,1,14,6,1,0,97
130633,1193495,1,15,1,0,1,97
130634,1193495,1,15,2,0,0,97
130635,1193495,1,15,3,0,0,97
130636,1193495,1,15,4,1,0,98
130637,1193495,1,15,5,2,0,100
130638,1193495,1,15,6,0,0,100
130639,1193495,1,16,1,1,0,101
130640,1193495,1,16,2,1,0,102
130641,1193495,1,16,3,1,0,103
130642,1193495,1,16,4,1,0,104
130643,1193495,1,16,5,0,0,104
130644,1193495,1,16,6,0,0,104
130645,1193495,1,17,1,1,0,105
130646,1193495,1,17,2,4,0,109
130647,1193495,1,17,3,7,0,116
130648,1193495,1,17,4,1,0,117
130649,1193495,1,17,5,1,0,118
130650,1193495,1,17,6,1,0,119
130651,1193495,1,18,1,1,0,120
130652,1193495,1,18,2,2,0,122
130653,1193495,1,18,3,1,0,123
130654,1193495,1,18,4,4,0,127
130655,1193495,1,18,5,1,0,128
130656,1193495,1,18,6,1,0,129
130657,1193495,1,19,1,1,0,130
130658,1193495,1,19,2,0,0,130
130659,1193495,1,19,3,1,0,131
130660,1193495,1,19,4,2,0,133
130661,1193495,1,19,5,1,0,134
130662,1193495,1,19,6,6,0,140
130663,1193495,1,20,1,0,0,140
130664,1193495,1,20,2,1,0,141
130665,1193495,1,20,3,0,1,141
130666,1193495,1,20,4,1,0,142
130667,1193495,1,20,5,1,0,143
130668,1193495,1,20,6,4,0,147
130789,1193496,1,1,1,1,0,1
130790,1193496,1,1,2,1,0,2
130791,1193496,1,1,3,0,0,2
130792,1193496,1,1,4,0,0,2
130793,1193496,1,1,5,1,1,3
130794,1193496,1,1,6,0,0,3
130795,1193496,1,2,1,1,0,4
130796,1193496,1,2,2,0,0,4
130797,1193496,1,2,3,1,0,5
130798,1193496,1,2,4,0,0,5
130799,1193496,1,2,5,0,0,5
130800,1193496,1,2,6,0,0,5
130801,1193496,1,3,1,0,0,5
130802,1193496,1,3,2,4,0,9
130803,1193496,1,3,3,0,0,9
130804,1193496,1,3,4,1,0,10
130805,1193496,1,3,5,2,0,12
130806,1193496,1,3,6,0,1,12
130807,1193496,1,4,1,6,0,18
130808,1193496,1,4,2,0,0,18
130809,1193496,1,4,3,0,0,18
130810,1193496,1,4,4,1,0,19
130811,1193496,1,4,5,0,0,19
130812,1193496,1,4,6,0,0,19
130813,1193496,1,5,1,0,0,19
130814,1193496,1,5,2,0,0,19
130815,1193496,1,5,3,4,0,23
130816,1193496,1,5,4,1,0,24
130817,1193496,1,5,5,0,0,24
130818,1193496,1,5,6,1,0,25
130819,1193496,1,6,1,6,0,31
130820,1193496,1,6,2,1,0,32
130821,1193496,1,6,3,0,0,32
130822,1193496,1,6,4,0,0,32
130823,1193496,1,6,5,0,0,32
130824,1193496,1,6,6,0,0,32
130825,1193496,1,7,1,3,0,35
130826,1193496,1,7,2,6,0,41
130827,1193496,1,7,3,1,0,42
130828,1193496,1,7,4,0,0,42
130829,1193496,1,7,5,0,0,42
130830,1193496,1,7,6,0,0,42
130831,1193496,1,8,1,1,0,43
130832,1193496,1,8,2,1,0,44
130833,1193496,1,8,3,0,1,44
130834,1193496,1,8,4,1,0,45
130835,1193496,1,8,5,0,0,45
130836,1193496,1,8,6,2,0,47
130837,1193496,1,9,1,1,0,48
130838,1193496,1,9,2,1,0,49
130839,1193496,1,9,3,1,0,50
130840,1193496,1,9,4,0,0,50
130841,1193496,1,9,5,0,0,50
130842,1193496,1,9,6,1,0,51
130843,1193496,1,10,1,1,0,52
130844,1193496,1,10,2,4,0,56
130845,1193496,1,10,3,4,0,60
130846,1193496,1,10,4,0,0,60
130847,1193496,1,10,5,1,0,61
130848,1193496,1,10,6,2,0,63
130849,1193496,1,11,1,0,0,63
130850,1193496,1,11,2,1,0,64
130851,1193496,1,11,3,2,0,66
130852,1193496,1,11,4,1,0,67
130853,1193496,1,11,5,1,0,68
130854,1193496,1,11,6,0,0,68
130855,1193496,1,12,1,1,0,69
130856,1193496,1,12,2,2,0,71
130857,1193496,1,12,3,1,0,72
130858,1193496,1,12,4,1,0,73
130859,1193496,1,12,5,1,0,74
130860,1193496,1,12,6,1,0,75
130861,1193496,1,13,1,1,0,76
130862,1193496,1,13,2,1,0,77
130863,1193496,1,13,3,0,0,77
130864,1193496,1,13,4,1,0,78
130865,1193496,1,13,5,4,0,82
130866,1193496,1,13,6,2,0,84
130867,1193496,1,14,1,4,0,88
130868,1193496,1,14,2,0,0,88
130869,1193496,1,14,3,6,0,94
130870,1193496,1,14,4,0,1,94
130871,1193496,1,14,5,0,0,94
130872,1193496,1,14,6,4,0,98
130873,1193496,1,15,1,0,0,98
130874,1193496,1,15,2,1,0,99
130875,1193496,1,15,3,2,0,101
130876,1193496,1,15,4,4,0,105
130877,1193496,1,15,5,1,0,106
130878,1193496,1,15,6,0,0,106
130879,1193496,1,16,1,7,0,113
130880,1193496,1,16,2,0,0,113
130881,1193496,1,16,3,1,0,114
130882,1193496,1,16,4,0,0,114
130883,1193496,1,16,5,0,0,114
130884,1193496,1,16,6,0,0,114
130885,1193496,1,17,1,6,0,120
130886,1193496,1,17,2,0,1,120
130887,1193496,1,17,3,1,0,121
130888,1193496,1,17,4,4,0,125
130889,1193496,1,17,5,0,0,125
130890,1193496,1,17,6,2,0,127
130891,1193496,1,18,1,0,0,127
130892,1193496,1,18,2,2,0,129
130893,1193496,1,18,3,6,0,135
130894,1193496,1,18,4,1,0,136
130895,1193496,1,18,5,4,0,140
130896,1193496,1,18,6,2,0,142
130897,1193496,1,19,1,0,1,142
130898,1193496,1,19,2,6,0,148
130899,1193496,1,19,3,1,0,149
130900,1193496,1,19,4,0,1,149
130901,1193496,1,19,5,1,0,150
130902,1193496,1,19,6,1,0,151
130903,1193496,1,20,1,0,1,151
130904,1193496,1,20,2,1,0,152
130905,1193496,1,20,3,1,0,153
130906,1193496,1,20,4,1,0,154
130907,1193496,1,20,5,1,0,155
130908,1193496,1,20,6,1,0,156
131029,1197140,1,1,1,4,0,4
131030,1197140,1,1,2,0,0,4
131031,1197140,1,1,3,1,0,5
131032,1197140,1,1,4,0,0,5
131033,1197140,1,1,5,1,0,6
131034,1197140,1,1,6,1,0,7
131035,1197140,1,2,1,0,1,7
131036,1197140,1,2,2,1,0,8
131037,1197140,1,2,3,1,0,9
131038,1197140,1,2,4,0,0,9
131039,1197140,1,2,5,0,0,9
131040,1197140,1,2,6,0,0,9
131041,1197140,1,3,1,0,0,9
131042,1197140,1,3,2,0,0,9
131043,1197140,1,3,3,0,0,9
131044,1197140,1,3,4,4,0,13
131045,1197140,1,3,5,4,0,17
131046,1197140,1,3,6,0,0,17
131047,1197140,1,4,1,1,0,18
131048,1197140,1,4,2,1,0,19
131049,1197140,1,4,3,0,0,19
131050,1197140,1,4,4,0,0,19
131051,1197140,1,4,5,0,0,19
131052,1197140,1,4,6,4,0,23
131053,1197140,1,5,1,1,0,24
131054,1197140,1,5,2,0,0,24
131055,1197140,1,5,3,1,0,25
131056,1197140,1,5,4,1,0,26
131057,1197140,1,5,5,4,0,30
131058,1197140,1,5,6,0,0,30
131059,1197140,1,6,1,4,0,34
131060,1197140,1,6,2,2,0,36
131061,1197140,1,6,3,1,0,37
131062,1197140,1,6,4,6,0,43
131063,1197140,1,6,5,4,0,47
131064,1197140,1,6,6,1,0,48
131065,1197140,1,7,1,1,0,49
131066,1197140,1,7,2,2,0,51
131067,1197140,1,7,3,0,0,51
131068,1197140,1,7,4,0,1,51
131069,1197140,1,7,5,0,0,51
131070,1197140,1,7,6,1,0,52
131071,1197140,1,8,1,1,0,53
131072,1197140,1,8,2,1,0,54
131073,1197140,1,8,3,1,0,55
131074,1197140,1,8,4,1,0,56
131075,1197140,1,8,5,0,1,56
131076,1197140,1,8,6,0,0,56
131077,1197140,1,9,1,0,1,56
131078,1197140,1,9,2,0,0,56
131079,1197140,1,9,3,0,0,56
131080,1197140,1,9,4,1,0,57
131081,1197140,1,9,5,1,0,58
131082,1197140,1,9,6,1,0,59
131083,1197140,1,10,1,4,0,63
131084,1197140,1,10,2,0,0,63
131085,1197140,1,10,3,0,1,63
131086,1197140,1,10,4,1,0,64
131087,1197140,1,10,5,0,0,64
131088,1197140,1,10,6,0,0,64
131089,1197140,1,11,1,0,0,64
131090,1197140,1,11,2,1,0,65
131091,1197140,1,11,3,1,0,66
131092,1197140,1,11,4,0,0,66
131093,1197140,1,11,5,1,0,67
131094,1197140,1,11,6,1,0,68
131095,1197140,1,12,1,1,0,69
131096,1197140,1,12,2,1,0,70
131097,1197140,1,12,3,0,0,70
131098,1197140,1,12,4,0,0,70
131099,1197140,1,12,5,1,0,71
131100,1197140,1,12,6,1,0,72
131101,1197140,1,13,1,1,0,73
131102,1197140,1,13,2,1,0,74
131103,1197140,1,13,3,0,0,74
131104,1197140,1,13,4,0,0,74
131105,1197140,1,13,5,2,0,76
131106,1197140,1,13,6,0,0,76
131107,1197140,1,14,1,1,0,77
131108,1197140,1,14,2,2,0,79
131109,1197140,1,14,3,0,0,79
131110,1197140,1,14,4,0,0,79
131111,1197140,1,14,5,2,0,81
131112,1197140,1,14,6,0,0,81
131113,1197140,1,15,1,1,0,82
131114,1197140,1,15,2,1,0,83
131115,1197140,1,15,3,6,0,89
131116,1197140,1,15,4,4,0,93
131117,1197140,1,15,5,2,0,95
131118,1197140,1,15,6,0,0,95
131119,1197140,1,16,1,6,0,101
131120,1197140,1,16,2,4,0,105
131121,1197140,1,16,3,4,0,109
131122,1197140,1,16,4,6,0,115
131123,1197140,1,16,5,4,0,119
131124,1197140,1,16,6,6,0,125
131125,1197140,1,17,1,1,0,126
131126,1197140,1,17,2,1,0,127
131127,1197140,1,17,3,1,0,128
131128,1197140,1,17,4,1,0,129
131129,1197140,1,17,5,6,0,135
131130,1197140,1,17,6,1,0,136
131131,1197140,1,18,1,1,0,137
131132,1197140,1,18,2,0,0,137
131133,1197140,1,18,3,1,0,138
131134,1197140,1,18,4,4,0,142
131135,1197140,1,18,5,0,0,142
131136,1197140,1,18,6,2,0,144
131243,1197141,1,1,1,1,0,1
131244,1197141,1,1,2,0,0,1
131245,1197141,1,1,3,1,0,2
131246,1197141,1,1,4,2,0,4
131247,1197141,1,1,5,1,0,5
131248,1197141,1,1,6,2,0,7
131249,1197141,1,2,1,0,0,7
131250,1197141,1,2,2,0,0,7
131251,1197141,1,2,3,0,0,7
131252,1197141,1,2,4,4,0,11
131253,1197141,1,2,5,4,0,15
131254,1197141,1,2,6,3,0,18
131255,1197141,1,3,1,0,0,18
131256,1197141,1,3,2,1,0,19
131257,1197141,1,3,3,0,0,19
131258,1197141,1,3,4,1,0,20
131259,1197141,1,3,5,2,0,22
131260,1197141,1,3,6,6,0,28
131261,1197141,1,4,1,0,0,28
131262,1197141,1,4,2,1,0,29
131263,1197141,1,4,3,4,0,33
131264,1197141,1,4,4,0,0,33
131265,1197141,1,4,5,4,0,37
131266,1197141,1,4,6,4,0,41
131267,1197141,1,5,1,6,0,47
131268,1197141,1,5,2,0,0,47
131269,1197141,1,5,3,0,0,47
131270,1197141,1,5,4,0,0,47
131271,1197141,1,5,5,1,0,48
131272,1197141,1,5,6,1,0,49
131273,1197141,1,6,1,1,0,50
131274,1197141,1,6,2,6,0,56
131275,1197141,1,6,3,1,0,57
131276,1197141,1,6,4,0,1,57
131277,1197141,1,6,5,0,0,57
131278,1197141,1,6,6,1,0,58
131279,1197141,1,7,1,1,0,59
131280,1197141,1,7,2,0,0,59
131281,1197141,1,7,3,0,0,59
131282,1197141,1,7,4,0,0,59
131283,1197141,1,7,5,1,0,60
131284,1197141,1,7,6,0,1,60
131285,1197141,1,8,1,0,0,60
131286,1197141,1,8,2,0,0,60
131287,1197141,1,8,3,1,0,61
131288,1197141,1,8,4,1,0,62
131289,1197141,1,8,5,6,0,68
131290,1197141,1,8,6,0,0,68
131291,1197141,1,9,1,0,0,68
131292,1197141,1,9,2,0,0,68
131293,1197141,1,9,3,1,0,69
131294,1197141,1,9,4,1,0,70
131295,1197141,1,9,5,1,0,71
131296,1197141,1,9,6,0,0,71
131297,1197141,1,10,1,1,0,72
131298,1197141,1,10,2,1,0,73
131299,1197141,1,10,3,0,0,73
131300,1197141,1,10,4,1,0,74
131301,1197141,1,10,5,0,0,74
131302,1197141,1,10,6,1,0,75
131303,1197141,1,11,1,1,0,76
131304,1197141,1,11,2,0,0,76
131305,1197141,1,11,3,1,0,77
131306,1197141,1,11,4,1,0,78
131307,1197141,1,11,5,1,0,79
131308,1197141,1,11,6,1,0,80
131309,1197141,1,12,1,0,0,80
131310,1197141,1,12,2,0,1,80
131311,1197141,1,12,3,0,0,80
131312,1197141,1,12,4,0,0,80
131313,1197141,1,12,5,1,0,81
131314,1197141,1,12,6,2,0,83
131315,1197141,1,13,1,0,0,83
131316,1197141,1,13,2,0,0,83
131317,1197141,1,13,3,1,0,84
131318,1197141,1,13,4,0,0,84
131319,1197141,1,13,5,0,0,84
131320,1197141,1,13,6,0,0,84
131321,1197141,1,14,1,6,0,90
131322,1197141,1,14,2,0,1,90
131323,1197141,1,14,3,6,0,96
131324,1197141,1,14,4,4,0,100
131325,1197141,1,14,5,1,0,101
131326,1197141,1,14,6,0,0,101
131327,1197141,1,15,1,0,0,101
131328,1197141,1,15,2,1,0,102
131329,1197141,1,15,3,1,0,103
131330,1197141,1,15,4,1,0,104
131331,1197141,1,15,5,3,0,107
131332,1197141,1,15,6,2,0,109
131333,1197141,1,16,1,1,0,110
131334,1197141,1,16,2,1,0,111
131335,1197141,1,16,3,1,0,112
131336,1197141,1,16,4,1,0,113
131337,1197141,1,16,5,4,0,117
131338,1197141,1,16,6,6,0,123
131339,1197141,1,17,1,1,0,124
131340,1197141,1,17,2,1,0,125
131341,1197141,1,17,3,6,0,131
131342,1197141,1,17,4,6,0,137
131343,1197141,1,17,5,6,0,143
131344,1197141,1,17,6,6,0,149
131345,1197141,1,18,1,6,0,155
131346,1197141,1,18,2,6,0,161
131347,1197141,1,18,3,6,0,167
131348,1197141,1,18,4,5,0,172
131349,1197141,1,18,5,1,0,173
131350,1197141,1,18,6,1,0,174
131351,1197141,1,19,1,1,0,175
131352,1197141,1,19,2,1,0,176
131353,1197141,1,19,3,1,0,177
131354,1197141,1,19,4,4,0,181
131355,1197141,1,19,5,2,0,183
131356,1197141,1,19,6,6,0,189
131357,1197141,1,20,1,2,0,191
131358,1197141,1,20,2,1,0,192
131359,1197141,1,20,3,0,0,192
131360,1197141,1,20,4,4,0,196
131361,1197141,1,20,5,1,0,197
131362,1197141,1,20,6,0,1,197
131483,1197142,1,1,1,0,1,0
131484,1197142,1,1,2,2,0,2
131485,1197142,1,1,3,1,0,3
131486,1197142,1,1,4,1,0,4
131487,1197142,1,1,5,0,0,4
131488,1197142,1,1,6,1,0,5
131489,1197142,1,2,1,4,0,9
131490,1197142,1,2,2,0,0,9
131491,1197142,1,2,3,1,0,10
131492,1197142,1,2,4,0,1,10
131493,1197142,1,2,5,0,0,10
131494,1197142,1,2,6,0,0,10
131495,1197142,1,3,1,1,0,11
131496,1197142,1,3,2,1,0,12
131497,1197142,1,3,3,1,0,13
131498,1197142,1,3,4,0,0,13
131499,1197142,1,3,5,6,0,19
131500,1197142,1,3,6,0,1,19
131501,1197142,1,4,1,0,0,19
131502,1197142,1,4,2,4,0,23
131503,1197142,1,4,3,0,0,23
131504,1197142,1,4,4,0,0,23
131505,1197142,1,4,5,0,0,23
131506,1197142,1,4,6,4,0,27
131507,1197142,1,5,1,0,0,27
131508,1197142,1,5,2,1,0,28
131509,1197142,1,5,3,0,0,28
131510,1197142,1,5,4,0,0,28
131511,1197142,1,5,5,4,0,32
131512,1197142,1,5,6,2,0,34
131513,1197142,1,6,1,1,0,35
131514,1197142,1,6,2,1,0,36
131515,1197142,1,6,3,4,0,40
131516,1197142,1,6,4,0,0,40
131517,1197142,1,6,5,0,1,40
131518,1197142,1,6,6,1,0,41
131519,1197142,1,7,1,0,0,41
131520,1197142,1,7,2,1,0,42
131521,1197142,1,7,3,0,0,42
131522,1197142,1,7,4,1,0,43
131523,1197142,1,7,5,0,0,43
131524,1197142,1,7,6,1,0,44
131525,1197142,1,8,1,0,0,44
131526,1197142,1,8,2,1,0,45
131527,1197142,1,8,3,2,0,47
131528,1197142,1,8,4,1,0,48
131529,1197142,1,8,5,1,0,49
131530,1197142,1,8,6,0,0,49
131531,1197142,1,9,1,0,0,49
131532,1197142,1,9,2,1,0,50
131533,1197142,1,9,3,0,0,50
131534,1197142,1,9,4,1,0,51
131535,1197142,1,9,5,0,0,51
131536,1197142,1,9,6,0,0,51
131537,1197142,1,10,1,0,0,51
131538,1197142,1,10,2,1,0,52
131539,1197142,1,10,3,4,0,56
131540,1197142,1,10,4,1,0,57
131541,1197142,1,10,5,2,0,59
131542,1197142,1,10,6,1,0,60
131543,1197142,1,11,1,2,0,62
131544,1197142,1,11,2,0,0,62
131545,1197142,1,11,3,2,0,64
131546,1197142,1,11,4,6,0,70
131547,1197142,1,11,5,0,0,70
131548,1197142,1,11,6,1,0,71
131549,1197142,1,12,1,1,0,72
131550,1197142,1,12,2,1,0,73
131551,1197142,1,12,3,1,0,74
131552,1197142,1,12,4,6,0,80
131553,1197142,1,12,5,1,0,81
131554,1197142,1,12,6,2,0,83
131555,1197142,1,13,1,4,0,87
131556,1197142,1,13,2,1,0,88
131557,1197142,1,13,3,0,0,88
131558,1197142,1,13,4,0,0,88
131559,1197142,1,13,5,1,0,89
131560,1197142,1,13,6,1,0,90
131561,1197142,1,14,1,0,0,90
131562,1197142,1,14,2,1,0,91
131563,1197142,1,14,3,1,0,92
131564,1197142,1,14,4,1,0,93
131565,1197142,1,14,5,0,0,93
131566,1197142,1,14,6,0,0,93
131567,1197142,1,15,1,2,0,95
131568,1197142,1,15,2,6,0,101
131569,1197142,1,15,3,1,0,102
131570,1197142,1,15,4,0,0,102
131571,1197142,1,15,5,6,0,108
131572,1197142,1,15,6,1,0,109
131573,1197142,1,16,1,6,0,115
131574,1197142,1,16,2,2,0,117
131575,1197142,1,16,3,1,0,118
131576,1197142,1,16,4,0,0,118
131577,1197142,1,16,5,1,0,119
131578,1197142,1,16,6,0,0,119
131579,1197142,1,17,1,0,0,119
131580,1197142,1,17,2,0,1,119
131581,1197142,1,17,3,2,0,121
131582,1197142,1,17,4,0,0,121
131583,1197142,1,17,5,0,1,121
131584,1197142,1,17,6,1,0,122
131585,1197142,1,18,1,1,0,123
131586,1197142,1,18,2,6,0,129
131587,1197142,1,18,3,4,0,133
131588,1197142,1,18,4,6,0,139
131589,1197142,1,18,5,4,0,143
131590,1197142,1,18,6,1,0,144
131591,1197142,1,19,1,3,0,147
131592,1197142,1,19,2,6,0,153
131593,1197142,1,19,3,0,0,153
131594,1197142,1,19,4,1,0,154
131595,1197142,1,19,5,1,0,155
131596,1197142,1,19,6,6,0,161
131597,1197142,1,20,1,0,0,161
131598,1197142,1,20,2,1,0,162
131599,1197142,1,20,3,0,0,162
131600,1197142,1,20,4,0,0,162
131601,1197142,1,20,5,1,0,163
131602,1197142,1,20,6,1,0,164
131722,1197143,1,1,1,1,0,1
131723,1197143,1,1,2,0,0,1
131724,1197143,1,1,3,0,0,1
131725,1197143,1,1,4,0,0,1
131726,1197143,1,1,5,0,0,1
131727,1197143,1,1,6,1,0,2
131728,1197143,1,2,1,4,0,6
131729,1197143,1,2,2,0,0,6
131730,1197143,1,2,3,0,0,6
131731,1197143,1,2,4,4,0,10
131732,1197143,1,2,5,1,0,11
131733,1197143,1,2,6,0,0,11
131734,1197143,1,3,1,6,0,17
131735,1197143,1,3,2,4,0,21
131736,1197143,1,3,3,6,0,27
131737,1197143,1,3,4,3,0,30
131738,1197143,1,3,5,1,0,31
131739,1197143,1,3,6,1,0,32
131740,1197143,1,4,1,1,0,33
131741,1197143,1,4,2,5,0,38
131742,1197143,1,4,3,0,0,38
131743,1197143,1,4,4,1,0,39
131744,1197143,1,4,5,1,0,40
131745,1197143,1,4,6,1,0,41
131746,1197143,1,5,1,3,0,44
131747,1197143,1,5,2,4,0,48
131748,1197143,1,5,3,0,0,48
131749,1197143,1,5,4,1,0,49
131750,1197143,1,5,5,0,1,49
131751,1197143,1,5,6,0,0,49
131752,1197143,1,6,1,1,0,50
131753,1197143,1,6,2,4,0,54
131754,1197143,1,6,3,0,0,54
131755,1197143,1,6,4,1,0,55
131756,1197143,1,6,5,0,1,55
131757,1197143,1,6,6,0,0,55
131758,1197143,1,7,1,1,0,56
131759,1197143,1,7,2,3,0,59
131760,1197143,1,7,3,1,0,60
131761,1197143,1,7,4,1,0,61
131762,1197143,1,7,5,1,0,62
131763,1197143,1,7,6,1,0,63
131764,1197143,1,8,1,2,0,65
131765,1197143,1,8,2,0,1,65
131766,1197143,1,8,3,6,0,71
131767,1197143,1,8,4,0,0,71
131768,1197143,1,8,5,1,0,72
131769,1197143,1,8,6,4,0,76
131770,1197143,1,9,1,0,0,76
131771,1197143,1,9,2,0,0,76
131772,1197143,1,9,3,1,0,77
131773,1197143,1,9,4,1,0,78
131774,1197143,1,9,5,1,0,79
131775,1197143,1,9,6,0,0,79
131776,1197143,1,10,1,2,0,81
131777,1197143,1,10,2,0,0,81
131778,1197143,1,10,3,0,0,81
131779,1197143,1,10,4,0,0,81
131780,1197143,1,10,5,2,0,83
131781,1197143,1,10,6,0,0,83
131782,1197143,1,11,1,1,0,84
131783,1197143,1,11,2,1,0,85
131784,1197143,1,11,3,4,0,89
131785,1197143,1,11,4,1,0,90
131786,1197143,1,11,5,1,0,91
131787,1197143,1,11,6,2,0,93
131788,1197143,1,12,1,1,0,94
131789,1197143,1,12,2,1,0,95
131790,1197143,1,12,3,1,0,96
131791,1197143,1,12,4,4,0,100
131792,1197143,1,12,5,1,0,101
131793,1197143,1,12,6,1,0,102
131794,1197143,1,13,1,6,0,108
131795,1197143,1,13,2,1,0,109
131796,1197143,1,13,3,0,0,109
131797,1197143,1,13,4,1,0,110
131798,1197143,1,13,5,1,0,111
131799,1197143,1,13,6,1,0,112
131800,1197143,1,14,1,1,0,113
131801,1197143,1,14,2,1,0,114
131802,1197143,1,14,3,0,0,114
131803,1197143,1,14,4,0,0,114
131804,1197143,1,14,5,6,0,120
131805,1197143,1,14,6,1,0,121
131806,1197143,1,15,1,2,0,123
131807,1197143,1,15,2,1,0,124
131808,1197143,1,15,3,1,0,125
131809,1197143,1,15,4,6,0,131
131810,1197143,1,15,5,1,0,132
131811,1197143,1,15,6,2,0,134
131812,1197143,1,16,1,1,0,135
131813,1197143,1,16,2,4,0,139
131814,1197143,1,16,3,1,0,140
131815,1197143,1,16,4,0,0,140
131816,1197143,1,16,5,1,0,141
131817,1197143,1,16,6,1,0,142
131818,1197143,1,17,1,1,0,143
131819,1197143,1,17,2,0,0,143
131820,1197143,1,17,3,0,1,143
131821,1197143,1,17,4,1,0,144
131822,1197143,1,17,5,1,0,145
131823,1197143,1,17,6,1,0,146
131824,1197143,1,18,1,0,0,146
131825,1197143,1,18,2,0,0,146
131826,1197143,1,18,3,2,0,148
131827,1197143,1,18,4,1,0,149
131828,1197143,1,18,5,1,0,150
131829,1197143,1,18,6,2,0,152
131830,1197143,1,19,1,0,0,152
131831,1197143,1,19,2,6,0,158
131832,1197143,1,19,3,1,0,159
131833,1197143,1,19,4,0,1,159
131834,1197143,1,19,5,1,0,160
131835,1197143,1,19,6,6,0,166
131836,1197143,1,20,1,1,0,167
131837,1197143,1,20,2,2,0,169
131838,1197143,1,20,3,0,1,169
131839,1197143,1,20,4,0,1,169
131840,1197143,1,20,5,2,0,171
131841,1197143,1,20,6,4,0,175
131962,1197144,1,1,1,0,0,0
131963,1197144,1,1,2,0,0,0
131964,1197144,1,1,3,0,0,0
131965,1197144,1,1,4,0,0,0
131966,1197144,1,1,5,2,0,2
131967,1197144,1,1,6,0,0,2
131968,1197144,1,2,1,0,0,2
131969,1197144,1,2,2,6,0,8
131970,1197144,1,2,3,1,0,9
131971,1197144,1,2,4,6,0,15
131972,1197144,1,2,5,1,0,16
131973,1197144,1,2,6,0,0,16
131974,1197144,1,3,1,0,0,16
131975,1197144,1,3,2,0,0,16
131976,1197144,1,3,3,2,0,18
131977,1197144,1,3,4,0,0,18
131978,1197144,1,3,5,6,0,24
131979,1197144,1,3,6,1,0,25
131980,1197144,1,4,1,1,0,26
131981,1197144,1,4,2,4,0,30
131982,1197144,1,4,3,4,0,34
131983,1197144,1,4,4,0,0,34
131984,1197144,1,4,5,4,0,38
131985,1197144,1,4,6,0,0,38
131986,1197144,1,5,1,6,0,44
131987,1197144,1,5,2,1,0,45
131988,1197144,1,5,3,0,0,45
131989,1197144,1,5,4,4,0,49
131990,1197144,1,5,5,0,0,49
131991,1197144,1,5,6,1,0,50
131992,1197144,1,6,1,0,0,50
131993,1197144,1,6,2,0,0,50
131994,1197144,1,6,3,1,0,51
131995,1197144,1,6,4,1,0,52
131996,1197144,1,6,5,1,0,53
131997,1197144,1,6,6,2,0,55
131998,1197144,1,7,1,0,0,55
131999,1197144,1,7,2,0,0,55
132000,1197144,1,7,3,0,0,55
132001,1197144,1,7,4,1,0,56
132002,1197144,1,7,5,6,0,62
132003,1197144,1,7,6,0,0,62
132004,1197144,1,8,1,4,0,66
132005,1197144,1,8,2,6,0,72
132006,1197144,1,8,3,1,0,73
132007,1197144,1,8,4,0,0,73
132008,1197144,1,8,5,1,0,74
132009,1197144,1,8,6,1,0,75
132010,1197144,1,9,1,0,0,75
132011,1197144,1,9,2,0,0,75
132012,1197144,1,9,3,4,0,79
132013,1197144,1,9,4,0,0,79
132014,1197144,1,9,5,1,0,80
132015,1197144,1,9,6,1,0,81
132016,1197144,1,10,1,1,0,82
132017,1197144,1,10,2,1,0,83
132018,1197144,1,10,3,0,1,83
132019,1197144,1,10,4,0,0,83
132020,1197144,1,10,5,1,0,84
132021,1197144,1,10,6,0,0,84
132022,1197144,1,11,1,0,0,84
132023,1197144,1,11,2,1,0,85
132024,1197144,1,11,3,0,0,85
132025,1197144,1,11,4,2,0,87
132026,1197144,1,11,5,1,0,88
132027,1197144,1,11,6,0,0,88
132028,1197144,1,12,1,4,0,92
132029,1197144,1,12,2,0,0,92
132030,1197144,1,12,3,0,0,92
132031,1197144,1,12,4,2,0,94
132032,1197144,1,12,5,6,0,100
132033,1197144,1,12,6,0,0,100
132034,1197144,1,13,1,1,0,101
132035,1197144,1,13,2,1,0,102
132036,1197144,1,13,3,4,0,106
132037,1197144,1,13,4,1,0,107
132038,1197144,1,13,5,0,0,107
132039,1197144,1,13,6,0,1,107
132040,1197144,1,14,1,1,0,108
132041,1197144,1,14,2,1,0,109
132042,1197144,1,14,3,4,0,113
132043,1197144,1,14,4,2,0,115
132044,1197144,1,14,5,1,0,116
132045,1197144,1,14,6,0,1,116
132046,1197144,1,15,1,0,0,116
132047,1197144,1,15,2,0,0,116
132048,1197144,1,15,3,1,0,117
132049,1197144,1,15,4,4,0,121
132050,1197144,1,15,5,0,1,121
132051,1197144,1,15,6,1,0,122
132052,1197144,1,16,1,1,0,123
132053,1197144,1,16,2,1,0,124
132054,1197144,1,16,3,0,1,124
132055,1197144,1,16,4,0,0,124
132056,1197144,1,16,5,0,0,124
132057,1197144,1,16,6,1,0,125
132058,1197144,1,17,1,0,0,125
132059,1197144,1,17,2,1,0,126
132060,1197144,1,17,3,1,0,127
132061,1197144,1,17,4,1,0,128
132062,1197144,1,17,5,1,0,129
132063,1197144,1,17,6,1,0,130
132064,1197144,1,18,1,0,0,130
132065,1197144,1,18,2,0,0,130
132066,1197144,1,18,3,1,0,131
132067,1197144,1,18,4,6,0,137
132068,1197144,1,18,5,1,0,138
132069,1197144,1,18,6,1,0,139
132070,1197144,1,19,1,1,0,140
132071,1197144,1,19,2,0,0,140
132072,1197144,1,19,3,0,1,140
132073,1197144,1,19,4,6,0,146
132074,1197144,1,19,5,0,0,146
132075,1197144,1,19,6,1,0,147
132076,1197144,1,20,1,6,0,153
132077,1197144,1,20,2,1,0,154
132078,1197144,1,20,3,0,1,154
132079,1197144,1,20,4,1,0,155
132080,1197144,1,20,5,0,1,155
132081,1197144,1,20,6,0,0,155
132199,1197145,1,1,1,2,0,2
132200,1197145,1,1,2,0,0,2
132201,1197145,1,1,3,0,0,2
132202,1197145,1,1,4,0,0,2
132203,1197145,1,1,5,0,0,2
132204,1197145,1,1,6,4,0,6
132205,1197145,1,2,1,0,0,6
132206,1197145,1,2,2,0,0,6
132207,1197145,1,2,3,0,0,6
132208,1197145,1,2,4,1,0,7
132209,1197145,1,2,5,1,0,8
132210,1197145,1,2,6,0,0,8
132211,1197145,1,3,1,1,0,9
132212,1197145,1,3,2,0,0,9
132213,1197145,1,3,3,1,0,10
132214,1197145,1,3,4,0,0,10
132215,1197145,1,3,5,1,0,11
132216,1197145,1,3,6,1,0,12
132217,1197145,1,4,1,4,0,16
132218,1197145,1,4,2,4,0,20
132219,1197145,1,4,3,1,0,21
132220,1197145,1,4,4,4,0,25
132221,1197145,1,4,5,0,0,25
132222,1197145,1,4,6,0,0,25
132223,1197145,1,5,1,0,0,25
132224,1197145,1,5,2,0,0,25
132225,1197145,1,5,3,0,0,25
132226,1197145,1,5,4,0,0,25
132227,1197145,1,5,5,0,0,25
132228,1197145,1,5,6,1,0,26
132229,1197145,1,6,1,4,0,30
132230,1197145,1,6,2,4,0,34
132231,1197145,1,6,3,0,0,34
132232,1197145,1,6,4,2,0,36
132233,1197145,1,6,5,0,0,36
132234,1197145,1,6,6,6,0,42
132235,1197145,1,7,1,0,0,42
132236,1197145,1,7,2,6,0,48
132237,1197145,1,7,3,1,0,49
132238,1197145,1,7,4,0,0,49
132239,1197145,1,7,5,2,0,51
132240,1197145,1,7,6,0,0,51
132241,1197145,1,8,1,4,0,55
132242,1197145,1,8,2,1,0,56
132243,1197145,1,8,3,1,0,57
132244,1197145,1,8,4,6,0,63
132245,1197145,1,8,5,1,0,64
132246,1197145,1,8,6,1,0,65
132247,1197145,1,9,1,0,0,65
132248,1197145,1,9,2,6,0,71
132249,1197145,1,9,3,1,0,72
132250,1197145,1,9,4,1,0,73
132251,1197145,1,9,5,1,0,74
132252,1197145,1,9,6,1,0,75
132253,1197145,1,10,1,0,0,75
132254,1197145,1,10,2,0,0,75
132255,1197145,1,10,3,0,1,75
132256,1197145,1,10,4,0,0,75
132257,1197145,1,10,5,0,1,75
132258,1197145,1,10,6,0,0,75
132259,1197145,1,11,1,1,0,76
132260,1197145,1,11,2,0,0,76
132261,1197145,1,11,3,4,0,80
132262,1197145,1,11,4,0,1,80
132263,1197145,1,11,5,2,0,82
132264,1197145,1,11,6,1,0,83
132265,1197145,1,12,1,1,0,84
132266,1197145,1,12,2,0,0,84
132267,1197145,1,12,3,0,0,84
132268,1197145,1,12,4,0,0,84
132269,1197145,1,12,5,1,0,85
132270,1197145,1,12,6,1,0,86
132271,1197145,1,13,1,1,0,87
132272,1197145,1,13,2,0,0,87
132273,1197145,1,13,3,1,0,88
132274,1197145,1,13,4,0,1,88
132275,1197145,1,13,5,1,0,89
132276,1197145,1,13,6,1,0,90
132277,1197145,1,14,1,6,0,96
132278,1197145,1,14,2,0,1,96
132279,1197145,1,14,3,0,0,96
132280,1197145,1,14,4,0,0,96
132281,1197145,1,14,5,0,0,96
132282,1197145,1,14,6,0,0,96
132283,1197145,1,15,1,1,0,97
132284,1197145,1,15,2,6,0,103
132285,1197145,1,15,3,1,0,104
132286,1197145,1,15,4,0,0,104
132287,1197145,1,15,5,2,0,106
132288,1197145,1,15,6,1,0,107
132289,1197145,1,16,1,1,0,108
132290,1197145,1,16,2,0,0,108
132291,1197145,1,16,3,1,0,109
132292,1197145,1,16,4,0,1,109
132293,1197145,1,16,5,1,0,110
132294,1197145,1,16,6,0,0,110
132295,1197145,1,17,1,1,0,111
132296,1197145,1,17,2,1,0,112
132297,1197145,1,17,3,1,0,113
132298,1197145,1,17,4,1,0,114
132299,1197145,1,17,5,0,1,114
132300,1197145,1,17,6,0,0,114
132301,1197145,1,18,1,1,0,115
132302,1197145,1,18,2,2,0,117
132303,1197145,1,18,3,0,0,117
132304,1197145,1,18,4,2,0,119
132305,1197145,1,18,5,1,0,120
132306,1197145,1,18,6,4,0,124
132307,1197145,1,19,1,0,0,124
132308,1197145,1,19,2,0,0,124
132309,1197145,1,19,3,1,0,125
132310,1197145,1,19,4,1,0,126
132311,1197145,1,19,5,2,0,128
132312,1197145,1,19,6,1,0,129
132313,1197145,1,20,1,0,0,129
132314,1197145,1,20,2,1,0,130
132315,1197145,1,20,3,4,0,134
132316,1197145,1,20,4,2,0,136
132317,1197145,1,20,5,1,0,137
132318,1197145,1,20,6,1,0,138
132433,1197521,1,1,1,4,0,4
132434,1197521,1,1,2,2,0,6
132435,1197521,1,1,3,0,0,6
132436,1197521,1,1,4,1,0,7
132437,1197521,1,1,5,4,0,11
132438,1197521,1,1,6,0,0,11
132439,1197521,1,2,1,0,0,11
132440,1197521,1,2,2,0,0,11
132441,1197521,1,2,3,4,0,15
132442,1197521,1,2,4,4,0,19
132443,1197521,1,2,5,0,1,19
132444,1197521,1,2,6,4,0,23
132445,1197521,1,3,1,1,0,24
132446,1197521,1,3,2,1,0,25
132447,1197521,1,3,3,6,0,31
132448,1197521,1,3,4,0,0,31
132449,1197521,1,3,5,0,0,31
132450,1197521,1,3,6,0,0,31
132451,1197521,1,4,1,0,0,31
132452,1197521,1,4,2,1,0,32
132453,1197521,1,4,3,1,0,33
132454,1197521,1,4,4,0,0,33
132455,1197521,1,4,5,4,0,37
132456,1197521,1,4,6,0,0,37
132457,1197521,1,5,1,2,0,39
132458,1197521,1,5,2,0,0,39
132459,1197521,1,5,3,4,0,43
132460,1197521,1,5,4,1,0,44
132461,1197521,1,5,5,0,0,44
132462,1197521,1,5,6,0,0,44
132463,1197521,1,6,1,4,0,48
132464,1197521,1,6,2,0,0,48
132465,1197521,1,6,3,1,0,49
132466,1197521,1,6,4,4,0,53
132467,1197521,1,6,5,0,0,53
132468,1197521,1,6,6,1,0,54
132469,1197521,1,7,1,1,0,55
132470,1197521,1,7,2,2,0,57
132471,1197521,1,7,3,6,0,63
132472,1197521,1,7,4,1,0,64
132473,1197521,1,7,5,4,0,68
132474,1197521,1,7,6,1,1,69
132475,1197521,1,8,1,0,0,69
132476,1197521,1,8,2,1,0,70
132477,1197521,1,8,3,2,0,72
132478,1197521,1,8,4,1,0,73
132479,1197521,1,8,5,1,0,74
132480,1197521,1,8,6,1,0,75
132481,1197521,1,9,1,4,0,79
132482,1197521,1,9,2,4,0,83
132483,1197521,1,9,3,1,0,84
132484,1197521,1,9,4,1,0,85
132485,1197521,1,9,5,1,0,86
132486,1197521,1,9,6,0,0,86
132487,1197521,1,10,1,0,0,86
132488,1197521,1,10,2,1,0,87
132489,1197521,1,10,3,0,0,87
132490,1197521,1,10,4,1,0,88
132491,1197521,1,10,5,1,0,89
132492,1197521,1,10,6,4,0,93
132493,1197521,1,11,1,1,0,94
132494,1197521,1,11,2,4,0,98
132495,1197521,1,11,3,1,0,99
132496,1197521,1,11,4,2,0,101
132497,1197521,1,11,5,1,0,102
132498,1197521,1,11,6,1,0,103
132499,1197521,1,12,1,1,0,104
132500,1197521,1,12,2,1,0,105
132501,1197521,1,12,3,1,0,106
132502,1197521,1,12,4,4,0,110
132503,1197521,1,12,5,1,0,111
132504,1197521,1,12,6,1,0,112
132505,1197521,1,13,1,4,0,116
132506,1197521,1,13,2,1,0,117
132507,1197521,1,13,3,1,0,118
132508,1197521,1,13,4,1,0,119
132509,1197521,1,13,5,1,0,120
132510,1197521,1,13,6,2,0,122
132511,1197521,1,14,1,1,0,123
132512,1197521,1,14,2,1,0,124
132513,1197521,1,14,3,0,1,124
132514,1197521,1,14,4,2,0,126
132515,1197521,1,14,5,1,0,127
132516,1197521,1,14,6,0,0,127
132517,1197521,1,15,1,1,0,128
132518,1197521,1,15,2,0,0,128
132519,1197521,1,15,3,1,0,129
132520,1197521,1,15,4,0,0,129
132521,1197521,1,15,5,0,0,129
132522,1197521,1,15,6,1,0,130
132523,1197521,1,16,1,1,0,131
132524,1197521,1,16,2,6,0,137
132525,1197521,1,16,3,1,0,138
132526,1197521,1,16,4,0,0,138
132527,1197521,1,16,5,1,0,139
132528,1197521,1,16,6,4,0,143
132529,1197521,1,17,1,2,0,145
132530,1197521,1,17,2,2,0,147
132531,1197521,1,17,3,1,0,148
132532,1197521,1,17,4,2,0,150
132533,1197521,1,17,5,2,0,152
132534,1197521,1,17,6,0,0,152
132535,1197521,1,18,1,0,0,152
132536,1197521,1,18,2,1,0,153
132537,1197521,1,18,3,2,0,155
132538,1197521,1,18,4,0,0,155
132539,1197521,1,18,5,1,0,156
132540,1197521,1,18,6,1,0,157
132541,1197521,1,19,1,0,1,157
132542,1197521,1,19,2,0,0,157
132543,1197521,1,19,3,1,0,158
132544,1197521,1,19,4,1,0,159
132545,1197521,1,19,5,0,1,159
132546,1197521,1,19,6,1,0,160
132547,1197521,1,20,1,1,0,161
132548,1197521,1,20,2,1,0,162
132549,1197521,1,20,3,0,1,162
132550,1197521,1,20,4,1,0,163
132551,1197521,1,20,5,0,1,163
132552,1197521,1,20,6,4,0,167
132663,1197524,1,1,1,2,0,2
132664,1197524,1,1,2,1,0,3
132665,1197524,1,1,3,1,0,4
132666,1197524,1,1,4,1,0,5
132667,1197524,1,1,5,0,0,5
132668,1197524,1,1,6,4,0,9
132669,1197524,1,2,1,0,1,9
132670,1197524,1,2,2,1,0,10
132671,1197524,1,2,3,0,0,10
132672,1197524,1,2,4,1,0,11
132673,1197524,1,2,5,0,0,11
132674,1197524,1,2,6,0,0,11
132675,1197524,1,3,1,0,0,11
132676,1197524,1,3,2,0,0,11
132677,1197524,1,3,3,0,0,11
132678,1197524,1,3,4,2,0,13
132679,1197524,1,3,5,4,0,17
132680,1197524,1,3,6,6,0,23
132681,1197524,1,4,1,2,0,25
132682,1197524,1,4,2,4,0,29
132683,1197524,1,4,3,0,0,29
132684,1197524,1,4,4,1,0,30
132685,1197524,1,4,5,2,0,32
132686,1197524,1,4,6,0,0,32
132687,1197524,1,5,1,0,0,32
132688,1197524,1,5,2,4,0,36
132689,1197524,1,5,3,4,0,40
132690,1197524,1,5,4,1,0,41
132691,1197524,1,5,5,0,0,41
132692,1197524,1,5,6,6,0,47
132693,1197524,1,6,1,0,0,47
132694,1197524,1,6,2,2,0,49
132695,1197524,1,6,3,1,0,50
132696,1197524,1,6,4,0,1,50
132697,1197524,1,6,5,0,0,50
132698,1197524,1,6,6,1,0,51
132699,1197524,1,7,1,0,0,51
132700,1197524,1,7,2,0,0,51
132701,1197524,1,7,3,0,0,51
132702,1197524,1,7,4,1,0,52
132703,1197524,1,7,5,2,0,54
132704,1197524,1,7,6,0,0,54
132705,1197524,1,8,1,1,0,55
132706,1197524,1,8,2,1,0,56
132707,1197524,1,8,3,0,0,56
132708,1197524,1,8,4,0,0,56
132709,1197524,1,8,5,1,0,57
132710,1197524,1,8,6,1,0,58
132711,1197524,1,9,1,2,0,60
132712,1197524,1,9,2,1,0,61
132713,1197524,1,9,3,6,0,67
132714,1197524,1,9,4,4,0,71
132715,1197524,1,9,5,1,0,72
132716,1197524,1,9,6,0,0,72
132717,1197524,1,10,1,6,0,78
132718,1197524,1,10,2,0,0,78
132719,1197524,1,10,3,1,0,79
132720,1197524,1,10,4,0,0,79
132721,1197524,1,10,5,2,0,81
132722,1197524,1,10,6,0,0,81
132723,1197524,1,11,1,2,0,83
132724,1197524,1,11,2,1,0,84
132725,1197524,1,11,3,1,0,85
132726,1197524,1,11,4,1,0,86
132727,1197524,1,11,5,1,0,87
132728,1197524,1,11,6,1,0,88
132729,1197524,1,12,1,0,0,88
132730,1197524,1,12,2,1,0,89
132731,1197524,1,12,3,1,0,90
132732,1197524,1,12,4,1,0,91
132733,1197524,1,12,5,2,0,93
132734,1197524,1,12,6,1,0,94
132735,1197524,1,13,1,0,0,94
132736,1197524,1,13,2,1,0,95
132737,1197524,1,13,3,1,0,96
132738,1197524,1,13,4,1,0,97
132739,1197524,1,13,5,0,1,97
132740,1197524,1,13,6,0,0,97
132741,1197524,1,14,1,0,0,97
132742,1197524,1,14,2,1,0,98
132743,1197524,1,14,3,1,0,99
132744,1197524,1,14,4,2,0,101
132745,1197524,1,14,5,1,0,102
132746,1197524,1,14,6,1,0,103
132747,1197524,1,15,1,1,0,104
132748,1197524,1,15,2,0,1,104
132749,1197524,1,15,3,0,0,104
132750,1197524,1,15,4,1,0,105
132751,1197524,1,15,5,0,0,105
132752,1197524,1,15,6,0,0,105
132753,1197524,1,16,1,0,0,105
132754,1197524,1,16,2,0,1,105
132755,1197524,1,16,3,0,0,105
132756,1197524,1,16,4,1,0,106
132757,1197524,1,16,5,1,0,107
132758,1197524,1,16,6,2,0,109
132759,1197524,1,17,1,0,0,109
132760,1197524,1,17,2,1,0,110
132761,1197524,1,17,3,2,0,112
132762,1197524,1,17,4,0,0,112
132763,1197524,1,17,5,1,0,113
132764,1197524,1,17,6,1,0,114
132765,1197524,1,18,1,4,0,118
132766,1197524,1,18,2,0,1,118
132767,1197524,1,18,3,1,0,119
132768,1197524,1,18,4,1,1,120
132769,1197524,1,18,5,1,0,121
132770,1197524,1,18,6,1,0,122
132771,1197524,1,19,1,1,0,123
132772,1197524,1,19,2,1,0,124
132773,1197524,1,19,3,1,0,125
132774,1197524,1,19,4,0,0,125
132775,1197524,1,19,5,1,0,126
132776,1197524,1,19,6,1,1,127
132777,1197524,1,20,1,6,0,133
132778,1197524,1,20,2,0,1,133
132779,1197524,1,20,3,0,1,133
132899,1197526,1,1,1,0,0,0
132900,1197526,1,1,2,1,0,1
132901,1197526,1,1,3,0,0,1
132902,1197526,1,1,4,1,0,2
132903,1197526,1,1,5,0,0,2
132904,1197526,1,1,6,0,0,2
132905,1197526,1,2,1,0,0,2
132906,1197526,1,2,2,4,0,6
132907,1197526,1,2,3,0,0,6
132908,1197526,1,2,4,1,1,7
132909,1197526,1,2,5,0,0,7
132910,1197526,1,2,6,0,0,7
132911,1197526,1,3,1,2,0,9
132912,1197526,1,3,2,6,0,15
132913,1197526,1,3,3,1,0,16
132914,1197526,1,3,4,0,0,16
132915,1197526,1,3,5,6,0,22
132916,1197526,1,3,6,1,0,23
132917,1197526,1,4,1,2,0,25
132918,1197526,1,4,2,0,0,25
132919,1197526,1,4,3,0,0,25
132920,1197526,1,4,4,4,0,29
132921,1197526,1,4,5,4,0,33
132922,1197526,1,4,6,0,0,33
132923,1197526,1,5,1,4,0,37
132924,1197526,1,5,2,0,0,37
132925,1197526,1,5,3,0,0,37
132926,1197526,1,5,4,0,0,37
132927,1197526,1,5,5,0,0,37
132928,1197526,1,5,6,4,0,41
132929,1197526,1,6,1,0,0,41
132930,1197526,1,6,2,4,0,45
132931,1197526,1,6,3,1,0,46
132932,1197526,1,6,4,1,0,47
132933,1197526,1,6,5,0,0,47
132934,1197526,1,6,6,0,0,47
132935,1197526,1,7,1,0,0,47
132936,1197526,1,7,2,6,0,53
132937,1197526,1,7,3,4,0,57
132938,1197526,1,7,4,1,0,58
132939,1197526,1,7,5,0,0,58
132940,1197526,1,7,6,1,0,59
132941,1197526,1,8,1,1,0,60
132942,1197526,1,8,2,1,0,61
132943,1197526,1,8,3,4,0,65
132944,1197526,1,8,4,1,0,66
132945,1197526,1,8,5,1,0,67
132946,1197526,1,8,6,4,0,71
132947,1197526,1,9,1,1,0,72
132948,1197526,1,9,2,1,0,73
132949,1197526,1,9,3,0,0,73
132950,1197526,1,9,4,0,0,73
132951,1197526,1,9,5,0,0,73
132952,1197526,1,9,6,1,0,74
132953,1197526,1,10,1,4,0,78
132954,1197526,1,10,2,1,0,79
132955,1197526,1,10,3,1,0,80
132956,1197526,1,10,4,4,0,84
132957,1197526,1,10,5,1,0,85
132958,1197526,1,10,6,2,0,87
132959,1197526,1,11,1,2,0,89
132960,1197526,1,11,2,1,0,90
132961,1197526,1,11,3,1,0,91
132962,1197526,1,11,4,1,0,92
132963,1197526,1,11,5,1,0,93
132964,1197526,1,11,6,1,0,94
132965,1197526,1,12,1,0,0,94
132966,1197526,1,12,2,1,0,95
132967,1197526,1,12,3,0,1,95
132968,1197526,1,12,4,1,0,96
132969,1197526,1,12,5,0,1,96
132970,1197526,1,12,6,0,0,96
132971,1197526,1,13,1,0,0,96
132972,1197526,1,13,2,1,0,97
132973,1197526,1,13,3,4,0,101
132974,1197526,1,13,4,0,0,101
132975,1197526,1,13,5,0,0,101
132976,1197526,1,13,6,3,0,104
132977,1197526,1,14,1,0,0,104
132978,1197526,1,14,2,1,0,105
132979,1197526,1,14,3,0,0,105
132980,1197526,1,14,4,1,0,106
132981,1197526,1,14,5,1,0,107
132982,1197526,1,14,6,1,0,108
132983,1197526,1,15,1,1,0,109
132984,1197526,1,15,2,1,0,110
132985,1197526,1,15,3,2,0,112
132986,1197526,1,15,4,0,0,112
132987,1197526,1,15,5,0,1,112
132988,1197526,1,15,6,0,0,112
132989,1197526,1,16,1,1,0,113
132990,1197526,1,16,2,0,1,113
132991,1197526,1,16,3,0,1,113
132992,1197526,1,16,4,1,0,114
132993,1197526,1,16,5,0,0,114
132994,1197526,1,16,6,2,0,116
132995,1197526,1,17,1,0,0,116
132996,1197526,1,17,2,1,0,117
132997,1197526,1,17,3,0,0,117
132998,1197526,1,17,4,1,0,118
132999,1197526,1,17,5,0,0,118
133000,1197526,1,17,6,1,0,119
133001,1197526,1,18,1,0,0,119
133002,1197526,1,18,2,1,0,120
133003,1197526,1,18,3,1,0,121
133004,1197526,1,18,4,1,0,122
133005,1197526,1,18,5,0,1,122
133006,1197526,1,18,6,1,0,123
133007,1197526,1,19,1,0,0,123
133008,1197526,1,19,2,1,0,124
133009,1197526,1,19,3,0,1,124
133010,1197526,1,19,4,1,0,125
133011,1197526,1,19,5,1,0,126
133012,1197526,1,19,6,1,0,127
133013,1197526,1,20,1,6,0,133
133014,1197526,1,20,2,2,0,135
133015,1197526,1,20,3,6,0,141
133016,1197526,1,20,4,0,0,141
133017,1197526,1,20,5,2,0,143
133018,1197526,1,20,6,2,0,145
133138,1198235,1,1,1,1,0,1
133139,1198235,1,1,2,0,0,1
133140,1198235,1,1,3,2,0,3
133141,1198235,1,1,4,1,0,4
133142,1198235,1,1,5,0,0,4
133143,1198235,1,1,6,4,0,8
133144,1198235,1,2,1,0,0,8
133145,1198235,1,2,2,6,0,14
133146,1198235,1,2,3,4,0,18
133147,1198235,1,2,4,0,0,18
133148,1198235,1,2,5,0,0,18
133149,1198235,1,2,6,6,0,24
133150,1198235,1,3,1,0,0,24
133151,1198235,1,3,2,1,0,25
133152,1198235,1,3,3,2,0,27
133153,1198235,1,3,4,4,0,31
133154,1198235,1,3,5,0,0,31
133155,1198235,1,3,6,4,0,35
133156,1198235,1,4,1,1,0,36
133157,1198235,1,4,2,4,0,40
133158,1198235,1,4,3,0,0,40
133159,1198235,1,4,4,1,0,41
133160,1198235,1,4,5,2,0,43
133161,1198235,1,4,6,0,1,43
133162,1198235,1,5,1,1,0,44
133163,1198235,1,5,2,4,0,48
133164,1198235,1,5,3,0,0,48
133165,1198235,1,5,4,0,0,48
133166,1198235,1,5,5,0,0,48
133167,1198235,1,5,6,0,0,48
133168,1198235,1,6,1,0,0,48
133169,1198235,1,6,2,4,0,52
133170,1198235,1,6,3,1,0,53
133171,1198235,1,6,4,1,0,54
133172,1198235,1,6,5,0,0,54
133173,1198235,1,6,6,1,0,55
133174,1198235,1,7,1,1,0,56
133175,1198235,1,7,2,0,0,56
133176,1198235,1,7,3,1,0,57
133177,1198235,1,7,4,1,0,58
133178,1198235,1,7,5,4,0,62
133179,1198235,1,7,6,0,0,62
133180,1198235,1,8,1,0,0,62
133181,1198235,1,8,2,1,0,63
133182,1198235,1,8,3,1,0,64
133183,1198235,1,8,4,0,0,64
133184,1198235,1,8,5,0,1,64
133185,1198235,1,8,6,1,0,65
133186,1198235,1,9,1,4,0,69
133187,1198235,1,9,2,0,0,69
133188,1198235,1,9,3,0,0,69
133189,1198235,1,9,4,0,0,69
133190,1198235,1,9,5,0,0,69
133191,1198235,1,9,6,1,0,70
133192,1198235,1,10,1,1,0,71
133193,1198235,1,10,2,1,0,72
133194,1198235,1,10,3,1,0,73
133195,1198235,1,10,4,1,0,74
133196,1198235,1,10,5,0,1,74
133197,1198235,1,10,6,1,0,75
133198,1198235,1,11,1,4,0,79
133199,1198235,1,11,2,1,0,80
133200,1198235,1,11,3,4,0,84
133201,1198235,1,11,4,1,0,85
133202,1198235,1,11,5,0,0,85
133203,1198235,1,11,6,1,0,86
133204,1198235,1,12,1,2,0,88
133205,1198235,1,12,2,0,0,88
133206,1198235,1,12,3,2,0,90
133207,1198235,1,12,4,1,0,91
133208,1198235,1,12,5,0,1,91
133209,1198235,1,12,6,1,0,92
133210,1198235,1,13,1,6,0,98
133211,1198235,1,13,2,1,0,99
133212,1198235,1,13,3,1,0,100
133213,1198235,1,13,4,1,0,101
133214,1198235,1,13,5,1,0,102
133215,1198235,1,13,6,4,0,106
133216,1198235,1,14,1,0,0,106
133217,1198235,1,14,2,0,0,106
133218,1198235,1,14,3,1,0,107
133219,1198235,1,14,4,1,0,108
133220,1198235,1,14,5,0,1,108
133221,1198235,1,14,6,1,0,109
133222,1198235,1,15,1,0,0,109
133223,1198235,1,15,2,4,0,113
133224,1198235,1,15,3,1,0,114
133225,1198235,1,15,4,1,0,115
133226,1198235,1,15,5,1,0,116
133227,1198235,1,15,6,1,0,117
133228,1198235,1,16,1,1,0,118
133229,1198235,1,16,2,1,0,119
133230,1198235,1,16,3,0,0,119
133231,1198235,1,16,4,1,0,120
133232,1198235,1,16,5,1,0,121
133233,1198235,1,16,6,1,0,122
133234,1198235,1,17,1,0,0,122
133235,1198235,1,17,2,1,0,123
133236,1198235,1,17,3,1,0,124
133237,1198235,1,17,4,0,0,124
133238,1198235,1,17,5,0,1,124
133239,1198235,1,17,6,1,0,125
133240,1198235,1,18,1,1,0,126
133241,1198235,1,18,2,1,0,127
133242,1198235,1,18,3,2,0,129
133243,1198235,1,18,4,11,0,140
133244,1198235,1,18,5,6,0,146
133245,1198235,1,18,6,1,0,147
133246,1198235,1,19,1,0,1,147
133247,1198235,1,19,2,1,0,148
133248,1198235,1,19,3,1,0,149
133249,1198235,1,19,4,2,0,151
133250,1198235,1,19,5,1,0,152
133251,1198235,1,19,6,0,0,152
133252,1198235,1,20,1,1,0,153
133253,1198235,1,20,2,0,0,153
133254,1198235,1,20,3,1,0,154
133255,1198235,1,20,4,2,0,156
133256,1198235,1,20,5,2,0,158
133257,1198235,1,20,6,4,0,162
133378,1198236,1,1,1,0,0,0
133379,1198236,1,1,2,0,0,0
133380,1198236,1,1,3,0,1,0
133381,1198236,1,1,4,0,0,0
133382,1198236,1,1,5,0,0,0
133383,1198236,1,1,6,1,0,1
133384,1198236,1,2,1,0,0,1
133385,1198236,1,2,2,0,0,1
133386,1198236,1,2,3,1,0,2
133387,1198236,1,2,4,1,0,3
133388,1198236,1,2,5,0,1,3
133389,1198236,1,2,6,0,0,3
133390,1198236,1,3,1,0,0,3
133391,1198236,1,3,2,6,0,9
133392,1198236,1,3,3,0,0,9
133393,1198236,1,3,4,0,0,9
133394,1198236,1,3,5,0,0,9
133395,1198236,1,3,6,1,0,10
133396,1198236,1,4,1,0,0,10
133397,1198236,1,4,2,0,0,10
133398,1198236,1,4,3,4,0,14
133399,1198236,1,4,4,0,0,14
133400,1198236,1,4,5,4,0,18
133401,1198236,1,4,6,2,0,20
133402,1198236,1,5,1,4,0,24
133403,1198236,1,5,2,0,0,24
133404,1198236,1,5,3,0,0,24
133405,1198236,1,5,4,6,0,30
133406,1198236,1,5,5,0,0,30
133407,1198236,1,5,6,0,1,30
133408,1198236,1,6,1,0,0,30
133409,1198236,1,6,2,0,0,30
133410,1198236,1,6,3,4,0,34
133411,1198236,1,6,4,4,0,38
133412,1198236,1,6,5,0,0,38
133413,1198236,1,6,6,1,0,39
133414,1198236,1,7,1,1,0,40
133415,1198236,1,7,2,0,0,40
133416,1198236,1,7,3,0,0,40
133417,1198236,1,7,4,1,0,41
133418,1198236,1,7,5,0,0,41
133419,1198236,1,7,6,0,0,41
133420,1198236,1,8,1,1,0,42
133421,1198236,1,8,2,6,0,48
133422,1198236,1,8,3,0,0,48
133423,1198236,1,8,4,0,0,48
133424,1198236,1,8,5,2,0,50
133425,1198236,1,8,6,2,0,52
133426,1198236,1,9,1,1,0,53
133427,1198236,1,9,2,1,0,54
133428,1198236,1,9,3,1,0,55
133429,1198236,1,9,4,1,0,56
133430,1198236,1,9,5,0,0,56
133431,1198236,1,9,6,0,0,56
133432,1198236,1,10,1,1,0,57
133433,1198236,1,10,2,0,0,57
133434,1198236,1,10,3,1,0,58
133435,1198236,1,10,4,0,0,58
133436,1198236,1,10,5,1,0,59
133437,1198236,1,10,6,1,0,60
133438,1198236,1,11,1,1,0,61
133439,1198236,1,11,2,1,0,62
133440,1198236,1,11,3,0,0,62
133441,1198236,1,11,4,6,0,68
133442,1198236,1,11,5,1,0,69
133443,1198236,1,11,6,0,0,69
133444,1198236,1,12,1,0,0,69
133445,1198236,1,12,2,4,0,73
133446,1198236,1,12,3,1,0,74
133447,1198236,1,12,4,1,0,75
133448,1198236,1,12,5,4,0,79
133449,1198236,1,12,6,0,1,79
133450,1198236,1,13,1,6,0,85
133451,1198236,1,13,2,1,0,86
133452,1198236,1,13,3,0,0,86
133453,1198236,1,13,4,1,0,87
133454,1198236,1,13,5,2,0,89
133455,1198236,1,13,6,0,1,89
133456,1198236,1,14,1,1,0,90
133457,1198236,1,14,2,0,0,90
133458,1198236,1,14,3,1,0,91
133459,1198236,1,14,4,1,0,92
133460,1198236,1,14,5,0,0,92
133461,1198236,1,14,6,1,0,93
133462,1198236,1,15,1,0,0,93
133463,1198236,1,15,2,1,0,94
133464,1198236,1,15,3,1,0,95
133465,1198236,1,15,4,4,0,99
133466,1198236,1,15,5,1,0,100
133467,1198236,1,15,6,1,0,101
133468,1198236,1,16,1,2,0,103
133469,1198236,1,16,2,1,0,104
133470,1198236,1,16,3,2,0,106
133471,1198236,1,16,4,1,0,107
133472,1198236,1,16,5,2,0,109
133473,1198236,1,16,6,1,0,110
133474,1198236,1,17,1,1,0,111
133475,1198236,1,17,2,1,0,112
133476,1198236,1,17,3,1,0,113
133477,1198236,1,17,4,2,0,115
133478,1198236,1,17,5,2,0,117
133479,1198236,1,17,6,0,0,117
133480,1198236,1,18,1,6,0,123
133481,1198236,1,18,2,1,0,124
133482,1198236,1,18,3,1,0,125
133483,1198236,1,18,4,1,0,126
133484,1198236,1,18,5,1,0,127
133485,1198236,1,18,6,1,0,128
133486,1198236,1,19,1,4,0,132
133487,1198236,1,19,2,0,1,132
133488,1198236,1,19,3,1,0,133
133489,1198236,1,19,4,4,0,137
133490,1198236,1,19,5,1,0,138
133491,1198236,1,19,6,1,0,139
133492,1198236,1,20,1,1,0,140
133493,1198236,1,20,2,2,0,142
133494,1198236,1,20,3,5,0,147
133495,1198236,1,20,4,6,0,153
133496,1198236,1,20,5,2,1,155
133497,1198236,1,20,6,2,0,157
133611,1198237,1,1,1,0,0,0
133612,1198237,1,1,2,0,0,0
133613,1198237,1,1,3,0,0,0
133614,1198237,1,1,4,1,0,1
133615,1198237,1,1,5,1,0,2
133616,1198237,1,1,6,0,0,2
133617,1198237,1,2,1,1,0,3
133618,1198237,1,2,2,0,0,3
133619,1198237,1,2,3,0,0,3
133620,1198237,1,2,4,1,0,4
133621,1198237,1,2,5,0,1,4
133622,1198237,1,2,6,0,0,4
133623,1198237,1,3,1,0,0,4
133624,1198237,1,3,2,3,0,7
133625,1198237,1,3,3,0,0,7
133626,1198237,1,3,4,4,0,11
133627,1198237,1,3,5,0,0,11
133628,1198237,1,3,6,2,0,13
133629,1198237,1,4,1,0,0,13
133630,1198237,1,4,2,0,0,13
133631,1198237,1,4,3,4,0,17
133632,1198237,1,4,4,0,0,17
133633,1198237,1,4,5,1,0,18
133634,1198237,1,4,6,1,0,19
133635,1198237,1,5,1,2,0,21
133636,1198237,1,5,2,0,0,21
133637,1198237,1,5,3,0,0,21
133638,1198237,1,5,4,0,0,21
133639,1198237,1,5,5,0,0,21
133640,1198237,1,5,6,2,0,23
133641,1198237,1,6,1,1,0,24
133642,1198237,1,6,2,0,0,24
133643,1198237,1,6,3,5,0,29
133644,1198237,1,6,4,4,0,33
133645,1198237,1,6,5,0,0,33
133646,1198237,1,6,6,0,0,33
133647,1198237,1,7,1,1,0,34
133648,1198237,1,7,2,2,0,36
133649,1198237,1,7,3,1,0,37
133650,1198237,1,7,4,1,0,38
133651,1198237,1,7,5,1,0,39
133652,1198237,1,7,6,1,0,40
133653,1198237,1,8,1,2,0,42
133654,1198237,1,8,2,4,0,46
133655,1198237,1,8,3,1,0,47
133656,1198237,1,8,4,0,0,47
133657,1198237,1,8,5,4,0,51
133658,1198237,1,8,6,2,0,53
133659,1198237,1,9,1,0,1,53
133660,1198237,1,9,2,1,0,54
133661,1198237,1,9,3,1,0,55
133662,1198237,1,9,4,1,0,56
133663,1198237,1,9,5,1,0,57
133664,1198237,1,9,6,1,0,58
133665,1198237,1,10,1,0,0,58
133666,1198237,1,10,2,2,0,60
133667,1198237,1,10,3,6,0,66
133668,1198237,1,10,4,0,0,66
133669,1198237,1,10,5,1,0,67
133670,1198237,1,10,6,2,0,69
133671,1198237,1,11,1,6,0,75
133672,1198237,1,11,2,1,0,76
133673,1198237,1,11,3,0,1,76
133674,1198237,1,11,4,0,0,76
133675,1198237,1,11,5,1,0,77
133676,1198237,1,11,6,0,0,77
133677,1198237,1,12,1,0,0,77
133678,1198237,1,12,2,0,0,77
133679,1198237,1,12,3,1,0,78
133680,1198237,1,12,4,1,0,79
133681,1198237,1,12,5,4,0,83
133682,1198237,1,12,6,0,0,83
133683,1198237,1,13,1,0,0,83
133684,1198237,1,13,2,1,0,84
133685,1198237,1,13,3,1,0,85
133686,1198237,1,13,4,6,0,91
133687,1198237,1,13,5,1,0,92
133688,1198237,1,13,6,0,0,92
133689,1198237,1,14,1,1,0,93
133690,1198237,1,14,2,1,0,94
133691,1198237,1,14,3,0,1,94
133692,1198237,1,14,4,0,0,94
133693,1198237,1,14,5,0,0,94
133694,1198237,1,14,6,4,0,98
133695,1198237,1,15,1,0,0,98
133696,1198237,1,15,2,1,0,99
133697,1198237,1,15,3,6,0,105
133698,1198237,1,15,4,1,0,106
133699,1198237,1,15,5,0,0,106
133700,1198237,1,15,6,4,0,110
133701,1198237,1,16,1,1,0,111
133702,1198237,1,16,2,1,0,112
133703,1198237,1,16,3,1,0,113
133704,1198237,1,16,4,0,0,113
133705,1198237,1,16,5,1,0,114
133706,1198237,1,16,6,2,0,116
133707,1198237,1,17,1,1,0,117
133708,1198237,1,17,2,0,0,117
133709,1198237,1,17,3,1,0,118
133710,1198237,1,17,4,1,0,119
133711,1198237,1,17,5,0,1,119
133712,1198237,1,17,6,1,0,120
133713,1198237,1,18,1,2,0,122
133714,1198237,1,18,2,4,0,126
133715,1198237,1,18,3,4,0,130
133716,1198237,1,18,4,4,0,134
133717,1198237,1,18,5,1,0,135
133718,1198237,1,18,6,1,0,136
133719,1198237,1,19,1,0,0,136
133720,1198237,1,19,2,1,0,137
133721,1198237,1,19,3,1,0,138
133722,1198237,1,19,4,1,0,139
133723,1198237,1,19,5,1,0,140
133724,1198237,1,19,6,1,0,141
133725,1198237,1,20,1,0,1,141
133726,1198237,1,20,2,1,0,142
133727,1198237,1,20,3,1,0,143
133728,1198237,1,20,4,1,0,144
133729,1198237,1,20,5,0,0,144
133730,1198237,1,20,6,1,0,145
133848,1198245,1,1,1,4,0,4
133849,1198245,1,1,2,0,0,4
133850,1198245,1,1,3,1,0,5
133851,1198245,1,1,4,0,0,5
133852,1198245,1,1,5,0,0,5
133853,1198245,1,1,6,0,0,5
133854,1198245,1,2,1,1,0,6
133855,1198245,1,2,2,1,0,7
133856,1198245,1,2,3,2,0,9
133857,1198245,1,2,4,1,0,10
133858,1198245,1,2,5,4,0,14
133859,1198245,1,2,6,1,0,15
133860,1198245,1,3,1,4,0,19
133861,1198245,1,3,2,0,0,19
133862,1198245,1,3,3,1,0,20
133863,1198245,1,3,4,2,0,22
133864,1198245,1,3,5,1,0,23
133865,1198245,1,3,6,1,0,24
133866,1198245,1,4,1,1,0,25
133867,1198245,1,4,2,0,0,25
133868,1198245,1,4,3,1,0,26
133869,1198245,1,4,4,0,0,26
133870,1198245,1,4,5,1,0,27
133871,1198245,1,4,6,4,0,31
133872,1198245,1,5,1,4,0,35
133873,1198245,1,5,2,0,0,35
133874,1198245,1,5,3,1,0,36
133875,1198245,1,5,4,4,0,40
133876,1198245,1,5,5,1,0,41
133877,1198245,1,5,6,1,0,42
133878,1198245,1,6,1,0,0,42
133879,1198245,1,6,2,1,0,43
133880,1198245,1,6,3,4,0,47
133881,1198245,1,6,4,1,0,48
133882,1198245,1,6,5,2,0,50
133883,1198245,1,6,6,1,0,51
133884,1198245,1,7,1,0,0,51
133885,1198245,1,7,2,1,0,52
133886,1198245,1,7,3,1,0,53
133887,1198245,1,7,4,0,0,53
133888,1198245,1,7,5,4,0,57
133889,1198245,1,7,6,1,0,58
133890,1198245,1,8,1,4,0,62
133891,1198245,1,8,2,1,0,63
133892,1198245,1,8,3,1,0,64
133893,1198245,1,8,4,0,0,64
133894,1198245,1,8,5,1,0,65
133895,1198245,1,8,6,1,0,66
133896,1198245,1,9,1,6,0,72
133897,1198245,1,9,2,0,0,72
133898,1198245,1,9,3,0,1,72
133899,1198245,1,9,4,1,0,73
133900,1198245,1,9,5,1,0,74
133901,1198245,1,9,6,1,0,75
133902,1198245,1,10,1,4,0,79
133903,1198245,1,10,2,1,0,80
133904,1198245,1,10,3,1,0,81
133905,1198245,1,10,4,1,0,82
133906,1198245,1,10,5,4,0,86
133907,1198245,1,10,6,1,0,87
133908,1198245,1,11,1,1,0,88
133909,1198245,1,11,2,4,0,92
133910,1198245,1,11,3,4,0,96
133911,1198245,1,11,4,1,0,97
133912,1198245,1,11,5,1,0,98
133913,1198245,1,11,6,1,0,99
133914,1198245,1,12,1,1,0,100
133915,1198245,1,12,2,6,0,106
133916,1198245,1,12,3,1,0,107
133917,1198245,1,12,4,1,0,108
133918,1198245,1,12,5,1,0,109
133919,1198245,1,12,6,0,0,109
133920,1198245,1,13,1,1,0,110
133921,1198245,1,13,2,1,0,111
133922,1198245,1,13,3,1,0,112
133923,1198245,1,13,4,0,1,112
133924,1198245,1,13,5,0,0,112
133925,1198245,1,13,6,1,0,113
133926,1198245,1,14,1,3,0,116
133927,1198245,1,14,2,0,0,116
133928,1198245,1,14,3,1,0,117
133929,1198245,1,14,4,2,0,119
133930,1198245,1,14,5,0,0,119
133931,1198245,1,14,6,0,0,119
133932,1198245,1,15,1,1,0,120
133933,1198245,1,15,2,4,0,124
133934,1198245,1,15,3,1,0,125
133935,1198245,1,15,4,2,0,127
133936,1198245,1,15,5,4,0,131
133937,1198245,1,15,6,1,0,132
133938,1198245,1,16,1,1,0,133
133939,1198245,1,16,2,3,0,136
133940,1198245,1,16,3,11,0,147
133941,1198245,1,16,4,1,0,148
133942,1198245,1,16,5,1,0,149
133943,1198245,1,16,6,6,0,155
133944,1198245,1,17,1,4,0,159
133945,1198245,1,17,2,3,0,162
133946,1198245,1,17,3,0,1,162
133947,1198245,1,17,4,1,0,163
133948,1198245,1,17,5,1,0,164
133949,1198245,1,17,6,1,0,165
133950,1198245,1,18,1,1,0,166
133951,1198245,1,18,2,4,0,170
133952,1198245,1,18,3,4,0,174
133953,1198245,1,18,4,1,0,175
133954,1198245,1,18,5,0,0,175
133955,1198245,1,18,6,2,0,177
133956,1198245,1,19,1,6,0,183
133957,1198245,1,19,2,0,0,183
133958,1198245,1,19,3,1,0,184
133959,1198245,1,19,4,1,0,185
133960,1198245,1,19,5,2,0,187
133961,1198245,1,19,6,1,0,188
133962,1198245,1,20,1,1,0,189
133963,1198245,1,20,2,2,0,191
133964,1198245,1,20,3,1,0,192
133965,1198245,1,20,4,2,0,194
133966,1198245,1,20,5,0,1,194
133967,1198245,1,20,6,1,0,195
134083,1198246,1,1,1,0,0,0
134084,1198246,1,1,2,0,0,0
134085,1198246,1,1,3,1,0,1
134086,1198246,1,1,4,0,0,1
134087,1198246,1,1,5,1,0,2
134088,1198246,1,1,6,0,0,2
134089,1198246,1,2,1,0,1,2
134090,1198246,1,2,2,1,0,3
134091,1198246,1,2,3,1,0,4
134092,1198246,1,2,4,6,0,10
134093,1198246,1,2,5,1,0,11
134094,1198246,1,2,6,1,0,12
134095,1198246,1,3,1,1,0,13
134096,1198246,1,3,2,1,0,14
134097,1198246,1,3,3,4,0,18
134098,1198246,1,3,4,4,0,22
134099,1198246,1,3,5,4,0,26
134100,1198246,1,3,6,1,0,27
134101,1198246,1,4,1,0,0,27
134102,1198246,1,4,2,0,0,27
134103,1198246,1,4,3,2,0,29
134104,1198246,1,4,4,1,0,30
134105,1198246,1,4,5,1,0,31
134106,1198246,1,4,6,1,0,32
134107,1198246,1,5,1,0,0,32
134108,1198246,1,5,2,0,1,32
134109,1198246,1,5,3,0,0,32
134110,1198246,1,5,4,1,0,33
134111,1198246,1,5,5,0,0,33
134112,1198246,1,5,6,4,0,37
134113,1198246,1,6,1,1,0,38
134114,1198246,1,6,2,4,0,42
134115,1198246,1,6,3,4,0,46
134116,1198246,1,6,4,1,0,47
134117,1198246,1,6,5,0,0,47
134118,1198246,1,6,6,0,0,47
134119,1198246,1,7,1,1,0,48
134120,1198246,1,7,2,0,0,48
134121,1198246,1,7,3,4,0,52
134122,1198246,1,7,4,1,0,53
134123,1198246,1,7,5,1,0,54
134124,1198246,1,7,6,0,0,54
134125,1198246,1,8,1,6,0,60
134126,1198246,1,8,2,1,0,61
134127,1198246,1,8,3,1,0,62
134128,1198246,1,8,4,1,0,63
134129,1198246,1,8,5,1,0,64
134130,1198246,1,8,6,2,0,66
134131,1198246,1,9,1,2,0,68
134132,1198246,1,9,2,2,0,70
134133,1198246,1,9,3,1,0,71
134134,1198246,1,9,4,4,0,75
134135,1198246,1,9,5,1,0,76
134136,1198246,1,9,6,1,0,77
134137,1198246,1,10,1,0,0,77
134138,1198246,1,10,2,4,0,81
134139,1198246,1,10,3,1,0,82
134140,1198246,1,10,4,2,0,84
134141,1198246,1,10,5,0,0,84
134142,1198246,1,10,6,0,0,84
134143,1198246,1,11,1,2,0,86
134144,1198246,1,11,2,1,0,87
134145,1198246,1,11,3,1,0,88
134146,1198246,1,11,4,6,0,94
134147,1198246,1,11,5,6,0,100
134148,1198246,1,11,6,0,0,100
134149,1198246,1,12,1,1,0,101
134150,1198246,1,12,2,0,0,101
134151,1198246,1,12,3,1,0,102
134152,1198246,1,12,4,2,0,104
134153,1198246,1,12,5,0,0,104
134154,1198246,1,12,6,4,0,108
134155,1198246,1,13,1,1,0,109
134156,1198246,1,13,2,0,0,109
134157,1198246,1,13,3,1,0,110
134158,1198246,1,13,4,6,0,116
134159,1198246,1,13,5,1,0,117
134160,1198246,1,13,6,0,0,117
134161,1198246,1,14,1,0,0,117
134162,1198246,1,14,2,7,0,124
134163,1198246,1,14,3,2,0,126
134164,1198246,1,14,4,0,0,126
134165,1198246,1,14,5,4,0,130
134166,1198246,1,14,6,0,0,130
134167,1198246,1,15,1,1,0,131
134168,1198246,1,15,2,1,0,132
134169,1198246,1,15,3,0,1,132
134170,1198246,1,15,4,1,0,133
134171,1198246,1,15,5,0,0,133
134172,1198246,1,15,6,1,0,134
134173,1198246,1,16,1,2,0,136
134174,1198246,1,16,2,3,0,139
134175,1198246,1,16,3,4,0,143
134176,1198246,1,16,4,1,0,144
134177,1198246,1,16,5,0,0,144
134178,1198246,1,16,6,4,0,148
134179,1198246,1,17,1,6,0,154
134180,1198246,1,17,2,1,0,155
134181,1198246,1,17,3,1,0,156
134182,1198246,1,17,4,1,0,157
134183,1198246,1,17,5,1,0,158
134184,1198246,1,17,6,1,0,159
134185,1198246,1,18,1,1,0,160
134186,1198246,1,18,2,1,0,161
134187,1198246,1,18,3,2,0,163
134188,1198246,1,18,4,1,0,164
134189,1198246,1,18,5,4,0,168
134190,1198246,1,18,6,2,0,170
134191,1198246,1,19,1,6,0,176
134192,1198246,1,19,2,1,0,177
134193,1198246,1,19,3,0,0,177
134194,1198246,1,19,4,0,1,177
134195,1198246,1,19,5,2,0,179
134196,1198246,1,19,6,2,0,181
134197,1198246,1,20,1,1,0,182
134198,1198246,1,20,2,2,0,184
134199,1198246,1,20,3,2,0,186
134200,1198246,1,20,4,1,0,187
134201,1198246,1,20,5,1,0,188
134202,1198246,1,20,6,2,0,190
134323,1198489,1,1,1,0,0,0
134324,1198489,1,1,2,0,0,0
134325,1198489,1,1,3,0,0,0
134326,1198489,1,1,4,0,0,0
134327,1198489,1,1,5,4,0,4
134328,1198489,1,1,6,1,0,5
134329,1198489,1,2,1,4,0,9
134330,1198489,1,2,2,1,0,10
134331,1198489,1,2,3,2,0,12
134332,1198489,1,2,4,4,0,16
134333,1198489,1,2,5,0,0,16
134334,1198489,1,2,6,1,0,17
134335,1198489,1,3,1,1,0,18
134336,1198489,1,3,2,0,0,18
134337,1198489,1,3,3,1,0,19
134338,1198489,1,3,4,4,0,23
134339,1198489,1,3,5,1,0,24
134340,1198489,1,3,6,1,0,25
134341,1198489,1,4,1,1,0,26
134342,1198489,1,4,2,5,0,31
134343,1198489,1,4,3,5,0,36
134344,1198489,1,4,4,4,0,40
134345,1198489,1,4,5,0,0,40
134346,1198489,1,4,6,1,0,41
134347,1198489,1,5,1,1,0,42
134348,1198489,1,5,2,1,0,43
134349,1198489,1,5,3,4,0,47
134350,1198489,1,5,4,2,0,49
134351,1198489,1,5,5,1,0,50
134352,1198489,1,5,6,0,0,50
134353,1198489,1,6,1,4,0,54
134354,1198489,1,6,2,4,0,58
134355,1198489,1,6,3,2,0,60
134356,1198489,1,6,4,0,0,60
134357,1198489,1,6,5,4,0,64
134358,1198489,1,6,6,0,0,64
134359,1198489,1,7,1,1,0,65
134360,1198489,1,7,2,0,0,65
134361,1198489,1,7,3,1,0,66
134362,1198489,1,7,4,1,0,67
134363,1198489,1,7,5,0,0,67
134364,1198489,1,7,6,1,0,68
134365,1198489,1,8,1,1,0,69
134366,1198489,1,8,2,0,0,69
134367,1198489,1,8,3,0,0,69
134368,1198489,1,8,4,1,0,70
134369,1198489,1,8,5,6,0,76
134370,1198489,1,8,6,1,0,77
134371,1198489,1,9,1,1,0,78
134372,1198489,1,9,2,1,0,79
134373,1198489,1,9,3,1,0,80
134374,1198489,1,9,4,0,0,80
134375,1198489,1,9,5,0,0,80
134376,1198489,1,9,6,1,0,81
134377,1198489,1,10,1,1,0,82
134378,1198489,1,10,2,0,0,82
134379,1198489,1,10,3,2,0,84
134380,1198489,1,10,4,0,1,84
134381,1198489,1,10,5,0,0,84
134382,1198489,1,10,6,0,0,84
134383,1198489,1,11,1,4,0,88
134384,1198489,1,11,2,0,0,88
134385,1198489,1,11,3,1,0,89
134386,1198489,1,11,4,0,0,89
134387,1198489,1,11,5,0,0,89
134388,1198489,1,11,6,2,0,91
134389,1198489,1,12,1,0,0,91
134390,1198489,1,12,2,1,0,92
134391,1198489,1,12,3,6,0,98
134392,1198489,1,12,4,1,0,99
134393,1198489,1,12,5,1,0,100
134394,1198489,1,12,6,0,0,100
134395,1198489,1,13,1,1,0,101
134396,1198489,1,13,2,4,0,105
134397,1198489,1,13,3,1,0,106
134398,1198489,1,13,4,0,0,106
134399,1198489,1,13,5,1,0,107
134400,1198489,1,13,6,0,0,107
134401,1198489,1,14,1,1,0,108
134402,1198489,1,14,2,1,0,109
134403,1198489,1,14,3,2,0,111
134404,1198489,1,14,4,1,0,112
134405,1198489,1,14,5,1,0,113
134406,1198489,1,14,6,4,0,117
134407,1198489,1,15,1,0,0,117
134408,1198489,1,15,2,2,0,119
134409,1198489,1,15,3,1,0,120
134410,1198489,1,15,4,0,1,120
134411,1198489,1,15,5,4,0,124
134412,1198489,1,15,6,2,0,126
134413,1198489,1,16,1,1,0,127
134414,1198489,1,16,2,6,0,133
134415,1198489,1,16,3,1,0,134
134416,1198489,1,16,4,1,0,135
134417,1198489,1,16,5,0,0,135
134418,1198489,1,16,6,0,1,135
134419,1198489,1,17,1,1,0,136
134420,1198489,1,17,2,0,0,136
134421,1198489,1,17,3,1,0,137
134422,1198489,1,17,4,6,0,143
134423,1198489,1,17,5,6,0,149
134424,1198489,1,17,6,1,0,150
134425,1198489,1,18,1,0,0,150
134426,1198489,1,18,2,1,0,151
134427,1198489,1,18,3,1,0,152
134428,1198489,1,18,4,1,0,153
134429,1198489,1,18,5,0,0,153
134430,1198489,1,18,6,0,0,153
134431,1198489,1,19,1,0,1,153
134432,1198489,1,19,2,0,1,153
134433,1198489,1,19,3,0,0,153
134434,1198489,1,19,4,1,0,154
134435,1198489,1,19,5,1,0,155
134436,1198489,1,19,6,4,0,159
134437,1198489,1,20,1,2,0,161
134438,1198489,1,20,2,1,0,162
134439,1198489,1,20,3,0,0,162
134440,1198489,1,20,4,1,0,163
134441,1198489,1,20,5,1,0,164
134442,1198489,1,20,6,1,0,165
134549,1198490,1,1,1,1,0,1
134550,1198490,1,1,2,0,0,1
134551,1198490,1,1,3,0,0,1
134552,1198490,1,1,4,1,0,2
134553,1198490,1,1,5,4,0,6
134554,1198490,1,1,6,1,0,7
134555,1198490,1,2,1,4,0,11
134556,1198490,1,2,2,4,0,15
134557,1198490,1,2,3,0,0,15
134558,1198490,1,2,4,0,0,15
134559,1198490,1,2,5,1,0,16
134560,1198490,1,2,6,0,0,16
134561,1198490,1,3,1,0,0,16
134562,1198490,1,3,2,0,1,16
134563,1198490,1,3,3,0,0,16
134564,1198490,1,3,4,0,0,16
134565,1198490,1,3,5,1,0,17
134566,1198490,1,3,6,1,0,18
134567,1198490,1,4,1,1,0,19
134568,1198490,1,4,2,0,0,19
134569,1198490,1,4,3,0,0,19
134570,1198490,1,4,4,4,0,23
134571,1198490,1,4,5,0,0,23
134572,1198490,1,4,6,4,0,27
134573,1198490,1,5,1,4,0,31
134574,1198490,1,5,2,1,0,32
134575,1198490,1,5,3,6,0,38
134576,1198490,1,5,4,3,0,41
134577,1198490,1,5,5,0,0,41
134578,1198490,1,5,6,0,1,41
134579,1198490,1,6,1,4,0,45
134580,1198490,1,6,2,0,0,45
134581,1198490,1,6,3,0,0,45
134582,1198490,1,6,4,0,0,45
134583,1198490,1,6,5,1,0,46
134584,1198490,1,6,6,6,0,52
134585,1198490,1,7,1,1,0,53
134586,1198490,1,7,2,2,0,55
134587,1198490,1,7,3,1,0,56
134588,1198490,1,7,4,1,0,57
134589,1198490,1,7,5,1,0,58
134590,1198490,1,7,6,1,0,59
134591,1198490,1,8,1,1,0,60
134592,1198490,1,8,2,0,0,60
134593,1198490,1,8,3,4,0,64
134594,1198490,1,8,4,1,0,65
134595,1198490,1,8,5,1,0,66
134596,1198490,1,8,6,1,0,67
134597,1198490,1,9,1,1,0,68
134598,1198490,1,9,2,0,0,68
134599,1198490,1,9,3,1,0,69
134600,1198490,1,9,4,4,0,73
134601,1198490,1,9,5,1,0,74
134602,1198490,1,9,6,0,0,74
134603,1198490,1,10,1,1,0,75
134604,1198490,1,10,2,1,0,76
134605,1198490,1,10,3,0,0,76
134606,1198490,1,10,4,1,0,77
134607,1198490,1,10,5,2,0,79
134608,1198490,1,10,6,1,0,80
134609,1198490,1,11,1,6,0,86
134610,1198490,1,11,2,6,0,92
134611,1198490,1,11,3,0,0,92
134612,1198490,1,11,4,1,0,93
134613,1198490,1,11,5,4,0,97
134614,1198490,1,11,6,2,0,99
134615,1198490,1,12,1,1,0,100
134616,1198490,1,12,2,1,0,101
134617,1198490,1,12,3,1,0,102
134618,1198490,1,12,4,2,0,104
134619,1198490,1,12,5,1,0,105
134620,1198490,1,12,6,1,0,106
134621,1198490,1,13,1,1,0,107
134622,1198490,1,13,2,1,0,108
134623,1198490,1,13,3,1,0,109
134624,1198490,1,13,4,0,0,109
134625,1198490,1,13,5,2,0,111
134626,1198490,1,13,6,0,0,111
134627,1198490,1,14,1,4,0,115
134628,1198490,1,14,2,1,0,116
134629,1198490,1,14,3,0,0,116
134630,1198490,1,14,4,6,0,122
134631,1198490,1,14,5,6,0,128
134632,1198490,1,14,6,0,0,128
134633,1198490,1,15,1,1,0,129
134634,1198490,1,15,2,2,0,131
134635,1198490,1,15,3,0,0,131
134636,1198490,1,15,4,0,0,131
134637,1198490,1,15,5,4,0,135
134638,1198490,1,15,6,0,0,135
134639,1198490,1,16,1,0,0,135
134640,1198490,1,16,2,0,1,135
134641,1198490,1,16,3,2,0,137
134642,1198490,1,16,4,4,0,141
134643,1198490,1,16,5,1,0,142
134644,1198490,1,16,6,0,0,142
134645,1198490,1,17,1,0,1,142
134646,1198490,1,17,2,2,0,144
134647,1198490,1,17,3,1,0,145
134648,1198490,1,17,4,0,1,145
134649,1198490,1,17,5,1,0,146
134650,1198490,1,17,6,1,0,147
134651,1198490,1,18,1,2,0,149
134652,1198490,1,18,2,4,0,153
134653,1198490,1,18,3,1,0,154
134654,1198490,1,18,4,1,0,155
134655,1198490,1,18,5,0,0,155
134656,1198490,1,18,6,0,1,155
134657,1198490,1,19,1,5,0,160
134658,1198490,1,19,2,0,0,160
134659,1198490,1,19,3,1,0,161
134660,1198490,1,19,4,1,0,162
134661,1198490,1,19,5,4,0,166
134662,1198490,1,19,6,2,0,168
134663,1198490,1,20,1,1,0,169
134664,1198490,1,20,2,1,0,170
134665,1198490,1,20,3,2,0,172
134666,1198490,1,20,4,4,0,176
134667,1198490,1,20,5,6,0,182
134668,1198490,1,20,6,0,0,182
134783,1198491,1,1,1,3,0,3
134784,1198491,1,1,2,0,0,3
134785,1198491,1,1,3,1,0,4
134786,1198491,1,1,4,0,0,4
134787,1198491,1,1,5,0,0,4
134788,1198491,1,1,6,4,0,8
134789,1198491,1,2,1,2,0,10
134790,1198491,1,2,2,2,0,12
134791,1198491,1,2,3,0,0,12
134792,1198491,1,2,4,5,0,17
134793,1198491,1,2,5,1,0,18
134794,1198491,1,2,6,1,0,19
134795,1198491,1,3,1,4,0,23
134796,1198491,1,3,2,0,0,23
134797,1198491,1,3,3,0,0,23
134798,1198491,1,3,4,1,0,24
134799,1198491,1,3,5,0,0,24
134800,1198491,1,3,6,0,1,24
134801,1198491,1,4,1,1,0,25
134802,1198491,1,4,2,0,0,25
134803,1198491,1,4,3,1,0,26
134804,1198491,1,4,4,1,0,27
134805,1198491,1,4,5,1,0,28
134806,1198491,1,4,6,0,1,28
134807,1198491,1,5,1,0,0,28
134808,1198491,1,5,2,1,0,29
134809,1198491,1,5,3,1,0,30
134810,1198491,1,5,4,0,0,30
134811,1198491,1,5,5,0,0,30
134812,1198491,1,5,6,0,1,30
134813,1198491,1,6,1,4,0,34
134814,1198491,1,6,2,6,0,40
134815,1198491,1,6,3,2,0,42
134816,1198491,1,6,4,1,0,43
134817,1198491,1,6,5,1,0,44
134818,1198491,1,6,6,0,0,44
134819,1198491,1,7,1,0,0,44
134820,1198491,1,7,2,0,0,44
134821,1198491,1,7,3,4,0,48
134822,1198491,1,7,4,2,0,50
134823,1198491,1,7,5,1,0,51
134824,1198491,1,7,6,1,0,52
134825,1198491,1,8,1,1,0,53
134826,1198491,1,8,2,0,0,53
134827,1198491,1,8,3,1,0,54
134828,1198491,1,8,4,1,0,55
134829,1198491,1,8,5,2,0,57
134830,1198491,1,8,6,1,1,58
134831,1198491,1,9,1,0,0,58
134832,1198491,1,9,2,1,0,59
134833,1198491,1,9,3,0,0,59
134834,1198491,1,9,4,0,0,59
134835,1198491,1,9,5,1,0,60
134836,1198491,1,9,6,1,0,61
134837,1198491,1,10,1,4,0,65
134838,1198491,1,10,2,4,0,69
134839,1198491,1,10,3,1,0,70
134840,1198491,1,10,4,0,0,70
134841,1198491,1,10,5,1,0,71
134842,1198491,1,10,6,1,0,72
134843,1198491,1,11,1,0,0,72
134844,1198491,1,11,2,1,0,73
134845,1198491,1,11,3,0,0,73
134846,1198491,1,11,4,0,0,73
134847,1198491,1,11,5,3,0,76
134848,1198491,1,11,6,0,0,76
134849,1198491,1,12,1,4,0,80
134850,1198491,1,12,2,2,0,82
134851,1198491,1,12,3,0,0,82
134852,1198491,1,12,4,4,0,86
134853,1198491,1,12,5,1,0,87
134854,1198491,1,12,6,0,0,87
134855,1198491,1,13,1,1,0,88
134856,1198491,1,13,2,0,0,88
134857,1198491,1,13,3,0,0,88
134858,1198491,1,13,4,1,0,89
134859,1198491,1,13,5,0,0,89
134860,1198491,1,13,6,0,0,89
134861,1198491,1,14,1,1,0,90
134862,1198491,1,14,2,1,0,91
134863,1198491,1,14,3,0,0,91
134864,1198491,1,14,4,1,0,92
134865,1198491,1,14,5,0,0,92
134866,1198491,1,14,6,2,0,94
134867,1198491,1,15,1,1,0,95
134868,1198491,1,15,2,4,0,99
134869,1198491,1,15,3,1,0,100
134870,1198491,1,15,4,2,0,102
134871,1198491,1,15,5,1,0,103
134872,1198491,1,15,6,1,0,104
134873,1198491,1,16,1,1,0,105
134874,1198491,1,16,2,1,0,106
134875,1198491,1,16,3,0,0,106
134876,1198491,1,16,4,1,0,107
134877,1198491,1,16,5,2,0,109
134878,1198491,1,16,6,2,0,111
134879,1198491,1,17,1,1,0,112
134880,1198491,1,17,2,2,0,114
134881,1198491,1,17,3,7,0,121
134882,1198491,1,17,4,0,0,121
134883,1198491,1,17,5,4,0,125
134884,1198491,1,17,6,0,0,125
134885,1198491,1,18,1,1,0,126
134886,1198491,1,18,2,6,0,132
134887,1198491,1,18,3,1,0,133
134888,1198491,1,18,4,0,0,133
134889,1198491,1,18,5,1,0,134
134890,1198491,1,18,6,0,1,134
134891,1198491,1,19,1,1,0,135
134892,1198491,1,19,2,4,0,139
134893,1198491,1,19,3,0,0,139
134894,1198491,1,19,4,1,0,140
134895,1198491,1,19,5,0,0,140
134896,1198491,1,19,6,0,1,140
134897,1198491,1,20,1,4,0,144
134898,1198491,1,20,2,0,0,144
134899,1198491,1,20,3,1,0,145
134900,1198491,1,20,4,1,0,146
134901,1198491,1,20,5,1,0,147
134902,1198491,1,20,6,0,1,147
135023,1199546,1,1,1,1,0,1
135024,1199546,1,1,2,1,0,2
135025,1199546,1,1,3,0,0,2
135026,1199546,1,1,4,0,0,2
135027,1199546,1,1,5,0,0,2
135028,1199546,1,1,6,1,0,3
135029,1199546,1,2,1,1,0,4
135030,1199546,1,2,2,0,0,4
135031,1199546,1,2,3,0,0,4
135032,1199546,1,2,4,0,0,4
135033,1199546,1,2,5,1,0,5
135034,1199546,1,2,6,3,0,8
135035,1199546,1,3,1,1,0,9
135036,1199546,1,3,2,1,0,10
135037,1199546,1,3,3,0,0,10
135038,1199546,1,3,4,4,0,14
135039,1199546,1,3,5,0,0,14
135040,1199546,1,3,6,1,0,15
135041,1199546,1,4,1,0,0,15
135042,1199546,1,4,2,2,0,17
135043,1199546,1,4,3,0,0,17
135044,1199546,1,4,4,0,1,17
135045,1199546,1,4,5,1,0,18
135046,1199546,1,4,6,1,0,19
135047,1199546,1,5,1,1,0,20
135048,1199546,1,5,2,1,0,21
135049,1199546,1,5,3,0,0,21
135050,1199546,1,5,4,1,0,22
135051,1199546,1,5,5,1,0,23
135052,1199546,1,5,6,0,0,23
135053,1199546,1,6,1,0,0,23
135054,1199546,1,6,2,4,0,27
135055,1199546,1,6,3,0,1,27
135056,1199546,1,6,4,1,0,28
135057,1199546,1,6,5,4,0,32
135058,1199546,1,6,6,1,0,33
135059,1199546,1,7,1,2,0,35
135060,1199546,1,7,2,1,0,36
135061,1199546,1,7,3,0,0,36
135062,1199546,1,7,4,1,0,37
135063,1199546,1,7,5,1,0,38
135064,1199546,1,7,6,0,0,38
135065,1199546,1,8,1,1,0,39
135066,1199546,1,8,2,1,0,40
135067,1199546,1,8,3,2,0,42
135068,1199546,1,8,4,4,0,46
135069,1199546,1,8,5,0,0,46
135070,1199546,1,8,6,1,0,47
135071,1199546,1,9,1,4,0,51
135072,1199546,1,9,2,0,0,51
135073,1199546,1,9,3,0,0,51
135074,1199546,1,9,4,3,0,54
135075,1199546,1,9,5,1,0,55
135076,1199546,1,9,6,0,0,55
135077,1199546,1,10,1,1,0,56
135078,1199546,1,10,2,2,0,58
135079,1199546,1,10,3,0,0,58
135080,1199546,1,10,4,0,0,58
135081,1199546,1,10,5,1,0,59
135082,1199546,1,10,6,2,0,61
135083,1199546,1,11,1,2,0,63
135084,1199546,1,11,2,1,0,64
135085,1199546,1,11,3,1,0,65
135086,1199546,1,11,4,1,0,66
135087,1199546,1,11,5,1,0,67
135088,1199546,1,11,6,2,0,69
135089,1199546,1,12,1,2,0,71
135090,1199546,1,12,2,0,1,71
135091,1199546,1,12,3,0,0,71
135092,1199546,1,12,4,1,0,72
135093,1199546,1,12,5,0,0,72
135094,1199546,1,12,6,1,0,73
135095,1199546,1,13,1,1,0,74
135096,1199546,1,13,2,0,0,74
135097,1199546,1,13,3,2,0,76
135098,1199546,1,13,4,1,0,77
135099,1199546,1,13,5,6,0,83
135100,1199546,1,13,6,1,0,84
135101,1199546,1,14,1,2,0,86
135102,1199546,1,14,2,3,0,89
135103,1199546,1,14,3,1,0,90
135104,1199546,1,14,4,1,0,91
135105,1199546,1,14,5,5,0,96
135106,1199546,1,14,6,1,0,97
135107,1199546,1,15,1,1,0,98
135108,1199546,1,15,2,1,0,99
135109,1199546,1,15,3,1,0,100
135110,1199546,1,15,4,1,0,101
135111,1199546,1,15,5,1,0,102
135112,1199546,1,15,6,0,1,102
135113,1199546,1,16,1,1,0,103
135114,1199546,1,16,2,0,0,103
135115,1199546,1,16,3,1,0,104
135116,1199546,1,16,4,0,0,104
135117,1199546,1,16,5,1,0,105
135118,1199546,1,16,6,1,0,106
135119,1199546,1,17,1,1,0,107
135120,1199546,1,17,2,1,0,108
135121,1199546,1,17,3,4,0,112
135122,1199546,1,17,4,4,0,116
135123,1199546,1,17,5,1,0,117
135124,1199546,1,17,6,0,0,117
135125,1199546,1,18,1,4,0,121
135126,1199546,1,18,2,0,0,121
135127,1199546,1,18,3,4,0,125
135128,1199546,1,18,4,1,0,126
135129,1199546,1,18,5,1,0,127
135130,1199546,1,18,6,1,0,128
135131,1199546,1,19,1,1,0,129
135132,1199546,1,19,2,1,0,130
135133,1199546,1,19,3,1,0,131
135134,1199546,1,19,4,4,0,135
135135,1199546,1,19,5,6,0,141
135136,1199546,1,19,6,6,0,147
135137,1199546,1,20,1,1,0,148
135138,1199546,1,20,2,2,0,150
135139,1199546,1,20,3,2,0,152
135140,1199546,1,20,4,4,0,156
135141,1199546,1,20,5,1,0,157
135142,1199546,1,20,6,1,0,158
135263,1200427,1,1,1,4,0,4
135264,1200427,1,1,2,1,0,5
135265,1200427,1,1,3,0,0,5
135266,1200427,1,1,4,0,0,5
135267,1200427,1,1,5,0,0,5
135268,1200427,1,1,6,0,0,5
135269,1200427,1,2,1,1,0,6
135270,1200427,1,2,2,2,0,8
135271,1200427,1,2,3,1,0,9
135272,1200427,1,2,4,5,0,14
135273,1200427,1,2,5,6,0,20
135274,1200427,1,2,6,2,0,22
135275,1200427,1,3,1,0,0,22
135276,1200427,1,3,2,1,0,23
135277,1200427,1,3,3,0,0,23
135278,1200427,1,3,4,1,1,24
135279,1200427,1,3,5,0,0,24
135280,1200427,1,3,6,0,0,24
135281,1200427,1,4,1,4,0,28
135282,1200427,1,4,2,6,0,34
135283,1200427,1,4,3,0,0,34
135284,1200427,1,4,4,6,0,40
135285,1200427,1,4,5,4,0,44
135286,1200427,1,4,6,2,0,46
135287,1200427,1,5,1,1,0,47
135288,1200427,1,5,2,1,0,48
135289,1200427,1,5,3,1,1,49
135290,1200427,1,5,4,0,0,49
135291,1200427,1,5,5,0,0,49
135292,1200427,1,5,6,4,0,53
135293,1200427,1,6,1,1,0,54
135294,1200427,1,6,2,1,0,55
135295,1200427,1,6,3,4,0,59
135296,1200427,1,6,4,2,0,61
135297,1200427,1,6,5,0,0,61
135298,1200427,1,6,6,1,0,62
135299,1200427,1,7,1,1,0,63
135300,1200427,1,7,2,1,0,64
135301,1200427,1,7,3,0,0,64
135302,1200427,1,7,4,6,0,70
135303,1200427,1,7,5,6,0,76
135304,1200427,1,7,6,1,0,77
135305,1200427,1,8,1,2,0,79
135306,1200427,1,8,2,1,0,80
135307,1200427,1,8,3,1,0,81
135308,1200427,1,8,4,6,0,87
135309,1200427,1,8,5,1,0,88
135310,1200427,1,8,6,1,0,89
135311,1200427,1,9,1,1,0,90
135312,1200427,1,9,2,1,0,91
135313,1200427,1,9,3,1,0,92
135314,1200427,1,9,4,1,0,93
135315,1200427,1,9,5,4,0,97
135316,1200427,1,9,6,1,0,98
135317,1200427,1,10,1,4,0,102
135318,1200427,1,10,2,0,0,102
135319,1200427,1,10,3,1,0,103
135320,1200427,1,10,4,4,0,107
135321,1200427,1,10,5,2,0,109
135322,1200427,1,10,6,1,0,110
135323,1200427,1,11,1,1,0,111
135324,1200427,1,11,2,1,0,112
135325,1200427,1,11,3,2,0,114
135326,1200427,1,11,4,1,0,115
135327,1200427,1,11,5,0,0,115
135328,1200427,1,11,6,2,0,117
135329,1200427,1,12,1,6,0,123
135330,1200427,1,12,2,1,0,124
135331,1200427,1,12,3,1,0,125
135332,1200427,1,12,4,1,0,126
135333,1200427,1,12,5,2,0,128
135334,1200427,1,12,6,0,1,128
135335,1200427,1,13,1,1,0,129
135336,1200427,1,13,2,0,0,129
135337,1200427,1,13,3,2,0,131
135338,1200427,1,13,4,0,0,131
135339,1200427,1,13,5,0,0,131
135340,1200427,1,13,6,1,0,132
135341,1200427,1,14,1,0,0,132
135342,1200427,1,14,2,2,0,134
135343,1200427,1,14,3,2,0,136
135344,1200427,1,14,4,0,0,136
135345,1200427,1,14,5,0,0,136
135346,1200427,1,14,6,0,0,136
135347,1200427,1,15,1,1,0,137
135348,1200427,1,15,2,0,0,137
135349,1200427,1,15,3,1,0,138
135350,1200427,1,15,4,6,0,144
135351,1200427,1,15,5,1,0,145
135352,1200427,1,15,6,0,1,145
135353,1200427,1,16,1,1,0,146
135354,1200427,1,16,2,0,0,146
135355,1200427,1,16,3,2,0,148
135356,1200427,1,16,4,4,0,152
135357,1200427,1,16,5,0,0,152
135358,1200427,1,16,6,0,0,152
135359,1200427,1,17,1,0,0,152
135360,1200427,1,17,2,0,1,152
135361,1200427,1,17,3,1,0,153
135362,1200427,1,17,4,1,0,154
135363,1200427,1,17,5,0,0,154
135364,1200427,1,17,6,1,0,155
135365,1200427,1,18,1,0,0,155
135366,1200427,1,18,2,1,0,156
135367,1200427,1,18,3,0,0,156
135368,1200427,1,18,4,1,0,157
135369,1200427,1,18,5,1,0,158
135370,1200427,1,18,6,2,0,160
135371,1200427,1,19,1,1,0,161
135372,1200427,1,19,2,2,0,163
135373,1200427,1,19,3,4,0,167
135374,1200427,1,19,4,1,0,168
135375,1200427,1,19,5,1,0,169
135376,1200427,1,19,6,4,0,173
135377,1200427,1,20,1,4,0,177
135378,1200427,1,20,2,1,0,178
135379,1200427,1,20,3,0,1,178
135380,1200427,1,20,4,1,0,179
135381,1200427,1,20,5,1,0,180
135382,1200427,1,20,6,1,1,181
135498,1201680,1,1,1,0,0,0
135499,1201680,1,1,2,4,0,4
135500,1201680,1,1,3,0,0,4
135501,1201680,1,1,4,0,0,4
135502,1201680,1,1,5,0,0,4
135503,1201680,1,1,6,0,0,4
135504,1201680,1,2,1,0,0,4
135505,1201680,1,2,2,0,0,4
135506,1201680,1,2,3,0,0,4
135507,1201680,1,2,4,1,0,5
135508,1201680,1,2,5,0,0,5
135509,1201680,1,2,6,0,1,5
135510,1201680,1,3,1,0,0,5
135511,1201680,1,3,2,0,0,5
135512,1201680,1,3,3,0,0,5
135513,1201680,1,3,4,4,0,9
135514,1201680,1,3,5,1,0,10
135515,1201680,1,3,6,0,0,10
135516,1201680,1,4,1,0,0,10
135517,1201680,1,4,2,4,0,14
135518,1201680,1,4,3,0,0,14
135519,1201680,1,4,4,1,0,15
135520,1201680,1,4,5,1,0,16
135521,1201680,1,4,6,0,0,16
135522,1201680,1,5,1,0,0,16
135523,1201680,1,5,2,0,0,16
135524,1201680,1,5,3,1,0,17
135525,1201680,1,5,4,0,0,17
135526,1201680,1,5,5,0,0,17
135527,1201680,1,5,6,1,0,18
135528,1201680,1,6,1,4,0,22
135529,1201680,1,6,2,0,0,22
135530,1201680,1,6,3,1,0,23
135531,1201680,1,6,4,1,0,24
135532,1201680,1,6,5,1,0,25
135533,1201680,1,6,6,5,0,30
135534,1201680,1,7,1,1,0,31
135535,1201680,1,7,2,0,0,31
135536,1201680,1,7,3,1,0,32
135537,1201680,1,7,4,0,1,32
135538,1201680,1,7,5,0,0,32
135539,1201680,1,7,6,1,0,33
135540,1201680,1,8,1,4,0,37
135541,1201680,1,8,2,1,0,38
135542,1201680,1,8,3,0,1,38
135543,1201680,1,8,4,0,0,38
135544,1201680,1,8,5,0,0,38
135545,1201680,1,8,6,0,0,38
135546,1201680,1,9,1,0,0,38
135547,1201680,1,9,2,0,0,38
135548,1201680,1,9,3,0,0,38
135549,1201680,1,9,4,1,0,39
135550,1201680,1,9,5,1,0,40
135551,1201680,1,9,6,1,0,41
135552,1201680,1,10,1,4,0,45
135553,1201680,1,10,2,0,0,45
135554,1201680,1,10,3,4,0,49
135555,1201680,1,10,4,4,0,53
135556,1201680,1,10,5,1,0,54
135557,1201680,1,10,6,1,0,55
135558,1201680,1,11,1,0,1,55
135559,1201680,1,11,2,2,0,57
135560,1201680,1,11,3,1,0,58
135561,1201680,1,11,4,0,0,58
135562,1201680,1,11,5,1,0,59
135563,1201680,1,11,6,1,0,60
135564,1201680,1,12,1,0,0,60
135565,1201680,1,12,2,1,0,61
135566,1201680,1,12,3,1,0,62
135567,1201680,1,12,4,1,0,63
135568,1201680,1,12,5,0,0,63
135569,1201680,1,12,6,4,0,67
135570,1201680,1,13,1,0,0,67
135571,1201680,1,13,2,4,0,71
135572,1201680,1,13,3,1,0,72
135573,1201680,1,13,4,2,0,74
135574,1201680,1,13,5,0,0,74
135575,1201680,1,13,6,0,0,74
135576,1201680,1,14,1,0,0,74
135577,1201680,1,14,2,1,0,75
135578,1201680,1,14,3,1,0,76
135579,1201680,1,14,4,1,0,77
135580,1201680,1,14,5,1,0,78
135581,1201680,1,14,6,1,0,79
135582,1201680,1,15,1,1,0,80
135583,1201680,1,15,2,4,0,84
135584,1201680,1,15,3,1,0,85
135585,1201680,1,15,4,1,0,86
135586,1201680,1,15,5,2,0,88
135587,1201680,1,15,6,0,0,88
135588,1201680,1,16,1,1,0,89
135589,1201680,1,16,2,0,1,89
135590,1201680,1,16,3,1,0,90
135591,1201680,1,16,4,1,0,91
135592,1201680,1,16,5,2,0,93
135593,1201680,1,16,6,1,0,94
135594,1201680,1,17,1,0,0,94
135595,1201680,1,17,2,1,0,95
135596,1201680,1,17,3,0,1,95
135597,1201680,1,17,4,0,0,95
135598,1201680,1,17,5,0,0,95
135599,1201680,1,17,6,1,0,96
135600,1201680,1,18,1,1,0,97
135601,1201680,1,18,2,1,0,98
135602,1201680,1,18,3,0,0,98
135603,1201680,1,18,4,6,0,104
135604,1201680,1,18,5,2,0,106
135605,1201680,1,18,6,2,0,108
135606,1201680,1,19,1,1,0,109
135607,1201680,1,19,2,1,0,110
135608,1201680,1,19,3,0,0,110
135609,1201680,1,19,4,1,0,111
135610,1201680,1,19,5,4,0,115
135611,1201680,1,19,6,0,0,115
135612,1201680,1,20,1,6,0,121
135613,1201680,1,20,2,7,0,128
135614,1201680,1,20,3,0,0,128
135615,1201680,1,20,4,1,0,129
135616,1201680,1,20,5,2,0,131
135617,1201680,1,20,6,1,0,132
135727,1201683,1,1,1,0,0,0
135728,1201683,1,1,2,0,0,0
135729,1201683,1,1,3,0,0,0
135730,1201683,1,1,4,0,1,0
135731,1201683,1,1,5,1,0,1
135732,1201683,1,1,6,0,0,1
135733,1201683,1,2,1,6,0,7
135734,1201683,1,2,2,0,0,7
135735,1201683,1,2,3,1,0,8
135736,1201683,1,2,4,6,0,14
135737,1201683,1,2,5,1,0,15
135738,1201683,1,2,6,1,0,16
135739,1201683,1,3,1,4,0,20
135740,1201683,1,3,2,0,0,20
135741,1201683,1,3,3,0,0,20
135742,1201683,1,3,4,5,0,25
135743,1201683,1,3,5,0,0,25
135744,1201683,1,3,6,4,0,29
135745,1201683,1,4,1,0,0,29
135746,1201683,1,4,2,1,0,30
135747,1201683,1,4,3,0,0,30
135748,1201683,1,4,4,0,1,30
135749,1201683,1,4,5,0,0,30
135750,1201683,1,4,6,0,0,30
135751,1201683,1,5,1,0,0,30
135752,1201683,1,5,2,6,0,36
135753,1201683,1,5,3,1,0,37
135754,1201683,1,5,4,0,0,37
135755,1201683,1,5,5,1,0,38
135756,1201683,1,5,6,0,1,38
135757,1201683,1,6,1,4,0,42
135758,1201683,1,6,2,0,0,42
135759,1201683,1,6,3,0,0,42
135760,1201683,1,6,4,0,0,42
135761,1201683,1,6,5,0,0,42
135762,1201683,1,6,6,1,0,43
135763,1201683,1,7,1,0,0,43
135764,1201683,1,7,2,1,0,44
135765,1201683,1,7,3,1,0,45
135766,1201683,1,7,4,1,0,46
135767,1201683,1,7,5,0,0,46
135768,1201683,1,7,6,1,0,47
135769,1201683,1,8,1,0,0,47
135770,1201683,1,8,2,1,0,48
135771,1201683,1,8,3,0,0,48
135772,1201683,1,8,4,1,0,49
135773,1201683,1,8,5,0,0,49
135774,1201683,1,8,6,1,0,50
135775,1201683,1,9,1,1,0,51
135776,1201683,1,9,2,2,0,53
135777,1201683,1,9,3,1,0,54
135778,1201683,1,9,4,4,0,58
135779,1201683,1,9,5,4,0,62
135780,1201683,1,9,6,0,0,62
135781,1201683,1,10,1,2,0,64
135782,1201683,1,10,2,6,0,70
135783,1201683,1,10,3,0,0,70
135784,1201683,1,10,4,1,0,71
135785,1201683,1,10,5,0,0,71
135786,1201683,1,10,6,1,0,72
135787,1201683,1,11,1,1,0,73
135788,1201683,1,11,2,4,0,77
135789,1201683,1,11,3,1,0,78
135790,1201683,1,11,4,1,0,79
135791,1201683,1,11,5,6,0,85
135792,1201683,1,11,6,0,0,85
135793,1201683,1,12,1,0,0,85
135794,1201683,1,12,2,1,0,86
135795,1201683,1,12,3,1,0,87
135796,1201683,1,12,4,2,0,89
135797,1201683,1,12,5,1,0,90
135798,1201683,1,12,6,1,0,91
135799,1201683,1,13,1,4,0,95
135800,1201683,1,13,2,1,0,96
135801,1201683,1,13,3,1,0,97
135802,1201683,1,13,4,1,0,98
135803,1201683,1,13,5,0,0,98
135804,1201683,1,13,6,0,1,98
135805,1201683,1,14,1,1,0,99
135806,1201683,1,14,2,1,0,100
135807,1201683,1,14,3,4,0,104
135808,1201683,1,14,4,2,0,106
135809,1201683,1,14,5,6,0,112
135810,1201683,1,14,6,0,1,112
135811,1201683,1,15,1,1,0,113
135812,1201683,1,15,2,0,0,113
135813,1201683,1,15,3,1,0,114
135814,1201683,1,15,4,2,0,116
135815,1201683,1,15,5,1,0,117
135816,1201683,1,15,6,1,0,118
135817,1201683,1,16,1,1,0,119
135818,1201683,1,16,2,1,0,120
135819,1201683,1,16,3,6,0,126
135820,1201683,1,16,4,2,0,128
135821,1201683,1,16,5,1,0,129
135822,1201683,1,16,6,1,0,130
135823,1201683,1,17,1,1,0,131
135824,1201683,1,17,2,0,0,131
135825,1201683,1,17,3,1,0,132
135826,1201683,1,17,4,1,0,133
135827,1201683,1,17,5,1,0,134
135828,1201683,1,17,6,1,0,135
135829,1201683,1,18,1,1,0,136
135830,1201683,1,18,2,1,0,137
135831,1201683,1,18,3,1,0,138
135832,1201683,1,18,4,2,0,140
135833,1201683,1,18,5,1,0,141
135834,1201683,1,18,6,1,0,142
135835,1201683,1,19,1,0,0,142
135836,1201683,1,19,2,4,0,146
135837,1201683,1,19,3,1,0,147
135838,1201683,1,19,4,1,0,148
135839,1201683,1,19,5,1,0,149
135840,1201683,1,19,6,1,0,150
135841,1201683,1,20,1,1,0,151
135842,1201683,1,20,2,1,0,152
135843,1201683,1,20,3,4,0,156
135844,1201683,1,20,4,0,1,156
135845,1201683,1,20,5,2,0,158
135846,1201683,1,20,6,2,0,160
135967,1202243,1,1,1,6,0,6
135968,1202243,1,1,2,0,0,6
135969,1202243,1,1,3,1,0,7
135970,1202243,1,1,4,0,0,7
135971,1202243,1,1,5,0,0,7
135972,1202243,1,1,6,0,0,7
135973,1202243,1,2,1,0,0,7
135974,1202243,1,2,2,0,0,7
135975,1202243,1,2,3,0,0,7
135976,1202243,1,2,4,4,0,11
135977,1202243,1,2,5,1,0,12
135978,1202243,1,2,6,0,0,12
135979,1202243,1,3,1,1,0,13
135980,1202243,1,3,2,0,0,13
135981,1202243,1,3,3,1,0,14
135982,1202243,1,3,4,4,0,18
135983,1202243,1,3,5,0,0,18
135984,1202243,1,3,6,4,0,22
135985,1202243,1,4,1,4,0,26
135986,1202243,1,4,2,0,0,26
135987,1202243,1,4,3,0,0,26
135988,1202243,1,4,4,1,0,27
135989,1202243,1,4,5,0,0,27
135990,1202243,1,4,6,4,0,31
135991,1202243,1,5,1,4,0,35
135992,1202243,1,5,2,1,0,36
135993,1202243,1,5,3,1,0,37
135994,1202243,1,5,4,1,0,38
135995,1202243,1,5,5,0,1,38
135996,1202243,1,5,6,1,0,39
135997,1202243,1,6,1,1,0,40
135998,1202243,1,6,2,4,0,44
135999,1202243,1,6,3,2,0,46
136000,1202243,1,6,4,1,0,47
136001,1202243,1,6,5,0,0,47
136002,1202243,1,6,6,1,0,48
136003,1202243,1,7,1,1,0,49
136004,1202243,1,7,2,0,0,49
136005,1202243,1,7,3,1,0,50
136006,1202243,1,7,4,1,0,51
136007,1202243,1,7,5,1,0,52
136008,1202243,1,7,6,1,0,53
136009,1202243,1,8,1,0,0,53
136010,1202243,1,8,2,1,0,54
136011,1202243,1,8,3,0,0,54
136012,1202243,1,8,4,0,1,54
136013,1202243,1,8,5,1,0,55
136014,1202243,1,8,6,1,0,56
136015,1202243,1,9,1,0,0,56
136016,1202243,1,9,2,0,0,56
136017,1202243,1,9,3,1,0,57
136018,1202243,1,9,4,1,0,58
136019,1202243,1,9,5,6,0,64
136020,1202243,1,9,6,0,0,64
136021,1202243,1,10,1,0,0,64
136022,1202243,1,10,2,1,0,65
136023,1202243,1,10,3,0,0,65
136024,1202243,1,10,4,0,0,65
136025,1202243,1,10,5,1,0,66
136026,1202243,1,10,6,1,0,67
136027,1202243,1,11,1,4,0,71
136028,1202243,1,11,2,1,0,72
136029,1202243,1,11,3,1,0,73
136030,1202243,1,11,4,1,0,74
136031,1202243,1,11,5,0,0,74
136032,1202243,1,11,6,1,0,75
136033,1202243,1,12,1,6,0,81
136034,1202243,1,12,2,1,0,82
136035,1202243,1,12,3,0,1,82
136036,1202243,1,12,4,0,0,82
136037,1202243,1,12,5,1,0,83
136038,1202243,1,12,6,1,0,84
136039,1202243,1,13,1,1,0,85
136040,1202243,1,13,2,0,0,85
136041,1202243,1,13,3,0,0,85
136042,1202243,1,13,4,4,0,89
136043,1202243,1,13,5,1,0,90
136044,1202243,1,13,6,1,0,91
136045,1202243,1,14,1,6,0,97
136046,1202243,1,14,2,0,1,97
136047,1202243,1,14,3,2,0,99
136048,1202243,1,14,4,1,0,100
136049,1202243,1,14,5,2,0,102
136050,1202243,1,14,6,0,0,102
136051,1202243,1,15,1,1,0,103
136052,1202243,1,15,2,1,0,104
136053,1202243,1,15,3,0,0,104
136054,1202243,1,15,4,0,0,104
136055,1202243,1,15,5,0,1,104
136056,1202243,1,15,6,0,0,104
136057,1202243,1,16,1,1,0,105
136058,1202243,1,16,2,0,0,105
136059,1202243,1,16,3,1,0,106
136060,1202243,1,16,4,1,0,107
136061,1202243,1,16,5,2,0,109
136062,1202243,1,16,6,4,0,113
136063,1202243,1,17,1,1,0,114
136064,1202243,1,17,2,0,0,114
136065,1202243,1,17,3,1,0,115
136066,1202243,1,17,4,1,0,116
136067,1202243,1,17,5,1,0,117
136068,1202243,1,17,6,0,1,117
136069,1202243,1,18,1,1,0,118
136070,1202243,1,18,2,1,0,119
136071,1202243,1,18,3,2,0,121
136072,1202243,1,18,4,4,0,125
136073,1202243,1,18,5,1,0,126
136074,1202243,1,18,6,1,0,127
136075,1202243,1,19,1,1,0,128
136076,1202243,1,19,2,0,1,128
136077,1202243,1,19,3,1,0,129
136078,1202243,1,19,4,1,0,130
136079,1202243,1,19,5,0,1,130
136080,1202243,1,19,6,0,1,130
136081,1202243,1,20,1,0,0,130
136082,1202243,1,20,2,0,0,130
136083,1202243,1,20,3,0,0,130
136084,1202243,1,20,4,4,0,134
136085,1202243,1,20,5,4,0,138
136086,1202243,1,20,6,4,0,142
136192,1202244,1,1,1,0,0,0
136193,1202244,1,1,2,1,0,1
136194,1202244,1,1,3,2,0,3
136195,1202244,1,1,4,1,0,4
136196,1202244,1,1,5,1,0,5
136197,1202244,1,1,6,4,0,9
136198,1202244,1,2,1,0,0,9
136199,1202244,1,2,2,0,0,9
136200,1202244,1,2,3,4,0,13
136201,1202244,1,2,4,1,0,14
136202,1202244,1,2,5,4,0,18
136203,1202244,1,2,6,4,0,22
136204,1202244,1,3,1,0,0,22
136205,1202244,1,3,2,1,0,23
136206,1202244,1,3,3,1,0,24
136207,1202244,1,3,4,0,0,24
136208,1202244,1,3,5,1,0,25
136209,1202244,1,3,6,1,0,26
136210,1202244,1,4,1,1,0,27
136211,1202244,1,4,2,4,0,31
136212,1202244,1,4,3,1,0,32
136213,1202244,1,4,4,0,0,32
136214,1202244,1,4,5,6,0,38
136215,1202244,1,4,6,1,0,39
136216,1202244,1,5,1,2,0,41
136217,1202244,1,5,2,1,0,42
136218,1202244,1,5,3,4,0,46
136219,1202244,1,5,4,1,0,47
136220,1202244,1,5,5,1,0,48
136221,1202244,1,5,6,4,0,52
136222,1202244,1,6,1,1,0,53
136223,1202244,1,6,2,4,0,57
136224,1202244,1,6,3,4,0,61
136225,1202244,1,6,4,1,0,62
136226,1202244,1,6,5,0,0,62
136227,1202244,1,6,6,1,0,63
136228,1202244,1,7,1,1,0,64
136229,1202244,1,7,2,2,0,66
136230,1202244,1,7,3,5,0,71
136231,1202244,1,7,4,0,0,71
136232,1202244,1,7,5,0,0,71
136233,1202244,1,7,6,1,0,72
136234,1202244,1,8,1,0,0,72
136235,1202244,1,8,2,1,0,73
136236,1202244,1,8,3,1,0,74
136237,1202244,1,8,4,0,0,74
136238,1202244,1,8,5,1,0,75
136239,1202244,1,8,6,1,0,76
136240,1202244,1,9,1,1,0,77
136241,1202244,1,9,2,1,0,78
136242,1202244,1,9,3,1,0,79
136243,1202244,1,9,4,1,0,80
136244,1202244,1,9,5,1,0,81
136245,1202244,1,9,6,1,0,82
136246,1202244,1,10,1,6,0,88
136247,1202244,1,10,2,1,0,89
136248,1202244,1,10,3,1,0,90
136249,1202244,1,10,4,0,0,90
136250,1202244,1,10,5,1,0,91
136251,1202244,1,10,6,1,0,92
136252,1202244,1,11,1,1,0,93
136253,1202244,1,11,2,1,0,94
136254,1202244,1,11,3,1,0,95
136255,1202244,1,11,4,2,0,97
136256,1202244,1,11,5,0,1,97
136257,1202244,1,11,6,6,0,103
136258,1202244,1,12,1,2,0,105
136259,1202244,1,12,2,1,0,106
136260,1202244,1,12,3,0,1,106
136261,1202244,1,12,4,1,0,107
136262,1202244,1,12,5,4,0,111
136263,1202244,1,12,6,1,0,112
136264,1202244,1,13,1,2,0,114
136265,1202244,1,13,2,4,0,118
136266,1202244,1,13,3,0,1,118
136267,1202244,1,13,4,4,0,122
136268,1202244,1,13,5,0,1,122
136269,1202244,1,13,6,1,0,123
136270,1202244,1,14,1,0,0,123
136271,1202244,1,14,2,1,0,124
136272,1202244,1,14,3,1,0,125
136273,1202244,1,14,4,0,0,125
136274,1202244,1,14,5,1,0,126
136275,1202244,1,14,6,4,0,130
136276,1202244,1,15,1,0,0,130
136277,1202244,1,15,2,4,0,134
136278,1202244,1,15,3,1,0,135
136279,1202244,1,15,4,1,0,136
136280,1202244,1,15,5,1,0,137
136281,1202244,1,15,6,1,0,138
136282,1202244,1,16,1,0,0,138
136283,1202244,1,16,2,1,0,139
136284,1202244,1,16,3,0,0,139
136285,1202244,1,16,4,1,0,140
136286,1202244,1,16,5,2,0,142
136287,1202244,1,16,6,0,0,142
136288,1202244,1,17,1,2,0,144
136289,1202244,1,17,2,6,0,150
136290,1202244,1,17,3,1,0,151
136291,1202244,1,17,4,1,0,152
136292,1202244,1,17,5,4,0,156
136293,1202244,1,17,6,2,0,158
136294,1202244,1,18,1,4,0,162
136295,1202244,1,18,2,1,0,163
136296,1202244,1,18,3,1,1,164
136297,1202244,1,18,4,0,1,164
136298,1202244,1,18,5,1,0,165
136299,1202244,1,18,6,2,0,167
136300,1202244,1,19,1,6,0,173
136301,1202244,1,19,2,1,0,174
136302,1202244,1,19,3,2,0,176
136303,1202244,1,19,4,4,0,180
136304,1202244,1,19,5,1,0,181
136305,1202244,1,19,6,1,0,182
136306,1202244,1,20,1,2,0,184
136307,1202244,1,20,2,6,0,190
136308,1202244,1,20,3,4,0,194
136309,1202244,1,20,4,1,0,195
136310,1202244,1,20,5,4,0,199
136311,1202244,1,20,6,2,0,201
136407,1203676,1,1,1,0,0,0
136408,1203676,1,1,2,0,0,0
136409,1203676,1,1,3,4,0,4
136410,1203676,1,1,4,0,0,4
136411,1203676,1,1,5,1,0,5
136412,1203676,1,1,6,0,0,5
136413,1203676,1,2,1,1,0,6
136414,1203676,1,2,2,1,0,7
136415,1203676,1,2,3,1,0,8
136416,1203676,1,2,4,2,0,10
136417,1203676,1,2,5,6,0,16
136418,1203676,1,2,6,4,0,20
136419,1203676,1,3,1,2,0,22
136420,1203676,1,3,2,6,0,28
136421,1203676,1,3,3,1,0,29
136422,1203676,1,3,4,1,0,30
136423,1203676,1,3,5,4,0,34
136424,1203676,1,3,6,1,0,35
136425,1203676,1,4,1,6,0,41
136426,1203676,1,4,2,1,0,42
136427,1203676,1,4,3,1,0,43
136428,1203676,1,4,4,1,0,44
136429,1203676,1,4,5,6,0,50
136430,1203676,1,4,6,1,0,51
136431,1203676,1,5,1,4,0,55
136432,1203676,1,5,2,6,0,61
136433,1203676,1,5,3,6,0,67
136434,1203676,1,5,4,1,0,68
136435,1203676,1,5,5,0,0,68
136436,1203676,1,5,6,1,0,69
136437,1203676,1,6,1,6,0,75
136438,1203676,1,6,2,6,0,81
136439,1203676,1,6,3,3,0,84
136440,1203676,1,6,4,4,0,88
136441,1203676,1,6,5,4,0,92
136442,1203676,1,6,6,1,0,93
136443,1203676,1,7,1,1,0,94
136444,1203676,1,7,2,4,0,98
136445,1203676,1,7,3,5,0,103
136446,1203676,1,7,4,1,0,104
136447,1203676,1,7,5,1,0,105
136448,1203676,1,7,6,1,0,106
136449,1203676,1,8,1,1,0,107
136450,1203676,1,8,2,0,0,107
136451,1203676,1,8,3,6,0,113
136452,1203676,1,8,4,2,0,115
136453,1203676,1,8,5,0,0,115
136454,1203676,1,8,6,0,0,115
136455,1203676,1,9,1,2,0,117
136456,1203676,1,9,2,1,0,118
136457,1203676,1,9,3,0,0,118
136458,1203676,1,9,4,1,0,119
136459,1203676,1,9,5,3,0,122
136460,1203676,1,9,6,2,0,124
136461,1203676,1,10,1,1,0,125
136462,1203676,1,10,2,1,0,126
136463,1203676,1,10,3,0,0,126
136464,1203676,1,10,4,0,0,126
136465,1203676,1,10,5,4,0,130
136466,1203676,1,10,6,0,0,130
136467,1203676,1,11,1,4,0,134
136468,1203676,1,11,2,1,0,135
136469,1203676,1,11,3,2,0,137
136470,1203676,1,11,4,4,0,141
136471,1203676,1,11,5,1,0,142
136472,1203676,1,11,6,1,0,143
136473,1203676,1,12,1,1,0,144
136474,1203676,1,12,2,6,0,150
136475,1203676,1,12,3,1,0,151
136476,1203676,1,12,4,1,0,152
136477,1203676,1,12,5,0,0,152
136478,1203676,1,12,6,1,0,153
136479,1203676,1,13,1,1,0,154
136480,1203676,1,13,2,0,0,154
136481,1203676,1,13,3,0,1,154
136482,1203676,1,13,4,0,0,154
136483,1203676,1,13,5,2,0,156
136484,1203676,1,13,6,0,0,156
136485,1203676,1,14,1,0,0,156
136486,1203676,1,14,2,0,1,156
136487,1203676,1,14,3,0,0,156
136488,1203676,1,14,4,0,0,156
136489,1203676,1,14,5,1,0,157
136490,1203676,1,14,6,0,0,157
136491,1203676,1,15,1,0,0,157
136492,1203676,1,15,2,1,0,158
136493,1203676,1,15,3,1,0,159
136494,1203676,1,15,4,1,0,160
136495,1203676,1,15,5,0,0,160
136496,1203676,1,15,6,0,0,160
136497,1203676,1,16,1,2,0,162
136498,1203676,1,16,2,0,1,162
136499,1203676,1,16,3,2,0,164
136500,1203676,1,16,4,0,1,164
136501,1203676,1,16,5,1,0,165
136502,1203676,1,16,6,1,0,166
136503,1203676,1,17,1,1,0,167
136504,1203676,1,17,2,4,0,171
136505,1203676,1,17,3,2,0,173
136506,1203676,1,17,4,4,0,177
136507,1203676,1,17,5,1,0,178
136508,1203676,1,17,6,0,0,178
136509,1203676,1,18,1,2,0,180
136510,1203676,1,18,2,1,0,181
136511,1203676,1,18,3,4,0,185
136512,1203676,1,18,4,6,0,191
136513,1203676,1,18,5,7,0,198
136514,1203676,1,18,6,0,0,198
136515,1203676,1,19,1,0,0,198
136516,1203676,1,19,2,1,0,199
136517,1203676,1,19,3,0,1,199
136518,1203676,1,19,4,1,0,200
136519,1203676,1,19,5,1,0,201
136520,1203676,1,19,6,1,0,202
136521,1203676,1,20,1,2,0,204
136522,1203676,1,20,2,2,0,206
136523,1203676,1,20,3,1,0,207
136524,1203676,1,20,4,1,0,208
136525,1203676,1,20,5,0,1,208
136526,1203676,1,20,6,0,1,208
136647,1203678,1,1,1,1,0,1
136648,1203678,1,1,2,4,0,5
136649,1203678,1,1,3,1,0,6
136650,1203678,1,1,4,1,0,7
136651,1203678,1,1,5,0,0,7
136652,1203678,1,1,6,1,0,8
136653,1203678,1,2,1,2,0,10
136654,1203678,1,2,2,4,0,14
136655,1203678,1,2,3,6,0,20
136656,1203678,1,2,4,0,0,20
136657,1203678,1,2,5,1,0,21
136658,1203678,1,2,6,6,0,27
136659,1203678,1,3,1,4,0,31
136660,1203678,1,3,2,4,0,35
136661,1203678,1,3,3,4,0,39
136662,1203678,1,3,4,4,0,43
136663,1203678,1,3,5,4,0,47
136664,1203678,1,3,6,1,0,48
136665,1203678,1,4,1,1,0,49
136666,1203678,1,4,2,1,0,50
136667,1203678,1,4,3,0,0,50
136668,1203678,1,4,4,0,1,50
136669,1203678,1,4,5,2,0,52
136670,1203678,1,4,6,0,0,52
136671,1203678,1,5,1,2,0,54
136672,1203678,1,5,2,0,0,54
136673,1203678,1,5,3,0,0,54
136674,1203678,1,5,4,1,0,55
136675,1203678,1,5,5,0,1,55
136676,1203678,1,5,6,0,0,55
136677,1203678,1,6,1,0,0,55
136678,1203678,1,6,2,4,0,59
136679,1203678,1,6,3,2,0,61
136680,1203678,1,6,4,0,0,61
136681,1203678,1,6,5,0,0,61
136682,1203678,1,6,6,0,0,61
136683,1203678,1,7,1,4,0,65
136684,1203678,1,7,2,1,0,66
136685,1203678,1,7,3,4,0,70
136686,1203678,1,7,4,1,0,71
136687,1203678,1,7,5,1,0,72
136688,1203678,1,7,6,1,0,73
136689,1203678,1,8,1,1,0,74
136690,1203678,1,8,2,0,1,74
136691,1203678,1,8,3,1,0,75
136692,1203678,1,8,4,1,0,76
136693,1203678,1,8,5,0,1,76
136694,1203678,1,8,6,0,0,76
136695,1203678,1,9,1,1,0,77
136696,1203678,1,9,2,4,0,81
136697,1203678,1,9,3,1,0,82
136698,1203678,1,9,4,1,0,83
136699,1203678,1,9,5,1,0,84
136700,1203678,1,9,6,4,0,88
136701,1203678,1,10,1,0,0,88
136702,1203678,1,10,2,0,0,88
136703,1203678,1,10,3,1,0,89
136704,1203678,1,10,4,2,0,91
136705,1203678,1,10,5,0,0,91
136706,1203678,1,10,6,1,0,92
136707,1203678,1,11,1,1,0,93
136708,1203678,1,11,2,0,1,93
136709,1203678,1,11,3,1,1,94
136710,1203678,1,11,4,1,0,95
136711,1203678,1,11,5,1,0,96
136712,1203678,1,11,6,0,0,96
136713,1203678,1,12,1,1,0,97
136714,1203678,1,12,2,2,0,99
136715,1203678,1,12,3,0,0,99
136716,1203678,1,12,4,1,0,100
136717,1203678,1,12,5,1,0,101
136718,1203678,1,12,6,1,0,102
136719,1203678,1,13,1,0,0,102
136720,1203678,1,13,2,1,0,103
136721,1203678,1,13,3,0,0,103
136722,1203678,1,13,4,2,0,105
136723,1203678,1,13,5,1,0,106
136724,1203678,1,13,6,1,0,107
136725,1203678,1,14,1,0,1,107
136726,1203678,1,14,2,1,0,108
136727,1203678,1,14,3,0,1,108
136728,1203678,1,14,4,1,0,109
136729,1203678,1,14,5,2,0,111
136730,1203678,1,14,6,1,0,112
136731,1203678,1,15,1,1,0,113
136732,1203678,1,15,2,1,0,114
136733,1203678,1,15,3,1,0,115
136734,1203678,1,15,4,0,0,115
136735,1203678,1,15,5,0,0,115
136736,1203678,1,15,6,0,0,115
136737,1203678,1,16,1,1,0,116
136738,1203678,1,16,2,0,0,116
136739,1203678,1,16,3,0,0,116
136740,1203678,1,16,4,1,0,117
136741,1203678,1,16,5,1,0,118
136742,1203678,1,16,6,4,0,122
136743,1203678,1,17,1,1,0,123
136744,1203678,1,17,2,1,0,124
136745,1203678,1,17,3,1,0,125
136746,1203678,1,17,4,0,1,125
136747,1203678,1,17,5,0,0,125
136748,1203678,1,17,6,1,0,126
136749,1203678,1,18,1,0,0,126
136750,1203678,1,18,2,0,0,126
136751,1203678,1,18,3,1,0,127
136752,1203678,1,18,4,1,0,128
136753,1203678,1,18,5,1,0,129
136754,1203678,1,18,6,6,0,135
136755,1203678,1,19,1,0,0,135
136756,1203678,1,19,2,0,0,135
136757,1203678,1,19,3,1,0,136
136758,1203678,1,19,4,1,0,137
136759,1203678,1,19,5,1,0,138
136760,1203678,1,19,6,0,0,138
136761,1203678,1,20,1,0,1,138
136828,1213058,1,1,1,0,0,0
136829,1213058,1,1,2,0,0,0
136830,1213058,1,1,3,0,0,0
136831,1213058,1,1,4,0,0,0
136832,1213058,1,1,5,2,0,2
136833,1213058,1,1,6,0,0,2
136834,1213058,1,2,1,0,0,2
136835,1213058,1,2,2,0,0,2
136836,1213058,1,2,3,4,0,6
136837,1213058,1,2,4,0,0,6
136838,1213058,1,2,5,0,0,6
136839,1213058,1,2,6,4,0,10
136840,1213058,1,3,1,0,0,10
136841,1213058,1,3,2,4,0,14
136842,1213058,1,3,3,1,0,15
136843,1213058,1,3,4,0,0,15
136844,1213058,1,3,5,0,0,15
136845,1213058,1,3,6,0,0,15
136846,1213058,1,4,1,1,0,16
136847,1213058,1,4,2,0,0,16
136848,1213058,1,4,3,4,0,20
136849,1213058,1,4,4,0,0,20
136850,1213058,1,4,5,6,0,26
136851,1213058,1,4,6,0,0,26
136852,1213058,1,5,1,0,0,26
136853,1213058,1,5,2,0,0,26
136854,1213058,1,5,3,1,0,27
136855,1213058,1,5,4,1,0,28
136856,1213058,1,5,5,1,0,29
136857,1213058,1,5,6,0,0,29
136858,1213058,1,6,1,0,0,29
136859,1213058,1,6,2,4,0,33
136860,1213058,1,6,3,1,0,34
136861,1213058,1,6,4,1,0,35
136862,1213058,1,6,5,0,0,35
136863,1213058,1,6,6,0,0,35
136864,1213058,1,7,1,1,0,36
136865,1213058,1,7,2,1,0,37
136866,1213058,1,7,3,1,0,38
136867,1213058,1,7,4,1,0,39
136868,1213058,1,7,5,0,0,39
136869,1213058,1,7,6,2,0,41
136870,1213058,1,8,1,4,0,45
136871,1213058,1,8,2,0,0,45
136872,1213058,1,8,3,4,0,49
136873,1213058,1,8,4,1,0,50
136874,1213058,1,8,5,0,0,50
136875,1213058,1,8,6,1,0,51
136876,1213058,1,9,1,1,0,52
136877,1213058,1,9,2,0,0,52
136878,1213058,1,9,3,2,0,54
136879,1213058,1,9,4,1,0,55
136880,1213058,1,9,5,2,0,57
136881,1213058,1,9,6,0,0,57
136882,1213058,1,10,1,1,0,58
136883,1213058,1,10,2,0,0,58
136884,1213058,1,10,3,1,0,59
136885,1213058,1,10,4,1,0,60
136886,1213058,1,10,5,1,0,61
136887,1213058,1,10,6,1,0,62
136888,1213058,1,11,1,6,0,68
136889,1213058,1,11,2,1,0,69
136890,1213058,1,11,3,0,0,69
136891,1213058,1,11,4,0,0,69
136892,1213058,1,11,5,1,0,70
136893,1213058,1,11,6,1,1,71
136894,1213058,1,12,1,2,0,73
136895,1213058,1,12,2,1,0,74
136896,1213058,1,12,3,1,0,75
136897,1213058,1,12,4,0,0,75
136898,1213058,1,12,5,0,0,75
136899,1213058,1,12,6,4,0,79
136900,1213058,1,13,1,6,0,85
136901,1213058,1,13,2,1,0,86
136902,1213058,1,13,3,0,0,86
136903,1213058,1,13,4,0,0,86
136904,1213058,1,13,5,0,0,86
136905,1213058,1,13,6,0,0,86
136906,1213058,1,14,1,1,0,87
136907,1213058,1,14,2,4,0,91
136908,1213058,1,14,3,1,0,92
136909,1213058,1,14,4,2,0,94
136910,1213058,1,14,5,1,0,95
136911,1213058,1,14,6,1,0,96
136912,1213058,1,15,1,0,0,96
136913,1213058,1,15,2,1,0,97
136914,1213058,1,15,3,1,1,98
136915,1213058,1,15,4,0,1,98
136916,1213058,1,15,5,1,0,99
136917,1213058,1,15,6,1,0,100
136918,1213058,1,16,1,1,0,101
136919,1213058,1,16,2,1,0,102
136920,1213058,1,16,3,1,0,103
136921,1213058,1,16,4,1,0,104
136922,1213058,1,16,5,1,0,105
136923,1213058,1,16,6,1,0,106
136924,1213058,1,17,1,1,0,107
136925,1213058,1,17,2,1,0,108
136926,1213058,1,17,3,4,0,112
136927,1213058,1,17,4,1,0,113
136928,1213058,1,17,5,2,0,115
136929,1213058,1,17,6,1,0,116
136930,1213058,1,18,1,1,0,117
136931,1213058,1,18,2,1,0,118
136932,1213058,1,18,3,1,0,119
136933,1213058,1,18,4,0,1,119
136934,1213058,1,18,5,4,0,123
136935,1213058,1,18,6,1,0,124
136936,1213058,1,19,1,1,0,125
136937,1213058,1,19,2,1,0,126
136938,1213058,1,19,3,1,0,127
136939,1213058,1,19,4,1,0,128
136940,1213058,1,19,5,0,1,128
136941,1213058,1,19,6,0,0,128
136942,1213058,1,20,1,2,0,130
136943,1213058,1,20,2,1,0,131
136944,1213058,1,20,3,4,0,135
136945,1213058,1,20,4,1,0,136
136946,1213058,1,20,5,4,0,140
136947,1213058,1,20,6,1,0,141
137065,1213059,1,1,1,0,0,0
137066,1213059,1,1,2,0,0,0
137067,1213059,1,1,3,1,0,1
137068,1213059,1,1,4,2,0,3
137069,1213059,1,1,5,0,0,3
137070,1213059,1,1,6,1,0,4
137071,1213059,1,2,1,1,0,5
137072,1213059,1,2,2,0,1,5
137073,1213059,1,2,3,0,0,5
137074,1213059,1,2,4,0,0,5
137075,1213059,1,2,5,0,0,5
137076,1213059,1,2,6,1,0,6
137077,1213059,1,3,1,0,0,6
137078,1213059,1,3,2,0,0,6
137079,1213059,1,3,3,6,0,12
137080,1213059,1,3,4,1,0,13
137081,1213059,1,3,5,4,0,17
137082,1213059,1,3,6,1,0,18
137083,1213059,1,4,1,0,0,18
137084,1213059,1,4,2,0,0,18
137085,1213059,1,4,3,2,0,20
137086,1213059,1,4,4,1,0,21
137087,1213059,1,4,5,0,0,21
137088,1213059,1,4,6,1,0,22
137089,1213059,1,5,1,0,0,22
137090,1213059,1,5,2,0,1,22
137091,1213059,1,5,3,1,0,23
137092,1213059,1,5,4,4,0,27
137093,1213059,1,5,5,0,0,27
137094,1213059,1,5,6,0,0,27
137095,1213059,1,6,1,0,0,27
137096,1213059,1,6,2,0,0,27
137097,1213059,1,6,3,0,0,27
137098,1213059,1,6,4,4,0,31
137099,1213059,1,6,5,1,0,32
137100,1213059,1,6,6,1,0,33
137101,1213059,1,7,1,1,0,34
137102,1213059,1,7,2,0,0,34
137103,1213059,1,7,3,0,0,34
137104,1213059,1,7,4,0,0,34
137105,1213059,1,7,5,1,0,35
137106,1213059,1,7,6,4,0,39
137107,1213059,1,8,1,0,0,39
137108,1213059,1,8,2,1,0,40
137109,1213059,1,8,3,1,0,41
137110,1213059,1,8,4,0,0,41
137111,1213059,1,8,5,0,1,41
137112,1213059,1,8,6,0,0,41
137113,1213059,1,9,1,1,0,42
137114,1213059,1,9,2,1,0,43
137115,1213059,1,9,3,1,0,44
137116,1213059,1,9,4,1,0,45
137117,1213059,1,9,5,0,0,45
137118,1213059,1,9,6,0,0,45
137119,1213059,1,10,1,0,0,45
137120,1213059,1,10,2,1,0,46
137121,1213059,1,10,3,1,0,47
137122,1213059,1,10,4,4,0,51
137123,1213059,1,10,5,6,0,57
137124,1213059,1,10,6,0,0,57
137125,1213059,1,11,1,1,0,58
137126,1213059,1,11,2,1,0,59
137127,1213059,1,11,3,1,0,60
137128,1213059,1,11,4,0,0,60
137129,1213059,1,11,5,1,0,61
137130,1213059,1,11,6,1,0,62
137131,1213059,1,12,1,2,0,64
137132,1213059,1,12,2,1,0,65
137133,1213059,1,12,3,1,0,66
137134,1213059,1,12,4,6,0,72
137135,1213059,1,12,5,1,0,73
137136,1213059,1,12,6,1,0,74
137137,1213059,1,13,1,1,0,75
137138,1213059,1,13,2,0,0,75
137139,1213059,1,13,3,2,0,77
137140,1213059,1,13,4,1,0,78
137141,1213059,1,13,5,1,0,79
137142,1213059,1,13,6,0,0,79
137143,1213059,1,14,1,1,0,80
137144,1213059,1,14,2,1,0,81
137145,1213059,1,14,3,0,0,81
137146,1213059,1,14,4,1,0,82
137147,1213059,1,14,5,1,0,83
137148,1213059,1,14,6,1,0,84
137149,1213059,1,15,1,0,0,84
137150,1213059,1,15,2,1,0,85
137151,1213059,1,15,3,1,0,86
137152,1213059,1,15,4,0,1,86
137153,1213059,1,15,5,1,0,87
137154,1213059,1,15,6,1,0,88
137155,1213059,1,16,1,4,0,92
137156,1213059,1,16,2,0,0,92
137157,1213059,1,16,3,4,0,96
137158,1213059,1,16,4,4,0,100
137159,1213059,1,16,5,1,0,101
137160,1213059,1,16,6,1,0,102
137161,1213059,1,17,1,1,0,103
137162,1213059,1,17,2,1,0,104
137163,1213059,1,17,3,1,0,105
137164,1213059,1,17,4,1,0,106
137165,1213059,1,17,5,1,0,107
137166,1213059,1,17,6,4,0,111
137167,1213059,1,18,1,4,0,115
137168,1213059,1,18,2,0,0,115
137169,1213059,1,18,3,2,0,117
137170,1213059,1,18,4,0,1,117
137171,1213059,1,18,5,1,0,118
137172,1213059,1,18,6,1,0,119
137173,1213059,1,19,1,3,0,122
137174,1213059,1,19,2,1,0,123
137175,1213059,1,19,3,1,0,124
137176,1213059,1,19,4,1,0,125
137177,1213059,1,19,5,0,0,125
137178,1213059,1,19,6,1,0,126
137179,1213059,1,20,1,0,1,126
137180,1213059,1,20,2,4,0,130
137181,1213059,1,20,3,0,0,130
137182,1213059,1,20,4,1,0,131
137183,1213059,1,20,5,1,0,132
137184,1213059,1,20,6,4,0,136
137285,1213874,1,1,1,0,0,0
137286,1213874,1,1,2,1,0,1
137287,1213874,1,1,3,0,0,1
137288,1213874,1,1,4,4,0,5
137289,1213874,1,1,5,1,0,6
137290,1213874,1,1,6,0,0,6
137291,1213874,1,2,1,0,0,6
137292,1213874,1,2,2,0,0,6
137293,1213874,1,2,3,0,0,6
137294,1213874,1,2,4,0,0,6
137295,1213874,1,2,5,0,0,6
137296,1213874,1,2,6,6,0,12
137297,1213874,1,3,1,4,0,16
137298,1213874,1,3,2,0,0,16
137299,1213874,1,3,3,0,0,16
137300,1213874,1,3,4,1,0,17
137301,1213874,1,3,5,0,0,17
137302,1213874,1,3,6,4,0,21
137303,1213874,1,4,1,4,0,25
137304,1213874,1,4,2,4,0,29
137305,1213874,1,4,3,0,0,29
137306,1213874,1,4,4,0,0,29
137307,1213874,1,4,5,1,0,30
137308,1213874,1,4,6,0,0,30
137309,1213874,1,5,1,0,0,30
137310,1213874,1,5,2,2,0,32
137311,1213874,1,5,3,4,0,36
137312,1213874,1,5,4,1,0,37
137313,1213874,1,5,5,1,0,38
137314,1213874,1,5,6,0,0,38
137315,1213874,1,6,1,6,0,44
137316,1213874,1,6,2,4,0,48
137317,1213874,1,6,3,0,0,48
137318,1213874,1,6,4,6,0,54
137319,1213874,1,6,5,4,0,58
137320,1213874,1,6,6,0,0,58
137321,1213874,1,7,1,0,0,58
137322,1213874,1,7,2,1,0,59
137323,1213874,1,7,3,0,0,59
137324,1213874,1,7,4,1,0,60
137325,1213874,1,7,5,4,0,64
137326,1213874,1,7,6,1,0,65
137327,1213874,1,8,1,4,0,69
137328,1213874,1,8,2,1,0,70
137329,1213874,1,8,3,1,0,71
137330,1213874,1,8,4,1,0,72
137331,1213874,1,8,5,1,0,73
137332,1213874,1,8,6,1,0,74
137333,1213874,1,9,1,0,0,74
137334,1213874,1,9,2,0,1,74
137335,1213874,1,9,3,2,0,76
137336,1213874,1,9,4,1,0,77
137337,1213874,1,9,5,0,0,77
137338,1213874,1,9,6,1,0,78
137339,1213874,1,10,1,4,0,82
137340,1213874,1,10,2,4,0,86
137341,1213874,1,10,3,0,0,86
137342,1213874,1,10,4,1,0,87
137343,1213874,1,10,5,1,0,88
137344,1213874,1,10,6,2,0,90
137345,1213874,1,11,1,4,0,94
137346,1213874,1,11,2,0,0,94
137347,1213874,1,11,3,1,0,95
137348,1213874,1,11,4,2,0,97
137349,1213874,1,11,5,1,0,98
137350,1213874,1,11,6,0,0,98
137351,1213874,1,12,1,1,0,99
137352,1213874,1,12,2,4,0,103
137353,1213874,1,12,3,1,0,104
137354,1213874,1,12,4,0,0,104
137355,1213874,1,12,5,1,0,105
137356,1213874,1,12,6,0,0,105
137357,1213874,1,13,1,1,0,106
137358,1213874,1,13,2,0,0,106
137359,1213874,1,13,3,0,1,106
137360,1213874,1,13,4,0,0,106
137361,1213874,1,13,5,0,0,106
137362,1213874,1,13,6,1,0,107
137363,1213874,1,14,1,6,0,113
137364,1213874,1,14,2,4,0,117
137365,1213874,1,14,3,1,0,118
137366,1213874,1,14,4,7,0,125
137367,1213874,1,14,5,1,0,126
137368,1213874,1,14,6,0,0,126
137369,1213874,1,15,1,4,0,130
137370,1213874,1,15,2,1,0,131
137371,1213874,1,15,3,1,0,132
137372,1213874,1,15,4,6,0,138
137373,1213874,1,15,5,0,0,138
137374,1213874,1,15,6,6,0,144
137375,1213874,1,16,1,1,0,145
137376,1213874,1,16,2,0,1,145
137377,1213874,1,16,3,1,0,146
137378,1213874,1,16,4,2,0,148
137379,1213874,1,16,5,1,0,149
137380,1213874,1,16,6,1,0,150
137381,1213874,1,17,1,2,0,152
137382,1213874,1,17,2,2,0,154
137383,1213874,1,17,3,1,0,155
137384,1213874,1,17,4,1,0,156
137385,1213874,1,17,5,0,0,156
137386,1213874,1,17,6,0,0,156
137387,1213874,1,18,1,4,0,160
137388,1213874,1,18,2,4,0,164
137389,1213874,1,18,3,2,0,166
137390,1213874,1,18,4,4,0,170
137391,1213874,1,18,5,2,0,172
137392,1213874,1,18,6,1,0,173
137393,1213874,1,19,1,0,0,173
137394,1213874,1,19,2,1,0,174
137395,1213874,1,19,3,6,0,180
137396,1213874,1,19,4,0,0,180
137397,1213874,1,19,5,1,0,181
137398,1213874,1,19,6,1,0,182
137399,1213874,1,20,1,8,0,190
137400,1213874,1,20,2,0,1,190
137401,1213874,1,20,3,1,0,191
137402,1213874,1,20,4,2,0,193
137403,1213874,1,20,5,2,0,195
137404,1213874,1,20,6,1,0,196
137520,1213875,1,1,1,1,0,1
137521,1213875,1,1,2,1,0,2
137522,1213875,1,1,3,1,0,3
137523,1213875,1,1,4,1,0,4
137524,1213875,1,1,5,0,0,4
137525,1213875,1,1,6,1,0,5
137526,1213875,1,2,1,0,0,5
137527,1213875,1,2,2,0,0,5
137528,1213875,1,2,3,5,0,10
137529,1213875,1,2,4,1,0,11
137530,1213875,1,2,5,2,0,13
137531,1213875,1,2,6,2,0,15
137532,1213875,1,3,1,1,0,16
137533,1213875,1,3,2,0,0,16
137534,1213875,1,3,3,0,1,16
137535,1213875,1,3,4,0,0,16
137536,1213875,1,3,5,0,0,16
137537,1213875,1,3,6,1,0,17
137538,1213875,1,4,1,0,0,17
137539,1213875,1,4,2,1,0,18
137540,1213875,1,4,3,4,0,22
137541,1213875,1,4,4,1,0,23
137542,1213875,1,4,5,0,0,23
137543,1213875,1,4,6,4,0,27
137544,1213875,1,5,1,1,0,28
137545,1213875,1,5,2,0,0,28
137546,1213875,1,5,3,0,0,28
137547,1213875,1,5,4,4,0,32
137548,1213875,1,5,5,4,0,36
137549,1213875,1,5,6,0,0,36
137550,1213875,1,6,1,1,0,37
137551,1213875,1,6,2,1,0,38
137552,1213875,1,6,3,4,0,42
137553,1213875,1,6,4,1,0,43
137554,1213875,1,6,5,0,0,43
137555,1213875,1,6,6,1,0,44
137556,1213875,1,7,1,4,0,48
137557,1213875,1,7,2,0,0,48
137558,1213875,1,7,3,0,1,48
137559,1213875,1,7,4,0,1,48
137560,1213875,1,7,5,1,0,49
137561,1213875,1,7,6,1,0,50
137562,1213875,1,8,1,1,0,51
137563,1213875,1,8,2,2,0,53
137564,1213875,1,8,3,0,0,53
137565,1213875,1,8,4,4,0,57
137566,1213875,1,8,5,1,0,58
137567,1213875,1,8,6,0,0,58
137568,1213875,1,9,1,0,0,58
137569,1213875,1,9,2,1,0,59
137570,1213875,1,9,3,4,0,63
137571,1213875,1,9,4,0,0,63
137572,1213875,1,9,5,1,0,64
137573,1213875,1,9,6,1,0,65
137574,1213875,1,10,1,1,0,66
137575,1213875,1,10,2,1,0,67
137576,1213875,1,10,3,5,0,72
137577,1213875,1,10,4,1,0,73
137578,1213875,1,10,5,1,0,74
137579,1213875,1,10,6,1,0,75
137580,1213875,1,11,1,1,0,76
137581,1213875,1,11,2,1,0,77
137582,1213875,1,11,3,1,0,78
137583,1213875,1,11,4,0,0,78
137584,1213875,1,11,5,1,0,79
137585,1213875,1,11,6,2,0,81
137586,1213875,1,12,1,0,0,81
137587,1213875,1,12,2,0,1,81
137588,1213875,1,12,3,0,0,81
137589,1213875,1,12,4,0,0,81
137590,1213875,1,12,5,2,0,83
137591,1213875,1,12,6,1,0,84
137592,1213875,1,13,1,1,0,85
137593,1213875,1,13,2,1,0,86
137594,1213875,1,13,3,6,0,92
137595,1213875,1,13,4,0,0,92
137596,1213875,1,13,5,0,0,92
137597,1213875,1,13,6,0,0,92
137598,1213875,1,14,1,1,0,93
137599,1213875,1,14,2,1,0,94
137600,1213875,1,14,3,1,0,95
137601,1213875,1,14,4,0,0,95
137602,1213875,1,14,5,0,1,95
137603,1213875,1,14,6,1,0,96
137604,1213875,1,15,1,0,0,96
137605,1213875,1,15,2,1,0,97
137606,1213875,1,15,3,1,0,98
137607,1213875,1,15,4,4,0,102
137608,1213875,1,15,5,1,0,103
137609,1213875,1,15,6,1,0,104
137610,1213875,1,16,1,0,0,104
137611,1213875,1,16,2,0,0,104
137612,1213875,1,16,3,1,0,105
137613,1213875,1,16,4,1,0,106
137614,1213875,1,16,5,1,0,107
137615,1213875,1,16,6,2,0,109
137616,1213875,1,17,1,0,1,109
137617,1213875,1,17,2,1,0,110
137618,1213875,1,17,3,4,0,114
137619,1213875,1,17,4,1,0,115
137620,1213875,1,17,5,0,0,115
137621,1213875,1,17,6,1,0,116
137622,1213875,1,18,1,0,0,116
137623,1213875,1,18,2,1,0,117
137624,1213875,1,18,3,4,0,121
137625,1213875,1,18,4,1,0,122
137626,1213875,1,18,5,2,0,124
137627,1213875,1,18,6,4,0,128
137628,1213875,1,19,1,1,0,129
137629,1213875,1,19,2,1,0,130
137630,1213875,1,19,3,1,0,131
137631,1213875,1,19,4,6,0,137
137632,1213875,1,19,5,2,0,139
137633,1213875,1,19,6,0,0,139
137634,1213875,1,20,1,4,0,143
137635,1213875,1,20,2,1,0,144
137636,1213875,1,20,3,1,0,145
137637,1213875,1,20,4,7,0,152
137638,1213875,1,20,5,1,0,153
137639,1213875,1,20,6,2,0,155
137742,1214670,1,1,1,0,0,0
137743,1214670,1,1,2,0,0,0
137744,1214670,1,1,3,1,0,1
137745,1214670,1,1,4,0,0,1
137746,1214670,1,1,5,6,0,7
137747,1214670,1,1,6,4,0,11
137748,1214670,1,2,1,4,0,15
137749,1214670,1,2,2,0,0,15
137750,1214670,1,2,3,1,0,16
137751,1214670,1,2,4,0,0,16
137752,1214670,1,2,5,4,0,20
137753,1214670,1,2,6,0,0,20
137754,1214670,1,3,1,0,0,20
137755,1214670,1,3,2,0,0,20
137756,1214670,1,3,3,0,0,20
137757,1214670,1,3,4,0,0,20
137758,1214670,1,3,5,1,0,21
137759,1214670,1,3,6,2,0,23
137760,1214670,1,4,1,1,0,24
137761,1214670,1,4,2,1,0,25
137762,1214670,1,4,3,2,0,27
137763,1214670,1,4,4,1,0,28
137764,1214670,1,4,5,4,0,32
137765,1214670,1,4,6,6,0,38
137766,1214670,1,5,1,4,0,42
137767,1214670,1,5,2,4,0,46
137768,1214670,1,5,3,0,0,46
137769,1214670,1,5,4,1,0,47
137770,1214670,1,5,5,1,0,48
137771,1214670,1,5,6,0,0,48
137772,1214670,1,6,1,1,0,49
137773,1214670,1,6,2,1,0,50
137774,1214670,1,6,3,1,0,51
137775,1214670,1,6,4,6,0,57
137776,1214670,1,6,5,1,0,58
137777,1214670,1,6,6,1,0,59
137778,1214670,1,7,1,6,0,65
137779,1214670,1,7,2,1,0,66
137780,1214670,1,7,3,1,0,67
137781,1214670,1,7,4,1,0,68
137782,1214670,1,7,5,1,0,69
137783,1214670,1,7,6,1,0,70
137784,1214670,1,8,1,1,0,71
137785,1214670,1,8,2,0,0,71
137786,1214670,1,8,3,1,0,72
137787,1214670,1,8,4,0,0,72
137788,1214670,1,8,5,6,0,78
137789,1214670,1,8,6,1,0,79
137790,1214670,1,9,1,1,0,80
137791,1214670,1,9,2,0,0,80
137792,1214670,1,9,3,1,0,81
137793,1214670,1,9,4,1,0,82
137794,1214670,1,9,5,1,0,83
137795,1214670,1,9,6,0,0,83
137796,1214670,1,10,1,0,0,83
137797,1214670,1,10,2,4,0,87
137798,1214670,1,10,3,1,0,88
137799,1214670,1,10,4,1,0,89
137800,1214670,1,10,5,1,0,90
137801,1214670,1,10,6,1,0,91
137802,1214670,1,11,1,1,0,92
137803,1214670,1,11,2,0,1,92
137804,1214670,1,11,3,1,0,93
137805,1214670,1,11,4,1,0,94
137806,1214670,1,11,5,1,0,95
137807,1214670,1,11,6,0,0,95
137808,1214670,1,12,1,0,0,95
137809,1214670,1,12,2,1,0,96
137810,1214670,1,12,3,0,0,96
137811,1214670,1,12,4,1,0,97
137812,1214670,1,12,5,0,0,97
137813,1214670,1,12,6,1,0,98
137814,1214670,1,13,1,2,0,100
137815,1214670,1,13,2,1,0,101
137816,1214670,1,13,3,0,0,101
137817,1214670,1,13,4,1,0,102
137818,1214670,1,13,5,4,0,106
137819,1214670,1,13,6,0,1,106
137820,1214670,1,14,1,6,0,112
137821,1214670,1,14,2,1,0,113
137822,1214670,1,14,3,1,0,114
137823,1214670,1,14,4,1,0,115
137824,1214670,1,14,5,1,0,116
137825,1214670,1,14,6,1,0,117
137826,1214670,1,15,1,4,0,121
137827,1214670,1,15,2,1,0,122
137828,1214670,1,15,3,1,0,123
137829,1214670,1,15,4,0,0,123
137830,1214670,1,15,5,1,0,124
137831,1214670,1,15,6,1,0,125
137832,1214670,1,16,1,6,0,131
137833,1214670,1,16,2,1,0,132
137834,1214670,1,16,3,4,0,136
137835,1214670,1,16,4,10,0,146
137836,1214670,1,16,5,0,1,146
137837,1214670,1,16,6,1,0,147
137838,1214670,1,17,1,2,0,149
137839,1214670,1,17,2,4,0,153
137840,1214670,1,17,3,1,0,154
137841,1214670,1,17,4,2,0,156
137842,1214670,1,17,5,1,0,157
137843,1214670,1,17,6,6,0,163
137844,1214670,1,18,1,1,0,164
137845,1214670,1,18,2,0,0,164
137846,1214670,1,18,3,1,0,165
137847,1214670,1,18,4,1,0,166
137848,1214670,1,18,5,0,0,166
137849,1214670,1,18,6,4,0,170
137850,1214670,1,19,1,1,0,171
137851,1214670,1,19,2,1,0,172
137852,1214670,1,19,3,1,0,173
137853,1214670,1,19,4,1,0,174
137854,1214670,1,19,5,4,0,178
137855,1214670,1,19,6,2,0,180
137856,1214670,1,20,1,6,0,186
137857,1214670,1,20,2,0,0,186
137858,1214670,1,20,3,1,0,187
137859,1214670,1,20,4,1,0,188
137860,1214670,1,20,5,6,0,194
137861,1214670,1,20,6,6,0,200
137976,1214671,1,1,1,0,0,0
137977,1214671,1,1,2,0,0,0
137978,1214671,1,1,3,4,0,4
137979,1214671,1,1,4,1,0,5
137980,1214671,1,1,5,0,0,5
137981,1214671,1,1,6,0,0,5
137982,1214671,1,2,1,4,0,9
137983,1214671,1,2,2,0,0,9
137984,1214671,1,2,3,0,0,9
137985,1214671,1,2,4,1,0,10
137986,1214671,1,2,5,0,0,10
137987,1214671,1,2,6,1,0,11
137988,1214671,1,3,1,1,0,12
137989,1214671,1,3,2,0,0,12
137990,1214671,1,3,3,0,1,12
137991,1214671,1,3,4,1,0,13
137992,1214671,1,3,5,1,0,14
137993,1214671,1,3,6,1,0,15
137994,1214671,1,4,1,0,0,15
137995,1214671,1,4,2,0,0,15
137996,1214671,1,4,3,0,0,15
137997,1214671,1,4,4,0,0,15
137998,1214671,1,4,5,1,0,16
137999,1214671,1,4,6,2,0,18
138000,1214671,1,5,1,0,0,18
138001,1214671,1,5,2,4,0,22
138002,1214671,1,5,3,1,0,23
138003,1214671,1,5,4,1,0,24
138004,1214671,1,5,5,0,0,24
138005,1214671,1,5,6,1,0,25
138006,1214671,1,6,1,1,0,26
138007,1214671,1,6,2,0,0,26
138008,1214671,1,6,3,2,0,28
138009,1214671,1,6,4,1,0,29
138010,1214671,1,6,5,0,0,29
138011,1214671,1,6,6,2,0,31
138012,1214671,1,7,1,4,0,35
138013,1214671,1,7,2,0,0,35
138014,1214671,1,7,3,0,0,35
138015,1214671,1,7,4,1,0,36
138016,1214671,1,7,5,1,0,37
138017,1214671,1,7,6,6,0,43
138018,1214671,1,8,1,1,0,44
138019,1214671,1,8,2,1,0,45
138020,1214671,1,8,3,0,0,45
138021,1214671,1,8,4,0,0,45
138022,1214671,1,8,5,1,0,46
138023,1214671,1,8,6,1,0,47
138024,1214671,1,9,1,1,0,48
138025,1214671,1,9,2,1,0,49
138026,1214671,1,9,3,0,0,49
138027,1214671,1,9,4,1,0,50
138028,1214671,1,9,5,4,0,54
138029,1214671,1,9,6,1,0,55
138030,1214671,1,10,1,0,0,55
138031,1214671,1,10,2,0,0,55
138032,1214671,1,10,3,2,0,57
138033,1214671,1,10,4,0,0,57
138034,1214671,1,10,5,4,0,61
138035,1214671,1,10,6,1,0,62
138036,1214671,1,11,1,0,0,62
138037,1214671,1,11,2,1,0,63
138038,1214671,1,11,3,1,0,64
138039,1214671,1,11,4,1,0,65
138040,1214671,1,11,5,0,0,65
138041,1214671,1,11,6,4,0,69
138042,1214671,1,12,1,0,1,69
138043,1214671,1,12,2,0,0,69
138044,1214671,1,12,3,1,0,70
138045,1214671,1,12,4,0,0,70
138046,1214671,1,12,5,0,0,70
138047,1214671,1,12,6,1,0,71
138048,1214671,1,13,1,1,0,72
138049,1214671,1,13,2,1,0,73
138050,1214671,1,13,3,0,0,73
138051,1214671,1,13,4,0,0,73
138052,1214671,1,13,5,1,0,74
138053,1214671,1,13,6,1,0,75
138054,1214671,1,14,1,1,0,76
138055,1214671,1,14,2,0,1,76
138056,1214671,1,14,3,0,0,76
138057,1214671,1,14,4,1,0,77
138058,1214671,1,14,5,1,0,78
138059,1214671,1,14,6,0,0,78
138060,1214671,1,15,1,1,0,79
138061,1214671,1,15,2,0,0,79
138062,1214671,1,15,3,0,0,79
138063,1214671,1,15,4,4,0,83
138064,1214671,1,15,5,1,0,84
138065,1214671,1,15,6,1,0,85
138066,1214671,1,16,1,4,0,89
138067,1214671,1,16,2,1,0,90
138068,1214671,1,16,3,2,0,92
138069,1214671,1,16,4,4,0,96
138070,1214671,1,16,5,0,1,96
138071,1214671,1,16,6,1,0,97
138072,1214671,1,17,1,0,1,97
138073,1214671,1,17,2,1,0,98
138074,1214671,1,17,3,1,0,99
138075,1214671,1,17,4,1,0,100
138076,1214671,1,17,5,1,0,101
138077,1214671,1,17,6,0,0,101
138078,1214671,1,18,1,1,0,102
138079,1214671,1,18,2,0,0,102
138080,1214671,1,18,3,4,0,106
138081,1214671,1,18,4,1,0,107
138082,1214671,1,18,5,0,0,107
138083,1214671,1,18,6,0,0,107
138084,1214671,1,19,1,1,0,108
138085,1214671,1,19,2,0,0,108
138086,1214671,1,19,3,0,1,108
138087,1214671,1,19,4,4,0,112
138088,1214671,1,19,5,1,0,113
138089,1214671,1,19,6,0,1,113
138090,1214671,1,20,1,1,0,114
138091,1214671,1,20,2,0,0,114
138092,1214671,1,20,3,4,0,118
138093,1214671,1,20,4,0,0,118
138094,1214671,1,20,5,0,0,118
138095,1214671,1,20,6,1,0,119
138191,1216416,1,1,1,0,0,0
138192,1216416,1,1,2,4,0,4
138193,1216416,1,1,3,1,0,5
138194,1216416,1,1,4,1,0,6
138195,1216416,1,1,5,0,0,6
138196,1216416,1,1,6,1,0,7
138197,1216416,1,2,1,0,0,7
138198,1216416,1,2,2,0,0,7
138199,1216416,1,2,3,1,0,8
138200,1216416,1,2,4,1,0,9
138201,1216416,1,2,5,4,0,13
138202,1216416,1,2,6,4,0,17
138203,1216416,1,3,1,1,0,18
138204,1216416,1,3,2,1,0,19
138205,1216416,1,3,3,4,0,23
138206,1216416,1,3,4,6,0,29
138207,1216416,1,3,5,0,0,29
138208,1216416,1,3,6,4,0,33
138209,1216416,1,4,1,4,0,37
138210,1216416,1,4,2,0,0,37
138211,1216416,1,4,3,4,0,41
138212,1216416,1,4,4,1,0,42
138213,1216416,1,4,5,1,0,43
138214,1216416,1,4,6,1,0,44
138215,1216416,1,5,1,0,0,44
138216,1216416,1,5,2,2,0,46
138217,1216416,1,5,3,0,0,46
138218,1216416,1,5,4,0,0,46
138219,1216416,1,5,5,1,0,47
138220,1216416,1,5,6,0,0,47
138221,1216416,1,6,1,4,0,51
138222,1216416,1,6,2,0,0,51
138223,1216416,1,6,3,6,0,57
138224,1216416,1,6,4,2,0,59
138225,1216416,1,6,5,4,0,63
138226,1216416,1,6,6,0,1,63
138227,1216416,1,7,1,0,0,63
138228,1216416,1,7,2,4,0,67
138229,1216416,1,7,3,0,0,67
138230,1216416,1,7,4,0,0,67
138231,1216416,1,7,5,0,0,67
138232,1216416,1,7,6,1,0,68
138233,1216416,1,8,1,0,0,68
138234,1216416,1,8,2,4,0,72
138235,1216416,1,8,3,1,0,73
138236,1216416,1,8,4,0,0,73
138237,1216416,1,8,5,0,0,73
138238,1216416,1,8,6,1,0,74
138239,1216416,1,9,1,1,0,75
138240,1216416,1,9,2,6,0,81
138241,1216416,1,9,3,1,0,82
138242,1216416,1,9,4,1,0,83
138243,1216416,1,9,5,1,0,84
138244,1216416,1,9,6,1,0,85
138245,1216416,1,10,1,1,0,86
138246,1216416,1,10,2,0,0,86
138247,1216416,1,10,3,1,0,87
138248,1216416,1,10,4,4,0,91
138249,1216416,1,10,5,1,0,92
138250,1216416,1,10,6,0,0,92
138251,1216416,1,11,1,1,0,93
138252,1216416,1,11,2,1,0,94
138253,1216416,1,11,3,0,0,94
138254,1216416,1,11,4,0,0,94
138255,1216416,1,11,5,1,0,95
138256,1216416,1,11,6,1,0,96
138257,1216416,1,12,1,1,0,97
138258,1216416,1,12,2,1,0,98
138259,1216416,1,12,3,6,0,104
138260,1216416,1,12,4,1,0,105
138261,1216416,1,12,5,1,0,106
138262,1216416,1,12,6,4,0,110
138263,1216416,1,13,1,1,0,111
138264,1216416,1,13,2,0,1,111
138265,1216416,1,13,3,0,0,111
138266,1216416,1,13,4,0,0,111
138267,1216416,1,13,5,1,0,112
138268,1216416,1,13,6,0,0,112
138269,1216416,1,14,1,0,0,112
138270,1216416,1,14,2,0,0,112
138271,1216416,1,14,3,1,0,113
138272,1216416,1,14,4,1,0,114
138273,1216416,1,14,5,2,0,116
138274,1216416,1,14,6,4,0,120
138275,1216416,1,15,1,1,0,121
138276,1216416,1,15,2,0,0,121
138277,1216416,1,15,3,2,0,123
138278,1216416,1,15,4,4,0,127
138279,1216416,1,15,5,0,1,127
138280,1216416,1,15,6,1,0,128
138281,1216416,1,16,1,0,0,128
138282,1216416,1,16,2,1,0,129
138283,1216416,1,16,3,0,0,129
138284,1216416,1,16,4,1,0,130
138285,1216416,1,16,5,1,0,131
138286,1216416,1,16,6,4,0,135
138287,1216416,1,17,1,4,0,139
138288,1216416,1,17,2,4,0,143
138289,1216416,1,17,3,1,0,144
138290,1216416,1,17,4,0,0,144
138291,1216416,1,17,5,1,0,145
138292,1216416,1,17,6,0,0,145
138293,1216416,1,18,1,1,0,146
138294,1216416,1,18,2,1,0,147
138295,1216416,1,18,3,0,1,147
138296,1216416,1,18,4,2,0,149
138297,1216416,1,18,5,1,0,150
138298,1216416,1,18,6,1,0,151
138299,1216416,1,19,1,1,0,152
138300,1216416,1,19,2,0,1,152
138301,1216416,1,19,3,4,0,156
138302,1216416,1,19,4,1,0,157
138303,1216416,1,19,5,2,0,159
138304,1216416,1,19,6,1,0,160
138305,1216416,1,20,1,1,1,161
138306,1216416,1,20,2,1,0,162
138307,1216416,1,20,3,6,0,168
138308,1216416,1,20,4,0,0,168
138309,1216416,1,20,5,2,0,170
138310,1216416,1,20,6,2,0,172
138401,1216417,1,1,1,0,0,0
138402,1216417,1,1,2,1,0,1
138403,1216417,1,1,3,1,0,2
138404,1216417,1,1,4,0,0,2
138405,1216417,1,1,5,1,0,3
138406,1216417,1,1,6,0,0,3
138407,1216417,1,2,1,1,0,4
138408,1216417,1,2,2,0,0,4
138409,1216417,1,2,3,0,0,4
138410,1216417,1,2,4,0,0,4
138411,1216417,1,2,5,1,0,5
138412,1216417,1,2,6,1,0,6
138413,1216417,1,3,1,0,0,6
138414,1216417,1,3,2,1,0,7
138415,1216417,1,3,3,0,0,7
138416,1216417,1,3,4,2,0,9
138417,1216417,1,3,5,1,0,10
138418,1216417,1,3,6,1,0,11
138419,1216417,1,4,1,0,0,11
138420,1216417,1,4,2,2,0,13
138421,1216417,1,4,3,0,0,13
138422,1216417,1,4,4,0,0,13
138423,1216417,1,4,5,4,0,17
138424,1216417,1,4,6,1,0,18
138425,1216417,1,5,1,1,0,19
138426,1216417,1,5,2,6,0,25
138427,1216417,1,5,3,1,0,26
138428,1216417,1,5,4,1,0,27
138429,1216417,1,5,5,1,0,28
138430,1216417,1,5,6,1,0,29
138431,1216417,1,6,1,2,0,31
138432,1216417,1,6,2,2,0,33
138433,1216417,1,6,3,0,0,33
138434,1216417,1,6,4,0,0,33
138435,1216417,1,6,5,0,0,33
138436,1216417,1,6,6,1,0,34
138437,1216417,1,7,1,6,0,40
138438,1216417,1,7,2,1,0,41
138439,1216417,1,7,3,1,0,42
138440,1216417,1,7,4,1,0,43
138441,1216417,1,7,5,1,0,44
138442,1216417,1,7,6,2,0,46
138443,1216417,1,8,1,1,0,47
138444,1216417,1,8,2,0,0,47
138445,1216417,1,8,3,1,0,48
138446,1216417,1,8,4,0,0,48
138447,1216417,1,8,5,2,0,50
138448,1216417,1,8,6,0,0,50
138449,1216417,1,9,1,0,0,50
138450,1216417,1,9,2,6,0,56
138451,1216417,1,9,3,1,0,57
138452,1216417,1,9,4,0,1,57
138453,1216417,1,9,5,0,0,57
138454,1216417,1,9,6,1,0,58
138455,1216417,1,10,1,1,0,59
138456,1216417,1,10,2,1,0,60
138457,1216417,1,10,3,1,0,61
138458,1216417,1,10,4,1,0,62
138459,1216417,1,10,5,1,0,63
138460,1216417,1,10,6,1,0,64
138461,1216417,1,11,1,0,0,64
138462,1216417,1,11,2,6,0,70
138463,1216417,1,11,3,1,0,71
138464,1216417,1,11,4,0,0,71
138465,1216417,1,11,5,1,0,72
138466,1216417,1,11,6,1,0,73
138467,1216417,1,12,1,0,0,73
138468,1216417,1,12,2,0,0,73
138469,1216417,1,12,3,2,0,75
138470,1216417,1,12,4,0,0,75
138471,1216417,1,12,5,1,0,76
138472,1216417,1,12,6,0,1,76
138473,1216417,1,13,1,1,0,77
138474,1216417,1,13,2,2,0,79
138475,1216417,1,13,3,4,0,83
138476,1216417,1,13,4,0,0,83
138477,1216417,1,13,5,1,0,84
138478,1216417,1,13,6,1,0,85
138479,1216417,1,14,1,1,0,86
138480,1216417,1,14,2,1,0,87
138481,1216417,1,14,3,6,0,93
138482,1216417,1,14,4,4,0,97
138483,1216417,1,14,5,4,0,101
138484,1216417,1,14,6,1,0,102
138485,1216417,1,15,1,1,0,103
138486,1216417,1,15,2,0,0,103
138487,1216417,1,15,3,6,0,109
138488,1216417,1,15,4,1,0,110
138489,1216417,1,15,5,1,0,111
138490,1216417,1,15,6,1,0,112
138491,1216417,1,16,1,4,0,116
138492,1216417,1,16,2,1,0,117
138493,1216417,1,16,3,4,0,121
138494,1216417,1,16,4,6,0,127
138495,1216417,1,16,5,4,0,131
138496,1216417,1,16,6,6,0,137
138497,1216417,1,17,1,2,0,139
138498,1216417,1,17,2,4,0,143
138499,1216417,1,17,3,1,0,144
138500,1216417,1,17,4,4,0,148
138501,1216417,1,17,5,2,0,150
138502,1216417,1,17,6,0,1,150
138503,1216417,1,18,1,1,0,151
138504,1216417,1,18,2,1,0,152
138505,1216417,1,18,3,1,0,153
138506,1216417,1,18,4,0,0,153
138507,1216417,1,18,5,1,0,154
138508,1216417,1,18,6,1,0,155
138509,1216417,1,19,1,1,0,156
138510,1216417,1,19,2,0,0,156
138511,1216417,1,19,3,1,0,157
138512,1216417,1,19,4,0,1,157
138513,1216417,1,19,5,1,0,158
138514,1216417,1,19,6,0,0,158
138515,1216417,1,20,1,1,0,159
138516,1216417,1,20,2,6,0,165
138517,1216417,1,20,3,6,0,171
138518,1216417,1,20,4,1,0,172
138519,1216417,1,20,5,6,0,178
138520,1216417,1,20,6,6,0,184
138641,1223952,1,1,1,0,0,0
138642,1223952,1,1,2,2,0,2
138643,1223952,1,1,3,0,0,2
138644,1223952,1,1,4,0,0,2
138645,1223952,1,1,5,0,0,2
138646,1223952,1,1,6,2,0,4
138647,1223952,1,2,1,0,0,4
138648,1223952,1,2,2,1,0,5
138649,1223952,1,2,3,1,0,6
138650,1223952,1,2,4,0,0,6
138651,1223952,1,2,5,0,0,6
138652,1223952,1,2,6,0,0,6
138653,1223952,1,3,1,0,0,6
138654,1223952,1,3,2,0,0,6
138655,1223952,1,3,3,4,0,10
138656,1223952,1,3,4,1,0,11
138657,1223952,1,3,5,0,1,11
138658,1223952,1,3,6,2,0,13
138659,1223952,1,4,1,1,0,14
138660,1223952,1,4,2,1,0,15
138661,1223952,1,4,3,0,0,15
138662,1223952,1,4,4,4,0,19
138663,1223952,1,4,5,1,0,20
138664,1223952,1,4,6,1,0,21
138665,1223952,1,5,1,4,0,25
138666,1223952,1,5,2,0,0,25
138667,1223952,1,5,3,2,0,27
138668,1223952,1,5,4,2,0,29
138669,1223952,1,5,5,1,0,30
138670,1223952,1,5,6,0,0,30
138671,1223952,1,6,1,1,0,31
138672,1223952,1,6,2,1,0,32
138673,1223952,1,6,3,4,0,36
138674,1223952,1,6,4,6,0,42
138675,1223952,1,6,5,0,0,42
138676,1223952,1,6,6,0,0,42
138677,1223952,1,7,1,1,0,43
138678,1223952,1,7,2,4,0,47
138679,1223952,1,7,3,1,0,48
138680,1223952,1,7,4,0,1,48
138681,1223952,1,7,5,1,0,49
138682,1223952,1,7,6,2,0,51
138683,1223952,1,8,1,1,0,52
138684,1223952,1,8,2,1,0,53
138685,1223952,1,8,3,1,0,54
138686,1223952,1,8,4,1,0,55
138687,1223952,1,8,5,1,0,56
138688,1223952,1,8,6,0,0,56
138689,1223952,1,9,1,6,0,62
138690,1223952,1,9,2,0,0,62
138691,1223952,1,9,3,1,0,63
138692,1223952,1,9,4,0,0,63
138693,1223952,1,9,5,4,0,67
138694,1223952,1,9,6,1,0,68
138695,1223952,1,10,1,1,0,69
138696,1223952,1,10,2,1,0,70
138697,1223952,1,10,3,1,0,71
138698,1223952,1,10,4,2,0,73
138699,1223952,1,10,5,1,0,74
138700,1223952,1,10,6,1,0,75
138701,1223952,1,11,1,1,0,76
138702,1223952,1,11,2,4,0,80
138703,1223952,1,11,3,1,0,81
138704,1223952,1,11,4,1,0,82
138705,1223952,1,11,5,3,0,85
138706,1223952,1,11,6,1,0,86
138707,1223952,1,12,1,0,1,86
138708,1223952,1,12,2,0,0,86
138709,1223952,1,12,3,0,0,86
138710,1223952,1,12,4,0,0,86
138711,1223952,1,12,5,2,0,88
138712,1223952,1,12,6,1,0,89
138713,1223952,1,13,1,1,0,90
138714,1223952,1,13,2,0,0,90
138715,1223952,1,13,3,0,0,90
138716,1223952,1,13,4,0,1,90
138717,1223952,1,13,5,1,0,91
138718,1223952,1,13,6,0,0,91
138719,1223952,1,14,1,0,0,91
138720,1223952,1,14,2,0,0,91
138721,1223952,1,14,3,0,0,91
138722,1223952,1,14,4,1,0,92
138723,1223952,1,14,5,0,1,92
138724,1223952,1,14,6,1,0,93
138725,1223952,1,15,1,1,0,94
138726,1223952,1,15,2,1,0,95
138727,1223952,1,15,3,0,0,95
138728,1223952,1,15,4,1,0,96
138729,1223952,1,15,5,1,0,97
138730,1223952,1,15,6,0,0,97
138731,1223952,1,16,1,2,0,99
138732,1223952,1,16,2,0,0,99
138733,1223952,1,16,3,1,0,100
138734,1223952,1,16,4,1,0,101
138735,1223952,1,16,5,1,0,102
138736,1223952,1,16,6,2,0,104
138737,1223952,1,17,1,6,0,110
138738,1223952,1,17,2,1,0,111
138739,1223952,1,17,3,1,0,112
138740,1223952,1,17,4,2,0,114
138741,1223952,1,17,5,0,1,114
138742,1223952,1,17,6,1,0,115
138743,1223952,1,18,1,1,0,116
138744,1223952,1,18,2,4,0,120
138745,1223952,1,18,3,1,0,121
138746,1223952,1,18,4,4,0,125
138747,1223952,1,18,5,2,0,127
138748,1223952,1,18,6,0,0,127
138749,1223952,1,19,1,4,0,131
138750,1223952,1,19,2,0,0,131
138751,1223952,1,19,3,5,0,136
138752,1223952,1,19,4,6,0,142
138753,1223952,1,19,5,4,0,146
138754,1223952,1,19,6,4,0,150
138755,1223952,1,20,1,1,0,151
138756,1223952,1,20,2,1,0,152
138757,1223952,1,20,3,0,1,152
138758,1223952,1,20,4,4,0,156
138759,1223952,1,20,5,4,0,160
138760,1223952,1,20,6,1,0,161
138881,1223953,1,1,1,0,0,0
138882,1223953,1,1,2,4,0,4
138883,1223953,1,1,3,0,0,4
138884,1223953,1,1,4,5,0,9
138885,1223953,1,1,5,4,0,13
138886,1223953,1,1,6,0,0,13
138887,1223953,1,2,1,1,0,14
138888,1223953,1,2,2,0,0,14
138889,1223953,1,2,3,6,0,20
138890,1223953,1,2,4,1,0,21
138891,1223953,1,2,5,1,0,22
138892,1223953,1,2,6,1,0,23
138893,1223953,1,3,1,4,0,27
138894,1223953,1,3,2,1,0,28
138895,1223953,1,3,3,1,0,29
138896,1223953,1,3,4,0,0,29
138897,1223953,1,3,5,2,0,31
138898,1223953,1,3,6,0,0,31
138899,1223953,1,4,1,4,0,35
138900,1223953,1,4,2,4,0,39
138901,1223953,1,4,3,1,0,40
138902,1223953,1,4,4,0,0,40
138903,1223953,1,4,5,2,0,42
138904,1223953,1,4,6,4,0,46
138905,1223953,1,5,1,1,0,47
138906,1223953,1,5,2,0,0,47
138907,1223953,1,5,3,0,1,47
138908,1223953,1,5,4,0,0,47
138909,1223953,1,5,5,0,0,47
138910,1223953,1,5,6,0,0,47
138911,1223953,1,6,1,4,0,51
138912,1223953,1,6,2,4,0,55
138913,1223953,1,6,3,0,0,55
138914,1223953,1,6,4,4,0,59
138915,1223953,1,6,5,0,0,59
138916,1223953,1,6,6,0,0,59
138917,1223953,1,7,1,1,0,60
138918,1223953,1,7,2,4,0,64
138919,1223953,1,7,3,1,0,65
138920,1223953,1,7,4,0,0,65
138921,1223953,1,7,5,2,0,67
138922,1223953,1,7,6,1,0,68
138923,1223953,1,8,1,1,0,69
138924,1223953,1,8,2,1,0,70
138925,1223953,1,8,3,2,0,72
138926,1223953,1,8,4,2,0,74
138927,1223953,1,8,5,0,0,74
138928,1223953,1,8,6,1,1,75
138929,1223953,1,9,1,1,0,76
138930,1223953,1,9,2,1,0,77
138931,1223953,1,9,3,1,0,78
138932,1223953,1,9,4,1,0,79
138933,1223953,1,9,5,1,0,80
138934,1223953,1,9,6,1,0,81
138935,1223953,1,10,1,0,0,81
138936,1223953,1,10,2,6,0,87
138937,1223953,1,10,3,2,0,89
138938,1223953,1,10,4,1,0,90
138939,1223953,1,10,5,1,0,91
138940,1223953,1,10,6,0,0,91
138941,1223953,1,11,1,4,0,95
138942,1223953,1,11,2,0,0,95
138943,1223953,1,11,3,1,0,96
138944,1223953,1,11,4,1,0,97
138945,1223953,1,11,5,1,0,98
138946,1223953,1,11,6,2,0,100
138947,1223953,1,12,1,2,0,102
138948,1223953,1,12,2,0,0,102
138949,1223953,1,12,3,1,0,103
138950,1223953,1,12,4,6,0,109
138951,1223953,1,12,5,1,0,110
138952,1223953,1,12,6,1,0,111
138953,1223953,1,13,1,4,0,115
138954,1223953,1,13,2,4,0,119
138955,1223953,1,13,3,1,0,120
138956,1223953,1,13,4,0,1,120
138957,1223953,1,13,5,1,0,121
138958,1223953,1,13,6,2,0,123
138959,1223953,1,14,1,0,0,123
138960,1223953,1,14,2,0,0,123
138961,1223953,1,14,3,1,0,124
138962,1223953,1,14,4,1,0,125
138963,1223953,1,14,5,1,0,126
138964,1223953,1,14,6,1,0,127
138965,1223953,1,15,1,1,0,128
138966,1223953,1,15,2,0,0,128
138967,1223953,1,15,3,0,0,128
138968,1223953,1,15,4,1,0,129
138969,1223953,1,15,5,2,0,131
138970,1223953,1,15,6,1,0,132
138971,1223953,1,16,1,1,0,133
138972,1223953,1,16,2,6,0,139
138973,1223953,1,16,3,1,0,140
138974,1223953,1,16,4,1,0,141
138975,1223953,1,16,5,10,0,151
138976,1223953,1,16,6,1,0,152
138977,1223953,1,17,1,2,0,154
138978,1223953,1,17,2,1,0,155
138979,1223953,1,17,3,1,0,156
138980,1223953,1,17,4,1,0,157
138981,1223953,1,17,5,0,0,157
138982,1223953,1,17,6,2,0,159
138983,1223953,1,18,1,2,0,161
138984,1223953,1,18,2,1,0,162
138985,1223953,1,18,3,0,0,162
138986,1223953,1,18,4,6,0,168
138987,1223953,1,18,5,0,1,168
138988,1223953,1,18,6,1,0,169
138989,1223953,1,19,1,1,0,170
138990,1223953,1,19,2,1,0,171
138991,1223953,1,19,3,0,1,171
138992,1223953,1,19,4,1,0,172
138993,1223953,1,19,5,1,0,173
138994,1223953,1,19,6,4,0,177
138995,1223953,1,20,1,2,0,179
138996,1223953,1,20,2,0,0,179
138997,1223953,1,20,3,3,0,182
138998,1223953,1,20,4,3,0,185
138999,1223953,1,20,5,6,0,191
139000,1223953,1,20,6,3,0,194
139119,1223954,1,1,1,0,0,0
139120,1223954,1,1,2,0,0,0
139121,1223954,1,1,3,4,0,4
139122,1223954,1,1,4,0,0,4
139123,1223954,1,1,5,4,0,8
139124,1223954,1,1,6,1,0,9
139125,1223954,1,2,1,4,0,13
139126,1223954,1,2,2,1,0,14
139127,1223954,1,2,3,0,0,14
139128,1223954,1,2,4,0,1,14
139129,1223954,1,2,5,0,0,14
139130,1223954,1,2,6,0,0,14
139131,1223954,1,3,1,0,0,14
139132,1223954,1,3,2,1,0,15
139133,1223954,1,3,3,0,0,15
139134,1223954,1,3,4,0,0,15
139135,1223954,1,3,5,1,0,16
139136,1223954,1,3,6,0,0,16
139137,1223954,1,4,1,9,0,25
139138,1223954,1,4,2,0,0,25
139139,1223954,1,4,3,1,0,26
139140,1223954,1,4,4,0,0,26
139141,1223954,1,4,5,1,0,27
139142,1223954,1,4,6,1,0,28
139143,1223954,1,5,1,4,0,32
139144,1223954,1,5,2,4,0,36
139145,1223954,1,5,3,2,0,38
139146,1223954,1,5,4,1,0,39
139147,1223954,1,5,5,3,0,42
139148,1223954,1,5,6,3,0,45
139149,1223954,1,6,1,0,0,45
139150,1223954,1,6,2,0,0,45
139151,1223954,1,6,3,1,0,46
139152,1223954,1,6,4,1,0,47
139153,1223954,1,6,5,3,0,50
139154,1223954,1,6,6,1,0,51
139155,1223954,1,7,1,2,0,53
139156,1223954,1,7,2,1,0,54
139157,1223954,1,7,3,1,0,55
139158,1223954,1,7,4,1,0,56
139159,1223954,1,7,5,1,0,57
139160,1223954,1,7,6,2,0,59
139161,1223954,1,8,1,1,0,60
139162,1223954,1,8,2,1,0,61
139163,1223954,1,8,3,1,0,62
139164,1223954,1,8,4,4,0,66
139165,1223954,1,8,5,1,0,67
139166,1223954,1,8,6,1,0,68
139167,1223954,1,9,1,1,0,69
139168,1223954,1,9,2,1,0,70
139169,1223954,1,9,3,1,0,71
139170,1223954,1,9,4,0,0,71
139171,1223954,1,9,5,1,0,72
139172,1223954,1,9,6,1,0,73
139173,1223954,1,10,1,0,0,73
139174,1223954,1,10,2,4,0,77
139175,1223954,1,10,3,2,0,79
139176,1223954,1,10,4,0,1,79
139177,1223954,1,10,5,2,0,81
139178,1223954,1,10,6,1,0,82
139179,1223954,1,11,1,0,0,82
139180,1223954,1,11,2,1,0,83
139181,1223954,1,11,3,3,0,86
139182,1223954,1,11,4,0,0,86
139183,1223954,1,11,5,1,0,87
139184,1223954,1,11,6,0,0,87
139185,1223954,1,12,1,6,0,93
139186,1223954,1,12,2,1,0,94
139187,1223954,1,12,3,0,0,94
139188,1223954,1,12,4,2,0,96
139189,1223954,1,12,5,4,0,100
139190,1223954,1,12,6,1,0,101
139191,1223954,1,13,1,2,0,103
139192,1223954,1,13,2,1,0,104
139193,1223954,1,13,3,4,0,108
139194,1223954,1,13,4,3,0,111
139195,1223954,1,13,5,1,0,112
139196,1223954,1,13,6,2,0,114
139197,1223954,1,14,1,1,0,115
139198,1223954,1,14,2,2,0,117
139199,1223954,1,14,3,0,0,117
139200,1223954,1,14,4,1,0,118
139201,1223954,1,14,5,6,0,124
139202,1223954,1,14,6,0,0,124
139203,1223954,1,15,1,1,0,125
139204,1223954,1,15,2,1,0,126
139205,1223954,1,15,3,6,0,132
139206,1223954,1,15,4,1,0,133
139207,1223954,1,15,5,6,0,139
139208,1223954,1,15,6,0,0,139
139209,1223954,1,16,1,1,0,140
139210,1223954,1,16,2,0,0,140
139211,1223954,1,16,3,1,0,141
139212,1223954,1,16,4,2,0,143
139213,1223954,1,16,5,1,0,144
139214,1223954,1,16,6,1,0,145
139215,1223954,1,17,1,0,0,145
139216,1223954,1,17,2,1,0,146
139217,1223954,1,17,3,2,0,148
139218,1223954,1,17,4,1,0,149
139219,1223954,1,17,5,2,0,151
139220,1223954,1,17,6,6,0,157
139221,1223954,1,18,1,3,0,160
139222,1223954,1,18,2,0,0,160
139223,1223954,1,18,3,1,0,161
139224,1223954,1,18,4,2,0,163
139225,1223954,1,18,5,4,0,167
139226,1223954,1,18,6,1,0,168
139227,1223954,1,19,1,1,0,169
139228,1223954,1,19,2,0,1,169
139229,1223954,1,19,3,4,0,173
139230,1223954,1,19,4,1,0,174
139231,1223954,1,19,5,0,0,174
139232,1223954,1,19,6,1,0,175
139233,1223954,1,20,1,0,1,175
139234,1223954,1,20,2,2,0,177
139235,1223954,1,20,3,4,0,181
139236,1223954,1,20,4,1,1,182
139237,1223954,1,20,5,4,0,186
139238,1223954,1,20,6,0,0,186
139359,1233464,1,1,1,4,0,4
139360,1233464,1,1,2,0,0,4
139361,1233464,1,1,3,1,0,5
139362,1233464,1,1,4,0,0,5
139363,1233464,1,1,5,0,1,5
139364,1233464,1,1,6,0,0,5
139365,1233464,1,2,1,3,0,8
139366,1233464,1,2,2,0,0,8
139367,1233464,1,2,3,0,0,8
139368,1233464,1,2,4,1,0,9
139369,1233464,1,2,5,1,0,10
139370,1233464,1,2,6,4,0,14
139371,1233464,1,3,1,4,0,18
139372,1233464,1,3,2,1,0,19
139373,1233464,1,3,3,4,0,23
139374,1233464,1,3,4,0,0,23
139375,1233464,1,3,5,4,0,27
139376,1233464,1,3,6,0,0,27
139377,1233464,1,4,1,1,0,28
139378,1233464,1,4,2,1,0,29
139379,1233464,1,4,3,4,0,33
139380,1233464,1,4,4,0,0,33
139381,1233464,1,4,5,0,0,33
139382,1233464,1,4,6,1,0,34
139383,1233464,1,5,1,0,1,34
139384,1233464,1,5,2,0,0,34
139385,1233464,1,5,3,0,0,34
139386,1233464,1,5,4,1,0,35
139387,1233464,1,5,5,1,0,36
139388,1233464,1,5,6,1,0,37
139389,1233464,1,6,1,1,0,38
139390,1233464,1,6,2,2,0,40
139391,1233464,1,6,3,0,0,40
139392,1233464,1,6,4,1,0,41
139393,1233464,1,6,5,1,0,42
139394,1233464,1,6,6,0,0,42
139395,1233464,1,7,1,4,0,46
139396,1233464,1,7,2,1,0,47
139397,1233464,1,7,3,0,0,47
139398,1233464,1,7,4,1,0,48
139399,1233464,1,7,5,1,0,49
139400,1233464,1,7,6,0,0,49
139401,1233464,1,8,1,0,0,49
139402,1233464,1,8,2,1,0,50
139403,1233464,1,8,3,1,0,51
139404,1233464,1,8,4,6,0,57
139405,1233464,1,8,5,1,0,58
139406,1233464,1,8,6,4,0,62
139407,1233464,1,9,1,4,0,66
139408,1233464,1,9,2,1,0,67
139409,1233464,1,9,3,0,0,67
139410,1233464,1,9,4,1,0,68
139411,1233464,1,9,5,1,0,69
139412,1233464,1,9,6,0,0,69
139413,1233464,1,10,1,1,0,70
139414,1233464,1,10,2,0,1,70
139415,1233464,1,10,3,1,0,71
139416,1233464,1,10,4,1,0,72
139417,1233464,1,10,5,1,0,73
139418,1233464,1,10,6,4,0,77
139419,1233464,1,11,1,1,0,78
139420,1233464,1,11,2,4,0,82
139421,1233464,1,11,3,1,0,83
139422,1233464,1,11,4,4,0,87
139423,1233464,1,11,5,0,1,87
139424,1233464,1,11,6,1,0,88
139425,1233464,1,12,1,0,0,88
139426,1233464,1,12,2,1,0,89
139427,1233464,1,12,3,1,0,90
139428,1233464,1,12,4,0,0,90
139429,1233464,1,12,5,1,0,91
139430,1233464,1,12,6,0,0,91
139431,1233464,1,13,1,1,0,92
139432,1233464,1,13,2,1,0,93
139433,1233464,1,13,3,1,0,94
139434,1233464,1,13,4,0,0,94
139435,1233464,1,13,5,1,0,95
139436,1233464,1,13,6,0,0,95
139437,1233464,1,14,1,4,0,99
139438,1233464,1,14,2,4,0,103
139439,1233464,1,14,3,1,0,104
139440,1233464,1,14,4,1,0,105
139441,1233464,1,14,5,0,0,105
139442,1233464,1,14,6,1,0,106
139443,1233464,1,15,1,1,0,107
139444,1233464,1,15,2,1,0,108
139445,1233464,1,15,3,0,0,108
139446,1233464,1,15,4,1,0,109
139447,1233464,1,15,5,1,0,110
139448,1233464,1,15,6,0,0,110
139449,1233464,1,16,1,1,0,111
139450,1233464,1,16,2,1,0,112
139451,1233464,1,16,3,0,0,112
139452,1233464,1,16,4,4,0,116
139453,1233464,1,16,5,0,0,116
139454,1233464,1,16,6,4,0,120
139455,1233464,1,17,1,1,0,121
139456,1233464,1,17,2,1,0,122
139457,1233464,1,17,3,0,1,122
139458,1233464,1,17,4,0,0,122
139459,1233464,1,17,5,1,0,123
139460,1233464,1,17,6,1,0,124
139461,1233464,1,18,1,1,0,125
139462,1233464,1,18,2,1,0,126
139463,1233464,1,18,3,1,0,127
139464,1233464,1,18,4,1,0,128
139465,1233464,1,18,5,2,0,130
139466,1233464,1,18,6,0,0,130
139467,1233464,1,19,1,1,0,131
139468,1233464,1,19,2,1,0,132
139469,1233464,1,19,3,4,0,136
139470,1233464,1,19,4,0,0,136
139471,1233464,1,19,5,1,0,137
139472,1233464,1,19,6,4,0,141
139473,1233464,1,20,1,4,0,145
139474,1233464,1,20,2,1,0,146
139475,1233464,1,20,3,1,0,147
139476,1233464,1,20,4,3,0,150
139477,1233464,1,20,5,6,0,156
139478,1233464,1,20,6,0,1,156
139592,1233465,1,1,1,0,0,0
139593,1233465,1,1,2,2,0,2
139594,1233465,1,1,3,0,0,2
139595,1233465,1,1,4,1,0,3
139596,1233465,1,1,5,1,0,4
139597,1233465,1,1,6,0,0,4
139598,1233465,1,2,1,0,0,4
139599,1233465,1,2,2,1,0,5
139600,1233465,1,2,3,0,1,5
139601,1233465,1,2,4,1,0,6
139602,1233465,1,2,5,4,0,10
139603,1233465,1,2,6,0,0,10
139604,1233465,1,3,1,1,0,11
139605,1233465,1,3,2,4,0,15
139606,1233465,1,3,3,1,0,16
139607,1233465,1,3,4,4,0,20
139608,1233465,1,3,5,1,0,21
139609,1233465,1,3,6,4,0,25
139610,1233465,1,4,1,4,0,29
139611,1233465,1,4,2,1,0,30
139612,1233465,1,4,3,0,1,30
139613,1233465,1,4,4,4,0,34
139614,1233465,1,4,5,1,0,35
139615,1233465,1,4,6,1,0,36
139616,1233465,1,5,1,1,0,37
139617,1233465,1,5,2,0,0,37
139618,1233465,1,5,3,1,0,38
139619,1233465,1,5,4,0,0,38
139620,1233465,1,5,5,0,1,38
139621,1233465,1,5,6,0,0,38
139622,1233465,1,6,1,0,0,38
139623,1233465,1,6,2,4,0,42
139624,1233465,1,6,3,1,0,43
139625,1233465,1,6,4,1,0,44
139626,1233465,1,6,5,0,0,44
139627,1233465,1,6,6,1,0,45
139628,1233465,1,7,1,4,0,49
139629,1233465,1,7,2,1,0,50
139630,1233465,1,7,3,1,0,51
139631,1233465,1,7,4,1,0,52
139632,1233465,1,7,5,1,0,53
139633,1233465,1,7,6,0,0,53
139634,1233465,1,8,1,6,0,59
139635,1233465,1,8,2,0,0,59
139636,1233465,1,8,3,0,0,59
139637,1233465,1,8,4,0,0,59
139638,1233465,1,8,5,0,0,59
139639,1233465,1,8,6,0,0,59
139640,1233465,1,9,1,1,0,60
139641,1233465,1,9,2,4,0,64
139642,1233465,1,9,3,1,0,65
139643,1233465,1,9,4,0,0,65
139644,1233465,1,9,5,0,0,65
139645,1233465,1,9,6,0,0,65
139646,1233465,1,10,1,0,0,65
139647,1233465,1,10,2,0,1,65
139648,1233465,1,10,3,1,0,66
139649,1233465,1,10,4,0,1,66
139650,1233465,1,10,5,0,0,66
139651,1233465,1,10,6,0,0,66
139652,1233465,1,11,1,1,0,67
139653,1233465,1,11,2,1,0,68
139654,1233465,1,11,3,1,0,69
139655,1233465,1,11,4,0,0,69
139656,1233465,1,11,5,0,0,69
139657,1233465,1,11,6,1,0,70
139658,1233465,1,12,1,2,0,72
139659,1233465,1,12,2,0,0,72
139660,1233465,1,12,3,1,0,73
139661,1233465,1,12,4,1,0,74
139662,1233465,1,12,5,0,0,74
139663,1233465,1,12,6,0,0,74
139664,1233465,1,13,1,0,0,74
139665,1233465,1,13,2,1,0,75
139666,1233465,1,13,3,0,0,75
139667,1233465,1,13,4,1,0,76
139668,1233465,1,13,5,1,0,77
139669,1233465,1,13,6,1,0,78
139670,1233465,1,14,1,1,0,79
139671,1233465,1,14,2,1,0,80
139672,1233465,1,14,3,6,0,86
139673,1233465,1,14,4,4,0,90
139674,1233465,1,14,5,0,0,90
139675,1233465,1,14,6,0,1,90
139676,1233465,1,15,1,1,0,91
139677,1233465,1,15,2,0,0,91
139678,1233465,1,15,3,0,0,91
139679,1233465,1,15,4,2,0,93
139680,1233465,1,15,5,2,0,95
139681,1233465,1,15,6,1,0,96
139682,1233465,1,16,1,1,0,97
139683,1233465,1,16,2,0,0,97
139684,1233465,1,16,3,1,0,98
139685,1233465,1,16,4,1,0,99
139686,1233465,1,16,5,1,0,100
139687,1233465,1,16,6,1,0,101
139688,1233465,1,17,1,2,0,103
139689,1233465,1,17,2,3,0,106
139690,1233465,1,17,3,1,0,107
139691,1233465,1,17,4,1,0,108
139692,1233465,1,17,5,1,0,109
139693,1233465,1,17,6,2,0,111
139694,1233465,1,18,1,1,0,112
139695,1233465,1,18,2,1,0,113
139696,1233465,1,18,3,2,0,115
139697,1233465,1,18,4,4,0,119
139698,1233465,1,18,5,0,0,119
139699,1233465,1,18,6,1,0,120
139700,1233465,1,19,1,0,0,120
139701,1233465,1,19,2,0,0,120
139702,1233465,1,19,3,0,1,120
139703,1233465,1,19,4,1,0,121
139704,1233465,1,19,5,0,0,121
139705,1233465,1,19,6,4,0,125
139706,1233465,1,20,1,0,0,125
139707,1233465,1,20,2,0,0,125
139708,1233465,1,20,3,1,0,126
139709,1233465,1,20,4,1,0,127
139710,1233465,1,20,5,1,0,128
139711,1233465,1,20,6,6,0,134
139803,1233466,1,1,1,0,0,0
139804,1233466,1,1,2,1,0,1
139805,1233466,1,1,3,0,0,1
139806,1233466,1,1,4,0,0,1
139807,1233466,1,1,5,1,0,2
139808,1233466,1,1,6,0,0,2
139809,1233466,1,2,1,4,0,6
139810,1233466,1,2,2,4,0,10
139811,1233466,1,2,3,6,0,16
139812,1233466,1,2,4,4,0,20
139813,1233466,1,2,5,1,0,21
139814,1233466,1,2,6,0,0,21
139815,1233466,1,3,1,0,0,21
139816,1233466,1,3,2,1,0,22
139817,1233466,1,3,3,0,0,22
139818,1233466,1,3,4,1,0,23
139819,1233466,1,3,5,0,0,23
139820,1233466,1,3,6,0,0,23
139821,1233466,1,4,1,0,0,23
139822,1233466,1,4,2,1,0,24
139823,1233466,1,4,3,1,0,25
139824,1233466,1,4,4,1,0,26
139825,1233466,1,4,5,0,1,26
139826,1233466,1,4,6,1,0,27
139827,1233466,1,5,1,1,0,28
139828,1233466,1,5,2,0,0,28
139829,1233466,1,5,3,0,0,28
139830,1233466,1,5,4,0,0,28
139831,1233466,1,5,5,0,0,28
139832,1233466,1,5,6,4,0,32
139833,1233466,1,6,1,0,0,32
139834,1233466,1,6,2,1,0,33
139835,1233466,1,6,3,0,1,33
139836,1233466,1,6,4,4,0,37
139837,1233466,1,6,5,1,0,38
139838,1233466,1,6,6,1,0,39
139839,1233466,1,7,1,1,0,40
139840,1233466,1,7,2,1,0,41
139841,1233466,1,7,3,0,0,41
139842,1233466,1,7,4,0,0,41
139843,1233466,1,7,5,1,0,42
139844,1233466,1,7,6,0,0,42
139845,1233466,1,8,1,1,0,43
139846,1233466,1,8,2,1,0,44
139847,1233466,1,8,3,6,0,50
139848,1233466,1,8,4,0,0,50
139849,1233466,1,8,5,4,0,54
139850,1233466,1,8,6,1,0,55
139851,1233466,1,9,1,0,0,55
139852,1233466,1,9,2,0,1,55
139853,1233466,1,9,3,1,0,56
139854,1233466,1,9,4,1,0,57
139855,1233466,1,9,5,0,0,57
139856,1233466,1,9,6,0,0,57
139857,1233466,1,10,1,0,0,57
139858,1233466,1,10,2,0,1,57
139859,1233466,1,10,3,0,0,57
139860,1233466,1,10,4,0,0,57
139861,1233466,1,10,5,0,0,57
139862,1233466,1,10,6,1,0,58
139863,1233466,1,11,1,1,0,59
139864,1233466,1,11,2,1,0,60
139865,1233466,1,11,3,1,0,61
139866,1233466,1,11,4,4,0,65
139867,1233466,1,11,5,0,0,65
139868,1233466,1,11,6,0,0,65
139869,1233466,1,12,1,1,0,66
139870,1233466,1,12,2,1,0,67
139871,1233466,1,12,3,0,0,67
139872,1233466,1,12,4,0,0,67
139873,1233466,1,12,5,6,0,73
139874,1233466,1,12,6,1,0,74
139875,1233466,1,13,1,0,1,74
139876,1233466,1,13,2,0,0,74
139877,1233466,1,13,3,0,0,74
139878,1233466,1,13,4,1,0,75
139879,1233466,1,13,5,0,1,75
139880,1233466,1,13,6,1,0,76
139881,1233466,1,14,1,0,0,76
139882,1233466,1,14,2,0,0,76
139883,1233466,1,14,3,2,0,78
139884,1233466,1,14,4,0,0,78
139885,1233466,1,14,5,2,0,80
139886,1233466,1,14,6,0,0,80
139887,1233466,1,15,1,0,0,80
139888,1233466,1,15,2,1,0,81
139889,1233466,1,15,3,0,0,81
139890,1233466,1,15,4,0,0,81
139891,1233466,1,15,5,6,0,87
139892,1233466,1,15,6,0,1,87
139893,1233466,1,16,1,4,0,91
139894,1233466,1,16,2,4,0,95
139895,1233466,1,16,3,0,0,95
139896,1233466,1,16,4,1,0,96
139897,1233466,1,16,5,1,0,97
139898,1233466,1,16,6,1,0,98
139899,1233466,1,17,1,1,0,99
139900,1233466,1,17,2,0,0,99
139901,1233466,1,17,3,4,0,103
139902,1233466,1,17,4,4,0,107
139903,1233466,1,17,5,1,0,108
139904,1233466,1,17,6,2,0,110
139905,1233466,1,18,1,0,0,110
139906,1233466,1,18,2,1,0,111
139907,1233466,1,18,3,1,0,112
139908,1233466,1,18,4,2,0,114
139909,1233466,1,18,5,4,0,118
139910,1233466,1,18,6,2,0,120
139911,1233466,1,19,1,0,1,120
139912,1233466,1,19,2,1,0,121
139913,1233466,1,19,3,1,1,122
139914,1233466,1,19,4,0,0,122
139915,1233466,1,19,5,4,0,126
139916,1233466,1,19,6,0,0,126
139917,1233466,1,20,1,1,0,127
139918,1233466,1,20,2,1,0,128
139919,1233466,1,20,3,0,0,128
139920,1233466,1,20,4,1,0,129
139921,1233466,1,20,5,0,0,129
139922,1233466,1,20,6,0,0,129
140015,1233954,1,1,1,2,0,2
140016,1233954,1,1,2,0,0,2
140017,1233954,1,1,3,4,0,6
140018,1233954,1,1,4,1,0,7
140019,1233954,1,1,5,0,0,7
140020,1233954,1,1,6,1,0,8
140021,1233954,1,2,1,0,0,8
140022,1233954,1,2,2,7,0,15
140023,1233954,1,2,3,6,0,21
140024,1233954,1,2,4,1,0,22
140025,1233954,1,2,5,0,0,22
140026,1233954,1,2,6,4,0,26
140027,1233954,1,3,1,1,0,27
140028,1233954,1,3,2,9,0,36
140029,1233954,1,3,3,1,0,37
140030,1233954,1,3,4,6,0,43
140031,1233954,1,3,5,1,0,44
140032,1233954,1,3,6,11,0,55
140033,1233954,1,4,1,3,0,58
140034,1233954,1,4,2,0,1,58
140035,1233954,1,4,3,0,0,58
140036,1233954,1,4,4,0,0,58
140037,1233954,1,4,5,0,0,58
140038,1233954,1,4,6,0,1,58
140039,1233954,1,5,1,0,0,58
140040,1233954,1,5,2,0,1,58
140041,1233954,1,5,3,0,0,58
140042,1233954,1,5,4,0,0,58
140043,1233954,1,5,5,0,1,58
140044,1233954,1,5,6,1,0,59
140045,1233954,1,6,1,0,1,59
140046,1233954,1,6,2,0,0,59
140047,1233954,1,6,3,0,0,59
140048,1233954,1,6,4,1,0,60
140049,1233954,1,6,5,0,0,60
140050,1233954,1,6,6,0,0,60
140051,1233954,1,7,1,1,0,61
140052,1233954,1,7,2,2,0,63
140053,1233954,1,7,3,0,0,63
140054,1233954,1,7,4,4,0,67
140055,1233954,1,7,5,2,0,69
140056,1233954,1,7,6,4,0,73
140057,1233954,1,8,1,0,0,73
140058,1233954,1,8,2,0,0,73
140059,1233954,1,8,3,4,0,77
140060,1233954,1,8,4,4,0,81
140061,1233954,1,8,5,0,0,81
140062,1233954,1,8,6,0,0,81
140063,1233954,1,9,1,0,0,81
140064,1233954,1,9,2,6,0,87
140065,1233954,1,9,3,0,0,87
140066,1233954,1,9,4,2,0,89
140067,1233954,1,9,5,1,0,90
140068,1233954,1,9,6,0,0,90
140069,1233954,1,10,1,2,0,92
140070,1233954,1,10,2,2,0,94
140071,1233954,1,10,3,0,0,94
140072,1233954,1,10,4,1,0,95
140073,1233954,1,10,5,1,0,96
140074,1233954,1,10,6,0,0,96
140075,1233954,1,11,1,1,0,97
140076,1233954,1,11,2,1,0,98
140077,1233954,1,11,3,2,0,100
140078,1233954,1,11,4,0,0,100
140079,1233954,1,11,5,4,0,104
140080,1233954,1,11,6,4,0,108
140081,1233954,1,12,1,6,0,114
140082,1233954,1,12,2,6,0,120
140083,1233954,1,12,3,4,0,124
140084,1233954,1,12,4,6,0,130
140085,1233954,1,12,5,0,0,130
140086,1233954,1,12,6,1,0,131
140087,1233954,1,13,1,1,0,132
140088,1233954,1,13,2,0,0,132
140089,1233954,1,13,3,0,0,132
140090,1233954,1,13,4,0,0,132
140091,1233954,1,13,5,0,0,132
140092,1233954,1,13,6,1,0,133
140093,1233954,1,14,1,6,0,139
140094,1233954,1,14,2,4,0,143
140095,1233954,1,14,3,0,1,143
140096,1233954,1,14,4,0,0,143
140097,1233954,1,14,5,3,1,146
140098,1233954,1,14,6,0,0,146
140099,1233954,1,15,1,0,0,146
140100,1233954,1,15,2,0,0,146
140101,1233954,1,15,3,0,0,146
140102,1233954,1,15,4,1,0,147
140103,1233954,1,15,5,4,0,151
140104,1233954,1,15,6,6,0,157
140105,1233954,1,16,1,1,0,158
140106,1233954,1,16,2,6,0,164
140107,1233954,1,16,3,6,0,170
140108,1233954,1,16,4,2,0,172
140109,1233954,1,16,5,7,0,179
140110,1233954,1,16,6,1,0,180
140203,1233955,1,1,1,0,0,0
140204,1233955,1,1,2,0,0,0
140205,1233955,1,1,3,0,0,0
140206,1233955,1,1,4,0,0,0
140207,1233955,1,1,5,4,0,4
140208,1233955,1,1,6,0,0,4
140209,1233955,1,2,1,1,0,5
140210,1233955,1,2,2,0,0,5
140211,1233955,1,2,3,0,0,5
140212,1233955,1,2,4,4,0,9
140213,1233955,1,2,5,4,0,13
140214,1233955,1,2,6,1,0,14
140215,1233955,1,3,1,1,0,15
140216,1233955,1,3,2,0,0,15
140217,1233955,1,3,3,0,0,15
140218,1233955,1,3,4,0,0,15
140219,1233955,1,3,5,1,0,16
140220,1233955,1,3,6,1,0,17
140221,1233955,1,4,1,4,0,21
140222,1233955,1,4,2,4,0,25
140223,1233955,1,4,3,0,0,25
140224,1233955,1,4,4,0,0,25
140225,1233955,1,4,5,1,0,26
140226,1233955,1,4,6,0,0,26
140227,1233955,1,5,1,4,0,30
140228,1233955,1,5,2,0,0,30
140229,1233955,1,5,3,1,0,31
140230,1233955,1,5,4,6,0,37
140231,1233955,1,5,5,0,0,37
140232,1233955,1,5,6,4,0,41
140233,1233955,1,6,1,1,0,42
140234,1233955,1,6,2,6,0,48
140235,1233955,1,6,3,1,0,49
140236,1233955,1,6,4,0,1,49
140237,1233955,1,6,5,0,0,49
140238,1233955,1,6,6,0,0,49
140239,1233955,1,7,1,4,0,53
140240,1233955,1,7,2,0,1,53
140241,1233955,1,7,3,1,0,54
140242,1233955,1,7,4,1,0,55
140243,1233955,1,7,5,1,0,56
140244,1233955,1,7,6,1,0,57
140245,1233955,1,8,1,1,0,58
140246,1233955,1,8,2,1,0,59
140247,1233955,1,8,3,2,0,61
140248,1233955,1,8,4,1,0,62
140249,1233955,1,8,5,4,0,66
140250,1233955,1,8,6,0,0,66
140251,1233955,1,9,1,0,0,66
140252,1233955,1,9,2,1,0,67
140253,1233955,1,9,3,1,0,68
140254,1233955,1,9,4,0,0,68
140255,1233955,1,9,5,1,0,69
140256,1233955,1,9,6,1,0,70
140257,1233955,1,10,1,1,0,71
140258,1233955,1,10,2,4,0,75
140259,1233955,1,10,3,2,0,77
140260,1233955,1,10,4,1,0,78
140261,1233955,1,10,5,0,0,78
140262,1233955,1,10,6,6,0,84
140263,1233955,1,11,1,1,0,85
140264,1233955,1,11,2,1,0,86
140265,1233955,1,11,3,2,0,88
140266,1233955,1,11,4,6,0,94
140267,1233955,1,11,5,4,0,98
140268,1233955,1,11,6,4,0,102
140269,1233955,1,12,1,1,0,103
140270,1233955,1,12,2,2,0,105
140271,1233955,1,12,3,2,0,107
140272,1233955,1,12,4,6,0,113
140273,1233955,1,12,5,0,0,113
140274,1233955,1,12,6,0,0,113
140275,1233955,1,13,1,1,0,114
140276,1233955,1,13,2,7,0,121
140277,1233955,1,13,3,6,0,127
140278,1233955,1,13,4,6,0,133
140279,1233955,1,13,5,0,0,133
140280,1233955,1,13,6,4,0,137
140281,1233955,1,14,1,2,0,139
140282,1233955,1,14,2,1,0,140
140283,1233955,1,14,3,0,0,140
140284,1233955,1,14,4,4,0,144
140285,1233955,1,14,5,1,0,145
140286,1233955,1,14,6,6,0,151
140287,1233955,1,15,1,0,0,151
140288,1233955,1,15,2,6,0,157
140289,1233955,1,15,3,1,0,158
140290,1233955,1,15,4,1,0,159
140291,1233955,1,15,5,0,0,159
140292,1233955,1,15,6,1,0,160
140293,1233955,1,16,1,4,0,164
140294,1233955,1,16,2,0,0,164
140295,1233955,1,16,3,2,0,166
140296,1233955,1,16,4,0,0,166
140297,1233955,1,16,5,1,0,167
140298,1233955,1,16,6,1,0,168
140299,1233955,1,17,1,1,0,169
140300,1233955,1,17,2,5,0,174
140301,1233955,1,17,3,5,0,179
140302,1233955,1,17,4,2,0,181
140303,1233955,1,17,5,7,0,188
140304,1233955,1,17,6,4,0,192
140305,1233955,1,18,1,4,0,196
140306,1233955,1,18,2,6,0,202
140307,1233955,1,18,3,1,0,203
140308,1233955,1,18,4,6,0,209
140309,1233955,1,18,5,4,0,213
140310,1233955,1,18,6,2,0,215
140311,1233955,1,19,1,1,0,216
140312,1233955,1,19,2,0,0,216
140313,1233955,1,19,3,4,0,220
140314,1233955,1,19,4,1,0,221
140315,1233955,1,19,5,1,0,222
140316,1233955,1,19,6,6,0,228
140317,1233955,1,20,1,2,0,230
140318,1233955,1,20,2,5,0,235
140319,1233955,1,20,3,2,0,237
140320,1233955,1,20,4,0,0,237
140321,1233955,1,20,5,0,1,237
140322,1233955,1,20,6,1,0,238
140443,1233959,1,1,1,0,0,0
140444,1233959,1,1,2,4,0,4
140445,1233959,1,1,3,2,0,6
140446,1233959,1,1,4,0,0,6
140447,1233959,1,1,5,0,0,6
140448,1233959,1,1,6,1,0,7
140449,1233959,1,2,1,0,0,7
140450,1233959,1,2,2,1,0,8
140451,1233959,1,2,3,0,0,8
140452,1233959,1,2,4,0,1,8
140453,1233959,1,2,5,0,0,8
140454,1233959,1,2,6,4,0,12
140455,1233959,1,3,1,1,0,13
140456,1233959,1,3,2,0,0,13
140457,1233959,1,3,3,1,0,14
140458,1233959,1,3,4,0,0,14
140459,1233959,1,3,5,0,0,14
140460,1233959,1,3,6,2,0,16
140461,1233959,1,4,1,0,0,16
140462,1233959,1,4,2,4,0,20
140463,1233959,1,4,3,0,0,20
140464,1233959,1,4,4,0,0,20
140465,1233959,1,4,5,0,1,20
140466,1233959,1,4,6,0,1,20
140467,1233959,1,5,1,0,1,20
140468,1233959,1,5,2,0,0,20
140469,1233959,1,5,3,0,0,20
140470,1233959,1,5,4,0,0,20
140471,1233959,1,5,5,4,0,24
140472,1233959,1,5,6,1,0,25
140473,1233959,1,6,1,2,0,27
140474,1233959,1,6,2,0,0,27
140475,1233959,1,6,3,1,0,28
140476,1233959,1,6,4,1,0,29
140477,1233959,1,6,5,0,0,29
140478,1233959,1,6,6,0,0,29
140479,1233959,1,7,1,1,0,30
140480,1233959,1,7,2,1,0,31
140481,1233959,1,7,3,0,0,31
140482,1233959,1,7,4,0,0,31
140483,1233959,1,7,5,0,0,31
140484,1233959,1,7,6,1,0,32
140485,1233959,1,8,1,0,0,32
140486,1233959,1,8,2,0,0,32
140487,1233959,1,8,3,4,0,36
140488,1233959,1,8,4,1,0,37
140489,1233959,1,8,5,1,0,38
140490,1233959,1,8,6,1,0,39
140491,1233959,1,9,1,0,0,39
140492,1233959,1,9,2,0,1,39
140493,1233959,1,9,3,1,0,40
140494,1233959,1,9,4,1,0,41
140495,1233959,1,9,5,0,0,41
140496,1233959,1,9,6,1,0,42
140497,1233959,1,10,1,0,0,42
140498,1233959,1,10,2,1,0,43
140499,1233959,1,10,3,1,0,44
140500,1233959,1,10,4,0,0,44
140501,1233959,1,10,5,4,0,48
140502,1233959,1,10,6,0,0,48
140503,1233959,1,11,1,1,0,49
140504,1233959,1,11,2,0,0,49
140505,1233959,1,11,3,0,0,49
140506,1233959,1,11,4,1,0,50
140507,1233959,1,11,5,0,0,50
140508,1233959,1,11,6,1,0,51
140509,1233959,1,12,1,2,0,53
140510,1233959,1,12,2,1,0,54
140511,1233959,1,12,3,6,0,60
140512,1233959,1,12,4,1,0,61
140513,1233959,1,12,5,1,0,62
140514,1233959,1,12,6,4,0,66
140515,1233959,1,13,1,1,0,67
140516,1233959,1,13,2,0,0,67
140517,1233959,1,13,3,1,0,68
140518,1233959,1,13,4,4,0,72
140519,1233959,1,13,5,1,0,73
140520,1233959,1,13,6,0,0,73
140521,1233959,1,14,1,4,0,77
140522,1233959,1,14,2,1,0,78
140523,1233959,1,14,3,1,0,79
140524,1233959,1,14,4,0,1,79
140525,1233959,1,14,5,0,0,79
140526,1233959,1,14,6,4,0,83
140527,1233959,1,15,1,6,0,89
140528,1233959,1,15,2,1,0,90
140529,1233959,1,15,3,1,0,91
140530,1233959,1,15,4,2,0,93
140531,1233959,1,15,5,6,0,99
140532,1233959,1,15,6,0,0,99
140533,1233959,1,16,1,0,0,99
140534,1233959,1,16,2,0,0,99
140535,1233959,1,16,3,0,0,99
140536,1233959,1,16,4,0,0,99
140537,1233959,1,16,5,0,0,99
140538,1233959,1,16,6,1,0,100
140539,1233959,1,17,1,2,0,102
140540,1233959,1,17,2,2,0,104
140541,1233959,1,17,3,1,0,105
140542,1233959,1,17,4,2,0,107
140543,1233959,1,17,5,1,0,108
140544,1233959,1,17,6,6,0,114
140545,1233959,1,18,1,0,1,114
140546,1233959,1,18,2,1,0,115
140547,1233959,1,18,3,6,0,121
140548,1233959,1,18,4,1,0,122
140549,1233959,1,18,5,6,0,128
140550,1233959,1,18,6,6,0,134
140551,1233959,1,19,1,2,0,136
140552,1233959,1,19,2,0,0,136
140553,1233959,1,19,3,0,1,136
140554,1233959,1,19,4,4,0,140
140555,1233959,1,19,5,1,0,141
140556,1233959,1,19,6,1,0,142
140557,1233959,1,20,1,6,0,148
140558,1233959,1,20,2,1,0,149
140559,1233959,1,20,3,0,1,149
140560,1233959,1,20,4,2,0,151
140561,1233959,1,20,5,1,0,152
140562,1233959,1,20,6,1,0,153
140676,1233960,1,1,1,0,0,0
140677,1233960,1,1,2,0,0,0
140678,1233960,1,1,3,4,0,4
140679,1233960,1,1,4,0,0,4
140680,1233960,1,1,5,4,0,8
140681,1233960,1,1,6,0,0,8
140682,1233960,1,2,1,2,0,10
140683,1233960,1,2,2,6,0,16
140684,1233960,1,2,3,0,0,16
140685,1233960,1,2,4,0,1,16
140686,1233960,1,2,5,0,0,16
140687,1233960,1,2,6,0,1,16
140688,1233960,1,3,1,0,0,16
140689,1233960,1,3,2,4,0,20
140690,1233960,1,3,3,0,0,20
140691,1233960,1,3,4,1,0,21
140692,1233960,1,3,5,0,0,21
140693,1233960,1,3,6,0,0,21
140694,1233960,1,4,1,0,0,21
140695,1233960,1,4,2,0,0,21
140696,1233960,1,4,3,1,0,22
140697,1233960,1,4,4,1,0,23
140698,1233960,1,4,5,0,0,23
140699,1233960,1,4,6,4,0,27
140700,1233960,1,5,1,0,0,27
140701,1233960,1,5,2,1,0,28
140702,1233960,1,5,3,0,0,28
140703,1233960,1,5,4,2,0,30
140704,1233960,1,5,5,1,0,31
140705,1233960,1,5,6,0,0,31
140706,1233960,1,6,1,1,0,32
140707,1233960,1,6,2,0,0,32
140708,1233960,1,6,3,1,0,33
140709,1233960,1,6,4,0,1,33
140710,1233960,1,6,5,0,0,33
140711,1233960,1,6,6,0,0,33
140712,1233960,1,7,1,0,0,33
140713,1233960,1,7,2,4,0,37
140714,1233960,1,7,3,4,0,41
140715,1233960,1,7,4,1,0,42
140716,1233960,1,7,5,4,0,46
140717,1233960,1,7,6,0,0,46
140718,1233960,1,8,1,0,0,46
140719,1233960,1,8,2,4,0,50
140720,1233960,1,8,3,4,0,54
140721,1233960,1,8,4,1,0,55
140722,1233960,1,8,5,0,0,55
140723,1233960,1,8,6,0,0,55
140724,1233960,1,9,1,1,0,56
140725,1233960,1,9,2,0,1,56
140726,1233960,1,9,3,0,0,56
140727,1233960,1,9,4,1,0,57
140728,1233960,1,9,5,1,0,58
140729,1233960,1,9,6,0,0,58
140730,1233960,1,10,1,4,0,62
140731,1233960,1,10,2,1,0,63
140732,1233960,1,10,3,0,0,63
140733,1233960,1,10,4,0,0,63
140734,1233960,1,10,5,1,0,64
140735,1233960,1,10,6,1,0,65
140736,1233960,1,11,1,1,0,66
140737,1233960,1,11,2,1,0,67
140738,1233960,1,11,3,4,0,71
140739,1233960,1,11,4,0,0,71
140740,1233960,1,11,5,0,0,71
140741,1233960,1,11,6,2,0,73
140742,1233960,1,12,1,0,0,73
140743,1233960,1,12,2,0,0,73
140744,1233960,1,12,3,1,0,74
140745,1233960,1,12,4,0,0,74
140746,1233960,1,12,5,0,0,74
140747,1233960,1,12,6,4,0,78
140748,1233960,1,13,1,1,0,79
140749,1233960,1,13,2,1,0,80
140750,1233960,1,13,3,4,0,84
140751,1233960,1,13,4,0,0,84
140752,1233960,1,13,5,0,0,84
140753,1233960,1,13,6,2,0,86
140754,1233960,1,14,1,1,0,87
140755,1233960,1,14,2,1,0,88
140756,1233960,1,14,3,1,0,89
140757,1233960,1,14,4,1,0,90
140758,1233960,1,14,5,0,0,90
140759,1233960,1,14,6,0,0,90
140760,1233960,1,15,1,1,0,91
140761,1233960,1,15,2,2,0,93
140762,1233960,1,15,3,2,0,95
140763,1233960,1,15,4,6,0,101
140764,1233960,1,15,5,6,0,107
140765,1233960,1,15,6,0,0,107
140766,1233960,1,16,1,1,0,108
140767,1233960,1,16,2,4,0,112
140768,1233960,1,16,3,6,0,118
140769,1233960,1,16,4,0,0,118
140770,1233960,1,16,5,1,0,119
140771,1233960,1,16,6,0,1,119
140772,1233960,1,17,1,1,0,120
140773,1233960,1,17,2,0,0,120
140774,1233960,1,17,3,2,0,122
140775,1233960,1,17,4,1,0,123
140776,1233960,1,17,5,4,0,127
140777,1233960,1,17,6,1,0,128
140778,1233960,1,18,1,2,0,130
140779,1233960,1,18,2,1,0,131
140780,1233960,1,18,3,1,0,132
140781,1233960,1,18,4,1,0,133
140782,1233960,1,18,5,0,1,133
140783,1233960,1,18,6,1,0,134
140784,1233960,1,19,1,1,0,135
140785,1233960,1,19,2,0,0,135
140786,1233960,1,19,3,4,0,139
140787,1233960,1,19,4,4,0,143
140788,1233960,1,19,5,1,0,144
140789,1233960,1,19,6,1,0,145
140790,1233960,1,20,1,1,0,146
140791,1233960,1,20,2,1,0,147
140792,1233960,1,20,3,0,0,147
140793,1233960,1,20,4,6,0,153
140794,1233960,1,20,5,4,0,157
140795,1233960,1,20,6,6,0,163
140912,1233961,1,1,1,0,0,0
140913,1233961,1,1,2,0,0,0
140914,1233961,1,1,3,0,0,0
140915,1233961,1,1,4,1,0,1
140916,1233961,1,1,5,4,0,5
140917,1233961,1,1,6,0,0,5
140918,1233961,1,2,1,1,0,6
140919,1233961,1,2,2,0,0,6
140920,1233961,1,2,3,0,0,6
140921,1233961,1,2,4,0,0,6
140922,1233961,1,2,5,6,0,12
140923,1233961,1,2,6,0,0,12
140924,1233961,1,3,1,1,0,13
140925,1233961,1,3,2,2,0,15
140926,1233961,1,3,3,3,0,18
140927,1233961,1,3,4,0,0,18
140928,1233961,1,3,5,4,0,22
140929,1233961,1,3,6,1,0,23
140930,1233961,1,4,1,0,0,23
140931,1233961,1,4,2,0,0,23
140932,1233961,1,4,3,4,0,27
140933,1233961,1,4,4,1,0,28
140934,1233961,1,4,5,0,0,28
140935,1233961,1,4,6,6,0,34
140936,1233961,1,5,1,0,0,34
140937,1233961,1,5,2,6,0,40
140938,1233961,1,5,3,0,1,40
140939,1233961,1,5,4,1,0,41
140940,1233961,1,5,5,0,0,41
140941,1233961,1,5,6,4,0,45
140942,1233961,1,6,1,0,0,45
140943,1233961,1,6,2,0,0,45
140944,1233961,1,6,3,0,1,45
140945,1233961,1,6,4,0,0,45
140946,1233961,1,6,5,1,0,46
140947,1233961,1,6,6,1,0,47
140948,1233961,1,7,1,0,0,47
140949,1233961,1,7,2,6,0,53
140950,1233961,1,7,3,1,0,54
140951,1233961,1,7,4,1,0,55
140952,1233961,1,7,5,0,0,55
140953,1233961,1,7,6,2,0,57
140954,1233961,1,8,1,1,0,58
140955,1233961,1,8,2,0,1,58
140956,1233961,1,8,3,0,0,58
140957,1233961,1,8,4,1,0,59
140958,1233961,1,8,5,1,0,60
140959,1233961,1,8,6,1,0,61
140960,1233961,1,9,1,0,0,61
140961,1233961,1,9,2,2,0,63
140962,1233961,1,9,3,2,0,65
140963,1233961,1,9,4,1,0,66
140964,1233961,1,9,5,0,0,66
140965,1233961,1,9,6,1,0,67
140966,1233961,1,10,1,4,0,71
140967,1233961,1,10,2,2,0,73
140968,1233961,1,10,3,1,0,74
140969,1233961,1,10,4,0,0,74
140970,1233961,1,10,5,1,0,75
140971,1233961,1,10,6,1,0,76
140972,1233961,1,11,1,0,0,76
140973,1233961,1,11,2,1,0,77
140974,1233961,1,11,3,3,0,80
140975,1233961,1,11,4,0,0,80
140976,1233961,1,11,5,0,0,80
140977,1233961,1,11,6,1,0,81
140978,1233961,1,12,1,1,0,82
140979,1233961,1,12,2,1,0,83
140980,1233961,1,12,3,1,0,84
140981,1233961,1,12,4,1,0,85
140982,1233961,1,12,5,1,0,86
140983,1233961,1,12,6,4,0,90
140984,1233961,1,13,1,1,0,91
140985,1233961,1,13,2,4,0,95
140986,1233961,1,13,3,1,0,96
140987,1233961,1,13,4,1,0,97
140988,1233961,1,13,5,4,0,101
140989,1233961,1,13,6,4,0,105
140990,1233961,1,14,1,1,0,106
140991,1233961,1,14,2,1,0,107
140992,1233961,1,14,3,0,0,107
140993,1233961,1,14,4,0,0,107
140994,1233961,1,14,5,1,0,108
140995,1233961,1,14,6,1,0,109
140996,1233961,1,15,1,0,1,109
140997,1233961,1,15,2,4,0,113
140998,1233961,1,15,3,4,0,117
140999,1233961,1,15,4,1,0,118
141000,1233961,1,15,5,1,0,119
141001,1233961,1,15,6,1,0,120
141002,1233961,1,16,1,0,0,120
141003,1233961,1,16,2,0,0,120
141004,1233961,1,16,3,4,0,124
141005,1233961,1,16,4,2,0,126
141006,1233961,1,16,5,1,0,127
141007,1233961,1,16,6,1,0,128
141008,1233961,1,17,1,0,0,128
141009,1233961,1,17,2,0,1,128
141010,1233961,1,17,3,1,0,129
141011,1233961,1,17,4,1,0,130
141012,1233961,1,17,5,1,0,131
141013,1233961,1,17,6,2,0,133
141014,1233961,1,18,1,4,0,137
141015,1233961,1,18,2,0,0,137
141016,1233961,1,18,3,6,0,143
141017,1233961,1,18,4,1,0,144
141018,1233961,1,18,5,1,0,145
141019,1233961,1,18,6,4,0,149
141020,1233961,1,19,1,4,0,153
141021,1233961,1,19,2,6,0,159
141022,1233961,1,19,3,0,1,159
141023,1233961,1,19,4,4,0,163
141024,1233961,1,19,5,1,0,164
141025,1233961,1,19,6,1,0,165
141026,1233961,1,20,1,2,0,167
141027,1233961,1,20,2,2,0,169
141028,1233961,1,20,3,0,1,169
141029,1233961,1,20,4,0,0,169
141030,1233961,1,20,5,2,0,171
141031,1233961,1,20,6,2,0,173
141150,1233971,1,1,1,0,0,0
141151,1233971,1,1,2,0,0,0
141152,1233971,1,1,3,0,1,0
141153,1233971,1,1,4,0,0,0
141154,1233971,1,1,5,4,0,4
141155,1233971,1,1,6,2,0,6
141156,1233971,1,2,1,1,0,7
141157,1233971,1,2,2,0,0,7
141158,1233971,1,2,3,1,0,8
141159,1233971,1,2,4,0,0,8
141160,1233971,1,2,5,2,0,10
141161,1233971,1,2,6,0,0,10
141162,1233971,1,3,1,1,0,11
141163,1233971,1,3,2,0,1,11
141164,1233971,1,3,3,0,0,11
141165,1233971,1,3,4,2,0,13
141166,1233971,1,3,5,1,0,14
141167,1233971,1,3,6,1,0,15
141168,1233971,1,4,1,0,0,15
141169,1233971,1,4,2,0,0,15
141170,1233971,1,4,3,0,0,15
141171,1233971,1,4,4,0,0,15
141172,1233971,1,4,5,4,0,19
141173,1233971,1,4,6,0,1,19
141174,1233971,1,5,1,0,0,19
141175,1233971,1,5,2,1,0,20
141176,1233971,1,5,3,2,0,22
141177,1233971,1,5,4,0,0,22
141178,1233971,1,5,5,0,0,22
141179,1233971,1,5,6,6,0,28
141180,1233971,1,6,1,0,0,28
141181,1233971,1,6,2,0,0,28
141182,1233971,1,6,3,1,0,29
141183,1233971,1,6,4,0,0,29
141184,1233971,1,6,5,4,0,33
141185,1233971,1,6,6,1,0,34
141186,1233971,1,7,1,1,0,35
141187,1233971,1,7,2,0,0,35
141188,1233971,1,7,3,1,0,36
141189,1233971,1,7,4,1,0,37
141190,1233971,1,7,5,0,0,37
141191,1233971,1,7,6,1,0,38
141192,1233971,1,8,1,1,0,39
141193,1233971,1,8,2,0,0,39
141194,1233971,1,8,3,4,0,43
141195,1233971,1,8,4,0,0,43
141196,1233971,1,8,5,1,0,44
141197,1233971,1,8,6,2,0,46
141198,1233971,1,9,1,1,0,47
141199,1233971,1,9,2,1,0,48
141200,1233971,1,9,3,0,0,48
141201,1233971,1,9,4,1,0,49
141202,1233971,1,9,5,6,0,55
141203,1233971,1,9,6,0,0,55
141204,1233971,1,10,1,1,0,56
141205,1233971,1,10,2,1,0,57
141206,1233971,1,10,3,2,0,59
141207,1233971,1,10,4,0,0,59
141208,1233971,1,10,5,4,0,63
141209,1233971,1,10,6,4,0,67
141210,1233971,1,11,1,6,0,73
141211,1233971,1,11,2,1,0,74
141212,1233971,1,11,3,0,0,74
141213,1233971,1,11,4,1,0,75
141214,1233971,1,11,5,0,0,75
141215,1233971,1,11,6,6,0,81
141216,1233971,1,12,1,0,0,81
141217,1233971,1,12,2,4,0,85
141218,1233971,1,12,3,4,0,89
141219,1233971,1,12,4,1,0,90
141220,1233971,1,12,5,1,0,91
141221,1233971,1,12,6,0,0,91
141222,1233971,1,13,1,2,0,93
141223,1233971,1,13,2,0,1,93
141224,1233971,1,13,3,1,0,94
141225,1233971,1,13,4,1,0,95
141226,1233971,1,13,5,2,0,97
141227,1233971,1,13,6,1,0,98
141228,1233971,1,14,1,1,0,99
141229,1233971,1,14,2,2,0,101
141230,1233971,1,14,3,4,0,105
141231,1233971,1,14,4,1,0,106
141232,1233971,1,14,5,1,0,107
141233,1233971,1,14,6,1,0,108
141234,1233971,1,15,1,2,0,110
141235,1233971,1,15,2,1,0,111
141236,1233971,1,15,3,2,0,113
141237,1233971,1,15,4,1,0,114
141238,1233971,1,15,5,4,0,118
141239,1233971,1,15,6,0,0,118
141240,1233971,1,16,1,1,0,119
141241,1233971,1,16,2,2,0,121
141242,1233971,1,16,3,4,0,125
141243,1233971,1,16,4,1,0,126
141244,1233971,1,16,5,2,0,128
141245,1233971,1,16,6,4,0,132
141246,1233971,1,17,1,1,0,133
141247,1233971,1,17,2,2,0,135
141248,1233971,1,17,3,1,0,136
141249,1233971,1,17,4,4,0,140
141250,1233971,1,17,5,0,1,140
141251,1233971,1,17,6,1,0,141
141252,1233971,1,18,1,1,0,142
141253,1233971,1,18,2,4,0,146
141254,1233971,1,18,3,2,0,148
141255,1233971,1,18,4,1,0,149
141256,1233971,1,18,5,1,0,150
141257,1233971,1,18,6,1,0,151
141258,1233971,1,19,1,0,0,151
141259,1233971,1,19,2,2,0,153
141260,1233971,1,19,3,7,0,160
141261,1233971,1,19,4,2,0,162
141262,1233971,1,19,5,4,0,166
141263,1233971,1,19,6,1,0,167
141264,1233971,1,20,1,1,0,168
141265,1233971,1,20,2,4,0,172
141266,1233971,1,20,3,1,0,173
141267,1233971,1,20,4,6,0,179
141268,1233971,1,20,5,4,0,183
141269,1233971,1,20,6,1,0,184
141375,1233972,1,1,1,4,0,4
141376,1233972,1,1,2,0,0,4
141377,1233972,1,1,3,0,0,4
141378,1233972,1,1,4,0,0,4
141379,1233972,1,1,5,1,0,5
141380,1233972,1,1,6,1,0,6
141381,1233972,1,2,1,1,0,7
141382,1233972,1,2,2,0,0,7
141383,1233972,1,2,3,0,0,7
141384,1233972,1,2,4,1,0,8
141385,1233972,1,2,5,0,0,8
141386,1233972,1,2,6,0,0,8
141387,1233972,1,3,1,6,0,14
141388,1233972,1,3,2,1,0,15
141389,1233972,1,3,3,1,0,16
141390,1233972,1,3,4,0,0,16
141391,1233972,1,3,5,4,0,20
141392,1233972,1,3,6,0,0,20
141393,1233972,1,4,1,0,1,20
141394,1233972,1,4,2,0,0,20
141395,1233972,1,4,3,1,0,21
141396,1233972,1,4,4,0,0,21
141397,1233972,1,4,5,4,0,25
141398,1233972,1,4,6,0,0,25
141399,1233972,1,5,1,1,0,26
141400,1233972,1,5,2,0,0,26
141401,1233972,1,5,3,2,0,28
141402,1233972,1,5,4,1,0,29
141403,1233972,1,5,5,0,0,29
141404,1233972,1,5,6,1,0,30
141405,1233972,1,6,1,1,0,31
141406,1233972,1,6,2,6,0,37
141407,1233972,1,6,3,2,0,39
141408,1233972,1,6,4,4,0,43
141409,1233972,1,6,5,1,0,44
141410,1233972,1,6,6,1,0,45
141411,1233972,1,7,1,1,0,46
141412,1233972,1,7,2,6,0,52
141413,1233972,1,7,3,0,0,52
141414,1233972,1,7,4,6,0,58
141415,1233972,1,7,5,1,0,59
141416,1233972,1,7,6,0,0,59
141417,1233972,1,8,1,1,0,60
141418,1233972,1,8,2,4,0,64
141419,1233972,1,8,3,0,0,64
141420,1233972,1,8,4,0,0,64
141421,1233972,1,8,5,1,0,65
141422,1233972,1,8,6,1,0,66
141423,1233972,1,9,1,2,0,68
141424,1233972,1,9,2,1,0,69
141425,1233972,1,9,3,1,0,70
141426,1233972,1,9,4,1,0,71
141427,1233972,1,9,5,1,0,72
141428,1233972,1,9,6,0,0,72
141429,1233972,1,10,1,0,0,72
141430,1233972,1,10,2,4,0,76
141431,1233972,1,10,3,1,0,77
141432,1233972,1,10,4,1,0,78
141433,1233972,1,10,5,6,0,84
141434,1233972,1,10,6,1,0,85
141435,1233972,1,11,1,2,0,87
141436,1233972,1,11,2,1,0,88
141437,1233972,1,11,3,1,0,89
141438,1233972,1,11,4,1,0,90
141439,1233972,1,11,5,6,0,96
141440,1233972,1,11,6,6,0,102
141441,1233972,1,12,1,1,0,103
141442,1233972,1,12,2,1,0,104
141443,1233972,1,12,3,3,0,107
141444,1233972,1,12,4,6,0,113
141445,1233972,1,12,5,6,0,119
141446,1233972,1,12,6,4,0,123
141447,1233972,1,13,1,1,0,124
141448,1233972,1,13,2,1,0,125
141449,1233972,1,13,3,6,0,131
141450,1233972,1,13,4,1,0,132
141451,1233972,1,13,5,4,0,136
141452,1233972,1,13,6,1,0,137
141453,1233972,1,14,1,1,0,138
141454,1233972,1,14,2,1,0,139
141455,1233972,1,14,3,1,0,140
141456,1233972,1,14,4,2,0,142
141457,1233972,1,14,5,1,0,143
141458,1233972,1,14,6,6,0,149
141459,1233972,1,15,1,1,0,150
141460,1233972,1,15,2,1,0,151
141461,1233972,1,15,3,0,0,151
141462,1233972,1,15,4,0,1,151
141463,1233972,1,15,5,6,0,157
141464,1233972,1,15,6,6,0,163
141465,1233972,1,16,1,1,0,164
141466,1233972,1,16,2,6,0,170
141467,1233972,1,16,3,1,0,171
141468,1233972,1,16,4,2,0,173
141469,1233972,1,16,5,0,1,173
141470,1233972,1,16,6,2,0,175
141471,1233972,1,17,1,0,0,175
141472,1233972,1,17,2,0,0,175
141473,1233972,1,17,3,6,0,181
141474,1233972,1,17,4,1,0,182
141475,1233972,1,17,5,6,0,188
141476,1233972,1,17,6,1,0,189
141477,1233972,1,18,1,0,0,189
141478,1233972,1,18,2,1,0,190
141479,1233972,1,18,3,0,1,190
141480,1233972,1,18,4,1,0,191
141481,1233972,1,18,5,4,0,195
141482,1233972,1,18,6,0,0,195
141483,1233972,1,19,1,1,0,196
141484,1233972,1,19,2,1,0,197
141485,1233972,1,19,3,1,0,198
141486,1233972,1,19,4,0,1,198
141487,1233972,1,19,5,1,0,199
141488,1233972,1,19,6,0,1,199
141489,1233972,1,20,1,7,0,206
141490,1233972,1,20,2,1,0,207
141491,1233972,1,20,3,2,0,209
141492,1233972,1,20,4,4,0,213
141493,1233972,1,20,5,0,1,213
141494,1233972,1,20,6,6,0,219
141615,1233973,1,1,1,1,0,1
141616,1233973,1,1,2,0,0,1
141617,1233973,1,1,3,1,0,2
141618,1233973,1,1,4,0,0,2
141619,1233973,1,1,5,0,0,2
141620,1233973,1,1,6,0,0,2
141621,1233973,1,2,1,4,0,6
141622,1233973,1,2,2,0,0,6
141623,1233973,1,2,3,0,1,6
141624,1233973,1,2,4,0,0,6
141625,1233973,1,2,5,1,0,7
141626,1233973,1,2,6,0,0,7
141627,1233973,1,3,1,0,0,7
141628,1233973,1,3,2,0,0,7
141629,1233973,1,3,3,1,0,8
141630,1233973,1,3,4,4,0,12
141631,1233973,1,3,5,1,0,13
141632,1233973,1,3,6,1,0,14
141633,1233973,1,4,1,2,0,16
141634,1233973,1,4,2,6,0,22
141635,1233973,1,4,3,0,0,22
141636,1233973,1,4,4,2,0,24
141637,1233973,1,4,5,4,0,28
141638,1233973,1,4,6,0,0,28
141639,1233973,1,5,1,6,0,34
141640,1233973,1,5,2,0,0,34
141641,1233973,1,5,3,4,0,38
141642,1233973,1,5,4,0,0,38
141643,1233973,1,5,5,0,0,38
141644,1233973,1,5,6,0,0,38
141645,1233973,1,6,1,3,0,41
141646,1233973,1,6,2,4,0,45
141647,1233973,1,6,3,0,0,45
141648,1233973,1,6,4,1,0,46
141649,1233973,1,6,5,1,0,47
141650,1233973,1,6,6,0,0,47
141651,1233973,1,7,1,1,0,48
141652,1233973,1,7,2,0,0,48
141653,1233973,1,7,3,4,0,52
141654,1233973,1,7,4,4,0,56
141655,1233973,1,7,5,4,0,60
141656,1233973,1,7,6,2,0,62
141657,1233973,1,8,1,1,0,63
141658,1233973,1,8,2,1,0,64
141659,1233973,1,8,3,1,0,65
141660,1233973,1,8,4,1,0,66
141661,1233973,1,8,5,2,0,68
141662,1233973,1,8,6,1,0,69
141663,1233973,1,9,1,4,0,73
141664,1233973,1,9,2,4,0,77
141665,1233973,1,9,3,2,0,79
141666,1233973,1,9,4,1,0,80
141667,1233973,1,9,5,2,0,82
141668,1233973,1,9,6,2,0,84
141669,1233973,1,10,1,1,0,85
141670,1233973,1,10,2,1,0,86
141671,1233973,1,10,3,1,0,87
141672,1233973,1,10,4,0,0,87
141673,1233973,1,10,5,2,0,89
141674,1233973,1,10,6,0,1,89
141675,1233973,1,11,1,1,0,90
141676,1233973,1,11,2,1,0,91
141677,1233973,1,11,3,0,0,91
141678,1233973,1,11,4,1,0,92
141679,1233973,1,11,5,2,0,94
141680,1233973,1,11,6,1,0,95
141681,1233973,1,12,1,1,0,96
141682,1233973,1,12,2,1,0,97
141683,1233973,1,12,3,1,0,98
141684,1233973,1,12,4,8,0,106
141685,1233973,1,12,5,2,0,108
141686,1233973,1,12,6,1,0,109
141687,1233973,1,13,1,1,0,110
141688,1233973,1,13,2,2,0,112
141689,1233973,1,13,3,0,0,112
141690,1233973,1,13,4,0,0,112
141691,1233973,1,13,5,0,0,112
141692,1233973,1,13,6,4,0,116
141693,1233973,1,14,1,4,0,120
141694,1233973,1,14,2,4,0,124
141695,1233973,1,14,3,0,0,124
141696,1233973,1,14,4,1,0,125
141697,1233973,1,14,5,1,0,126
141698,1233973,1,14,6,4,0,130
141699,1233973,1,15,1,4,0,134
141700,1233973,1,15,2,0,0,134
141701,1233973,1,15,3,4,0,138
141702,1233973,1,15,4,0,0,138
141703,1233973,1,15,5,1,0,139
141704,1233973,1,15,6,6,0,145
141705,1233973,1,16,1,1,0,146
141706,1233973,1,16,2,0,0,146
141707,1233973,1,16,3,6,0,152
141708,1233973,1,16,4,1,0,153
141709,1233973,1,16,5,0,1,153
141710,1233973,1,16,6,0,0,153
141711,1233973,1,17,1,4,0,157
141712,1233973,1,17,2,6,0,163
141713,1233973,1,17,3,4,0,167
141714,1233973,1,17,4,4,0,171
141715,1233973,1,17,5,4,0,175
141716,1233973,1,17,6,6,0,181
141717,1233973,1,18,1,1,0,182
141718,1233973,1,18,2,4,0,186
141719,1233973,1,18,3,2,0,188
141720,1233973,1,18,4,6,0,194
141721,1233973,1,18,5,0,0,194
141722,1233973,1,18,6,0,1,194
141723,1233973,1,19,1,1,0,195
141724,1233973,1,19,2,0,0,195
141725,1233973,1,19,3,0,0,195
141726,1233973,1,19,4,3,0,198
141727,1233973,1,19,5,1,0,199
141728,1233973,1,19,6,1,0,200
141729,1233973,1,20,1,1,0,201
141730,1233973,1,20,2,0,0,201
141731,1233973,1,20,3,1,0,202
141732,1233973,1,20,4,1,0,203
141733,1233973,1,20,5,4,0,207
141734,1233973,1,20,6,1,0,208
141838,1233974,1,1,1,4,0,4
141839,1233974,1,1,2,0,0,4
141840,1233974,1,1,3,0,0,4
141841,1233974,1,1,4,6,0,10
141842,1233974,1,1,5,1,0,11
141843,1233974,1,1,6,0,0,11
141844,1233974,1,2,1,2,0,13
141845,1233974,1,2,2,1,0,14
141846,1233974,1,2,3,4,0,18
141847,1233974,1,2,4,0,0,18
141848,1233974,1,2,5,0,0,18
141849,1233974,1,2,6,0,0,18
141850,1233974,1,3,1,0,0,18
141851,1233974,1,3,2,0,0,18
141852,1233974,1,3,3,0,1,18
141853,1233974,1,3,4,0,0,18
141854,1233974,1,3,5,1,0,19
141855,1233974,1,3,6,0,0,19
141856,1233974,1,4,1,0,0,19
141857,1233974,1,4,2,1,0,20
141858,1233974,1,4,3,0,0,20
141859,1233974,1,4,4,4,0,24
141860,1233974,1,4,5,4,0,28
141861,1233974,1,4,6,0,0,28
141862,1233974,1,5,1,3,0,31
141863,1233974,1,5,2,0,0,31
141864,1233974,1,5,3,1,0,32
141865,1233974,1,5,4,0,0,32
141866,1233974,1,5,5,1,0,33
141867,1233974,1,5,6,0,0,33
141868,1233974,1,6,1,0,0,33
141869,1233974,1,6,2,0,0,33
141870,1233974,1,6,3,0,0,33
141871,1233974,1,6,4,4,0,37
141872,1233974,1,6,5,0,0,37
141873,1233974,1,6,6,1,0,38
141874,1233974,1,7,1,0,0,38
141875,1233974,1,7,2,1,0,39
141876,1233974,1,7,3,1,0,40
141877,1233974,1,7,4,1,0,41
141878,1233974,1,7,5,1,0,42
141879,1233974,1,7,6,0,1,42
141880,1233974,1,8,1,1,0,43
141881,1233974,1,8,2,0,0,43
141882,1233974,1,8,3,1,0,44
141883,1233974,1,8,4,2,0,46
141884,1233974,1,8,5,1,0,47
141885,1233974,1,8,6,1,0,48
141886,1233974,1,9,1,0,0,48
141887,1233974,1,9,2,2,0,50
141888,1233974,1,9,3,1,0,51
141889,1233974,1,9,4,0,0,51
141890,1233974,1,9,5,4,0,55
141891,1233974,1,9,6,6,0,61
141892,1233974,1,10,1,1,0,62
141893,1233974,1,10,2,2,0,64
141894,1233974,1,10,3,4,0,68
141895,1233974,1,10,4,0,1,68
141896,1233974,1,10,5,0,0,68
141897,1233974,1,10,6,2,0,70
141898,1233974,1,11,1,1,0,71
141899,1233974,1,11,2,4,0,75
141900,1233974,1,11,3,0,0,75
141901,1233974,1,11,4,1,0,76
141902,1233974,1,11,5,0,0,76
141903,1233974,1,11,6,1,0,77
141904,1233974,1,12,1,1,0,78
141905,1233974,1,12,2,0,0,78
141906,1233974,1,12,3,0,0,78
141907,1233974,1,12,4,6,0,84
141908,1233974,1,12,5,1,0,85
141909,1233974,1,12,6,0,0,85
141910,1233974,1,13,1,1,0,86
141911,1233974,1,13,2,2,0,88
141912,1233974,1,13,3,1,0,89
141913,1233974,1,13,4,0,0,89
141914,1233974,1,13,5,4,0,93
141915,1233974,1,13,6,0,1,93
141916,1233974,1,14,1,2,0,95
141917,1233974,1,14,2,0,0,95
141918,1233974,1,14,3,1,0,96
141919,1233974,1,14,4,0,0,96
141920,1233974,1,14,5,1,0,97
141921,1233974,1,14,6,0,1,97
141922,1233974,1,15,1,1,0,98
141923,1233974,1,15,2,1,0,99
141924,1233974,1,15,3,0,0,99
141925,1233974,1,15,4,0,0,99
141926,1233974,1,15,5,1,0,100
141927,1233974,1,15,6,0,0,100
141928,1233974,1,16,1,1,0,101
141929,1233974,1,16,2,0,0,101
141930,1233974,1,16,3,4,0,105
141931,1233974,1,16,4,1,0,106
141932,1233974,1,16,5,2,0,108
141933,1233974,1,16,6,1,0,109
141934,1233974,1,17,1,4,0,113
141935,1233974,1,17,2,1,0,114
141936,1233974,1,17,3,0,1,114
141937,1233974,1,17,4,0,0,114
141938,1233974,1,17,5,0,0,114
141939,1233974,1,17,6,2,0,116
141940,1233974,1,18,1,1,0,117
141941,1233974,1,18,2,0,0,117
141942,1233974,1,18,3,1,0,118
141943,1233974,1,18,4,4,0,122
141944,1233974,1,18,5,1,0,123
141945,1233974,1,18,6,0,0,123
141946,1233974,1,19,1,1,0,124
141947,1233974,1,19,2,1,0,125
141948,1233974,1,19,3,0,0,125
141949,1233974,1,19,4,2,0,127
141950,1233974,1,19,5,2,0,129
141951,1233974,1,19,6,1,0,130
141952,1233974,1,20,1,2,0,132
141953,1233974,1,20,2,6,0,138
141954,1233974,1,20,3,6,0,144
141955,1233974,1,20,4,6,0,150
141956,1233974,1,20,5,0,0,150
141957,1233974,1,20,6,6,0,156
142071,1233975,1,1,1,0,0,0
142072,1233975,1,1,2,1,0,1
142073,1233975,1,1,3,0,0,1
142074,1233975,1,1,4,4,0,5
142075,1233975,1,1,5,1,0,6
142076,1233975,1,1,6,1,0,7
142077,1233975,1,2,1,0,0,7
142078,1233975,1,2,2,0,0,7
142079,1233975,1,2,3,1,0,8
142080,1233975,1,2,4,0,0,8
142081,1233975,1,2,5,0,0,8
142082,1233975,1,2,6,0,0,8
142083,1233975,1,3,1,0,0,8
142084,1233975,1,3,2,0,1,8
142085,1233975,1,3,3,0,0,8
142086,1233975,1,3,4,4,0,12
142087,1233975,1,3,5,1,0,13
142088,1233975,1,3,6,1,0,14
142089,1233975,1,4,1,0,0,14
142090,1233975,1,4,2,0,0,14
142091,1233975,1,4,3,4,0,18
142092,1233975,1,4,4,1,0,19
142093,1233975,1,4,5,2,0,21
142094,1233975,1,4,6,4,0,25
142095,1233975,1,5,1,0,0,25
142096,1233975,1,5,2,1,0,26
142097,1233975,1,5,3,0,0,26
142098,1233975,1,5,4,0,0,26
142099,1233975,1,5,5,4,0,30
142100,1233975,1,5,6,2,0,32
142101,1233975,1,6,1,1,0,33
142102,1233975,1,6,2,2,0,35
142103,1233975,1,6,3,0,0,35
142104,1233975,1,6,4,4,0,39
142105,1233975,1,6,5,2,0,41
142106,1233975,1,6,6,6,0,47
142107,1233975,1,7,1,1,0,48
142108,1233975,1,7,2,1,0,49
142109,1233975,1,7,3,1,0,50
142110,1233975,1,7,4,2,0,52
142111,1233975,1,7,5,1,0,53
142112,1233975,1,7,6,0,0,53
142113,1233975,1,8,1,1,0,54
142114,1233975,1,8,2,1,0,55
142115,1233975,1,8,3,1,0,56
142116,1233975,1,8,4,1,0,57
142117,1233975,1,8,5,1,0,58
142118,1233975,1,8,6,0,0,58
142119,1233975,1,9,1,0,0,58
142120,1233975,1,9,2,1,0,59
142121,1233975,1,9,3,6,0,65
142122,1233975,1,9,4,0,0,65
142123,1233975,1,9,5,1,0,66
142124,1233975,1,9,6,0,0,66
142125,1233975,1,10,1,0,0,66
142126,1233975,1,10,2,4,0,70
142127,1233975,1,10,3,0,0,70
142128,1233975,1,10,4,4,0,74
142129,1233975,1,10,5,0,0,74
142130,1233975,1,10,6,0,1,74
142131,1233975,1,11,1,0,0,74
142132,1233975,1,11,2,1,0,75
142133,1233975,1,11,3,1,0,76
142134,1233975,1,11,4,1,0,77
142135,1233975,1,11,5,0,1,77
142136,1233975,1,11,6,0,0,77
142137,1233975,1,12,1,6,0,83
142138,1233975,1,12,2,1,0,84
142139,1233975,1,12,3,0,0,84
142140,1233975,1,12,4,0,0,84
142141,1233975,1,12,5,1,0,85
142142,1233975,1,12,6,1,0,86
142143,1233975,1,13,1,1,0,87
142144,1233975,1,13,2,4,0,91
142145,1233975,1,13,3,5,0,96
142146,1233975,1,13,4,0,0,96
142147,1233975,1,13,5,1,0,97
142148,1233975,1,13,6,2,0,99
142149,1233975,1,14,1,0,0,99
142150,1233975,1,14,2,0,0,99
142151,1233975,1,14,3,1,0,100
142152,1233975,1,14,4,1,0,101
142153,1233975,1,14,5,0,0,101
142154,1233975,1,14,6,1,0,102
142155,1233975,1,15,1,1,0,103
142156,1233975,1,15,2,0,1,103
142157,1233975,1,15,3,1,0,104
142158,1233975,1,15,4,1,0,105
142159,1233975,1,15,5,0,0,105
142160,1233975,1,15,6,1,0,106
142161,1233975,1,16,1,1,0,107
142162,1233975,1,16,2,1,0,108
142163,1233975,1,16,3,1,0,109
142164,1233975,1,16,4,1,0,110
142165,1233975,1,16,5,1,0,111
142166,1233975,1,16,6,1,0,112
142167,1233975,1,17,1,1,0,113
142168,1233975,1,17,2,0,0,113
142169,1233975,1,17,3,1,0,114
142170,1233975,1,17,4,1,0,115
142171,1233975,1,17,5,6,0,121
142172,1233975,1,17,6,1,0,122
142173,1233975,1,18,1,0,1,122
142174,1233975,1,18,2,0,1,122
142175,1233975,1,18,3,0,0,122
142176,1233975,1,18,4,0,0,122
142177,1233975,1,18,5,1,0,123
142178,1233975,1,18,6,1,0,124
142179,1233975,1,19,1,1,0,125
142180,1233975,1,19,2,1,0,126
142181,1233975,1,19,3,1,0,127
142182,1233975,1,19,4,0,0,127
142183,1233975,1,19,5,6,0,133
142184,1233975,1,19,6,1,0,134
142185,1233975,1,20,1,4,0,138
142186,1233975,1,20,2,1,1,139
142187,1233975,1,20,3,1,0,140
142188,1233975,1,20,4,1,0,141
142189,1233975,1,20,5,1,0,142
142190,1233975,1,20,6,0,1,142
142284,1233979,1,1,1,0,0,0
142285,1233979,1,1,2,0,0,0
142286,1233979,1,1,3,0,0,0
142287,1233979,1,1,4,0,0,0
142288,1233979,1,1,5,1,0,1
142289,1233979,1,1,6,0,1,1
142290,1233979,1,2,1,1,0,2
142291,1233979,1,2,2,0,0,2
142292,1233979,1,2,3,0,0,2
142293,1233979,1,2,4,1,0,3
142294,1233979,1,2,5,4,0,7
142295,1233979,1,2,6,1,0,8
142296,1233979,1,3,1,6,0,14
142297,1233979,1,3,2,1,0,15
142298,1233979,1,3,3,1,0,16
142299,1233979,1,3,4,4,0,20
142300,1233979,1,3,5,0,0,20
142301,1233979,1,3,6,1,0,21
142302,1233979,1,4,1,4,0,25
142303,1233979,1,4,2,1,0,26
142304,1233979,1,4,3,0,0,26
142305,1233979,1,4,4,4,0,30
142306,1233979,1,4,5,0,0,30
142307,1233979,1,4,6,4,0,34
142308,1233979,1,5,1,0,0,34
142309,1233979,1,5,2,0,0,34
142310,1233979,1,5,3,1,0,35
142311,1233979,1,5,4,1,0,36
142312,1233979,1,5,5,2,0,38
142313,1233979,1,5,6,0,0,38
142314,1233979,1,6,1,2,0,40
142315,1233979,1,6,2,1,0,41
142316,1233979,1,6,3,0,0,41
142317,1233979,1,6,4,0,0,41
142318,1233979,1,6,5,6,0,47
142319,1233979,1,6,6,1,0,48
142320,1233979,1,7,1,1,0,49
142321,1233979,1,7,2,1,0,50
142322,1233979,1,7,3,1,0,51
142323,1233979,1,7,4,2,0,53
142324,1233979,1,7,5,0,1,53
142325,1233979,1,7,6,1,0,54
142326,1233979,1,8,1,4,0,58
142327,1233979,1,8,2,1,0,59
142328,1233979,1,8,3,1,0,60
142329,1233979,1,8,4,1,0,61
142330,1233979,1,8,5,1,0,62
142331,1233979,1,8,6,1,0,63
142332,1233979,1,9,1,4,0,67
142333,1233979,1,9,2,1,0,68
142334,1233979,1,9,3,0,0,68
142335,1233979,1,9,4,1,0,69
142336,1233979,1,9,5,4,0,73
142337,1233979,1,9,6,1,0,74
142338,1233979,1,10,1,1,0,75
142339,1233979,1,10,2,6,0,81
142340,1233979,1,10,3,1,0,82
142341,1233979,1,10,4,1,0,83
142342,1233979,1,10,5,1,0,84
142343,1233979,1,10,6,4,0,88
142344,1233979,1,11,1,1,0,89
142345,1233979,1,11,2,0,0,89
142346,1233979,1,11,3,1,0,90
142347,1233979,1,11,4,0,0,90
142348,1233979,1,11,5,0,0,90
142349,1233979,1,11,6,1,0,91
142350,1233979,1,12,1,1,0,92
142351,1233979,1,12,2,1,0,93
142352,1233979,1,12,3,6,0,99
142353,1233979,1,12,4,1,0,100
142354,1233979,1,12,5,1,0,101
142355,1233979,1,12,6,1,0,102
142356,1233979,1,13,1,2,0,104
142357,1233979,1,13,2,1,0,105
142358,1233979,1,13,3,1,0,106
142359,1233979,1,13,4,1,0,107
142360,1233979,1,13,5,0,0,107
142361,1233979,1,13,6,2,0,109
142362,1233979,1,14,1,4,0,113
142363,1233979,1,14,2,1,0,114
142364,1233979,1,14,3,1,0,115
142365,1233979,1,14,4,6,0,121
142366,1233979,1,14,5,1,0,122
142367,1233979,1,14,6,1,0,123
142368,1233979,1,15,1,1,0,124
142369,1233979,1,15,2,1,0,125
142370,1233979,1,15,3,1,0,126
142371,1233979,1,15,4,1,0,127
142372,1233979,1,15,5,6,0,133
142373,1233979,1,15,6,0,0,133
142374,1233979,1,16,1,1,0,134
142375,1233979,1,16,2,1,0,135
142376,1233979,1,16,3,6,0,141
142377,1233979,1,16,4,1,0,142
142378,1233979,1,16,5,4,0,146
142379,1233979,1,16,6,0,0,146
142380,1233979,1,17,1,4,0,150
142381,1233979,1,17,2,1,0,151
142382,1233979,1,17,3,6,0,157
142383,1233979,1,17,4,1,0,158
142384,1233979,1,17,5,0,1,158
142385,1233979,1,17,6,4,0,162
142386,1233979,1,18,1,0,0,162
142387,1233979,1,18,2,2,0,164
142388,1233979,1,18,3,2,0,166
142389,1233979,1,18,4,6,0,172
142390,1233979,1,18,5,0,0,172
142391,1233979,1,18,6,4,0,176
142392,1233979,1,19,1,1,0,177
142393,1233979,1,19,2,1,0,178
142394,1233979,1,19,3,4,0,182
142395,1233979,1,19,4,6,0,188
142396,1233979,1,19,5,0,0,188
142397,1233979,1,19,6,2,0,190
142398,1233979,1,20,1,5,0,195
142399,1233979,1,20,2,4,0,199
142400,1233979,1,20,3,1,0,200
142401,1233979,1,20,4,4,0,204
142402,1233979,1,20,5,4,0,208
142403,1233979,1,20,6,2,0,210
142524,1233980,1,1,1,0,0,0
142525,1233980,1,1,2,4,0,4
142526,1233980,1,1,3,1,0,5
142527,1233980,1,1,4,0,0,5
142528,1233980,1,1,5,0,0,5
142529,1233980,1,1,6,4,0,9
142530,1233980,1,2,1,0,0,9
142531,1233980,1,2,2,1,0,10
142532,1233980,1,2,3,0,0,10
142533,1233980,1,2,4,4,0,14
142534,1233980,1,2,5,1,0,15
142535,1233980,1,2,6,1,0,16
142536,1233980,1,3,1,4,0,20
142537,1233980,1,3,2,0,0,20
142538,1233980,1,3,3,0,0,20
142539,1233980,1,3,4,0,0,20
142540,1233980,1,3,5,0,0,20
142541,1233980,1,3,6,0,0,20
142542,1233980,1,4,1,6,0,26
142543,1233980,1,4,2,2,0,28
142544,1233980,1,4,3,1,0,29
142545,1233980,1,4,4,6,0,35
142546,1233980,1,4,5,1,0,36
142547,1233980,1,4,6,0,1,36
142548,1233980,1,5,1,1,0,37
142549,1233980,1,5,2,1,0,38
142550,1233980,1,5,3,1,0,39
142551,1233980,1,5,4,1,0,40
142552,1233980,1,5,5,0,0,40
142553,1233980,1,5,6,3,0,43
142554,1233980,1,6,1,2,0,45
142555,1233980,1,6,2,1,0,46
142556,1233980,1,6,3,4,0,50
142557,1233980,1,6,4,4,0,54
142558,1233980,1,6,5,1,0,55
142559,1233980,1,6,6,0,1,55
142560,1233980,1,7,1,0,1,55
142561,1233980,1,7,2,1,0,56
142562,1233980,1,7,3,0,0,56
142563,1233980,1,7,4,1,0,57
142564,1233980,1,7,5,0,0,57
142565,1233980,1,7,6,1,0,58
142566,1233980,1,8,1,1,0,59
142567,1233980,1,8,2,1,0,60
142568,1233980,1,8,3,0,0,60
142569,1233980,1,8,4,1,0,61
142570,1233980,1,8,5,4,0,65
142571,1233980,1,8,6,1,0,66
142572,1233980,1,9,1,1,0,67
142573,1233980,1,9,2,1,0,68
142574,1233980,1,9,3,1,0,69
142575,1233980,1,9,4,0,0,69
142576,1233980,1,9,5,1,0,70
142577,1233980,1,9,6,1,0,71
142578,1233980,1,10,1,2,0,73
142579,1233980,1,10,2,0,0,73
142580,1233980,1,10,3,2,0,75
142581,1233980,1,10,4,1,0,76
142582,1233980,1,10,5,1,0,77
142583,1233980,1,10,6,4,0,81
142584,1233980,1,11,1,1,0,82
142585,1233980,1,11,2,0,0,82
142586,1233980,1,11,3,1,0,83
142587,1233980,1,11,4,0,0,83
142588,1233980,1,11,5,1,0,84
142589,1233980,1,11,6,4,0,88
142590,1233980,1,12,1,6,0,94
142591,1233980,1,12,2,0,0,94
142592,1233980,1,12,3,0,0,94
142593,1233980,1,12,4,0,1,94
142594,1233980,1,12,5,1,0,95
142595,1233980,1,12,6,6,0,101
142596,1233980,1,13,1,0,0,101
142597,1233980,1,13,2,1,0,102
142598,1233980,1,13,3,0,0,102
142599,1233980,1,13,4,1,0,103
142600,1233980,1,13,5,4,0,107
142601,1233980,1,13,6,1,0,108
142602,1233980,1,14,1,1,0,109
142603,1233980,1,14,2,1,0,110
142604,1233980,1,14,3,1,0,111
142605,1233980,1,14,4,0,1,111
142606,1233980,1,14,5,1,0,112
142607,1233980,1,14,6,5,0,117
142608,1233980,1,15,1,4,0,121
142609,1233980,1,15,2,1,0,122
142610,1233980,1,15,3,1,0,123
142611,1233980,1,15,4,3,0,126
142612,1233980,1,15,5,0,0,126
142613,1233980,1,15,6,2,0,128
142614,1233980,1,16,1,1,0,129
142615,1233980,1,16,2,1,0,130
142616,1233980,1,16,3,6,0,136
142617,1233980,1,16,4,2,0,138
142618,1233980,1,16,5,4,0,142
142619,1233980,1,16,6,1,0,143
142620,1233980,1,17,1,1,0,144
142621,1233980,1,17,2,4,0,148
142622,1233980,1,17,3,4,0,152
142623,1233980,1,17,4,4,0,156
142624,1233980,1,17,5,1,0,157
142625,1233980,1,17,6,2,0,159
142626,1233980,1,18,1,2,0,161
142627,1233980,1,18,2,4,0,165
142628,1233980,1,18,3,4,0,169
142629,1233980,1,18,4,0,0,169
142630,1233980,1,18,5,4,0,173
142727,1233981,1,1,1,0,0,0
142728,1233981,1,1,2,2,0,2
142729,1233981,1,1,3,6,0,8
142730,1233981,1,1,4,0,0,8
142731,1233981,1,1,5,1,0,9
142732,1233981,1,1,6,0,0,9
142733,1233981,1,2,1,0,0,9
142734,1233981,1,2,2,6,0,15
142735,1233981,1,2,3,0,0,15
142736,1233981,1,2,4,6,0,21
142737,1233981,1,2,5,0,0,21
142738,1233981,1,2,6,2,0,23
142739,1233981,1,3,1,4,0,27
142740,1233981,1,3,2,4,0,31
142741,1233981,1,3,3,4,0,35
142742,1233981,1,3,4,6,0,41
142743,1233981,1,3,5,1,0,42
142744,1233981,1,3,6,1,0,43
142745,1233981,1,4,1,1,0,44
142746,1233981,1,4,2,0,0,44
142747,1233981,1,4,3,2,0,46
142748,1233981,1,4,4,4,0,50
142749,1233981,1,4,5,4,0,54
142750,1233981,1,4,6,1,0,55
142751,1233981,1,5,1,4,0,59
142752,1233981,1,5,2,6,0,65
142753,1233981,1,5,3,1,0,66
142754,1233981,1,5,4,2,0,68
142755,1233981,1,5,5,1,0,69
142756,1233981,1,5,6,0,0,69
142757,1233981,1,6,1,6,0,75
142758,1233981,1,6,2,6,0,81
142759,1233981,1,6,3,4,0,85
142760,1233981,1,6,4,0,1,85
142761,1233981,1,6,5,4,0,89
142762,1233981,1,6,6,1,0,90
142763,1233981,1,7,1,4,0,94
142764,1233981,1,7,2,1,0,95
142765,1233981,1,7,3,1,0,96
142766,1233981,1,7,4,1,0,97
142767,1233981,1,7,5,6,0,103
142768,1233981,1,7,6,6,0,109
142769,1233981,1,8,1,1,0,110
142770,1233981,1,8,2,0,0,110
142771,1233981,1,8,3,1,0,111
142772,1233981,1,8,4,4,0,115
142773,1233981,1,8,5,6,0,121
142774,1233981,1,8,6,1,0,122
142775,1233981,1,9,1,1,0,123
142776,1233981,1,9,2,0,1,123
142777,1233981,1,9,3,1,0,124
142778,1233981,1,9,4,4,0,128
142779,1233981,1,9,5,2,0,130
142780,1233981,1,9,6,1,0,131
142781,1233981,1,10,1,4,0,135
142782,1233981,1,10,2,2,0,137
142783,1233981,1,10,3,1,0,138
142784,1233981,1,10,4,0,1,138
142785,1233981,1,10,5,2,0,140
142786,1233981,1,10,6,1,1,141
142844,1237122,1,1,1,0,0,0
142845,1237122,1,1,2,0,0,0
142846,1237122,1,1,3,4,0,4
142847,1237122,1,1,4,1,0,5
142848,1237122,1,1,5,1,0,6
142849,1237122,1,1,6,0,1,6
142850,1237122,1,2,1,1,0,7
142851,1237122,1,2,2,0,0,7
142852,1237122,1,2,3,0,0,7
142853,1237122,1,2,4,2,0,9
142854,1237122,1,2,5,0,0,9
142855,1237122,1,2,6,0,0,9
142856,1237122,1,3,1,1,0,10
142857,1237122,1,3,2,0,0,10
142858,1237122,1,3,3,0,0,10
142859,1237122,1,3,4,0,0,10
142860,1237122,1,3,5,1,0,11
142861,1237122,1,3,6,1,0,12
142862,1237122,1,4,1,2,0,14
142863,1237122,1,4,2,6,0,20
142864,1237122,1,4,3,1,0,21
142865,1237122,1,4,4,1,0,22
142866,1237122,1,4,5,4,0,26
142867,1237122,1,4,6,0,0,26
142868,1237122,1,5,1,6,0,32
142869,1237122,1,5,2,4,0,36
142870,1237122,1,5,3,6,0,42
142871,1237122,1,5,4,2,0,44
142872,1237122,1,5,5,2,0,46
142873,1237122,1,5,6,4,0,50
142874,1237122,1,6,1,4,0,54
142875,1237122,1,6,2,0,0,54
142876,1237122,1,6,3,1,0,55
142877,1237122,1,6,4,1,0,56
142878,1237122,1,6,5,0,0,56
142879,1237122,1,6,6,1,0,57
142880,1237122,1,7,1,1,0,58
142881,1237122,1,7,2,1,0,59
142882,1237122,1,7,3,1,0,60
142883,1237122,1,7,4,1,0,61
142884,1237122,1,7,5,1,0,62
142885,1237122,1,7,6,1,0,63
142886,1237122,1,8,1,0,0,63
142887,1237122,1,8,2,2,0,65
142888,1237122,1,8,3,4,0,69
142889,1237122,1,8,4,1,0,70
142890,1237122,1,8,5,1,0,71
142891,1237122,1,8,6,0,0,71
142892,1237122,1,9,1,3,0,74
142893,1237122,1,9,2,2,0,76
142894,1237122,1,9,3,0,0,76
142895,1237122,1,9,4,0,0,76
142896,1237122,1,9,5,1,0,77
142897,1237122,1,9,6,1,0,78
142898,1237122,1,10,1,4,0,82
142899,1237122,1,10,2,1,0,83
142900,1237122,1,10,3,0,1,83
142901,1237122,1,10,4,1,0,84
142902,1237122,1,10,5,1,0,85
142903,1237122,1,10,6,1,0,86
142904,1237122,1,11,1,0,0,86
142905,1237122,1,11,2,0,0,86
142906,1237122,1,11,3,1,0,87
142907,1237122,1,11,4,1,0,88
142908,1237122,1,11,5,1,0,89
142909,1237122,1,11,6,1,0,90
142910,1237122,1,12,1,1,0,91
142911,1237122,1,12,2,1,0,92
142912,1237122,1,12,3,3,0,95
142913,1237122,1,12,4,0,0,95
142914,1237122,1,12,5,0,0,95
142915,1237122,1,12,6,1,0,96
142916,1237122,1,13,1,0,0,96
142917,1237122,1,13,2,6,0,102
142918,1237122,1,13,3,1,0,103
142919,1237122,1,13,4,2,0,105
142920,1237122,1,13,5,0,0,105
142921,1237122,1,13,6,1,0,106
142922,1237122,1,14,1,2,0,108
142923,1237122,1,14,2,1,0,109
142924,1237122,1,14,3,1,0,110
142925,1237122,1,14,4,0,1,110
142926,1237122,1,14,5,3,0,113
142927,1237122,1,14,6,0,0,113
142928,1237122,1,15,1,2,0,115
142929,1237122,1,15,2,1,0,116
142930,1237122,1,15,3,3,0,119
142931,1237122,1,15,4,4,0,123
142932,1237122,1,15,5,3,0,126
142933,1237122,1,15,6,1,0,127
142934,1237122,1,16,1,1,0,128
142935,1237122,1,16,2,0,0,128
142936,1237122,1,16,3,2,0,130
142937,1237122,1,16,4,1,0,131
142938,1237122,1,16,5,2,0,133
142939,1237122,1,16,6,6,0,139
142940,1237122,1,17,1,0,0,139
142941,1237122,1,17,2,4,0,143
142942,1237122,1,17,3,2,0,145
142943,1237122,1,17,4,1,0,146
142944,1237122,1,17,5,1,0,147
142945,1237122,1,17,6,0,1,147
142946,1237122,1,18,1,1,0,148
142947,1237122,1,18,2,1,0,149
142948,1237122,1,18,3,1,0,150
142949,1237122,1,18,4,6,0,156
142950,1237122,1,18,5,1,0,157
142951,1237122,1,18,6,1,0,158
142952,1237122,1,19,1,1,0,159
142953,1237122,1,19,2,1,0,160
142954,1237122,1,19,3,1,0,161
142955,1237122,1,19,4,0,1,161
142956,1237122,1,19,5,1,0,162
142957,1237122,1,19,6,1,0,163
142958,1237122,1,20,1,5,0,168
142959,1237122,1,20,2,1,0,169
142960,1237122,1,20,3,2,0,171
142961,1237122,1,20,4,8,0,179
142962,1237122,1,20,5,0,0,179
142963,1237122,1,20,6,0,1,179
143080,1237123,1,1,1,1,0,1
143081,1237123,1,1,2,0,0,1
143082,1237123,1,1,3,2,0,3
143083,1237123,1,1,4,2,0,5
143084,1237123,1,1,5,1,0,6
143085,1237123,1,1,6,1,0,7
143086,1237123,1,2,1,1,0,8
143087,1237123,1,2,2,0,0,8
143088,1237123,1,2,3,0,0,8
143089,1237123,1,2,4,1,0,9
143090,1237123,1,2,5,0,0,9
143091,1237123,1,2,6,0,0,9
143092,1237123,1,3,1,0,0,9
143093,1237123,1,3,2,4,0,13
143094,1237123,1,3,3,6,0,19
143095,1237123,1,3,4,1,0,20
143096,1237123,1,3,5,4,0,24
143097,1237123,1,3,6,2,0,26
143098,1237123,1,4,1,3,0,29
143099,1237123,1,4,2,4,0,33
143100,1237123,1,4,3,0,0,33
143101,1237123,1,4,4,0,1,33
143102,1237123,1,4,5,0,0,33
143103,1237123,1,4,6,0,0,33
143104,1237123,1,5,1,0,0,33
143105,1237123,1,5,2,4,0,37
143106,1237123,1,5,3,1,0,38
143107,1237123,1,5,4,4,0,42
143108,1237123,1,5,5,1,0,43
143109,1237123,1,5,6,1,0,44
143110,1237123,1,6,1,4,0,48
143111,1237123,1,6,2,0,1,48
143112,1237123,1,6,3,0,0,48
143113,1237123,1,6,4,0,0,48
143114,1237123,1,6,5,1,0,49
143115,1237123,1,6,6,1,0,50
143116,1237123,1,7,1,0,0,50
143117,1237123,1,7,2,1,0,51
143118,1237123,1,7,3,1,0,52
143119,1237123,1,7,4,1,0,53
143120,1237123,1,7,5,1,0,54
143121,1237123,1,7,6,0,0,54
143122,1237123,1,8,1,1,0,55
143123,1237123,1,8,2,1,0,56
143124,1237123,1,8,3,1,0,57
143125,1237123,1,8,4,1,0,58
143126,1237123,1,8,5,0,0,58
143127,1237123,1,8,6,0,0,58
143128,1237123,1,9,1,1,0,59
143129,1237123,1,9,2,2,0,61
143130,1237123,1,9,3,0,0,61
143131,1237123,1,9,4,0,0,61
143132,1237123,1,9,5,4,0,65
143133,1237123,1,9,6,0,1,65
143134,1237123,1,10,1,4,0,69
143135,1237123,1,10,2,1,0,70
143136,1237123,1,10,3,2,0,72
143137,1237123,1,10,4,1,0,73
143138,1237123,1,10,5,2,0,75
143139,1237123,1,10,6,0,0,75
143140,1237123,1,11,1,0,1,75
143141,1237123,1,11,2,0,0,75
143142,1237123,1,11,3,0,0,75
143143,1237123,1,11,4,1,0,76
143144,1237123,1,11,5,0,0,76
143145,1237123,1,11,6,1,0,77
143146,1237123,1,12,1,0,0,77
143147,1237123,1,12,2,0,0,77
143148,1237123,1,12,3,1,0,78
143149,1237123,1,12,4,1,0,79
143150,1237123,1,12,5,1,0,80
143151,1237123,1,12,6,2,0,82
143152,1237123,1,13,1,1,0,83
143153,1237123,1,13,2,1,0,84
143154,1237123,1,13,3,1,0,85
143155,1237123,1,13,4,0,0,85
143156,1237123,1,13,5,6,0,91
143157,1237123,1,13,6,1,0,92
143158,1237123,1,14,1,1,0,93
143159,1237123,1,14,2,1,0,94
143160,1237123,1,14,3,1,0,95
143161,1237123,1,14,4,0,1,95
143162,1237123,1,14,5,2,0,97
143163,1237123,1,14,6,0,0,97
143164,1237123,1,15,1,1,0,98
143165,1237123,1,15,2,0,0,98
143166,1237123,1,15,3,1,0,99
143167,1237123,1,15,4,1,0,100
143168,1237123,1,15,5,1,0,101
143169,1237123,1,15,6,1,0,102
143170,1237123,1,16,1,2,0,104
143171,1237123,1,16,2,1,0,105
143172,1237123,1,16,3,0,0,105
143173,1237123,1,16,4,1,0,106
143174,1237123,1,16,5,1,0,107
143175,1237123,1,16,6,1,0,108
143176,1237123,1,17,1,1,0,109
143177,1237123,1,17,2,1,0,110
143178,1237123,1,17,3,1,0,111
143179,1237123,1,17,4,0,0,111
143180,1237123,1,17,5,0,0,111
143181,1237123,1,17,6,1,0,112
143182,1237123,1,18,1,1,0,113
143183,1237123,1,18,2,2,0,115
143184,1237123,1,18,3,1,0,116
143185,1237123,1,18,4,4,0,120
143186,1237123,1,18,5,6,0,126
143187,1237123,1,18,6,1,0,127
143188,1237123,1,19,1,4,0,131
143189,1237123,1,19,2,2,0,133
143190,1237123,1,19,3,2,0,135
143191,1237123,1,19,4,1,0,136
143192,1237123,1,19,5,1,0,137
143193,1237123,1,19,6,2,1,139
143194,1237123,1,20,1,1,0,140
143195,1237123,1,20,2,0,0,140
143196,1237123,1,20,3,1,0,141
143197,1237123,1,20,4,0,0,141
143198,1237123,1,20,5,4,0,145
143199,1237123,1,20,6,1,0,146
143319,1237124,1,1,1,1,0,1
143320,1237124,1,1,2,1,0,2
143321,1237124,1,1,3,1,0,3
143322,1237124,1,1,4,0,0,3
143323,1237124,1,1,5,0,0,3
143324,1237124,1,1,6,1,0,4
143325,1237124,1,2,1,0,0,4
143326,1237124,1,2,2,0,0,4
143327,1237124,1,2,3,0,0,4
143328,1237124,1,2,4,0,0,4
143329,1237124,1,2,5,1,0,5
143330,1237124,1,2,6,1,0,6
143331,1237124,1,3,1,1,0,7
143332,1237124,1,3,2,4,0,11
143333,1237124,1,3,3,6,0,17
143334,1237124,1,3,4,1,0,18
143335,1237124,1,3,5,1,0,19
143336,1237124,1,3,6,1,0,20
143337,1237124,1,4,1,0,0,20
143338,1237124,1,4,2,1,0,21
143339,1237124,1,4,3,0,0,21
143340,1237124,1,4,4,4,0,25
143341,1237124,1,4,5,6,0,31
143342,1237124,1,4,6,1,0,32
143343,1237124,1,5,1,1,0,33
143344,1237124,1,5,2,1,0,34
143345,1237124,1,5,3,0,0,34
143346,1237124,1,5,4,0,1,34
143347,1237124,1,5,5,1,0,35
143348,1237124,1,5,6,1,0,36
143349,1237124,1,6,1,0,0,36
143350,1237124,1,6,2,1,0,37
143351,1237124,1,6,3,2,0,39
143352,1237124,1,6,4,1,0,40
143353,1237124,1,6,5,4,0,44
143354,1237124,1,6,6,0,0,44
143355,1237124,1,7,1,1,0,45
143356,1237124,1,7,2,0,0,45
143357,1237124,1,7,3,0,0,45
143358,1237124,1,7,4,1,0,46
143359,1237124,1,7,5,0,0,46
143360,1237124,1,7,6,6,0,52
143361,1237124,1,8,1,4,0,56
143362,1237124,1,8,2,1,0,57
143363,1237124,1,8,3,0,0,57
143364,1237124,1,8,4,2,0,59
143365,1237124,1,8,5,2,0,61
143366,1237124,1,8,6,0,1,61
143367,1237124,1,9,1,0,0,61
143368,1237124,1,9,2,1,0,62
143369,1237124,1,9,3,0,0,62
143370,1237124,1,9,4,0,0,62
143371,1237124,1,9,5,0,0,62
143372,1237124,1,9,6,1,0,63
143373,1237124,1,10,1,1,0,64
143374,1237124,1,10,2,0,0,64
143375,1237124,1,10,3,0,1,64
143376,1237124,1,10,4,0,0,64
143377,1237124,1,10,5,1,0,65
143378,1237124,1,10,6,1,0,66
143379,1237124,1,11,1,0,0,66
143380,1237124,1,11,2,0,0,66
143381,1237124,1,11,3,1,0,67
143382,1237124,1,11,4,1,0,68
143383,1237124,1,11,5,1,0,69
143384,1237124,1,11,6,1,0,70
143385,1237124,1,12,1,2,0,72
143386,1237124,1,12,2,0,0,72
143387,1237124,1,12,3,1,0,73
143388,1237124,1,12,4,4,0,77
143389,1237124,1,12,5,1,0,78
143390,1237124,1,12,6,6,0,84
143391,1237124,1,13,1,0,0,84
143392,1237124,1,13,2,1,0,85
143393,1237124,1,13,3,4,0,89
143394,1237124,1,13,4,1,0,90
143395,1237124,1,13,5,0,0,90
143396,1237124,1,13,6,0,0,90
143397,1237124,1,14,1,1,0,91
143398,1237124,1,14,2,4,0,95
143399,1237124,1,14,3,0,0,95
143400,1237124,1,14,4,1,0,96
143401,1237124,1,14,5,1,0,97
143402,1237124,1,14,6,1,0,98
143403,1237124,1,15,1,1,0,99
143404,1237124,1,15,2,1,0,100
143405,1237124,1,15,3,1,0,101
143406,1237124,1,15,4,1,0,102
143407,1237124,1,15,5,1,0,103
143408,1237124,1,15,6,4,0,107
143409,1237124,1,16,1,6,0,113
143410,1237124,1,16,2,0,0,113
143411,1237124,1,16,3,1,0,114
143412,1237124,1,16,4,2,0,116
143413,1237124,1,16,5,1,0,117
143414,1237124,1,16,6,6,0,123
143415,1237124,1,17,1,6,0,129
143416,1237124,1,17,2,4,0,133
143417,1237124,1,17,3,4,0,137
143418,1237124,1,17,4,0,0,137
143419,1237124,1,17,5,6,0,143
143420,1237124,1,17,6,2,0,145
143421,1237124,1,18,1,6,0,151
143422,1237124,1,18,2,0,0,151
143423,1237124,1,18,3,1,0,152
143424,1237124,1,18,4,1,0,153
143425,1237124,1,18,5,1,0,154
143426,1237124,1,18,6,0,0,154
143427,1237124,1,19,1,3,0,157
143428,1237124,1,19,2,1,0,158
143429,1237124,1,19,3,1,0,159
143430,1237124,1,19,4,4,0,163
143431,1237124,1,19,5,4,0,167
143432,1237124,1,19,6,4,0,171
143433,1237124,1,20,1,4,0,175
143434,1237124,1,20,2,6,0,181
143435,1237124,1,20,3,2,0,183
143436,1237124,1,20,4,0,0,183
143437,1237124,1,20,5,6,0,189
143438,1237124,1,20,6,2,0,191
143545,1239540,1,1,1,0,0,0
143546,1239540,1,1,2,0,0,0
143547,1239540,1,1,3,1,0,1
143548,1239540,1,1,4,0,0,1
143549,1239540,1,1,5,4,0,5
143550,1239540,1,1,6,0,0,5
143551,1239540,1,2,1,0,0,5
143552,1239540,1,2,2,0,0,5
143553,1239540,1,2,3,4,0,9
143554,1239540,1,2,4,1,0,10
143555,1239540,1,2,5,0,0,10
143556,1239540,1,2,6,1,0,11
143557,1239540,1,3,1,2,0,13
143558,1239540,1,3,2,1,0,14
143559,1239540,1,3,3,4,0,18
143560,1239540,1,3,4,4,0,22
143561,1239540,1,3,5,4,0,26
143562,1239540,1,3,6,1,0,27
143563,1239540,1,4,1,0,0,27
143564,1239540,1,4,2,1,0,28
143565,1239540,1,4,3,0,0,28
143566,1239540,1,4,4,4,0,32
143567,1239540,1,4,5,1,0,33
143568,1239540,1,4,6,1,0,34
143569,1239540,1,5,1,1,0,35
143570,1239540,1,5,2,1,0,36
143571,1239540,1,5,3,1,0,37
143572,1239540,1,5,4,1,0,38
143573,1239540,1,5,5,4,0,42
143574,1239540,1,5,6,1,0,43
143575,1239540,1,6,1,0,0,43
143576,1239540,1,6,2,4,0,47
143577,1239540,1,6,3,1,0,48
143578,1239540,1,6,4,0,0,48
143579,1239540,1,6,5,1,0,49
143580,1239540,1,6,6,0,0,49
143581,1239540,1,7,1,1,0,50
143582,1239540,1,7,2,0,0,50
143583,1239540,1,7,3,4,0,54
143584,1239540,1,7,4,1,0,55
143585,1239540,1,7,5,2,0,57
143586,1239540,1,7,6,1,0,58
143587,1239540,1,8,1,1,0,59
143588,1239540,1,8,2,1,0,60
143589,1239540,1,8,3,1,0,61
143590,1239540,1,8,4,1,0,62
143591,1239540,1,8,5,1,0,63
143592,1239540,1,8,6,1,0,64
143593,1239540,1,9,1,0,0,64
143594,1239540,1,9,2,2,0,66
143595,1239540,1,9,3,1,0,67
143596,1239540,1,9,4,0,0,67
143597,1239540,1,9,5,4,0,71
143598,1239540,1,9,6,4,0,75
143599,1239540,1,10,1,1,0,76
143600,1239540,1,10,2,1,0,77
143601,1239540,1,10,3,2,0,79
143602,1239540,1,10,4,1,0,80
143603,1239540,1,10,5,0,0,80
143604,1239540,1,10,6,0,0,80
143605,1239540,1,11,1,1,0,81
143606,1239540,1,11,2,4,0,85
143607,1239540,1,11,3,1,0,86
143608,1239540,1,11,4,2,0,88
143609,1239540,1,11,5,1,0,89
143610,1239540,1,11,6,4,0,93
143611,1239540,1,12,1,2,0,95
143612,1239540,1,12,2,6,0,101
143613,1239540,1,12,3,1,0,102
143614,1239540,1,12,4,6,0,108
143615,1239540,1,12,5,1,0,109
143616,1239540,1,12,6,2,0,111
143617,1239540,1,13,1,2,0,113
143618,1239540,1,13,2,3,0,116
143619,1239540,1,13,3,2,0,118
143620,1239540,1,13,4,1,0,119
143621,1239540,1,13,5,1,0,120
143622,1239540,1,13,6,1,0,121
143623,1239540,1,14,1,4,0,125
143624,1239540,1,14,2,1,0,126
143625,1239540,1,14,3,2,0,128
143626,1239540,1,14,4,6,0,134
143627,1239540,1,14,5,4,0,138
143628,1239540,1,14,6,1,0,139
143629,1239540,1,15,1,6,0,145
143630,1239540,1,15,2,1,0,146
143631,1239540,1,15,3,4,0,150
143632,1239540,1,15,4,0,1,150
143633,1239540,1,15,5,4,0,154
143634,1239540,1,15,6,1,0,155
143635,1239540,1,16,1,6,0,161
143636,1239540,1,16,2,6,0,167
143637,1239540,1,16,3,2,0,169
143638,1239540,1,16,4,0,0,169
143639,1239540,1,16,5,0,1,169
143640,1239540,1,16,6,4,0,173
143641,1239540,1,17,1,2,0,175
143642,1239540,1,17,2,0,1,175
143643,1239540,1,17,3,0,0,175
143644,1239540,1,17,4,1,0,176
143645,1239540,1,17,5,1,0,177
143646,1239540,1,17,6,6,0,183
143647,1239540,1,18,1,6,0,189
143648,1239540,1,18,2,2,0,191
143649,1239540,1,18,3,1,0,192
143650,1239540,1,18,4,1,0,193
143651,1239540,1,18,5,6,0,199
143652,1239540,1,18,6,6,0,205
143653,1239540,1,19,1,6,0,211
143654,1239540,1,19,2,0,0,211
143655,1239540,1,19,3,6,0,217
143656,1239540,1,19,4,0,0,217
143657,1239540,1,19,5,4,0,221
143658,1239540,1,19,6,0,1,221
143659,1239540,1,20,1,0,1,221
143660,1239540,1,20,2,4,0,225
143661,1239540,1,20,3,3,0,228
143662,1239540,1,20,4,1,0,229
143663,1239540,1,20,5,2,0,231
143664,1239540,1,20,6,1,1,232
143781,1239541,1,1,1,0,0,0
143782,1239541,1,1,2,6,0,6
143783,1239541,1,1,3,4,0,10
143784,1239541,1,1,4,1,1,11
143785,1239541,1,1,5,0,0,11
143786,1239541,1,1,6,0,0,11
143787,1239541,1,2,1,0,0,11
143788,1239541,1,2,2,0,0,11
143789,1239541,1,2,3,1,0,12
143790,1239541,1,2,4,4,0,16
143791,1239541,1,2,5,0,0,16
143792,1239541,1,2,6,1,0,17
143793,1239541,1,3,1,1,0,18
143794,1239541,1,3,2,0,0,18
143795,1239541,1,3,3,0,1,18
143796,1239541,1,3,4,1,0,19
143797,1239541,1,3,5,0,0,19
143798,1239541,1,3,6,4,0,23
143799,1239541,1,4,1,0,0,23
143800,1239541,1,4,2,1,0,24
143801,1239541,1,4,3,4,0,28
143802,1239541,1,4,4,0,0,28
143803,1239541,1,4,5,0,0,28
143804,1239541,1,4,6,0,0,28
143805,1239541,1,5,1,0,0,28
143806,1239541,1,5,2,4,0,32
143807,1239541,1,5,3,1,0,33
143808,1239541,1,5,4,6,0,39
143809,1239541,1,5,5,4,0,43
143810,1239541,1,5,6,4,0,47
143811,1239541,1,6,1,4,0,51
143812,1239541,1,6,2,4,0,55
143813,1239541,1,6,3,1,0,56
143814,1239541,1,6,4,1,0,57
143815,1239541,1,6,5,5,0,62
143816,1239541,1,6,6,4,0,66
143817,1239541,1,7,1,1,0,67
143818,1239541,1,7,2,1,0,68
143819,1239541,1,7,3,2,0,70
143820,1239541,1,7,4,1,0,71
143821,1239541,1,7,5,4,0,75
143822,1239541,1,7,6,6,0,81
143823,1239541,1,8,1,1,0,82
143824,1239541,1,8,2,2,0,84
143825,1239541,1,8,3,1,0,85
143826,1239541,1,8,4,0,1,85
143827,1239541,1,8,5,1,0,86
143828,1239541,1,8,6,1,0,87
143829,1239541,1,9,1,0,0,87
143830,1239541,1,9,2,1,0,88
143831,1239541,1,9,3,0,0,88
143832,1239541,1,9,4,1,0,89
143833,1239541,1,9,5,0,0,89
143834,1239541,1,9,6,1,0,90
143835,1239541,1,10,1,4,0,94
143836,1239541,1,10,2,0,0,94
143837,1239541,1,10,3,4,0,98
143838,1239541,1,10,4,1,0,99
143839,1239541,1,10,5,6,0,105
143840,1239541,1,10,6,0,0,105
143841,1239541,1,11,1,1,0,106
143842,1239541,1,11,2,0,0,106
143843,1239541,1,11,3,0,0,106
143844,1239541,1,11,4,2,0,108
143845,1239541,1,11,5,1,0,109
143846,1239541,1,11,6,1,0,110
143847,1239541,1,12,1,1,0,111
143848,1239541,1,12,2,4,0,115
143849,1239541,1,12,3,2,0,117
143850,1239541,1,12,4,2,0,119
143851,1239541,1,12,5,1,0,120
143852,1239541,1,12,6,1,0,121
143853,1239541,1,13,1,6,0,127
143854,1239541,1,13,2,1,0,128
143855,1239541,1,13,3,2,0,130
143856,1239541,1,13,4,0,0,130
143857,1239541,1,13,5,0,0,130
143858,1239541,1,13,6,6,0,136
143859,1239541,1,14,1,1,0,137
143860,1239541,1,14,2,0,1,137
143861,1239541,1,14,3,1,0,138
143862,1239541,1,14,4,1,0,139
143863,1239541,1,14,5,4,0,143
143864,1239541,1,14,6,7,0,150
143865,1239541,1,15,1,0,0,150
143866,1239541,1,15,2,1,0,151
143867,1239541,1,15,3,2,0,153
143868,1239541,1,15,4,0,0,153
143869,1239541,1,15,5,0,1,153
143870,1239541,1,15,6,1,0,154
143871,1239541,1,16,1,6,0,160
143872,1239541,1,16,2,4,0,164
143873,1239541,1,16,3,0,1,164
143874,1239541,1,16,4,1,0,165
143875,1239541,1,16,5,0,0,165
143876,1239541,1,16,6,0,0,165
143877,1239541,1,17,1,1,0,166
143878,1239541,1,17,2,1,0,167
143879,1239541,1,17,3,2,0,169
143880,1239541,1,17,4,2,0,171
143881,1239541,1,17,5,1,0,172
143882,1239541,1,17,6,6,0,178
143883,1239541,1,18,1,4,0,182
143884,1239541,1,18,2,0,1,182
143885,1239541,1,18,3,2,0,184
143886,1239541,1,18,4,4,0,188
143887,1239541,1,18,5,1,0,189
143888,1239541,1,18,6,1,0,190
143889,1239541,1,19,1,0,0,190
143890,1239541,1,19,2,1,0,191
143891,1239541,1,19,3,0,1,191
143892,1239541,1,19,4,0,1,191
143893,1239541,1,19,5,1,0,192
143894,1239541,1,19,6,1,0,193
143895,1239541,1,20,1,1,0,194
143896,1239541,1,20,2,1,0,195
143897,1239541,1,20,3,1,0,196
143898,1239541,1,20,4,4,0,200
143899,1239541,1,20,5,0,1,200
144020,1239542,1,1,1,0,0,0
144021,1239542,1,1,2,1,0,1
144022,1239542,1,1,3,0,0,1
144023,1239542,1,1,4,0,0,1
144024,1239542,1,1,5,1,0,2
144025,1239542,1,1,6,1,0,3
144026,1239542,1,2,1,0,0,3
144027,1239542,1,2,2,0,0,3
144028,1239542,1,2,3,0,0,3
144029,1239542,1,2,4,0,0,3
144030,1239542,1,2,5,4,0,7
144031,1239542,1,2,6,4,0,11
144032,1239542,1,3,1,0,0,11
144033,1239542,1,3,2,2,0,13
144034,1239542,1,3,3,0,0,13
144035,1239542,1,3,4,1,0,14
144036,1239542,1,3,5,6,0,20
144037,1239542,1,3,6,0,0,20
144038,1239542,1,4,1,5,0,25
144039,1239542,1,4,2,1,0,26
144040,1239542,1,4,3,1,0,27
144041,1239542,1,4,4,1,0,28
144042,1239542,1,4,5,0,0,28
144043,1239542,1,4,6,1,0,29
144044,1239542,1,5,1,6,0,35
144045,1239542,1,5,2,1,0,36
144046,1239542,1,5,3,1,0,37
144047,1239542,1,5,4,1,0,38
144048,1239542,1,5,5,1,0,39
144049,1239542,1,5,6,1,0,40
144050,1239542,1,6,1,1,0,41
144051,1239542,1,6,2,1,1,42
144052,1239542,1,6,3,0,0,42
144053,1239542,1,6,4,0,0,42
144054,1239542,1,6,5,4,0,46
144055,1239542,1,6,6,4,0,50
144056,1239542,1,7,1,1,0,51
144057,1239542,1,7,2,1,0,52
144058,1239542,1,7,3,1,0,53
144059,1239542,1,7,4,1,0,54
144060,1239542,1,7,5,1,0,55
144061,1239542,1,7,6,1,0,56
144062,1239542,1,8,1,1,0,57
144063,1239542,1,8,2,1,0,58
144064,1239542,1,8,3,4,0,62
144065,1239542,1,8,4,0,0,62
144066,1239542,1,8,5,1,0,63
144067,1239542,1,8,6,4,0,67
144068,1239542,1,9,1,0,1,67
144069,1239542,1,9,2,1,0,68
144070,1239542,1,9,3,1,0,69
144071,1239542,1,9,4,0,1,69
144072,1239542,1,9,5,0,0,69
144073,1239542,1,9,6,0,0,69
144074,1239542,1,10,1,0,0,69
144075,1239542,1,10,2,2,0,71
144076,1239542,1,10,3,1,0,72
144077,1239542,1,10,4,0,0,72
144078,1239542,1,10,5,0,0,72
144079,1239542,1,10,6,1,0,73
144080,1239542,1,11,1,4,0,77
144081,1239542,1,11,2,0,0,77
144082,1239542,1,11,3,6,0,83
144083,1239542,1,11,4,1,0,84
144084,1239542,1,11,5,1,0,85
144085,1239542,1,11,6,2,0,87
144086,1239542,1,12,1,1,0,88
144087,1239542,1,12,2,0,0,88
144088,1239542,1,12,3,1,0,89
144089,1239542,1,12,4,1,0,90
144090,1239542,1,12,5,1,0,91
144091,1239542,1,12,6,1,0,92
144092,1239542,1,13,1,4,0,96
144093,1239542,1,13,2,1,0,97
144094,1239542,1,13,3,2,0,99
144095,1239542,1,13,4,1,0,100
144096,1239542,1,13,5,0,0,100
144097,1239542,1,13,6,1,0,101
144098,1239542,1,14,1,0,0,101
144099,1239542,1,14,2,1,0,102
144100,1239542,1,14,3,2,0,104
144101,1239542,1,14,4,1,0,105
144102,1239542,1,14,5,2,0,107
144103,1239542,1,14,6,1,0,108
144104,1239542,1,15,1,0,0,108
144105,1239542,1,15,2,1,0,109
144106,1239542,1,15,3,1,0,110
144107,1239542,1,15,4,1,0,111
144108,1239542,1,15,5,1,0,112
144109,1239542,1,15,6,1,0,113
144110,1239542,1,16,1,1,0,114
144111,1239542,1,16,2,0,1,114
144112,1239542,1,16,3,0,0,114
144113,1239542,1,16,4,1,0,115
144114,1239542,1,16,5,0,0,115
144115,1239542,1,16,6,1,0,116
144116,1239542,1,17,1,6,0,122
144117,1239542,1,17,2,1,0,123
144118,1239542,1,17,3,1,0,124
144119,1239542,1,17,4,1,0,125
144120,1239542,1,17,5,0,0,125
144121,1239542,1,17,6,0,1,125
144122,1239542,1,18,1,1,0,126
144123,1239542,1,18,2,1,0,127
144124,1239542,1,18,3,2,1,129
144125,1239542,1,18,4,2,0,131
144126,1239542,1,18,5,4,0,135
144127,1239542,1,18,6,0,0,135
144128,1239542,1,19,1,0,0,135
144129,1239542,1,19,2,6,0,141
144130,1239542,1,19,3,1,0,142
144131,1239542,1,19,4,2,0,144
144132,1239542,1,19,5,4,0,148
144133,1239542,1,19,6,1,0,149
144134,1239542,1,20,1,0,0,149
144135,1239542,1,20,2,2,0,151
144136,1239542,1,20,3,0,0,151
144137,1239542,1,20,4,1,0,152
144138,1239542,1,20,5,0,0,152
144139,1239542,1,20,6,2,0,154
144258,1243019,1,1,1,1,0,1
144259,1243019,1,1,2,0,1,1
144260,1243019,1,1,3,0,0,1
144261,1243019,1,1,4,0,0,1
144262,1243019,1,1,5,3,0,4
144263,1243019,1,1,6,0,0,4
144264,1243019,1,2,1,1,0,5
144265,1243019,1,2,2,0,0,5
144266,1243019,1,2,3,1,0,6
144267,1243019,1,2,4,0,0,6
144268,1243019,1,2,5,0,0,6
144269,1243019,1,2,6,1,0,7
144270,1243019,1,3,1,1,0,8
144271,1243019,1,3,2,6,0,14
144272,1243019,1,3,3,0,0,14
144273,1243019,1,3,4,0,0,14
144274,1243019,1,3,5,6,0,20
144275,1243019,1,3,6,1,0,21
144276,1243019,1,4,1,1,0,22
144277,1243019,1,4,2,0,0,22
144278,1243019,1,4,3,0,0,22
144279,1243019,1,4,4,4,0,26
144280,1243019,1,4,5,0,0,26
144281,1243019,1,4,6,4,0,30
144282,1243019,1,5,1,0,0,30
144283,1243019,1,5,2,0,0,30
144284,1243019,1,5,3,6,0,36
144285,1243019,1,5,4,0,0,36
144286,1243019,1,5,5,0,0,36
144287,1243019,1,5,6,1,0,37
144288,1243019,1,6,1,0,1,37
144289,1243019,1,6,2,6,0,43
144290,1243019,1,6,3,0,0,43
144291,1243019,1,6,4,0,0,43
144292,1243019,1,6,5,1,0,44
144293,1243019,1,6,6,1,0,45
144294,1243019,1,7,1,1,0,46
144295,1243019,1,7,2,1,0,47
144296,1243019,1,7,3,4,0,51
144297,1243019,1,7,4,4,0,55
144298,1243019,1,7,5,1,0,56
144299,1243019,1,7,6,1,0,57
144300,1243019,1,8,1,1,0,58
144301,1243019,1,8,2,1,0,59
144302,1243019,1,8,3,2,0,61
144303,1243019,1,8,4,0,0,61
144304,1243019,1,8,5,1,0,62
144305,1243019,1,8,6,1,0,63
144306,1243019,1,9,1,1,0,64
144307,1243019,1,9,2,1,0,65
144308,1243019,1,9,3,1,0,66
144309,1243019,1,9,4,1,0,67
144310,1243019,1,9,5,1,0,68
144311,1243019,1,9,6,1,0,69
144312,1243019,1,10,1,0,0,69
144313,1243019,1,10,2,0,1,69
144314,1243019,1,10,3,1,0,70
144315,1243019,1,10,4,0,0,70
144316,1243019,1,10,5,1,0,71
144317,1243019,1,10,6,0,0,71
144318,1243019,1,11,1,0,0,71
144319,1243019,1,11,2,6,0,77
144320,1243019,1,11,3,6,0,83
144321,1243019,1,11,4,1,0,84
144322,1243019,1,11,5,1,0,85
144323,1243019,1,11,6,6,0,91
144324,1243019,1,12,1,1,0,92
144325,1243019,1,12,2,4,0,96
144326,1243019,1,12,3,1,0,97
144327,1243019,1,12,4,0,0,97
144328,1243019,1,12,5,2,0,99
144329,1243019,1,12,6,0,0,99
144330,1243019,1,13,1,0,0,99
144331,1243019,1,13,2,0,1,99
144332,1243019,1,13,3,1,0,100
144333,1243019,1,13,4,1,0,101
144334,1243019,1,13,5,4,0,105
144335,1243019,1,13,6,1,0,106
144336,1243019,1,14,1,1,0,107
144337,1243019,1,14,2,1,0,108
144338,1243019,1,14,3,4,0,112
144339,1243019,1,14,4,1,0,113
144340,1243019,1,14,5,0,0,113
144341,1243019,1,14,6,0,0,113
144342,1243019,1,15,1,1,0,114
144343,1243019,1,15,2,1,0,115
144344,1243019,1,15,3,0,0,115
144345,1243019,1,15,4,6,0,121
144346,1243019,1,15,5,1,0,122
144347,1243019,1,15,6,1,0,123
144348,1243019,1,16,1,1,0,124
144349,1243019,1,16,2,1,0,125
144350,1243019,1,16,3,0,0,125
144351,1243019,1,16,4,1,0,126
144352,1243019,1,16,5,1,0,127
144353,1243019,1,16,6,0,0,127
144354,1243019,1,17,1,1,0,128
144355,1243019,1,17,2,6,0,134
144356,1243019,1,17,3,0,1,134
144357,1243019,1,17,4,1,0,135
144358,1243019,1,17,5,1,0,136
144359,1243019,1,17,6,1,0,137
144360,1243019,1,18,1,1,0,138
144361,1243019,1,18,2,2,0,140
144362,1243019,1,18,3,1,0,141
144363,1243019,1,18,4,1,0,142
144364,1243019,1,18,5,1,0,143
144365,1243019,1,18,6,0,1,143
144366,1243019,1,19,1,1,0,144
144367,1243019,1,19,2,1,0,145
144368,1243019,1,19,3,1,0,146
144369,1243019,1,19,4,6,0,152
144370,1243019,1,19,5,4,0,156
144371,1243019,1,19,6,1,0,157
144372,1243019,1,20,1,2,0,159
144373,1243019,1,20,2,2,0,161
144374,1243019,1,20,3,0,0,161
144375,1243019,1,20,4,6,0,167
144376,1243019,1,20,5,1,0,168
144377,1243019,1,20,6,1,0,169
144498,1243020,1,1,1,4,0,4
144499,1243020,1,1,2,0,0,4
144500,1243020,1,1,3,1,0,5
144501,1243020,1,1,4,0,0,5
144502,1243020,1,1,5,1,0,6
144503,1243020,1,1,6,0,0,6
144504,1243020,1,2,1,4,0,10
144505,1243020,1,2,2,0,1,10
144506,1243020,1,2,3,0,0,10
144507,1243020,1,2,4,1,0,11
144508,1243020,1,2,5,0,0,11
144509,1243020,1,2,6,1,0,12
144510,1243020,1,3,1,0,0,12
144511,1243020,1,3,2,4,0,16
144512,1243020,1,3,3,0,0,16
144513,1243020,1,3,4,2,0,18
144514,1243020,1,3,5,4,0,22
144515,1243020,1,3,6,5,0,27
144516,1243020,1,4,1,0,0,27
144517,1243020,1,4,2,0,0,27
144518,1243020,1,4,3,4,0,31
144519,1243020,1,4,4,0,0,31
144520,1243020,1,4,5,0,0,31
144521,1243020,1,4,6,1,0,32
144522,1243020,1,5,1,4,0,36
144523,1243020,1,5,2,0,0,36
144524,1243020,1,5,3,0,1,36
144525,1243020,1,5,4,0,0,36
144526,1243020,1,5,5,0,0,36
144527,1243020,1,5,6,0,0,36
144528,1243020,1,6,1,4,0,40
144529,1243020,1,6,2,1,0,41
144530,1243020,1,6,3,0,0,41
144531,1243020,1,6,4,1,0,42
144532,1243020,1,6,5,0,0,42
144533,1243020,1,6,6,4,0,46
144534,1243020,1,7,1,2,0,48
144535,1243020,1,7,2,0,1,48
144536,1243020,1,7,3,1,0,49
144537,1243020,1,7,4,1,0,50
144538,1243020,1,7,5,1,0,51
144539,1243020,1,7,6,0,0,51
144540,1243020,1,8,1,0,0,51
144541,1243020,1,8,2,1,0,52
144542,1243020,1,8,3,1,0,53
144543,1243020,1,8,4,1,0,54
144544,1243020,1,8,5,0,0,54
144545,1243020,1,8,6,1,0,55
144546,1243020,1,9,1,1,0,56
144547,1243020,1,9,2,0,0,56
144548,1243020,1,9,3,0,0,56
144549,1243020,1,9,4,2,0,58
144550,1243020,1,9,5,1,0,59
144551,1243020,1,9,6,1,0,60
144552,1243020,1,10,1,4,0,64
144553,1243020,1,10,2,1,0,65
144554,1243020,1,10,3,0,0,65
144555,1243020,1,10,4,1,0,66
144556,1243020,1,10,5,1,0,67
144557,1243020,1,10,6,1,0,68
144558,1243020,1,11,1,1,0,69
144559,1243020,1,11,2,1,0,70
144560,1243020,1,11,3,1,0,71
144561,1243020,1,11,4,1,0,72
144562,1243020,1,11,5,1,0,73
144563,1243020,1,11,6,0,0,73
144564,1243020,1,12,1,1,0,74
144565,1243020,1,12,2,4,0,78
144566,1243020,1,12,3,1,0,79
144567,1243020,1,12,4,1,0,80
144568,1243020,1,12,5,6,0,86
144569,1243020,1,12,6,1,0,87
144570,1243020,1,13,1,1,0,88
144571,1243020,1,13,2,1,0,89
144572,1243020,1,13,3,0,0,89
144573,1243020,1,13,4,0,0,89
144574,1243020,1,13,5,1,0,90
144575,1243020,1,13,6,0,0,90
144576,1243020,1,14,1,1,0,91
144577,1243020,1,14,2,1,0,92
144578,1243020,1,14,3,1,0,93
144579,1243020,1,14,4,0,1,93
144580,1243020,1,14,5,1,0,94
144581,1243020,1,14,6,1,0,95
144582,1243020,1,15,1,0,0,95
144583,1243020,1,15,2,0,0,95
144584,1243020,1,15,3,0,0,95
144585,1243020,1,15,4,0,0,95
144586,1243020,1,15,5,0,0,95
144587,1243020,1,15,6,1,0,96
144588,1243020,1,16,1,0,0,96
144589,1243020,1,16,2,0,0,96
144590,1243020,1,16,3,1,0,97
144591,1243020,1,16,4,0,1,97
144592,1243020,1,16,5,1,0,98
144593,1243020,1,16,6,1,0,99
144594,1243020,1,17,1,2,0,101
144595,1243020,1,17,2,1,0,102
144596,1243020,1,17,3,1,0,103
144597,1243020,1,17,4,1,0,104
144598,1243020,1,17,5,1,0,105
144599,1243020,1,17,6,6,0,111
144600,1243020,1,18,1,1,0,112
144601,1243020,1,18,2,4,0,116
144602,1243020,1,18,3,1,0,117
144603,1243020,1,18,4,4,0,121
144604,1243020,1,18,5,4,0,125
144605,1243020,1,18,6,1,0,126
144606,1243020,1,19,1,0,1,126
144607,1243020,1,19,2,0,0,126
144608,1243020,1,19,3,0,1,126
144609,1243020,1,19,4,1,0,127
144610,1243020,1,19,5,1,0,128
144611,1243020,1,19,6,1,0,129
144612,1243020,1,20,1,1,0,130
144613,1243020,1,20,2,1,0,131
144614,1243020,1,20,3,1,0,132
144615,1243020,1,20,4,6,0,138
144616,1243020,1,20,5,2,0,140
144617,1243020,1,20,6,4,0,144
144716,1243021,1,1,1,2,0,2
144717,1243021,1,1,2,0,0,2
144718,1243021,1,1,3,4,0,6
144719,1243021,1,1,4,1,0,7
144720,1243021,1,1,5,0,0,7
144721,1243021,1,1,6,1,0,8
144722,1243021,1,2,1,0,0,8
144723,1243021,1,2,2,1,0,9
144724,1243021,1,2,3,0,0,9
144725,1243021,1,2,4,1,0,10
144726,1243021,1,2,5,0,1,10
144727,1243021,1,2,6,0,0,10
144728,1243021,1,3,1,1,0,11
144729,1243021,1,3,2,0,0,11
144730,1243021,1,3,3,0,0,11
144731,1243021,1,3,4,1,0,12
144732,1243021,1,3,5,0,0,12
144733,1243021,1,3,6,1,0,13
144734,1243021,1,4,1,4,0,17
144735,1243021,1,4,2,0,0,17
144736,1243021,1,4,3,6,0,23
144737,1243021,1,4,4,1,0,24
144738,1243021,1,4,5,0,0,24
144739,1243021,1,4,6,0,1,24
144740,1243021,1,5,1,0,0,24
144741,1243021,1,5,2,0,0,24
144742,1243021,1,5,3,0,0,24
144743,1243021,1,5,4,0,0,24
144744,1243021,1,5,5,4,0,28
144745,1243021,1,5,6,0,0,28
144746,1243021,1,6,1,1,0,29
144747,1243021,1,6,2,0,0,29
144748,1243021,1,6,3,4,0,33
144749,1243021,1,6,4,4,0,37
144750,1243021,1,6,5,4,0,41
144751,1243021,1,6,6,0,1,41
144752,1243021,1,7,1,4,0,45
144753,1243021,1,7,2,1,0,46
144754,1243021,1,7,3,0,1,46
144755,1243021,1,7,4,0,1,46
144756,1243021,1,7,5,1,0,47
144757,1243021,1,7,6,0,0,47
144758,1243021,1,8,1,1,0,48
144759,1243021,1,8,2,0,1,48
144760,1243021,1,8,3,0,0,48
144761,1243021,1,8,4,0,0,48
144762,1243021,1,8,5,0,0,48
144763,1243021,1,8,6,1,0,49
144764,1243021,1,9,1,1,0,50
144765,1243021,1,9,2,0,0,50
144766,1243021,1,9,3,1,0,51
144767,1243021,1,9,4,0,0,51
144768,1243021,1,9,5,0,0,51
144769,1243021,1,9,6,6,0,57
144770,1243021,1,10,1,4,0,61
144771,1243021,1,10,2,0,0,61
144772,1243021,1,10,3,0,0,61
144773,1243021,1,10,4,0,0,61
144774,1243021,1,10,5,0,0,61
144775,1243021,1,10,6,0,0,61
144776,1243021,1,11,1,1,0,62
144777,1243021,1,11,2,2,0,64
144778,1243021,1,11,3,1,0,65
144779,1243021,1,11,4,0,1,65
144780,1243021,1,11,5,4,0,69
144781,1243021,1,11,6,1,0,70
144782,1243021,1,12,1,0,0,70
144783,1243021,1,12,2,1,0,71
144784,1243021,1,12,3,4,0,75
144785,1243021,1,12,4,0,0,75
144786,1243021,1,12,5,0,0,75
144787,1243021,1,12,6,1,0,76
144788,1243021,1,13,1,6,0,82
144789,1243021,1,13,2,1,0,83
144790,1243021,1,13,3,1,0,84
144791,1243021,1,13,4,2,0,86
144792,1243021,1,13,5,6,0,92
144793,1243021,1,13,6,1,0,93
144794,1243021,1,14,1,2,0,95
144795,1243021,1,14,2,1,0,96
144796,1243021,1,14,3,0,0,96
144797,1243021,1,14,4,0,0,96
144798,1243021,1,14,5,1,0,97
144799,1243021,1,14,6,0,0,97
144800,1243021,1,15,1,1,0,98
144801,1243021,1,15,2,4,0,102
144802,1243021,1,15,3,1,0,103
144803,1243021,1,15,4,1,0,104
144804,1243021,1,15,5,1,0,105
144805,1243021,1,15,6,1,0,106
144806,1243021,1,16,1,0,1,106
144807,1243021,1,16,2,1,0,107
144808,1243021,1,16,3,1,0,108
144809,1243021,1,16,4,1,0,109
144810,1243021,1,16,5,1,0,110
144811,1243021,1,16,6,0,0,110
144812,1243021,1,17,1,4,0,114
144813,1243021,1,17,2,4,0,118
144814,1243021,1,17,3,2,0,120
144815,1243021,1,17,4,1,0,121
144816,1243021,1,17,5,1,0,122
144817,1243021,1,17,6,1,0,123
144818,1243021,1,18,1,1,0,124
144819,1243021,1,18,2,0,0,124
144820,1243021,1,18,3,1,0,125
144821,1243021,1,18,4,6,0,131
144822,1243021,1,18,5,2,0,133
144823,1243021,1,18,6,0,0,133
144824,1243021,1,19,1,0,0,133
144825,1243021,1,19,2,0,0,133
144826,1243021,1,19,3,4,0,137
144827,1243021,1,19,4,1,0,138
144828,1243021,1,19,5,0,0,138
144829,1243021,1,19,6,1,0,139
144830,1243021,1,20,1,6,0,145
144831,1243021,1,20,2,7,0,152
144832,1243021,1,20,3,0,0,152
144833,1243021,1,20,4,6,0,158
144834,1243021,1,20,5,0,0,158
144835,1243021,1,20,6,6,0,164
144948,1243389,1,1,1,0,0,0
144949,1243389,1,1,2,1,0,1
144950,1243389,1,1,3,0,1,1
144951,1243389,1,1,4,0,0,1
144952,1243389,1,1,5,0,0,1
144953,1243389,1,1,6,4,0,5
144954,1243389,1,2,1,6,0,11
144955,1243389,1,2,2,0,0,11
144956,1243389,1,2,3,1,0,12
144957,1243389,1,2,4,0,0,12
144958,1243389,1,2,5,0,0,12
144959,1243389,1,2,6,0,0,12
144960,1243389,1,3,1,0,0,12
144961,1243389,1,3,2,4,0,16
144962,1243389,1,3,3,4,0,20
144963,1243389,1,3,4,1,0,21
144964,1243389,1,3,5,0,0,21
144965,1243389,1,3,6,2,0,23
144966,1243389,1,4,1,1,0,24
144967,1243389,1,4,2,0,0,24
144968,1243389,1,4,3,1,0,25
144969,1243389,1,4,4,1,0,26
144970,1243389,1,4,5,0,0,26
144971,1243389,1,4,6,4,0,30
144972,1243389,1,5,1,0,0,30
144973,1243389,1,5,2,1,0,31
144974,1243389,1,5,3,1,0,32
144975,1243389,1,5,4,4,0,36
144976,1243389,1,5,5,1,0,37
144977,1243389,1,5,6,0,0,37
144978,1243389,1,6,1,1,0,38
144979,1243389,1,6,2,1,0,39
144980,1243389,1,6,3,1,0,40
144981,1243389,1,6,4,3,0,43
144982,1243389,1,6,5,1,0,44
144983,1243389,1,6,6,0,0,44
144984,1243389,1,7,1,0,0,44
144985,1243389,1,7,2,0,0,44
144986,1243389,1,7,3,0,0,44
144987,1243389,1,7,4,1,0,45
144988,1243389,1,7,5,6,0,51
144989,1243389,1,7,6,0,0,51
144990,1243389,1,8,1,4,0,55
144991,1243389,1,8,2,1,0,56
144992,1243389,1,8,3,2,0,58
144993,1243389,1,8,4,4,0,62
144994,1243389,1,8,5,1,0,63
144995,1243389,1,8,6,1,0,64
144996,1243389,1,9,1,0,0,64
144997,1243389,1,9,2,0,1,64
144998,1243389,1,9,3,1,0,65
144999,1243389,1,9,4,0,0,65
145000,1243389,1,9,5,4,0,69
145001,1243389,1,9,6,5,0,74
145002,1243389,1,10,1,2,0,76
145003,1243389,1,10,2,1,0,77
145004,1243389,1,10,3,1,0,78
145005,1243389,1,10,4,1,0,79
145006,1243389,1,10,5,2,0,81
145007,1243389,1,10,6,2,0,83
145008,1243389,1,11,1,1,0,84
145009,1243389,1,11,2,1,0,85
145010,1243389,1,11,3,0,0,85
145011,1243389,1,11,4,1,0,86
145012,1243389,1,11,5,1,0,87
145013,1243389,1,11,6,4,0,91
145014,1243389,1,12,1,0,1,91
145015,1243389,1,12,2,1,0,92
145016,1243389,1,12,3,0,0,92
145017,1243389,1,12,4,4,0,96
145018,1243389,1,12,5,1,0,97
145019,1243389,1,12,6,0,0,97
145020,1243389,1,13,1,0,0,97
145021,1243389,1,13,2,4,0,101
145022,1243389,1,13,3,1,0,102
145023,1243389,1,13,4,1,0,103
145024,1243389,1,13,5,4,0,107
145025,1243389,1,13,6,4,0,111
145026,1243389,1,14,1,0,0,111
145027,1243389,1,14,2,6,0,117
145028,1243389,1,14,3,1,0,118
145029,1243389,1,14,4,1,0,119
145030,1243389,1,14,5,0,1,119
145031,1243389,1,14,6,1,0,120
145032,1243389,1,15,1,1,0,121
145033,1243389,1,15,2,1,0,122
145034,1243389,1,15,3,1,0,123
145035,1243389,1,15,4,1,0,124
145036,1243389,1,15,5,4,0,128
145037,1243389,1,15,6,1,0,129
145038,1243389,1,16,1,2,0,131
145039,1243389,1,16,2,1,0,132
145040,1243389,1,16,3,0,0,132
145041,1243389,1,16,4,2,0,134
145042,1243389,1,16,5,1,0,135
145043,1243389,1,16,6,1,0,136
145044,1243389,1,17,1,1,0,137
145045,1243389,1,17,2,1,0,138
145046,1243389,1,17,3,2,0,140
145047,1243389,1,17,4,2,0,142
145048,1243389,1,17,5,0,0,142
145049,1243389,1,17,6,0,0,142
145050,1243389,1,18,1,0,1,142
145051,1243389,1,18,2,1,0,143
145052,1243389,1,18,3,1,0,144
145053,1243389,1,18,4,3,0,147
145054,1243389,1,18,5,1,0,148
145055,1243389,1,18,6,1,0,149
145056,1243389,1,19,1,2,0,151
145057,1243389,1,19,2,0,0,151
145058,1243389,1,19,3,0,0,151
145059,1243389,1,19,4,2,0,153
145060,1243389,1,19,5,4,0,157
145061,1243389,1,19,6,1,0,158
145062,1243389,1,20,1,1,0,159
145063,1243389,1,20,2,1,0,160
145064,1243389,1,20,3,0,0,160
145065,1243389,1,20,4,0,1,160
145066,1243389,1,20,5,0,0,160
145067,1243389,1,20,6,4,0,164
145175,1243390,1,1,1,0,0,0
145176,1243390,1,1,2,2,0,2
145177,1243390,1,1,3,2,0,4
145178,1243390,1,1,4,0,0,4
145179,1243390,1,1,5,1,0,5
145180,1243390,1,1,6,0,0,5
145181,1243390,1,2,1,0,0,5
145182,1243390,1,2,2,0,0,5
145183,1243390,1,2,3,0,0,5
145184,1243390,1,2,4,1,0,6
145185,1243390,1,2,5,0,0,6
145186,1243390,1,2,6,0,0,6
145187,1243390,1,3,1,0,0,6
145188,1243390,1,3,2,1,0,7
145189,1243390,1,3,3,0,1,7
145190,1243390,1,3,4,0,0,7
145191,1243390,1,3,5,0,0,7
145192,1243390,1,3,6,1,0,8
145193,1243390,1,4,1,0,0,8
145194,1243390,1,4,2,1,0,9
145195,1243390,1,4,3,4,0,13
145196,1243390,1,4,4,1,0,14
145197,1243390,1,4,5,2,0,16
145198,1243390,1,4,6,0,0,16
145199,1243390,1,5,1,4,0,20
145200,1243390,1,5,2,0,0,20
145201,1243390,1,5,3,0,0,20
145202,1243390,1,5,4,0,1,20
145203,1243390,1,5,5,0,0,20
145204,1243390,1,5,6,4,0,24
145205,1243390,1,6,1,0,0,24
145206,1243390,1,6,2,0,1,24
145207,1243390,1,6,3,0,0,24
145208,1243390,1,6,4,0,0,24
145209,1243390,1,6,5,0,0,24
145210,1243390,1,6,6,0,0,24
145211,1243390,1,7,1,0,0,24
145212,1243390,1,7,2,4,0,28
145213,1243390,1,7,3,0,0,28
145214,1243390,1,7,4,0,0,28
145215,1243390,1,7,5,1,0,29
145216,1243390,1,7,6,1,0,30
145217,1243390,1,8,1,4,0,34
145218,1243390,1,8,2,1,0,35
145219,1243390,1,8,3,1,0,36
145220,1243390,1,8,4,1,0,37
145221,1243390,1,8,5,0,0,37
145222,1243390,1,8,6,1,0,38
145223,1243390,1,9,1,2,0,40
145224,1243390,1,9,2,1,0,41
145225,1243390,1,9,3,0,0,41
145226,1243390,1,9,4,1,0,42
145227,1243390,1,9,5,1,0,43
145228,1243390,1,9,6,1,0,44
145229,1243390,1,10,1,4,0,48
145230,1243390,1,10,2,4,0,52
145231,1243390,1,10,3,1,0,53
145232,1243390,1,10,4,1,0,54
145233,1243390,1,10,5,1,0,55
145234,1243390,1,10,6,0,0,55
145235,1243390,1,11,1,2,0,57
145236,1243390,1,11,2,0,0,57
145237,1243390,1,11,3,1,0,58
145238,1243390,1,11,4,0,0,58
145239,1243390,1,11,5,4,0,62
145240,1243390,1,11,6,0,0,62
145241,1243390,1,12,1,2,1,64
145242,1243390,1,12,2,1,0,65
145243,1243390,1,12,3,4,0,69
145244,1243390,1,12,4,1,0,70
145245,1243390,1,12,5,1,0,71
145246,1243390,1,12,6,0,0,71
145247,1243390,1,13,1,1,0,72
145248,1243390,1,13,2,0,0,72
145249,1243390,1,13,3,1,0,73
145250,1243390,1,13,4,0,0,73
145251,1243390,1,13,5,1,0,74
145252,1243390,1,13,6,0,0,74
145253,1243390,1,14,1,4,0,78
145254,1243390,1,14,2,2,0,80
145255,1243390,1,14,3,0,0,80
145256,1243390,1,14,4,1,0,81
145257,1243390,1,14,5,1,0,82
145258,1243390,1,14,6,1,0,83
145259,1243390,1,15,1,1,0,84
145260,1243390,1,15,2,2,0,86
145261,1243390,1,15,3,0,1,86
145262,1243390,1,15,4,1,0,87
145263,1243390,1,15,5,0,0,87
145264,1243390,1,15,6,0,0,87
145265,1243390,1,16,1,5,0,92
145266,1243390,1,16,2,0,0,92
145267,1243390,1,16,3,6,0,98
145268,1243390,1,16,4,1,0,99
145269,1243390,1,16,5,0,0,99
145270,1243390,1,16,6,1,0,100
145271,1243390,1,17,1,1,0,101
145272,1243390,1,17,2,0,0,101
145273,1243390,1,17,3,6,0,107
145274,1243390,1,17,4,2,0,109
145275,1243390,1,17,5,1,0,110
145276,1243390,1,17,6,4,0,114
145277,1243390,1,18,1,0,0,114
145278,1243390,1,18,2,1,0,115
145279,1243390,1,18,3,6,0,121
145280,1243390,1,18,4,6,0,127
145281,1243390,1,18,5,4,0,131
145282,1243390,1,18,6,0,0,131
145283,1243390,1,19,1,0,0,131
145284,1243390,1,19,2,6,0,137
145285,1243390,1,19,3,0,0,137
145286,1243390,1,19,4,1,0,138
145287,1243390,1,19,5,0,0,138
145288,1243390,1,19,6,4,0,142
145289,1243390,1,20,1,6,0,148
145290,1243390,1,20,2,1,0,149
145291,1243390,1,20,3,4,0,153
145292,1243390,1,20,4,2,0,155
145293,1243390,1,20,5,1,0,156
145294,1243390,1,20,6,0,1,156
145405,1243391,1,1,1,6,0,6
145406,1243391,1,1,2,0,0,6
145407,1243391,1,1,3,4,0,10
145408,1243391,1,1,4,0,0,10
145409,1243391,1,1,5,1,0,11
145410,1243391,1,1,6,1,0,12
145411,1243391,1,2,1,0,0,12
145412,1243391,1,2,2,0,0,12
145413,1243391,1,2,3,1,0,13
145414,1243391,1,2,4,1,0,14
145415,1243391,1,2,5,0,0,14
145416,1243391,1,2,6,4,0,18
145417,1243391,1,3,1,0,0,18
145418,1243391,1,3,2,0,0,18
145419,1243391,1,3,3,1,0,19
145420,1243391,1,3,4,0,0,19
145421,1243391,1,3,5,0,0,19
145422,1243391,1,3,6,0,0,19
145423,1243391,1,4,1,0,0,19
145424,1243391,1,4,2,1,0,20
145425,1243391,1,4,3,1,0,21
145426,1243391,1,4,4,0,1,21
145427,1243391,1,4,5,6,0,27
145428,1243391,1,4,6,0,0,27
145429,1243391,1,5,1,1,0,28
145430,1243391,1,5,2,0,0,28
145431,1243391,1,5,3,4,0,32
145432,1243391,1,5,4,1,0,33
145433,1243391,1,5,5,0,0,33
145434,1243391,1,5,6,1,0,34
145435,1243391,1,6,1,1,0,35
145436,1243391,1,6,2,5,0,40
145437,1243391,1,6,3,1,0,41
145438,1243391,1,6,4,4,0,45
145439,1243391,1,6,5,0,0,45
145440,1243391,1,6,6,0,0,45
145441,1243391,1,7,1,1,0,46
145442,1243391,1,7,2,1,0,47
145443,1243391,1,7,3,1,0,48
145444,1243391,1,7,4,4,0,52
145445,1243391,1,7,5,6,0,58
145446,1243391,1,7,6,1,0,59
145447,1243391,1,8,1,3,0,62
145448,1243391,1,8,2,1,0,63
145449,1243391,1,8,3,0,0,63
145450,1243391,1,8,4,0,1,63
145451,1243391,1,8,5,1,0,64
145452,1243391,1,8,6,4,0,68
145453,1243391,1,9,1,0,0,68
145454,1243391,1,9,2,2,0,70
145455,1243391,1,9,3,0,0,70
145456,1243391,1,9,4,0,1,70
145457,1243391,1,9,5,0,0,70
145458,1243391,1,9,6,0,0,70
145459,1243391,1,10,1,1,0,71
145460,1243391,1,10,2,0,0,71
145461,1243391,1,10,3,1,0,72
145462,1243391,1,10,4,0,0,72
145463,1243391,1,10,5,1,0,73
145464,1243391,1,10,6,2,0,75
145465,1243391,1,11,1,1,0,76
145466,1243391,1,11,2,1,0,77
145467,1243391,1,11,3,0,0,77
145468,1243391,1,11,4,1,0,78
145469,1243391,1,11,5,0,0,78
145470,1243391,1,11,6,1,0,79
145471,1243391,1,12,1,1,0,80
145472,1243391,1,12,2,4,0,84
145473,1243391,1,12,3,2,0,86
145474,1243391,1,12,4,1,0,87
145475,1243391,1,12,5,1,0,88
145476,1243391,1,12,6,4,0,92
145477,1243391,1,13,1,4,0,96
145478,1243391,1,13,2,1,0,97
145479,1243391,1,13,3,1,0,98
145480,1243391,1,13,4,4,0,102
145481,1243391,1,13,5,0,0,102
145482,1243391,1,13,6,2,0,104
145483,1243391,1,14,1,6,0,110
145484,1243391,1,14,2,0,1,110
145485,1243391,1,14,3,4,0,114
145486,1243391,1,14,4,1,0,115
145487,1243391,1,14,5,1,0,116
145488,1243391,1,14,6,4,0,120
145489,1243391,1,15,1,0,0,120
145490,1243391,1,15,2,1,0,121
145491,1243391,1,15,3,1,0,122
145492,1243391,1,15,4,4,0,126
145493,1243391,1,15,5,1,0,127
145494,1243391,1,15,6,1,0,128
145495,1243391,1,16,1,0,0,128
145496,1243391,1,16,2,2,0,130
145497,1243391,1,16,3,4,0,134
145498,1243391,1,16,4,1,0,135
145499,1243391,1,16,5,1,0,136
145500,1243391,1,16,6,4,0,140
145501,1243391,1,17,1,4,0,144
145502,1243391,1,17,2,0,1,144
145503,1243391,1,17,3,1,0,145
145504,1243391,1,17,4,2,0,147
145505,1243391,1,17,5,1,0,148
145506,1243391,1,17,6,1,0,149
145507,1243391,1,18,1,6,0,155
145508,1243391,1,18,2,1,0,156
145509,1243391,1,18,3,0,0,156
145510,1243391,1,18,4,4,0,160
145511,1243391,1,18,5,6,0,166
145512,1243391,1,18,6,1,0,167
145513,1243391,1,19,1,1,0,168
145514,1243391,1,19,2,2,0,170
145515,1243391,1,19,3,0,0,170
145516,1243391,1,19,4,0,0,170
145517,1243391,1,19,5,0,1,170
145518,1243391,1,19,6,4,0,174
145519,1243391,1,20,1,0,1,174
145520,1243391,1,20,2,1,0,175
145521,1243391,1,20,3,4,0,179
145522,1243391,1,20,4,0,1,179
145523,1243391,1,20,5,5,0,184
145524,1243391,1,20,6,1,0,185
145645,1243392,1,1,1,0,0,0
145646,1243392,1,1,2,1,0,1
145647,1243392,1,1,3,1,0,2
145648,1243392,1,1,4,0,0,2
145649,1243392,1,1,5,1,0,3
145650,1243392,1,1,6,0,0,3
145651,1243392,1,2,1,0,0,3
145652,1243392,1,2,2,1,0,4
145653,1243392,1,2,3,4,0,8
145654,1243392,1,2,4,0,0,8
145655,1243392,1,2,5,1,0,9
145656,1243392,1,2,6,4,0,13
145657,1243392,1,3,1,0,0,13
145658,1243392,1,3,2,1,0,14
145659,1243392,1,3,3,0,0,14
145660,1243392,1,3,4,1,0,15
145661,1243392,1,3,5,1,0,16
145662,1243392,1,3,6,6,0,22
145663,1243392,1,4,1,1,0,23
145664,1243392,1,4,2,4,0,27
145665,1243392,1,4,3,2,0,29
145666,1243392,1,4,4,0,0,29
145667,1243392,1,4,5,4,0,33
145668,1243392,1,4,6,2,0,35
145669,1243392,1,5,1,1,0,36
145670,1243392,1,5,2,1,0,37
145671,1243392,1,5,3,0,0,37
145672,1243392,1,5,4,6,0,43
145673,1243392,1,5,5,1,0,44
145674,1243392,1,5,6,0,0,44
145675,1243392,1,6,1,1,0,45
145676,1243392,1,6,2,6,0,51
145677,1243392,1,6,3,2,0,53
145678,1243392,1,6,4,6,0,59
145679,1243392,1,6,5,0,0,59
145680,1243392,1,6,6,1,0,60
145681,1243392,1,7,1,2,0,62
145682,1243392,1,7,2,0,0,62
145683,1243392,1,7,3,0,0,62
145684,1243392,1,7,4,1,0,63
145685,1243392,1,7,5,1,0,64
145686,1243392,1,7,6,6,0,70
145687,1243392,1,8,1,1,0,71
145688,1243392,1,8,2,0,0,71
145689,1243392,1,8,3,1,0,72
145690,1243392,1,8,4,1,0,73
145691,1243392,1,8,5,2,0,75
145692,1243392,1,8,6,6,0,81
145693,1243392,1,9,1,1,0,82
145694,1243392,1,9,2,6,0,88
145695,1243392,1,9,3,4,0,92
145696,1243392,1,9,4,1,0,93
145697,1243392,1,9,5,1,0,94
145698,1243392,1,9,6,0,1,94
145699,1243392,1,10,1,1,0,95
145700,1243392,1,10,2,1,0,96
145701,1243392,1,10,3,1,0,97
145702,1243392,1,10,4,6,0,103
145703,1243392,1,10,5,6,0,109
145704,1243392,1,10,6,1,0,110
145705,1243392,1,11,1,0,0,110
145706,1243392,1,11,2,2,0,112
145707,1243392,1,11,3,1,0,113
145708,1243392,1,11,4,1,0,114
145709,1243392,1,11,5,0,0,114
145710,1243392,1,11,6,0,0,114
145711,1243392,1,12,1,4,0,118
145712,1243392,1,12,2,1,0,119
145713,1243392,1,12,3,2,0,121
145714,1243392,1,12,4,4,0,125
145715,1243392,1,12,5,4,0,129
145716,1243392,1,12,6,4,0,133
145717,1243392,1,13,1,6,0,139
145718,1243392,1,13,2,1,0,140
145719,1243392,1,13,3,1,0,141
145720,1243392,1,13,4,1,0,142
145721,1243392,1,13,5,0,0,142
145722,1243392,1,13,6,0,0,142
145723,1243392,1,14,1,1,0,143
145724,1243392,1,14,2,0,1,143
145725,1243392,1,14,3,1,0,144
145726,1243392,1,14,4,1,0,145
145727,1243392,1,14,5,1,0,146
145728,1243392,1,14,6,0,0,146
145729,1243392,1,15,1,1,0,147
145730,1243392,1,15,2,1,0,148
145731,1243392,1,15,3,1,0,149
145732,1243392,1,15,4,1,0,150
145733,1243392,1,15,5,3,0,153
145734,1243392,1,15,6,4,0,157
145735,1243392,1,16,1,2,0,159
145736,1243392,1,16,2,2,0,161
145737,1243392,1,16,3,1,0,162
145738,1243392,1,16,4,4,0,166
145739,1243392,1,16,5,4,0,170
145740,1243392,1,16,6,0,0,170
145741,1243392,1,17,1,1,0,171
145742,1243392,1,17,2,2,0,173
145743,1243392,1,17,3,4,0,177
145744,1243392,1,17,4,1,0,178
145745,1243392,1,17,5,1,0,179
145746,1243392,1,17,6,2,0,181
145747,1243392,1,18,1,1,0,182
145748,1243392,1,18,2,1,0,183
145749,1243392,1,18,3,0,0,183
145750,1243392,1,18,4,4,0,187
145751,1243392,1,18,5,4,0,191
145752,1243392,1,18,6,2,0,193
145753,1243392,1,19,1,6,0,199
145754,1243392,1,19,2,6,0,205
145755,1243392,1,19,3,1,0,206
145756,1243392,1,19,4,0,0,206
145757,1243392,1,19,5,4,0,210
145758,1243392,1,19,6,1,0,211
145759,1243392,1,20,1,1,0,212
145760,1243392,1,20,2,1,0,213
145761,1243392,1,20,3,4,0,217
145762,1243392,1,20,4,2,0,219
145763,1243392,1,20,5,4,0,223
145764,1243392,1,20,6,1,0,224
145885,1249206,1,1,1,0,0,0
145886,1249206,1,1,2,0,0,0
145887,1249206,1,1,3,0,0,0
145888,1249206,1,1,4,2,0,2
145889,1249206,1,1,5,0,0,2
145890,1249206,1,1,6,0,0,2
145891,1249206,1,2,1,1,0,3
145892,1249206,1,2,2,0,0,3
145893,1249206,1,2,3,0,1,3
145894,1249206,1,2,4,2,0,5
145895,1249206,1,2,5,2,0,7
145896,1249206,1,2,6,2,0,9
145897,1249206,1,3,1,0,0,9
145898,1249206,1,3,2,0,0,9
145899,1249206,1,3,3,1,0,10
145900,1249206,1,3,4,0,0,10
145901,1249206,1,3,5,4,0,14
145902,1249206,1,3,6,2,0,16
145903,1249206,1,4,1,0,0,16
145904,1249206,1,4,2,1,0,17
145905,1249206,1,4,3,0,0,17
145906,1249206,1,4,4,1,0,18
145907,1249206,1,4,5,4,0,22
145908,1249206,1,4,6,4,0,26
145909,1249206,1,5,1,1,0,27
145910,1249206,1,5,2,4,0,31
145911,1249206,1,5,3,0,1,31
145912,1249206,1,5,4,0,0,31
145913,1249206,1,5,5,1,0,32
145914,1249206,1,5,6,1,0,33
145915,1249206,1,6,1,2,0,35
145916,1249206,1,6,2,0,0,35
145917,1249206,1,6,3,0,0,35
145918,1249206,1,6,4,1,0,36
145919,1249206,1,6,5,2,0,38
145920,1249206,1,6,6,1,0,39
145921,1249206,1,7,1,0,0,39
145922,1249206,1,7,2,1,0,40
145923,1249206,1,7,3,2,0,42
145924,1249206,1,7,4,1,0,43
145925,1249206,1,7,5,1,0,44
145926,1249206,1,7,6,1,0,45
145927,1249206,1,8,1,0,0,45
145928,1249206,1,8,2,2,0,47
145929,1249206,1,8,3,1,0,48
145930,1249206,1,8,4,1,0,49
145931,1249206,1,8,5,0,1,49
145932,1249206,1,8,6,1,0,50
145933,1249206,1,9,1,2,0,52
145934,1249206,1,9,2,0,0,52
145935,1249206,1,9,3,0,1,52
145936,1249206,1,9,4,0,0,52
145937,1249206,1,9,5,0,0,52
145938,1249206,1,9,6,0,0,52
145939,1249206,1,10,1,1,0,53
145940,1249206,1,10,2,1,0,54
145941,1249206,1,10,3,1,0,55
145942,1249206,1,10,4,1,0,56
145943,1249206,1,10,5,1,0,57
145944,1249206,1,10,6,0,0,57
145945,1249206,1,11,1,6,0,63
145946,1249206,1,11,2,1,0,64
145947,1249206,1,11,3,1,0,65
145948,1249206,1,11,4,2,0,67
145949,1249206,1,11,5,1,0,68
145950,1249206,1,11,6,1,0,69
145951,1249206,1,12,1,1,0,70
145952,1249206,1,12,2,0,0,70
145953,1249206,1,12,3,0,0,70
145954,1249206,1,12,4,1,0,71
145955,1249206,1,12,5,1,0,72
145956,1249206,1,12,6,2,0,74
145957,1249206,1,13,1,1,0,75
145958,1249206,1,13,2,2,0,77
145959,1249206,1,13,3,0,0,77
145960,1249206,1,13,4,0,0,77
145961,1249206,1,13,5,0,0,77
145962,1249206,1,13,6,2,0,79
145963,1249206,1,14,1,0,1,79
145964,1249206,1,14,2,1,0,80
145965,1249206,1,14,3,1,0,81
145966,1249206,1,14,4,1,0,82
145967,1249206,1,14,5,2,0,84
145968,1249206,1,14,6,0,0,84
145969,1249206,1,15,1,4,0,88
145970,1249206,1,15,2,4,0,92
145971,1249206,1,15,3,0,0,92
145972,1249206,1,15,4,0,0,92
145973,1249206,1,15,5,1,0,93
145974,1249206,1,15,6,1,0,94
145975,1249206,1,16,1,1,0,95
145976,1249206,1,16,2,1,0,96
145977,1249206,1,16,3,0,0,96
145978,1249206,1,16,4,0,1,96
145979,1249206,1,16,5,1,0,97
145980,1249206,1,16,6,0,0,97
145981,1249206,1,17,1,1,0,98
145982,1249206,1,17,2,0,0,98
145983,1249206,1,17,3,0,0,98
145984,1249206,1,17,4,1,0,99
145985,1249206,1,17,5,1,0,100
145986,1249206,1,17,6,0,0,100
145987,1249206,1,18,1,1,0,101
145988,1249206,1,18,2,1,0,102
145989,1249206,1,18,3,0,0,102
145990,1249206,1,18,4,1,0,103
145991,1249206,1,18,5,0,0,103
145992,1249206,1,18,6,1,0,104
145993,1249206,1,19,1,1,0,105
145994,1249206,1,19,2,1,0,106
145995,1249206,1,19,3,0,0,106
145996,1249206,1,19,4,4,0,110
145997,1249206,1,19,5,6,0,116
145998,1249206,1,19,6,1,0,117
145999,1249206,1,20,1,0,0,117
146000,1249206,1,20,2,2,0,119
146001,1249206,1,20,3,6,0,125
146002,1249206,1,20,4,2,0,127
146003,1249206,1,20,5,2,0,129
146004,1249206,1,20,6,0,1,129
146108,1249207,1,1,1,2,0,2
146109,1249207,1,1,2,1,0,3
146110,1249207,1,1,3,0,0,3
146111,1249207,1,1,4,0,0,3
146112,1249207,1,1,5,1,0,4
146113,1249207,1,1,6,1,0,5
146114,1249207,1,2,1,1,0,6
146115,1249207,1,2,2,0,0,6
146116,1249207,1,2,3,0,1,6
146117,1249207,1,2,4,0,0,6
146118,1249207,1,2,5,2,0,8
146119,1249207,1,2,6,1,0,9
146120,1249207,1,3,1,1,0,10
146121,1249207,1,3,2,0,0,10
146122,1249207,1,3,3,2,0,12
146123,1249207,1,3,4,1,0,13
146124,1249207,1,3,5,0,0,13
146125,1249207,1,3,6,2,0,15
146126,1249207,1,4,1,1,0,16
146127,1249207,1,4,2,2,0,18
146128,1249207,1,4,3,0,1,18
146129,1249207,1,4,4,1,0,19
146130,1249207,1,4,5,0,0,19
146131,1249207,1,4,6,0,0,19
146132,1249207,1,5,1,0,0,19
146133,1249207,1,5,2,0,0,19
146134,1249207,1,5,3,2,0,21
146135,1249207,1,5,4,0,0,21
146136,1249207,1,5,5,0,0,21
146137,1249207,1,5,6,0,0,21
146138,1249207,1,6,1,0,0,21
146139,1249207,1,6,2,1,0,22
146140,1249207,1,6,3,1,0,23
146141,1249207,1,6,4,2,0,25
146142,1249207,1,6,5,1,0,26
146143,1249207,1,6,6,0,0,26
146144,1249207,1,7,1,1,0,27
146145,1249207,1,7,2,0,0,27
146146,1249207,1,7,3,1,0,28
146147,1249207,1,7,4,1,0,29
146148,1249207,1,7,5,0,0,29
146149,1249207,1,7,6,0,0,29
146150,1249207,1,8,1,1,0,30
146151,1249207,1,8,2,1,0,31
146152,1249207,1,8,3,1,0,32
146153,1249207,1,8,4,4,0,36
146154,1249207,1,8,5,0,0,36
146155,1249207,1,8,6,1,0,37
146156,1249207,1,9,1,0,0,37
146157,1249207,1,9,2,4,0,41
146158,1249207,1,9,3,0,0,41
146159,1249207,1,9,4,2,0,43
146160,1249207,1,9,5,1,0,44
146161,1249207,1,9,6,0,0,44
146162,1249207,1,10,1,0,0,44
146163,1249207,1,10,2,0,0,44
146164,1249207,1,10,3,0,0,44
146165,1249207,1,10,4,1,0,45
146166,1249207,1,10,5,1,0,46
146167,1249207,1,10,6,1,0,47
146168,1249207,1,11,1,1,0,48
146169,1249207,1,11,2,1,0,49
146170,1249207,1,11,3,1,0,50
146171,1249207,1,11,4,2,0,52
146172,1249207,1,11,5,1,0,53
146173,1249207,1,11,6,2,0,55
146174,1249207,1,12,1,1,0,56
146175,1249207,1,12,2,0,0,56
146176,1249207,1,12,3,6,0,62
146177,1249207,1,12,4,0,0,62
146178,1249207,1,12,5,1,0,63
146179,1249207,1,12,6,2,0,65
146180,1249207,1,13,1,2,0,67
146181,1249207,1,13,2,1,0,68
146182,1249207,1,13,3,0,1,68
146183,1249207,1,13,4,2,0,70
146184,1249207,1,13,5,1,0,71
146185,1249207,1,13,6,1,0,72
146186,1249207,1,14,1,4,0,76
146187,1249207,1,14,2,0,1,76
146188,1249207,1,14,3,0,1,76
146189,1249207,1,14,4,0,0,76
146190,1249207,1,14,5,0,0,76
146191,1249207,1,14,6,0,0,76
146192,1249207,1,15,1,0,0,76
146193,1249207,1,15,2,1,0,77
146194,1249207,1,15,3,1,0,78
146195,1249207,1,15,4,0,0,78
146196,1249207,1,15,5,2,0,80
146197,1249207,1,15,6,1,0,81
146198,1249207,1,16,1,0,0,81
146199,1249207,1,16,2,0,0,81
146200,1249207,1,16,3,1,0,82
146201,1249207,1,16,4,1,0,83
146202,1249207,1,16,5,0,0,83
146203,1249207,1,16,6,1,0,84
146204,1249207,1,17,1,1,0,85
146205,1249207,1,17,2,1,0,86
146206,1249207,1,17,3,1,0,87
146207,1249207,1,17,4,0,1,87
146208,1249207,1,17,5,0,0,87
146209,1249207,1,17,6,1,0,88
146210,1249207,1,18,1,0,0,88
146211,1249207,1,18,2,1,0,89
146212,1249207,1,18,3,1,0,90
146213,1249207,1,18,4,0,1,90
146214,1249207,1,18,5,0,0,90
146215,1249207,1,18,6,0,0,90
146216,1249207,1,19,1,1,0,91
146217,1249207,1,19,2,3,0,94
146218,1249207,1,19,3,0,0,94
146219,1249207,1,19,4,1,0,95
146220,1249207,1,19,5,1,0,96
146221,1249207,1,19,6,1,0,97
146222,1249207,1,20,1,4,0,101
146223,1249207,1,20,2,0,0,101
146224,1249207,1,20,3,2,0,103
146225,1249207,1,20,4,6,0,109
146226,1249207,1,20,5,0,0,109
146227,1249207,1,20,6,2,0,111
146325,1249208,1,1,1,0,0,0
146326,1249208,1,1,2,1,0,1
146327,1249208,1,1,3,1,0,2
146328,1249208,1,1,4,0,0,2
146329,1249208,1,1,5,0,0,2
146330,1249208,1,1,6,1,0,3
146331,1249208,1,2,1,0,0,3
146332,1249208,1,2,2,0,0,3
146333,1249208,1,2,3,2,0,5
146334,1249208,1,2,4,1,0,6
146335,1249208,1,2,5,0,0,6
146336,1249208,1,2,6,0,0,6
146337,1249208,1,3,1,4,0,10
146338,1249208,1,3,2,1,0,11
146339,1249208,1,3,3,1,0,12
146340,1249208,1,3,4,0,0,12
146341,1249208,1,3,5,1,0,13
146342,1249208,1,3,6,1,0,14
146343,1249208,1,4,1,6,0,20
146344,1249208,1,4,2,1,0,21
146345,1249208,1,4,3,1,0,22
146346,1249208,1,4,4,0,0,22
146347,1249208,1,4,5,0,0,22
146348,1249208,1,4,6,0,0,22
146349,1249208,1,5,1,5,0,27
146350,1249208,1,5,2,5,0,32
146351,1249208,1,5,3,0,0,32
146352,1249208,1,5,4,1,0,33
146353,1249208,1,5,5,6,0,39
146354,1249208,1,5,6,0,0,39
146355,1249208,1,6,1,4,0,43
146356,1249208,1,6,2,0,0,43
146357,1249208,1,6,3,0,0,43
146358,1249208,1,6,4,4,0,47
146359,1249208,1,6,5,0,0,47
146360,1249208,1,6,6,1,0,48
146361,1249208,1,7,1,2,0,50
146362,1249208,1,7,2,1,0,51
146363,1249208,1,7,3,1,0,52
146364,1249208,1,7,4,0,0,52
146365,1249208,1,7,5,1,0,53
146366,1249208,1,7,6,2,0,55
146367,1249208,1,8,1,0,0,55
146368,1249208,1,8,2,2,0,57
146369,1249208,1,8,3,2,0,59
146370,1249208,1,8,4,1,0,60
146371,1249208,1,8,5,1,0,61
146372,1249208,1,8,6,1,0,62
146373,1249208,1,9,1,1,0,63
146374,1249208,1,9,2,4,0,67
146375,1249208,1,9,3,1,0,68
146376,1249208,1,9,4,1,0,69
146377,1249208,1,9,5,6,0,75
146378,1249208,1,9,6,4,0,79
146379,1249208,1,10,1,6,0,85
146380,1249208,1,10,2,2,0,87
146381,1249208,1,10,3,0,0,87
146382,1249208,1,10,4,0,0,87
146383,1249208,1,10,5,2,0,89
146384,1249208,1,10,6,4,0,93
146385,1249208,1,11,1,0,0,93
146386,1249208,1,11,2,4,0,97
146387,1249208,1,11,3,0,0,97
146388,1249208,1,11,4,0,0,97
146389,1249208,1,11,5,1,0,98
146390,1249208,1,11,6,0,0,98
146391,1249208,1,12,1,4,0,102
146392,1249208,1,12,2,2,0,104
146393,1249208,1,12,3,1,0,105
146394,1249208,1,12,4,0,1,105
146395,1249208,1,12,5,0,0,105
146396,1249208,1,12,6,1,0,106
146397,1249208,1,13,1,1,0,107
146398,1249208,1,13,2,2,0,109
146399,1249208,1,13,3,1,0,110
146400,1249208,1,13,4,1,0,111
146401,1249208,1,13,5,2,0,113
146402,1249208,1,13,6,1,0,114
146403,1249208,1,14,1,0,0,114
146404,1249208,1,14,2,1,0,115
146405,1249208,1,14,3,4,0,119
146406,1249208,1,14,4,1,0,120
146407,1249208,1,14,5,1,0,121
146408,1249208,1,14,6,4,0,125
146409,1249208,1,15,1,6,0,131
146410,1249208,1,15,2,3,0,134
146411,1249208,1,15,3,1,0,135
146412,1249208,1,15,4,6,0,141
146413,1249208,1,15,5,1,0,142
146414,1249208,1,15,6,1,0,143
146415,1249208,1,16,1,0,1,143
146416,1249208,1,16,2,1,0,144
146417,1249208,1,16,3,1,0,145
146418,1249208,1,16,4,1,0,146
146419,1249208,1,16,5,0,0,146
146420,1249208,1,16,6,1,0,147
146421,1249208,1,17,1,1,0,148
146422,1249208,1,17,2,0,1,148
146423,1249208,1,17,3,1,0,149
146424,1249208,1,17,4,1,0,150
146425,1249208,1,17,5,1,0,151
146426,1249208,1,17,6,0,1,151
146427,1249208,1,18,1,1,0,152
146428,1249208,1,18,2,1,0,153
146429,1249208,1,18,3,1,0,154
146430,1249208,1,18,4,4,0,158
146431,1249208,1,18,5,0,0,158
146432,1249208,1,18,6,2,0,160
146433,1249208,1,19,1,2,0,162
146434,1249208,1,19,2,0,0,162
146435,1249208,1,19,3,0,1,162
146436,1249208,1,19,4,0,0,162
146437,1249208,1,19,5,0,1,162
146438,1249208,1,19,6,1,0,163
146439,1249208,1,20,1,4,0,167
146440,1249208,1,20,2,2,0,169
146441,1249208,1,20,3,2,0,171
146442,1249208,1,20,4,1,0,172
146443,1249208,1,20,5,4,0,176
146444,1249208,1,20,6,4,0,180
146558,1251575,1,1,1,0,0,0
146559,1251575,1,1,2,4,0,4
146560,1251575,1,1,3,0,0,4
146561,1251575,1,1,4,1,0,5
146562,1251575,1,1,5,0,0,5
146563,1251575,1,1,6,4,0,9
146564,1251575,1,2,1,1,0,10
146565,1251575,1,2,2,0,0,10
146566,1251575,1,2,3,1,0,11
146567,1251575,1,2,4,0,0,11
146568,1251575,1,2,5,1,0,12
146569,1251575,1,2,6,0,0,12
146570,1251575,1,3,1,0,0,12
146571,1251575,1,3,2,4,0,16
146572,1251575,1,3,3,6,0,22
146573,1251575,1,3,4,0,0,22
146574,1251575,1,3,5,6,0,28
146575,1251575,1,3,6,0,0,28
146576,1251575,1,4,1,0,0,28
146577,1251575,1,4,2,1,0,29
146578,1251575,1,4,3,0,0,29
146579,1251575,1,4,4,1,0,30
146580,1251575,1,4,5,1,0,31
146581,1251575,1,4,6,0,1,31
146582,1251575,1,5,1,1,0,32
146583,1251575,1,5,2,4,0,36
146584,1251575,1,5,3,0,0,36
146585,1251575,1,5,4,0,1,36
146586,1251575,1,5,5,0,0,36
146587,1251575,1,5,6,1,0,37
146588,1251575,1,6,1,1,0,38
146589,1251575,1,6,2,1,0,39
146590,1251575,1,6,3,4,0,43
146591,1251575,1,6,4,0,0,43
146592,1251575,1,6,5,4,0,47
146593,1251575,1,6,6,1,0,48
146594,1251575,1,7,1,1,0,49
146595,1251575,1,7,2,0,0,49
146596,1251575,1,7,3,1,0,50
146597,1251575,1,7,4,0,0,50
146598,1251575,1,7,5,4,0,54
146599,1251575,1,7,6,1,0,55
146600,1251575,1,8,1,4,0,59
146601,1251575,1,8,2,4,0,63
146602,1251575,1,8,3,0,0,63
146603,1251575,1,8,4,1,0,64
146604,1251575,1,8,5,2,0,66
146605,1251575,1,8,6,1,0,67
146606,1251575,1,9,1,6,0,73
146607,1251575,1,9,2,1,0,74
146608,1251575,1,9,3,4,0,78
146609,1251575,1,9,4,0,0,78
146610,1251575,1,9,5,6,0,84
146611,1251575,1,9,6,1,0,85
146612,1251575,1,10,1,4,0,89
146613,1251575,1,10,2,1,0,90
146614,1251575,1,10,3,0,0,90
146615,1251575,1,10,4,6,0,96
146616,1251575,1,10,5,1,0,97
146617,1251575,1,10,6,1,0,98
146618,1251575,1,11,1,0,1,98
146619,1251575,1,11,2,1,0,99
146620,1251575,1,11,3,1,0,100
146621,1251575,1,11,4,1,0,101
146622,1251575,1,11,5,1,0,102
146623,1251575,1,11,6,0,0,102
146624,1251575,1,12,1,4,0,106
146625,1251575,1,12,2,2,0,108
146626,1251575,1,12,3,6,0,114
146627,1251575,1,12,4,0,0,114
146628,1251575,1,12,5,1,0,115
146629,1251575,1,12,6,1,0,116
146630,1251575,1,13,1,1,0,117
146631,1251575,1,13,2,4,0,121
146632,1251575,1,13,3,1,0,122
146633,1251575,1,13,4,0,0,122
146634,1251575,1,13,5,6,0,128
146635,1251575,1,13,6,1,0,129
146636,1251575,1,14,1,1,0,130
146637,1251575,1,14,2,1,0,131
146638,1251575,1,14,3,6,0,137
146639,1251575,1,14,4,1,0,138
146640,1251575,1,14,5,1,0,139
146641,1251575,1,14,6,1,0,140
146642,1251575,1,15,1,1,0,141
146643,1251575,1,15,2,1,0,142
146644,1251575,1,15,3,1,0,143
146645,1251575,1,15,4,6,0,149
146646,1251575,1,15,5,2,0,151
146647,1251575,1,15,6,0,0,151
146648,1251575,1,16,1,2,0,153
146649,1251575,1,16,2,2,0,155
146650,1251575,1,16,3,1,0,156
146651,1251575,1,16,4,1,0,157
146652,1251575,1,16,5,2,0,159
146653,1251575,1,16,6,0,0,159
146654,1251575,1,17,1,0,0,159
146655,1251575,1,17,2,0,1,159
146656,1251575,1,17,3,1,0,160
146657,1251575,1,17,4,1,0,161
146658,1251575,1,17,5,1,0,162
146659,1251575,1,17,6,1,0,163
146660,1251575,1,18,1,1,0,164
146661,1251575,1,18,2,2,0,166
146662,1251575,1,18,3,1,0,167
146663,1251575,1,18,4,1,0,168
146664,1251575,1,18,5,0,1,168
146665,1251575,1,18,6,1,0,169
146666,1251575,1,19,1,1,0,170
146667,1251575,1,19,2,1,0,171
146668,1251575,1,19,3,0,1,171
146669,1251575,1,19,4,1,0,172
146670,1251575,1,19,5,1,0,173
146671,1251575,1,19,6,1,0,174
146672,1251575,1,20,1,1,0,175
146673,1251575,1,20,2,2,0,177
146674,1251575,1,20,3,4,0,181
146675,1251575,1,20,4,1,0,182
146676,1251575,1,20,5,0,0,182
146677,1251575,1,20,6,6,0,188
146797,1251576,1,1,1,0,1,0
146798,1251576,1,1,2,0,0,0
146799,1251576,1,1,3,0,0,0
146800,1251576,1,1,4,0,0,0
146801,1251576,1,1,5,6,0,6
146802,1251576,1,1,6,1,0,7
146803,1251576,1,2,1,0,0,7
146804,1251576,1,2,2,1,0,8
146805,1251576,1,2,3,1,0,9
146806,1251576,1,2,4,0,0,9
146807,1251576,1,2,5,0,0,9
146808,1251576,1,2,6,0,0,9
146809,1251576,1,3,1,0,0,9
146810,1251576,1,3,2,0,0,9
146811,1251576,1,3,3,1,0,10
146812,1251576,1,3,4,0,0,10
146813,1251576,1,3,5,0,1,10
146814,1251576,1,3,6,1,0,11
146815,1251576,1,4,1,0,0,11
146816,1251576,1,4,2,0,0,11
146817,1251576,1,4,3,1,0,12
146818,1251576,1,4,4,0,0,12
146819,1251576,1,4,5,4,0,16
146820,1251576,1,4,6,1,0,17
146821,1251576,1,5,1,0,0,17
146822,1251576,1,5,2,4,0,21
146823,1251576,1,5,3,1,0,22
146824,1251576,1,5,4,2,0,24
146825,1251576,1,5,5,0,0,24
146826,1251576,1,5,6,0,0,24
146827,1251576,1,6,1,1,0,25
146828,1251576,1,6,2,1,0,26
146829,1251576,1,6,3,4,0,30
146830,1251576,1,6,4,1,0,31
146831,1251576,1,6,5,0,0,31
146832,1251576,1,6,6,4,0,35
146833,1251576,1,7,1,4,0,39
146834,1251576,1,7,2,1,0,40
146835,1251576,1,7,3,1,0,41
146836,1251576,1,7,4,1,0,42
146837,1251576,1,7,5,0,0,42
146838,1251576,1,7,6,4,0,46
146839,1251576,1,8,1,1,0,47
146840,1251576,1,8,2,1,0,48
146841,1251576,1,8,3,1,0,49
146842,1251576,1,8,4,4,0,53
146843,1251576,1,8,5,1,0,54
146844,1251576,1,8,6,1,0,55
146845,1251576,1,9,1,1,0,56
146846,1251576,1,9,2,1,0,57
146847,1251576,1,9,3,2,0,59
146848,1251576,1,9,4,0,0,59
146849,1251576,1,9,5,0,0,59
146850,1251576,1,9,6,1,0,60
146851,1251576,1,10,1,0,0,60
146852,1251576,1,10,2,0,0,60
146853,1251576,1,10,3,1,0,61
146854,1251576,1,10,4,4,0,65
146855,1251576,1,10,5,0,0,65
146856,1251576,1,10,6,0,0,65
146857,1251576,1,11,1,0,0,65
146858,1251576,1,11,2,1,0,66
146859,1251576,1,11,3,1,0,67
146860,1251576,1,11,4,1,0,68
146861,1251576,1,11,5,0,1,68
146862,1251576,1,11,6,4,0,72
146863,1251576,1,12,1,9,0,81
146864,1251576,1,12,2,2,0,83
146865,1251576,1,12,3,2,0,85
146866,1251576,1,12,4,0,0,85
146867,1251576,1,12,5,4,0,89
146868,1251576,1,12,6,1,0,90
146869,1251576,1,13,1,0,0,90
146870,1251576,1,13,2,0,0,90
146871,1251576,1,13,3,1,0,91
146872,1251576,1,13,4,1,0,92
146873,1251576,1,13,5,0,1,92
146874,1251576,1,13,6,1,0,93
146875,1251576,1,14,1,4,0,97
146876,1251576,1,14,2,0,0,97
146877,1251576,1,14,3,1,0,98
146878,1251576,1,14,4,0,0,98
146879,1251576,1,14,5,1,0,99
146880,1251576,1,14,6,0,0,99
146881,1251576,1,15,1,1,0,100
146882,1251576,1,15,2,1,0,101
146883,1251576,1,15,3,0,0,101
146884,1251576,1,15,4,0,0,101
146885,1251576,1,15,5,1,0,102
146886,1251576,1,15,6,0,0,102
146887,1251576,1,16,1,1,0,103
146888,1251576,1,16,2,1,0,104
146889,1251576,1,16,3,0,0,104
146890,1251576,1,16,4,1,0,105
146891,1251576,1,16,5,4,0,109
146892,1251576,1,16,6,1,0,110
146893,1251576,1,17,1,1,0,111
146894,1251576,1,17,2,0,1,111
146895,1251576,1,17,3,1,0,112
146896,1251576,1,17,4,6,0,118
146897,1251576,1,17,5,6,0,124
146898,1251576,1,17,6,0,1,124
146899,1251576,1,18,1,1,0,125
146900,1251576,1,18,2,1,0,126
146901,1251576,1,18,3,1,0,127
146902,1251576,1,18,4,1,0,128
146903,1251576,1,18,5,0,1,128
146904,1251576,1,18,6,0,0,128
146905,1251576,1,19,1,0,1,128
146906,1251576,1,19,2,1,0,129
146907,1251576,1,19,3,0,0,129
146908,1251576,1,19,4,1,0,130
146909,1251576,1,19,5,1,0,131
146910,1251576,1,19,6,4,0,135
146911,1251576,1,20,1,2,0,137
146912,1251576,1,20,2,1,0,138
146913,1251576,1,20,3,1,0,139
146914,1251576,1,20,4,0,1,139
146915,1251576,1,20,5,0,0,139
146916,1251576,1,20,6,1,0,140
147001,1251577,1,1,1,0,0,0
147002,1251577,1,1,2,0,0,0
147003,1251577,1,1,3,0,0,0
147004,1251577,1,1,4,1,0,1
147005,1251577,1,1,5,0,0,1
147006,1251577,1,1,6,1,0,2
147007,1251577,1,2,1,0,0,2
147008,1251577,1,2,2,1,0,3
147009,1251577,1,2,3,1,0,4
147010,1251577,1,2,4,0,0,4
147011,1251577,1,2,5,0,0,4
147012,1251577,1,2,6,6,0,10
147013,1251577,1,3,1,1,0,11
147014,1251577,1,3,2,1,0,12
147015,1251577,1,3,3,5,0,17
147016,1251577,1,3,4,6,0,23
147017,1251577,1,3,5,0,0,23
147018,1251577,1,3,6,1,0,24
147019,1251577,1,4,1,1,0,25
147020,1251577,1,4,2,1,0,26
147021,1251577,1,4,3,6,0,32
147022,1251577,1,4,4,0,0,32
147023,1251577,1,4,5,1,0,33
147024,1251577,1,4,6,0,0,33
147025,1251577,1,5,1,1,0,34
147026,1251577,1,5,2,0,0,34
147027,1251577,1,5,3,4,0,38
147028,1251577,1,5,4,4,0,42
147029,1251577,1,5,5,6,0,48
147030,1251577,1,5,6,4,0,52
147031,1251577,1,6,1,1,0,53
147032,1251577,1,6,2,6,0,59
147033,1251577,1,6,3,1,0,60
147034,1251577,1,6,4,4,0,64
147035,1251577,1,6,5,0,0,64
147036,1251577,1,6,6,1,0,65
147037,1251577,1,7,1,1,0,66
147038,1251577,1,7,2,1,0,67
147039,1251577,1,7,3,2,0,69
147040,1251577,1,7,4,0,0,69
147041,1251577,1,7,5,2,0,71
147042,1251577,1,7,6,1,0,72
147043,1251577,1,8,1,0,0,72
147044,1251577,1,8,2,0,0,72
147045,1251577,1,8,3,1,0,73
147046,1251577,1,8,4,1,0,74
147047,1251577,1,8,5,1,0,75
147048,1251577,1,8,6,1,0,76
147049,1251577,1,9,1,1,0,77
147050,1251577,1,9,2,1,0,78
147051,1251577,1,9,3,4,0,82
147052,1251577,1,9,4,2,0,84
147053,1251577,1,9,5,1,0,85
147054,1251577,1,9,6,4,0,89
147055,1251577,1,10,1,4,0,93
147056,1251577,1,10,2,1,0,94
147057,1251577,1,10,3,0,0,94
147058,1251577,1,10,4,1,0,95
147059,1251577,1,10,5,4,0,99
147060,1251577,1,10,6,1,0,100
147061,1251577,1,11,1,6,0,106
147062,1251577,1,11,2,1,0,107
147063,1251577,1,11,3,1,0,108
147064,1251577,1,11,4,0,1,108
147065,1251577,1,11,5,2,0,110
147066,1251577,1,11,6,6,0,116
147067,1251577,1,12,1,4,0,120
147068,1251577,1,12,2,1,0,121
147069,1251577,1,12,3,0,0,121
147070,1251577,1,12,4,4,0,125
147071,1251577,1,12,5,1,0,126
147072,1251577,1,12,6,4,0,130
147073,1251577,1,13,1,2,0,132
147074,1251577,1,13,2,0,0,132
147075,1251577,1,13,3,0,0,132
147076,1251577,1,13,4,1,0,133
147077,1251577,1,13,5,1,0,134
147078,1251577,1,13,6,6,0,140
147079,1251577,1,14,1,1,0,141
147080,1251577,1,14,2,0,1,141
147081,1251577,1,14,3,1,0,142
147082,1251577,1,14,4,1,0,143
147083,1251577,1,14,5,0,0,143
147084,1251577,1,14,6,0,0,143
147085,1251577,1,15,1,0,1,143
147086,1251577,1,15,2,1,0,144
147087,1251577,1,15,3,2,0,146
147088,1251577,1,15,4,1,0,147
147089,1251577,1,15,5,1,0,148
147090,1251577,1,15,6,0,0,148
147091,1251577,1,16,1,1,0,149
147092,1251577,1,16,2,1,0,150
147093,1251577,1,16,3,1,0,151
147094,1251577,1,16,4,4,0,155
147095,1251577,1,16,5,1,0,156
147096,1251577,1,16,6,2,0,158
147097,1251577,1,17,1,4,0,162
147098,1251577,1,17,2,2,0,164
147099,1251577,1,17,3,0,0,164
147100,1251577,1,17,4,0,1,164
147101,1251577,1,17,5,1,0,165
147102,1251577,1,17,6,1,0,166
147103,1251577,1,18,1,2,0,168
147104,1251577,1,18,2,6,0,174
147105,1251577,1,18,3,1,0,175
147106,1251577,1,18,4,1,0,176
147107,1251577,1,18,5,4,0,180
147108,1251577,1,18,6,1,0,181
147109,1251577,1,19,1,2,0,183
147110,1251577,1,19,2,1,0,184
147111,1251577,1,19,3,1,0,185
147112,1251577,1,19,4,6,0,191
147113,1251577,1,19,5,1,0,192
147114,1251577,1,19,6,2,0,194
147115,1251577,1,20,1,1,0,195
147116,1251577,1,20,2,4,0,199
147117,1251577,1,20,3,1,0,200
147118,1251577,1,20,4,1,0,201
147119,1251577,1,20,5,2,0,203
147120,1251577,1,20,6,0,1,203
147229,1251578,1,1,1,0,0,0
147230,1251578,1,1,2,0,0,0
147231,1251578,1,1,3,0,0,0
147232,1251578,1,1,4,0,0,0
147233,1251578,1,1,5,0,0,0
147234,1251578,1,1,6,4,0,4
147235,1251578,1,2,1,0,0,4
147236,1251578,1,2,2,6,0,10
147237,1251578,1,2,3,4,0,14
147238,1251578,1,2,4,1,0,15
147239,1251578,1,2,5,1,0,16
147240,1251578,1,2,6,0,1,16
147241,1251578,1,3,1,0,0,16
147242,1251578,1,3,2,1,0,17
147243,1251578,1,3,3,1,0,18
147244,1251578,1,3,4,4,0,22
147245,1251578,1,3,5,0,0,22
147246,1251578,1,3,6,1,0,23
147247,1251578,1,4,1,0,0,23
147248,1251578,1,4,2,6,0,29
147249,1251578,1,4,3,1,0,30
147250,1251578,1,4,4,0,0,30
147251,1251578,1,4,5,0,0,30
147252,1251578,1,4,6,0,0,30
147253,1251578,1,5,1,0,0,30
147254,1251578,1,5,2,4,0,34
147255,1251578,1,5,3,0,0,34
147256,1251578,1,5,4,1,0,35
147257,1251578,1,5,5,0,0,35
147258,1251578,1,5,6,1,0,36
147259,1251578,1,6,1,9,0,45
147260,1251578,1,6,2,0,0,45
147261,1251578,1,6,3,1,0,46
147262,1251578,1,6,4,1,0,47
147263,1251578,1,6,5,4,0,51
147264,1251578,1,6,6,2,0,53
147265,1251578,1,7,1,1,0,54
147266,1251578,1,7,2,0,0,54
147267,1251578,1,7,3,1,0,55
147268,1251578,1,7,4,1,0,56
147269,1251578,1,7,5,4,0,60
147270,1251578,1,7,6,4,0,64
147271,1251578,1,8,1,2,0,66
147272,1251578,1,8,2,1,0,67
147273,1251578,1,8,3,0,0,67
147274,1251578,1,8,4,1,0,68
147275,1251578,1,8,5,2,0,70
147276,1251578,1,8,6,1,0,71
147277,1251578,1,9,1,1,0,72
147278,1251578,1,9,2,1,0,73
147279,1251578,1,9,3,0,1,73
147280,1251578,1,9,4,1,0,74
147281,1251578,1,9,5,1,0,75
147282,1251578,1,9,6,0,0,75
147283,1251578,1,10,1,0,0,75
147284,1251578,1,10,2,6,0,81
147285,1251578,1,10,3,1,0,82
147286,1251578,1,10,4,1,0,83
147287,1251578,1,10,5,1,0,84
147288,1251578,1,10,6,1,0,85
147289,1251578,1,11,1,0,0,85
147290,1251578,1,11,2,0,0,85
147291,1251578,1,11,3,1,0,86
147292,1251578,1,11,4,0,0,86
147293,1251578,1,11,5,1,0,87
147294,1251578,1,11,6,0,0,87
147295,1251578,1,12,1,1,0,88
147296,1251578,1,12,2,0,0,88
147297,1251578,1,12,3,4,0,92
147298,1251578,1,12,4,1,0,93
147299,1251578,1,12,5,6,0,99
147300,1251578,1,12,6,1,0,100
147301,1251578,1,13,1,4,0,104
147302,1251578,1,13,2,2,0,106
147303,1251578,1,13,3,2,0,108
147304,1251578,1,13,4,1,0,109
147305,1251578,1,13,5,0,1,109
147306,1251578,1,13,6,1,0,110
147307,1251578,1,14,1,1,0,111
147308,1251578,1,14,2,1,0,112
147309,1251578,1,14,3,0,1,112
147310,1251578,1,14,4,1,0,113
147311,1251578,1,14,5,0,0,113
147312,1251578,1,14,6,1,0,114
147313,1251578,1,15,1,2,0,116
147314,1251578,1,15,2,0,0,116
147315,1251578,1,15,3,1,0,117
147316,1251578,1,15,4,1,0,118
147317,1251578,1,15,5,1,0,119
147318,1251578,1,15,6,0,1,119
147319,1251578,1,16,1,0,0,119
147320,1251578,1,16,2,1,0,120
147321,1251578,1,16,3,1,0,121
147322,1251578,1,16,4,0,1,121
147323,1251578,1,16,5,1,1,122
147324,1251578,1,16,6,1,0,123
147325,1251578,1,17,1,4,0,127
147326,1251578,1,17,2,1,0,128
147327,1251578,1,17,3,1,0,129
147328,1251578,1,17,4,1,0,130
147329,1251578,1,17,5,0,0,130
147330,1251578,1,17,6,0,0,130
147331,1251578,1,18,1,1,0,131
147332,1251578,1,18,2,4,0,135
147333,1251578,1,18,3,6,0,141
147334,1251578,1,18,4,0,0,141
147335,1251578,1,18,5,0,0,141
147336,1251578,1,18,6,0,1,141
147337,1251578,1,19,1,0,0,141
147338,1251578,1,19,2,1,0,142
147339,1251578,1,19,3,0,1,142
147340,1251578,1,19,4,0,0,142
147341,1251578,1,19,5,1,0,143
147342,1251578,1,19,6,0,0,143
147343,1251578,1,20,1,1,0,144
147344,1251578,1,20,2,0,0,144
147345,1251578,1,20,3,0,1,144
147465,1251953,1,1,1,0,0,0
147466,1251953,1,1,2,4,0,4
147467,1251953,1,1,3,1,0,5
147468,1251953,1,1,4,1,0,6
147469,1251953,1,1,5,4,0,10
147470,1251953,1,1,6,1,0,11
147471,1251953,1,2,1,0,0,11
147472,1251953,1,2,2,1,0,12
147473,1251953,1,2,3,4,0,16
147474,1251953,1,2,4,0,0,16
147475,1251953,1,2,5,6,0,22
147476,1251953,1,2,6,1,0,23
147477,1251953,1,3,1,4,0,27
147478,1251953,1,3,2,4,0,31
147479,1251953,1,3,3,0,0,31
147480,1251953,1,3,4,0,1,31
147481,1251953,1,3,5,1,0,32
147482,1251953,1,3,6,1,0,33
147483,1251953,1,4,1,0,0,33
147484,1251953,1,4,2,1,0,34
147485,1251953,1,4,3,2,0,36
147486,1251953,1,4,4,1,0,37
147487,1251953,1,4,5,0,0,37
147488,1251953,1,4,6,0,0,37
147489,1251953,1,5,1,0,0,37
147490,1251953,1,5,2,0,1,37
147491,1251953,1,5,3,0,0,37
147492,1251953,1,5,4,1,0,38
147493,1251953,1,5,5,0,0,38
147494,1251953,1,5,6,6,0,44
147495,1251953,1,6,1,0,1,44
147496,1251953,1,6,2,1,0,45
147497,1251953,1,6,3,0,0,45
147498,1251953,1,6,4,1,0,46
147499,1251953,1,6,5,2,0,48
147500,1251953,1,6,6,0,0,48
147501,1251953,1,7,1,0,0,48
147502,1251953,1,7,2,1,0,49
147503,1251953,1,7,3,1,0,50
147504,1251953,1,7,4,1,0,51
147505,1251953,1,7,5,0,0,51
147506,1251953,1,7,6,1,0,52
147507,1251953,1,8,1,1,0,53
147508,1251953,1,8,2,1,0,54
147509,1251953,1,8,3,1,0,55
147510,1251953,1,8,4,0,0,55
147511,1251953,1,8,5,1,0,56
147512,1251953,1,8,6,1,0,57
147513,1251953,1,9,1,0,0,57
147514,1251953,1,9,2,1,0,58
147515,1251953,1,9,3,1,0,59
147516,1251953,1,9,4,1,0,60
147517,1251953,1,9,5,0,0,60
147518,1251953,1,9,6,1,0,61
147519,1251953,1,10,1,1,0,62
147520,1251953,1,10,2,1,0,63
147521,1251953,1,10,3,1,0,64
147522,1251953,1,10,4,4,0,68
147523,1251953,1,10,5,6,0,74
147524,1251953,1,10,6,1,0,75
147525,1251953,1,11,1,4,0,79
147526,1251953,1,11,2,0,1,79
147527,1251953,1,11,3,1,0,80
147528,1251953,1,11,4,1,0,81
147529,1251953,1,11,5,1,0,82
147530,1251953,1,11,6,1,0,83
147531,1251953,1,12,1,1,0,84
147532,1251953,1,12,2,1,0,85
147533,1251953,1,12,3,1,0,86
147534,1251953,1,12,4,1,0,87
147535,1251953,1,12,5,1,0,88
147536,1251953,1,12,6,1,0,89
147537,1251953,1,13,1,1,0,90
147538,1251953,1,13,2,1,0,91
147539,1251953,1,13,3,4,0,95
147540,1251953,1,13,4,4,0,99
147541,1251953,1,13,5,1,0,100
147542,1251953,1,13,6,4,0,104
147543,1251953,1,14,1,2,0,106
147544,1251953,1,14,2,6,0,112
147545,1251953,1,14,3,1,0,113
147546,1251953,1,14,4,0,0,113
147547,1251953,1,14,5,1,0,114
147548,1251953,1,14,6,1,0,115
147549,1251953,1,15,1,0,1,115
147550,1251953,1,15,2,4,0,119
147551,1251953,1,15,3,0,0,119
147552,1251953,1,15,4,0,0,119
147553,1251953,1,15,5,0,0,119
147554,1251953,1,15,6,1,0,120
147555,1251953,1,16,1,2,0,122
147556,1251953,1,16,2,1,0,123
147557,1251953,1,16,3,0,0,123
147558,1251953,1,16,4,1,0,124
147559,1251953,1,16,5,2,0,126
147560,1251953,1,16,6,1,0,127
147561,1251953,1,17,1,1,0,128
147562,1251953,1,17,2,1,0,129
147563,1251953,1,17,3,4,0,133
147564,1251953,1,17,4,4,0,137
147565,1251953,1,17,5,1,0,138
147566,1251953,1,17,6,1,0,139
147567,1251953,1,18,1,1,0,140
147568,1251953,1,18,2,1,0,141
147569,1251953,1,18,3,1,0,142
147570,1251953,1,18,4,1,0,143
147571,1251953,1,18,5,0,1,143
147572,1251953,1,18,6,1,0,144
147573,1251953,1,19,1,0,1,144
147574,1251953,1,19,2,1,0,145
147575,1251953,1,19,3,0,0,145
147576,1251953,1,19,4,1,0,146
147577,1251953,1,19,5,1,0,147
147578,1251953,1,19,6,1,0,148
147579,1251953,1,20,1,4,0,152
147580,1251953,1,20,2,4,0,156
147581,1251953,1,20,3,4,0,160
147582,1251953,1,20,4,4,0,164
147583,1251953,1,20,5,0,0,164
147584,1251953,1,20,6,1,0,165
147705,1251954,1,1,1,0,0,0
147706,1251954,1,1,2,0,1,0
147707,1251954,1,1,3,0,0,0
147708,1251954,1,1,4,0,1,0
147709,1251954,1,1,5,1,0,1
147710,1251954,1,1,6,1,0,2
147711,1251954,1,2,1,2,0,4
147712,1251954,1,2,2,1,0,5
147713,1251954,1,2,3,0,0,5
147714,1251954,1,2,4,4,0,9
147715,1251954,1,2,5,4,0,13
147716,1251954,1,2,6,1,0,14
147717,1251954,1,3,1,2,0,16
147718,1251954,1,3,2,1,0,17
147719,1251954,1,3,3,1,0,18
147720,1251954,1,3,4,0,0,18
147721,1251954,1,3,5,0,0,18
147722,1251954,1,3,6,0,0,18
147723,1251954,1,4,1,2,0,20
147724,1251954,1,4,2,4,0,24
147725,1251954,1,4,3,0,1,24
147726,1251954,1,4,4,0,0,24
147727,1251954,1,4,5,0,0,24
147728,1251954,1,4,6,0,0,24
147729,1251954,1,5,1,0,0,24
147730,1251954,1,5,2,0,0,24
147731,1251954,1,5,3,4,0,28
147732,1251954,1,5,4,4,0,32
147733,1251954,1,5,5,0,0,32
147734,1251954,1,5,6,4,0,36
147735,1251954,1,6,1,0,0,36
147736,1251954,1,6,2,1,0,37
147737,1251954,1,6,3,0,0,37
147738,1251954,1,6,4,1,0,38
147739,1251954,1,6,5,0,0,38
147740,1251954,1,6,6,0,0,38
147741,1251954,1,7,1,0,1,38
147742,1251954,1,7,2,0,0,38
147743,1251954,1,7,3,0,0,38
147744,1251954,1,7,4,1,0,39
147745,1251954,1,7,5,1,0,40
147746,1251954,1,7,6,1,0,41
147747,1251954,1,8,1,2,0,43
147748,1251954,1,8,2,1,0,44
147749,1251954,1,8,3,1,0,45
147750,1251954,1,8,4,4,0,49
147751,1251954,1,8,5,1,0,50
147752,1251954,1,8,6,0,0,50
147753,1251954,1,9,1,1,0,51
147754,1251954,1,9,2,1,0,52
147755,1251954,1,9,3,1,0,53
147756,1251954,1,9,4,1,0,54
147757,1251954,1,9,5,2,0,56
147758,1251954,1,9,6,0,0,56
147759,1251954,1,10,1,1,0,57
147760,1251954,1,10,2,0,0,57
147761,1251954,1,10,3,0,0,57
147762,1251954,1,10,4,1,0,58
147763,1251954,1,10,5,0,0,58
147764,1251954,1,10,6,0,1,58
147765,1251954,1,11,1,1,0,59
147766,1251954,1,11,2,1,0,60
147767,1251954,1,11,3,0,0,60
147768,1251954,1,11,4,2,0,62
147769,1251954,1,11,5,1,0,63
147770,1251954,1,11,6,1,0,64
147771,1251954,1,12,1,0,0,64
147772,1251954,1,12,2,0,0,64
147773,1251954,1,12,3,2,0,66
147774,1251954,1,12,4,0,0,66
147775,1251954,1,12,5,1,0,67
147776,1251954,1,12,6,1,0,68
147777,1251954,1,13,1,1,0,69
147778,1251954,1,13,2,1,0,70
147779,1251954,1,13,3,1,0,71
147780,1251954,1,13,4,0,0,71
147781,1251954,1,13,5,1,0,72
147782,1251954,1,13,6,4,0,76
147783,1251954,1,14,1,1,0,77
147784,1251954,1,14,2,0,0,77
147785,1251954,1,14,3,1,0,78
147786,1251954,1,14,4,1,0,79
147787,1251954,1,14,5,1,0,80
147788,1251954,1,14,6,2,0,82
147789,1251954,1,15,1,1,0,83
147790,1251954,1,15,2,1,0,84
147791,1251954,1,15,3,1,0,85
147792,1251954,1,15,4,0,0,85
147793,1251954,1,15,5,0,0,85
147794,1251954,1,15,6,6,0,91
147795,1251954,1,16,1,1,0,92
147796,1251954,1,16,2,1,0,93
147797,1251954,1,16,3,4,0,97
147798,1251954,1,16,4,1,0,98
147799,1251954,1,16,5,4,0,102
147800,1251954,1,16,6,1,0,103
147801,1251954,1,17,1,6,0,109
147802,1251954,1,17,2,4,0,113
147803,1251954,1,17,3,1,0,114
147804,1251954,1,17,4,1,0,115
147805,1251954,1,17,5,0,0,115
147806,1251954,1,17,6,1,0,116
147807,1251954,1,18,1,0,1,116
147808,1251954,1,18,2,4,0,120
147809,1251954,1,18,3,1,0,121
147810,1251954,1,18,4,1,0,122
147811,1251954,1,18,5,1,0,123
147812,1251954,1,18,6,0,0,123
147813,1251954,1,19,1,6,0,129
147814,1251954,1,19,2,1,0,130
147815,1251954,1,19,3,4,0,134
147816,1251954,1,19,4,0,1,134
147817,1251954,1,19,5,1,0,135
147818,1251954,1,19,6,0,0,135
147819,1251954,1,20,1,6,0,141
147820,1251954,1,20,2,0,0,141
147821,1251954,1,20,3,0,0,141
147822,1251954,1,20,4,6,0,147
147823,1251954,1,20,5,6,0,153
147824,1251954,1,20,6,6,0,159
147942,1251955,1,1,1,0,0,0
147943,1251955,1,1,2,1,0,1
147944,1251955,1,1,3,0,0,1
147945,1251955,1,1,4,0,0,1
147946,1251955,1,1,5,1,0,2
147947,1251955,1,1,6,0,0,2
147948,1251955,1,2,1,0,0,2
147949,1251955,1,2,2,2,0,4
147950,1251955,1,2,3,2,0,6
147951,1251955,1,2,4,1,0,7
147952,1251955,1,2,5,1,0,8
147953,1251955,1,2,6,0,0,8
147954,1251955,1,3,1,0,0,8
147955,1251955,1,3,2,1,0,9
147956,1251955,1,3,3,1,0,10
147957,1251955,1,3,4,4,0,14
147958,1251955,1,3,5,1,0,15
147959,1251955,1,3,6,1,0,16
147960,1251955,1,4,1,0,0,16
147961,1251955,1,4,2,4,0,20
147962,1251955,1,4,3,0,0,20
147963,1251955,1,4,4,1,0,21
147964,1251955,1,4,5,1,0,22
147965,1251955,1,4,6,1,0,23
147966,1251955,1,5,1,1,0,24
147967,1251955,1,5,2,4,0,28
147968,1251955,1,5,3,0,0,28
147969,1251955,1,5,4,1,0,29
147970,1251955,1,5,5,1,0,30
147971,1251955,1,5,6,1,0,31
147972,1251955,1,6,1,1,0,32
147973,1251955,1,6,2,1,0,33
147974,1251955,1,6,3,1,0,34
147975,1251955,1,6,4,0,0,34
147976,1251955,1,6,5,0,0,34
147977,1251955,1,6,6,1,0,35
147978,1251955,1,7,1,1,0,36
147979,1251955,1,7,2,1,0,37
147980,1251955,1,7,3,6,0,43
147981,1251955,1,7,4,1,0,44
147982,1251955,1,7,5,1,0,45
147983,1251955,1,7,6,0,0,45
147984,1251955,1,8,1,2,0,47
147985,1251955,1,8,2,1,0,48
147986,1251955,1,8,3,4,0,52
147987,1251955,1,8,4,1,0,53
147988,1251955,1,8,5,2,0,55
147989,1251955,1,8,6,0,0,55
147990,1251955,1,9,1,0,0,55
147991,1251955,1,9,2,0,0,55
147992,1251955,1,9,3,2,0,57
147993,1251955,1,9,4,1,0,58
147994,1251955,1,9,5,0,0,58
147995,1251955,1,9,6,1,0,59
147996,1251955,1,10,1,1,0,60
147997,1251955,1,10,2,1,0,61
147998,1251955,1,10,3,0,0,61
147999,1251955,1,10,4,1,0,62
148000,1251955,1,10,5,1,0,63
148001,1251955,1,10,6,0,0,63
148002,1251955,1,11,1,1,0,64
148003,1251955,1,11,2,1,0,65
148004,1251955,1,11,3,1,0,66
148005,1251955,1,11,4,6,0,72
148006,1251955,1,11,5,1,0,73
148007,1251955,1,11,6,1,0,74
148008,1251955,1,12,1,1,0,75
148009,1251955,1,12,2,2,0,77
148010,1251955,1,12,3,1,0,78
148011,1251955,1,12,4,4,0,82
148012,1251955,1,12,5,1,0,83
148013,1251955,1,12,6,4,0,87
148014,1251955,1,13,1,1,0,88
148015,1251955,1,13,2,2,0,90
148016,1251955,1,13,3,1,0,91
148017,1251955,1,13,4,4,0,95
148018,1251955,1,13,5,1,0,96
148019,1251955,1,13,6,1,0,97
148020,1251955,1,14,1,4,0,101
148021,1251955,1,14,2,2,0,103
148022,1251955,1,14,3,1,0,104
148023,1251955,1,14,4,1,0,105
148024,1251955,1,14,5,4,0,109
148025,1251955,1,14,6,1,0,110
148026,1251955,1,15,1,1,0,111
148027,1251955,1,15,2,4,0,115
148028,1251955,1,15,3,1,0,116
148029,1251955,1,15,4,4,0,120
148030,1251955,1,15,5,1,0,121
148031,1251955,1,15,6,2,0,123
148032,1251955,1,16,1,4,0,127
148033,1251955,1,16,2,0,1,127
148034,1251955,1,16,3,0,0,127
148035,1251955,1,16,4,1,0,128
148036,1251955,1,16,5,1,0,129
148037,1251955,1,16,6,4,0,133
148038,1251955,1,17,1,2,0,135
148039,1251955,1,17,2,1,0,136
148040,1251955,1,17,3,4,0,140
148041,1251955,1,17,4,6,0,146
148042,1251955,1,17,5,1,0,147
148043,1251955,1,17,6,1,0,148
148044,1251955,1,18,1,4,0,152
148045,1251955,1,18,2,4,0,156
148046,1251955,1,18,3,1,0,157
148047,1251955,1,18,4,2,0,159
148048,1251955,1,18,5,0,1,159
148049,1251955,1,18,6,1,0,160
148050,1251955,1,19,1,2,0,162
148051,1251955,1,19,2,4,0,166
148052,1251955,1,19,3,1,0,167
148053,1251955,1,19,4,1,0,168
148054,1251955,1,19,5,2,0,170
148055,1251955,1,19,6,6,0,176
148056,1251955,1,20,1,4,0,180
148057,1251955,1,20,2,1,0,181
148058,1251955,1,20,3,2,0,183
148059,1251955,1,20,4,1,0,184
148060,1251955,1,20,5,1,0,185
148061,1251955,1,20,6,4,0,189
148182,1252058,1,1,1,0,0,0
148183,1252058,1,1,2,1,0,1
148184,1252058,1,1,3,0,0,1
148185,1252058,1,1,4,1,0,2
148186,1252058,1,1,5,4,0,6
148187,1252058,1,1,6,1,0,7
148188,1252058,1,2,1,0,0,7
148189,1252058,1,2,2,2,0,9
148190,1252058,1,2,3,7,0,16
148191,1252058,1,2,4,6,0,22
148192,1252058,1,2,5,0,0,22
148193,1252058,1,2,6,0,0,22
148194,1252058,1,3,1,2,0,24
148195,1252058,1,3,2,1,0,25
148196,1252058,1,3,3,5,0,30
148197,1252058,1,3,4,1,0,31
148198,1252058,1,3,5,0,0,31
148199,1252058,1,3,6,2,0,33
148200,1252058,1,4,1,4,0,37
148201,1252058,1,4,2,2,0,39
148202,1252058,1,4,3,4,0,43
148203,1252058,1,4,4,0,0,43
148204,1252058,1,4,5,0,0,43
148205,1252058,1,4,6,1,0,44
148206,1252058,1,5,1,4,0,48
148207,1252058,1,5,2,1,0,49
148208,1252058,1,5,3,4,0,53
148209,1252058,1,5,4,4,0,57
148210,1252058,1,5,5,0,0,57
148211,1252058,1,5,6,1,0,58
148212,1252058,1,6,1,1,0,59
148213,1252058,1,6,2,1,0,60
148214,1252058,1,6,3,4,0,64
148215,1252058,1,6,4,0,0,64
148216,1252058,1,6,5,2,0,66
148217,1252058,1,6,6,0,0,66
148218,1252058,1,7,1,5,0,71
148219,1252058,1,7,2,1,0,72
148220,1252058,1,7,3,0,0,72
148221,1252058,1,7,4,2,0,74
148222,1252058,1,7,5,1,0,75
148223,1252058,1,7,6,1,0,76
148224,1252058,1,8,1,1,0,77
148225,1252058,1,8,2,1,0,78
148226,1252058,1,8,3,0,0,78
148227,1252058,1,8,4,1,0,79
148228,1252058,1,8,5,1,0,80
148229,1252058,1,8,6,0,1,80
148230,1252058,1,9,1,1,0,81
148231,1252058,1,9,2,0,0,81
148232,1252058,1,9,3,0,0,81
148233,1252058,1,9,4,1,0,82
148234,1252058,1,9,5,6,0,88
148235,1252058,1,9,6,1,0,89
148236,1252058,1,10,1,6,0,95
148237,1252058,1,10,2,0,0,95
148238,1252058,1,10,3,1,0,96
148239,1252058,1,10,4,4,0,100
148240,1252058,1,10,5,7,0,107
148241,1252058,1,10,6,1,0,108
148242,1252058,1,11,1,2,0,110
148243,1252058,1,11,2,0,0,110
148244,1252058,1,11,3,6,0,116
148245,1252058,1,11,4,1,0,117
148246,1252058,1,11,5,0,0,117
148247,1252058,1,11,6,0,0,117
148248,1252058,1,12,1,6,0,123
148249,1252058,1,12,2,1,0,124
148250,1252058,1,12,3,1,0,125
148251,1252058,1,12,4,6,0,131
148252,1252058,1,12,5,1,0,132
148253,1252058,1,12,6,1,0,133
148254,1252058,1,13,1,0,0,133
148255,1252058,1,13,2,1,0,134
148256,1252058,1,13,3,0,0,134
148257,1252058,1,13,4,0,0,134
148258,1252058,1,13,5,3,0,137
148259,1252058,1,13,6,0,0,137
148260,1252058,1,14,1,4,0,141
148261,1252058,1,14,2,2,0,143
148262,1252058,1,14,3,5,0,148
148263,1252058,1,14,4,1,0,149
148264,1252058,1,14,5,1,0,150
148265,1252058,1,14,6,4,0,154
148266,1252058,1,15,1,0,0,154
148267,1252058,1,15,2,0,1,154
148268,1252058,1,15,3,0,0,154
148269,1252058,1,15,4,1,0,155
148270,1252058,1,15,5,0,0,155
148271,1252058,1,15,6,1,0,156
148272,1252058,1,16,1,1,0,157
148273,1252058,1,16,2,1,0,158
148274,1252058,1,16,3,4,0,162
148275,1252058,1,16,4,2,0,164
148276,1252058,1,16,5,1,0,165
148277,1252058,1,16,6,1,0,166
148278,1252058,1,17,1,2,0,168
148279,1252058,1,17,2,1,0,169
148280,1252058,1,17,3,1,0,170
148281,1252058,1,17,4,0,0,170
148282,1252058,1,17,5,1,0,171
148283,1252058,1,17,6,1,0,172
148284,1252058,1,18,1,1,0,173
148285,1252058,1,18,2,0,0,173
148286,1252058,1,18,3,4,0,177
148287,1252058,1,18,4,1,0,178
148288,1252058,1,18,5,0,0,178
148289,1252058,1,18,6,0,0,178
148290,1252058,1,19,1,0,0,178
148291,1252058,1,19,2,4,0,182
148292,1252058,1,19,3,1,0,183
148293,1252058,1,19,4,1,0,184
148294,1252058,1,19,5,1,0,185
148295,1252058,1,19,6,0,1,185
148296,1252058,1,20,1,1,0,186
148297,1252058,1,20,2,6,0,192
148298,1252058,1,20,3,0,1,192
148299,1252058,1,20,4,6,0,198
148300,1252058,1,20,5,0,1,198
148301,1252058,1,20,6,0,0,198
148422,1252059,1,1,1,0,0,0
148423,1252059,1,1,2,0,0,0
148424,1252059,1,1,3,4,0,4
148425,1252059,1,1,4,4,0,8
148426,1252059,1,1,5,0,0,8
148427,1252059,1,1,6,1,0,9
148428,1252059,1,2,1,0,0,9
148429,1252059,1,2,2,0,1,9
148430,1252059,1,2,3,0,0,9
148431,1252059,1,2,4,0,0,9
148432,1252059,1,2,5,1,0,10
148433,1252059,1,2,6,0,0,10
148434,1252059,1,3,1,0,0,10
148435,1252059,1,3,2,6,0,16
148436,1252059,1,3,3,0,0,16
148437,1252059,1,3,4,4,0,20
148438,1252059,1,3,5,1,0,21
148439,1252059,1,3,6,1,0,22
148440,1252059,1,4,1,0,0,22
148441,1252059,1,4,2,0,0,22
148442,1252059,1,4,3,4,0,26
148443,1252059,1,4,4,1,0,27
148444,1252059,1,4,5,0,0,27
148445,1252059,1,4,6,0,0,27
148446,1252059,1,5,1,0,0,27
148447,1252059,1,5,2,0,0,27
148448,1252059,1,5,3,0,0,27
148449,1252059,1,5,4,1,0,28
148450,1252059,1,5,5,0,0,28
148451,1252059,1,5,6,1,0,29
148452,1252059,1,6,1,6,0,35
148453,1252059,1,6,2,0,0,35
148454,1252059,1,6,3,4,0,39
148455,1252059,1,6,4,0,0,39
148456,1252059,1,6,5,4,0,43
148457,1252059,1,6,6,6,0,49
148458,1252059,1,7,1,3,0,52
148459,1252059,1,7,2,2,0,54
148460,1252059,1,7,3,1,0,55
148461,1252059,1,7,4,1,0,56
148462,1252059,1,7,5,1,0,57
148463,1252059,1,7,6,1,0,58
148464,1252059,1,8,1,1,0,59
148465,1252059,1,8,2,2,0,61
148466,1252059,1,8,3,0,0,61
148467,1252059,1,8,4,1,0,62
148468,1252059,1,8,5,7,0,69
148469,1252059,1,8,6,2,0,71
148470,1252059,1,9,1,0,0,71
148471,1252059,1,9,2,4,0,75
148472,1252059,1,9,3,0,0,75
148473,1252059,1,9,4,0,0,75
148474,1252059,1,9,5,1,0,76
148475,1252059,1,9,6,0,0,76
148476,1252059,1,10,1,6,0,82
148477,1252059,1,10,2,1,0,83
148478,1252059,1,10,3,1,0,84
148479,1252059,1,10,4,0,0,84
148480,1252059,1,10,5,0,0,84
148481,1252059,1,10,6,2,0,86
148482,1252059,1,11,1,0,0,86
148483,1252059,1,11,2,1,0,87
148484,1252059,1,11,3,1,0,88
148485,1252059,1,11,4,1,0,89
148486,1252059,1,11,5,4,0,93
148487,1252059,1,11,6,1,0,94
148488,1252059,1,12,1,6,0,100
148489,1252059,1,12,2,4,0,104
148490,1252059,1,12,3,1,0,105
148491,1252059,1,12,4,1,0,106
148492,1252059,1,12,5,5,0,111
148493,1252059,1,12,6,0,1,111
148494,1252059,1,13,1,1,0,112
148495,1252059,1,13,2,0,0,112
148496,1252059,1,13,3,1,0,113
148497,1252059,1,13,4,0,0,113
148498,1252059,1,13,5,0,0,113
148499,1252059,1,13,6,1,0,114
148500,1252059,1,14,1,1,0,115
148501,1252059,1,14,2,2,0,117
148502,1252059,1,14,3,0,0,117
148503,1252059,1,14,4,1,0,118
148504,1252059,1,14,5,0,0,118
148505,1252059,1,14,6,1,0,119
148506,1252059,1,15,1,0,1,119
148507,1252059,1,15,2,0,0,119
148508,1252059,1,15,3,2,0,121
148509,1252059,1,15,4,1,0,122
148510,1252059,1,15,5,0,0,122
148511,1252059,1,15,6,1,0,123
148512,1252059,1,16,1,1,0,124
148513,1252059,1,16,2,6,0,130
148514,1252059,1,16,3,6,0,136
148515,1252059,1,16,4,3,0,139
148516,1252059,1,16,5,1,0,140
148517,1252059,1,16,6,6,0,146
148518,1252059,1,17,1,2,0,148
148519,1252059,1,17,2,2,0,150
148520,1252059,1,17,3,0,0,150
148521,1252059,1,17,4,0,0,150
148522,1252059,1,17,5,4,0,154
148523,1252059,1,17,6,0,1,154
148524,1252059,1,18,1,0,0,154
148525,1252059,1,18,2,0,0,154
148526,1252059,1,18,3,4,0,158
148527,1252059,1,18,4,1,0,159
148528,1252059,1,18,5,1,0,160
148529,1252059,1,18,6,4,0,164
148530,1252059,1,19,1,1,0,165
148531,1252059,1,19,2,6,0,171
148532,1252059,1,19,3,0,1,171
148533,1252059,1,19,4,1,0,172
148534,1252059,1,19,5,2,0,174
148535,1252059,1,19,6,1,0,175
148536,1252059,1,20,1,6,0,181
148537,1252059,1,20,2,6,0,187
148538,1252059,1,20,3,0,0,187
148539,1252059,1,20,4,1,0,188
148540,1252059,1,20,5,4,0,192
148541,1252059,1,20,6,1,0,193
148645,1252060,1,1,1,0,0,0
148646,1252060,1,1,2,0,0,0
148647,1252060,1,1,3,0,0,0
148648,1252060,1,1,4,0,0,0
148649,1252060,1,1,5,0,0,0
148650,1252060,1,1,6,1,0,1
148651,1252060,1,2,1,0,0,1
148652,1252060,1,2,2,1,0,2
148653,1252060,1,2,3,0,0,2
148654,1252060,1,2,4,4,0,6
148655,1252060,1,2,5,4,0,10
148656,1252060,1,2,6,1,0,11
148657,1252060,1,3,1,1,0,12
148658,1252060,1,3,2,0,0,12
148659,1252060,1,3,3,4,0,16
148660,1252060,1,3,4,1,0,17
148661,1252060,1,3,5,1,0,18
148662,1252060,1,3,6,1,0,19
148663,1252060,1,4,1,4,0,23
148664,1252060,1,4,2,1,0,24
148665,1252060,1,4,3,0,0,24
148666,1252060,1,4,4,6,0,30
148667,1252060,1,4,5,0,0,30
148668,1252060,1,4,6,1,0,31
148669,1252060,1,5,1,0,0,31
148670,1252060,1,5,2,0,0,31
148671,1252060,1,5,3,1,0,32
148672,1252060,1,5,4,4,0,36
148673,1252060,1,5,5,1,0,37
148674,1252060,1,5,6,0,0,37
148675,1252060,1,6,1,4,0,41
148676,1252060,1,6,2,1,0,42
148677,1252060,1,6,3,0,1,42
148678,1252060,1,6,4,0,0,42
148679,1252060,1,6,5,1,0,43
148680,1252060,1,6,6,0,0,43
148681,1252060,1,7,1,1,0,44
148682,1252060,1,7,2,1,0,45
148683,1252060,1,7,3,1,0,46
148684,1252060,1,7,4,1,0,47
148685,1252060,1,7,5,1,0,48
148686,1252060,1,7,6,1,0,49
148687,1252060,1,8,1,0,0,49
148688,1252060,1,8,2,1,0,50
148689,1252060,1,8,3,1,0,51
148690,1252060,1,8,4,0,0,51
148691,1252060,1,8,5,0,0,51
148692,1252060,1,8,6,2,0,53
148693,1252060,1,9,1,1,0,54
148694,1252060,1,9,2,0,0,54
148695,1252060,1,9,3,0,0,54
148696,1252060,1,9,4,1,0,55
148697,1252060,1,9,5,1,0,56
148698,1252060,1,9,6,1,0,57
148699,1252060,1,10,1,1,0,58
148700,1252060,1,10,2,1,0,59
148701,1252060,1,10,3,1,0,60
148702,1252060,1,10,4,4,0,64
148703,1252060,1,10,5,4,0,68
148704,1252060,1,10,6,6,0,74
148705,1252060,1,11,1,1,0,75
148706,1252060,1,11,2,0,0,75
148707,1252060,1,11,3,0,1,75
148708,1252060,1,11,4,0,0,75
148709,1252060,1,11,5,1,0,76
148710,1252060,1,11,6,1,0,77
148711,1252060,1,12,1,6,0,83
148712,1252060,1,12,2,0,1,83
148713,1252060,1,12,3,0,0,83
148714,1252060,1,12,4,2,0,85
148715,1252060,1,12,5,0,0,85
148716,1252060,1,12,6,1,0,86
148717,1252060,1,13,1,2,0,88
148718,1252060,1,13,2,4,0,92
148719,1252060,1,13,3,1,0,93
148720,1252060,1,13,4,0,0,93
148721,1252060,1,13,5,1,0,94
148722,1252060,1,13,6,0,0,94
148723,1252060,1,14,1,1,0,95
148724,1252060,1,14,2,1,0,96
148725,1252060,1,14,3,0,0,96
148726,1252060,1,14,4,0,1,96
148727,1252060,1,14,5,1,0,97
148728,1252060,1,14,6,1,0,98
148729,1252060,1,15,1,1,0,99
148730,1252060,1,15,2,2,0,101
148731,1252060,1,15,3,1,0,102
148732,1252060,1,15,4,2,0,104
148733,1252060,1,15,5,0,0,104
148734,1252060,1,15,6,1,0,105
148735,1252060,1,16,1,1,0,106
148736,1252060,1,16,2,6,0,112
148737,1252060,1,16,3,1,0,113
148738,1252060,1,16,4,0,0,113
148739,1252060,1,16,5,1,0,114
148740,1252060,1,16,6,0,0,114
148741,1252060,1,17,1,3,0,117
148742,1252060,1,17,2,1,0,118
148743,1252060,1,17,3,1,0,119
148744,1252060,1,17,4,6,0,125
148745,1252060,1,17,5,6,0,131
148746,1252060,1,17,6,4,0,135
148747,1252060,1,18,1,2,0,137
148748,1252060,1,18,2,6,0,143
148749,1252060,1,18,3,0,0,143
148750,1252060,1,18,4,1,0,144
148751,1252060,1,18,5,0,0,144
148752,1252060,1,18,6,6,0,150
148753,1252060,1,19,1,5,0,155
148754,1252060,1,19,2,0,1,155
148755,1252060,1,19,3,2,0,157
148756,1252060,1,19,4,0,0,157
148757,1252060,1,19,5,6,0,163
148758,1252060,1,19,6,4,0,167
148759,1252060,1,20,1,0,1,167
148760,1252060,1,20,2,0,1,167
148761,1252060,1,20,3,4,0,171
148762,1252060,1,20,4,4,0,175
148763,1252060,1,20,5,2,0,177
148764,1252060,1,20,6,6,0,183
148885,1252066,1,1,1,1,0,1
148886,1252066,1,1,2,1,0,2
148887,1252066,1,1,3,1,0,3
148888,1252066,1,1,4,1,0,4
148889,1252066,1,1,5,1,0,5
148890,1252066,1,1,6,1,0,6
148891,1252066,1,2,1,2,0,8
148892,1252066,1,2,2,4,0,12
148893,1252066,1,2,3,0,0,12
148894,1252066,1,2,4,0,0,12
148895,1252066,1,2,5,0,0,12
148896,1252066,1,2,6,1,0,13
148897,1252066,1,3,1,2,0,15
148898,1252066,1,3,2,0,0,15
148899,1252066,1,3,3,4,0,19
148900,1252066,1,3,4,1,0,20
148901,1252066,1,3,5,0,0,20
148902,1252066,1,3,6,0,1,20
148903,1252066,1,4,1,2,0,22
148904,1252066,1,4,2,0,0,22
148905,1252066,1,4,3,0,0,22
148906,1252066,1,4,4,0,0,22
148907,1252066,1,4,5,1,0,23
148908,1252066,1,4,6,1,0,24
148909,1252066,1,5,1,0,0,24
148910,1252066,1,5,2,0,0,24
148911,1252066,1,5,3,2,0,26
148912,1252066,1,5,4,2,0,28
148913,1252066,1,5,5,1,0,29
148914,1252066,1,5,6,1,0,30
148915,1252066,1,6,1,0,0,30
148916,1252066,1,6,2,4,0,34
148917,1252066,1,6,3,1,0,35
148918,1252066,1,6,4,4,0,39
148919,1252066,1,6,5,0,0,39
148920,1252066,1,6,6,1,0,40
148921,1252066,1,7,1,1,0,41
148922,1252066,1,7,2,1,0,42
148923,1252066,1,7,3,4,0,46
148924,1252066,1,7,4,1,0,47
148925,1252066,1,7,5,0,0,47
148926,1252066,1,7,6,0,0,47
148927,1252066,1,8,1,0,0,47
148928,1252066,1,8,2,4,0,51
148929,1252066,1,8,3,6,0,57
148930,1252066,1,8,4,1,0,58
148931,1252066,1,8,5,1,0,59
148932,1252066,1,8,6,1,0,60
148933,1252066,1,9,1,1,0,61
148934,1252066,1,9,2,1,0,62
148935,1252066,1,9,3,0,0,62
148936,1252066,1,9,4,2,0,64
148937,1252066,1,9,5,6,0,70
148938,1252066,1,9,6,0,0,70
148939,1252066,1,10,1,0,0,70
148940,1252066,1,10,2,0,0,70
148941,1252066,1,10,3,0,0,70
148942,1252066,1,10,4,0,0,70
148943,1252066,1,10,5,1,0,71
148944,1252066,1,10,6,0,1,71
148945,1252066,1,11,1,0,0,71
148946,1252066,1,11,2,0,0,71
148947,1252066,1,11,3,0,0,71
148948,1252066,1,11,4,4,0,75
148949,1252066,1,11,5,0,0,75
148950,1252066,1,11,6,2,0,77
148951,1252066,1,12,1,1,0,78
148952,1252066,1,12,2,1,0,79
148953,1252066,1,12,3,0,0,79
148954,1252066,1,12,4,1,0,80
148955,1252066,1,12,5,1,0,81
148956,1252066,1,12,6,1,0,82
148957,1252066,1,13,1,1,0,83
148958,1252066,1,13,2,0,1,83
148959,1252066,1,13,3,1,0,84
148960,1252066,1,13,4,1,0,85
148961,1252066,1,13,5,0,0,85
148962,1252066,1,13,6,1,0,86
148963,1252066,1,14,1,1,0,87
148964,1252066,1,14,2,6,0,93
148965,1252066,1,14,3,0,0,93
148966,1252066,1,14,4,1,0,94
148967,1252066,1,14,5,2,0,96
148968,1252066,1,14,6,0,1,96
148969,1252066,1,15,1,1,1,97
148970,1252066,1,15,2,1,0,98
148971,1252066,1,15,3,0,0,98
148972,1252066,1,15,4,1,0,99
148973,1252066,1,15,5,0,0,99
148974,1252066,1,15,6,1,0,100
148975,1252066,1,16,1,2,0,102
148976,1252066,1,16,2,0,0,102
148977,1252066,1,16,3,0,0,102
148978,1252066,1,16,4,2,0,104
148979,1252066,1,16,5,1,0,105
148980,1252066,1,16,6,0,0,105
148981,1252066,1,17,1,1,0,106
148982,1252066,1,17,2,0,1,106
148983,1252066,1,17,3,1,0,107
148984,1252066,1,17,4,1,0,108
148985,1252066,1,17,5,0,0,108
148986,1252066,1,17,6,1,0,109
148987,1252066,1,18,1,2,0,111
148988,1252066,1,18,2,0,1,111
148989,1252066,1,18,3,1,0,112
148990,1252066,1,18,4,0,0,112
148991,1252066,1,18,5,1,0,113
148992,1252066,1,18,6,4,0,117
148993,1252066,1,19,1,2,0,119
148994,1252066,1,19,2,0,0,119
148995,1252066,1,19,3,1,0,120
148996,1252066,1,19,4,2,0,122
148997,1252066,1,19,5,1,0,123
148998,1252066,1,19,6,1,0,124
148999,1252066,1,20,1,0,0,124
149000,1252066,1,20,2,1,0,125
149001,1252066,1,20,3,1,1,126
149002,1252066,1,20,4,1,0,127
149003,1252066,1,20,5,3,0,130
149004,1252066,1,20,6,1,1,131
149084,1252067,1,1,1,0,0,0
149085,1252067,1,1,2,4,0,4
149086,1252067,1,1,3,0,0,4
149087,1252067,1,1,4,0,0,4
149088,1252067,1,1,5,4,0,8
149089,1252067,1,1,6,1,0,9
149090,1252067,1,2,1,2,0,11
149091,1252067,1,2,2,1,0,12
149092,1252067,1,2,3,1,0,13
149093,1252067,1,2,4,1,0,14
149094,1252067,1,2,5,1,0,15
149095,1252067,1,2,6,1,0,16
149096,1252067,1,3,1,0,0,16
149097,1252067,1,3,2,1,0,17
149098,1252067,1,3,3,1,0,18
149099,1252067,1,3,4,2,0,20
149100,1252067,1,3,5,4,0,24
149101,1252067,1,3,6,1,0,25
149102,1252067,1,4,1,0,0,25
149103,1252067,1,4,2,4,0,29
149104,1252067,1,4,3,0,0,29
149105,1252067,1,4,4,4,0,33
149106,1252067,1,4,5,1,0,34
149107,1252067,1,4,6,1,0,35
149108,1252067,1,5,1,0,0,35
149109,1252067,1,5,2,0,0,35
149110,1252067,1,5,3,1,0,36
149111,1252067,1,5,4,4,0,40
149112,1252067,1,5,5,1,0,41
149113,1252067,1,5,6,1,0,42
149114,1252067,1,6,1,4,0,46
149115,1252067,1,6,2,7,0,53
149116,1252067,1,6,3,0,0,53
149117,1252067,1,6,4,1,0,54
149118,1252067,1,6,5,1,0,55
149119,1252067,1,6,6,1,0,56
149120,1252067,1,7,1,0,0,56
149121,1252067,1,7,2,1,0,57
149122,1252067,1,7,3,1,0,58
149123,1252067,1,7,4,2,0,60
149124,1252067,1,7,5,1,0,61
149125,1252067,1,7,6,1,0,62
149126,1252067,1,8,1,1,0,63
149127,1252067,1,8,2,0,0,63
149128,1252067,1,8,3,2,0,65
149129,1252067,1,8,4,0,0,65
149130,1252067,1,8,5,6,0,71
149131,1252067,1,8,6,1,0,72
149132,1252067,1,9,1,1,0,73
149133,1252067,1,9,2,6,0,79
149134,1252067,1,9,3,1,0,80
149135,1252067,1,9,4,1,0,81
149136,1252067,1,9,5,1,0,82
149137,1252067,1,9,6,2,0,84
149138,1252067,1,10,1,1,0,85
149139,1252067,1,10,2,4,0,89
149140,1252067,1,10,3,1,0,90
149141,1252067,1,10,4,1,0,91
149142,1252067,1,10,5,2,0,93
149143,1252067,1,10,6,1,0,94
149144,1252067,1,11,1,1,0,95
149145,1252067,1,11,2,0,1,95
149146,1252067,1,11,3,1,0,96
149147,1252067,1,11,4,0,0,96
149148,1252067,1,11,5,0,1,96
149149,1252067,1,11,6,0,0,96
149150,1252067,1,12,1,0,0,96
149151,1252067,1,12,2,0,0,96
149152,1252067,1,12,3,1,0,97
149153,1252067,1,12,4,1,0,98
149154,1252067,1,12,5,1,0,99
149155,1252067,1,12,6,1,0,100
149156,1252067,1,13,1,2,0,102
149157,1252067,1,13,2,0,0,102
149158,1252067,1,13,3,1,0,103
149159,1252067,1,13,4,1,0,104
149160,1252067,1,13,5,0,1,104
149161,1252067,1,13,6,1,0,105
149162,1252067,1,14,1,1,0,106
149163,1252067,1,14,2,1,0,107
149164,1252067,1,14,3,1,0,108
149165,1252067,1,14,4,1,0,109
149166,1252067,1,14,5,2,0,111
149167,1252067,1,14,6,1,0,112
149168,1252067,1,15,1,1,0,113
149169,1252067,1,15,2,1,0,114
149170,1252067,1,15,3,1,0,115
149171,1252067,1,15,4,1,0,116
149172,1252067,1,15,5,1,0,117
149173,1252067,1,15,6,1,0,118
149174,1252067,1,16,1,1,0,119
149175,1252067,1,16,2,0,0,119
149176,1252067,1,16,3,0,1,119
149177,1252067,1,16,4,2,0,121
149178,1252067,1,16,5,1,0,122
149179,1252067,1,16,6,2,0,124
149180,1252067,1,17,1,1,0,125
149181,1252067,1,17,2,1,0,126
149182,1252067,1,17,3,2,0,128
149183,1252067,1,17,4,1,1,129
149184,1252067,1,17,5,1,0,130
149185,1252067,1,17,6,1,0,131
149186,1252067,1,18,1,1,0,132
149187,1252067,1,18,2,2,0,134
149188,1252067,1,18,3,0,0,134
149189,1252067,1,18,4,1,0,135
149190,1252067,1,18,5,1,0,136
149191,1252067,1,18,6,6,0,142
149192,1252067,1,19,1,1,0,143
149193,1252067,1,19,2,1,0,144
149194,1252067,1,19,3,4,0,148
149195,1252067,1,19,4,1,0,149
149196,1252067,1,19,5,1,0,150
149197,1252067,1,19,6,4,0,154
149198,1252067,1,20,1,0,0,154
149199,1252067,1,20,2,0,1,154
149200,1252067,1,20,3,4,0,158
149201,1252067,1,20,4,0,0,158
149202,1252067,1,20,5,0,0,158
149203,1252067,1,20,6,2,0,160
149316,1252068,1,1,1,0,0,0
149317,1252068,1,1,2,0,0,0
149318,1252068,1,1,3,1,0,1
149319,1252068,1,1,4,0,0,1
149320,1252068,1,1,5,0,0,1
149321,1252068,1,1,6,0,0,1
149322,1252068,1,2,1,2,0,3
149323,1252068,1,2,2,0,0,3
149324,1252068,1,2,3,4,0,7
149325,1252068,1,2,4,1,0,8
149326,1252068,1,2,5,1,0,9
149327,1252068,1,2,6,1,0,10
149328,1252068,1,3,1,0,1,10
149329,1252068,1,3,2,0,0,10
149330,1252068,1,3,3,0,0,10
149331,1252068,1,3,4,1,0,11
149332,1252068,1,3,5,0,0,11
149333,1252068,1,3,6,0,0,11
149334,1252068,1,4,1,1,0,12
149335,1252068,1,4,2,1,0,13
149336,1252068,1,4,3,2,0,15
149337,1252068,1,4,4,0,1,15
149338,1252068,1,4,5,1,0,16
149339,1252068,1,4,6,5,0,21
149340,1252068,1,5,1,1,0,22
149341,1252068,1,5,2,1,0,23
149342,1252068,1,5,3,0,0,23
149343,1252068,1,5,4,0,0,23
149344,1252068,1,5,5,0,0,23
149345,1252068,1,5,6,1,0,24
149346,1252068,1,6,1,1,0,25
149347,1252068,1,6,2,0,0,25
149348,1252068,1,6,3,0,0,25
149349,1252068,1,6,4,1,0,26
149350,1252068,1,6,5,1,0,27
149351,1252068,1,6,6,0,1,27
149352,1252068,1,7,1,2,0,29
149353,1252068,1,7,2,1,0,30
149354,1252068,1,7,3,1,0,31
149355,1252068,1,7,4,0,0,31
149356,1252068,1,7,5,4,0,35
149357,1252068,1,7,6,0,0,35
149358,1252068,1,8,1,0,0,35
149359,1252068,1,8,2,1,0,36
149360,1252068,1,8,3,1,0,37
149361,1252068,1,8,4,1,0,38
149362,1252068,1,8,5,1,0,39
149363,1252068,1,8,6,1,0,40
149364,1252068,1,9,1,1,0,41
149365,1252068,1,9,2,1,0,42
149366,1252068,1,9,3,1,0,43
149367,1252068,1,9,4,1,0,44
149368,1252068,1,9,5,0,0,44
149369,1252068,1,9,6,1,0,45
149370,1252068,1,10,1,1,0,46
149371,1252068,1,10,2,0,0,46
149372,1252068,1,10,3,0,1,46
149373,1252068,1,10,4,0,0,46
149374,1252068,1,10,5,0,0,46
149375,1252068,1,10,6,1,0,47
149376,1252068,1,11,1,1,0,48
149377,1252068,1,11,2,1,0,49
149378,1252068,1,11,3,1,0,50
149379,1252068,1,11,4,1,0,51
149380,1252068,1,11,5,1,0,52
149381,1252068,1,11,6,1,0,53
149382,1252068,1,12,1,4,0,57
149383,1252068,1,12,2,1,0,58
149384,1252068,1,12,3,1,0,59
149385,1252068,1,12,4,0,0,59
149386,1252068,1,12,5,2,0,61
149387,1252068,1,12,6,0,0,61
149388,1252068,1,13,1,1,0,62
149389,1252068,1,13,2,0,0,62
149390,1252068,1,13,3,0,0,62
149391,1252068,1,13,4,2,0,64
149392,1252068,1,13,5,0,0,64
149393,1252068,1,13,6,1,0,65
149394,1252068,1,14,1,4,0,69
149395,1252068,1,14,2,1,0,70
149396,1252068,1,14,3,1,0,71
149397,1252068,1,14,4,1,0,72
149398,1252068,1,14,5,1,0,73
149399,1252068,1,14,6,1,0,74
149400,1252068,1,15,1,1,0,75
149401,1252068,1,15,2,1,0,76
149402,1252068,1,15,3,4,0,80
149403,1252068,1,15,4,0,0,80
149404,1252068,1,15,5,1,0,81
149405,1252068,1,15,6,1,0,82
149406,1252068,1,16,1,1,0,83
149407,1252068,1,16,2,1,0,84
149408,1252068,1,16,3,0,0,84
149409,1252068,1,16,4,6,0,90
149410,1252068,1,16,5,4,0,94
149411,1252068,1,16,6,1,0,95
149412,1252068,1,17,1,4,0,99
149413,1252068,1,17,2,0,0,99
149414,1252068,1,17,3,1,0,100
149415,1252068,1,17,4,1,0,101
149416,1252068,1,17,5,1,0,102
149417,1252068,1,17,6,3,0,105
149418,1252068,1,18,1,1,0,106
149419,1252068,1,18,2,1,0,107
149420,1252068,1,18,3,2,0,109
149421,1252068,1,18,4,1,0,110
149422,1252068,1,18,5,0,0,110
149423,1252068,1,18,6,1,0,111
149424,1252068,1,19,1,2,0,113
149425,1252068,1,19,2,1,0,114
149426,1252068,1,19,3,0,0,114
149427,1252068,1,19,4,2,0,116
149428,1252068,1,19,5,1,0,117
149429,1252068,1,19,6,1,0,118
149430,1252068,1,20,1,1,0,119
149431,1252068,1,20,2,6,0,125
149432,1252068,1,20,3,4,0,129
149433,1252068,1,20,4,0,0,129
149434,1252068,1,20,5,1,0,130
149435,1252068,1,20,6,1,0,131
149550,1256720,1,1,1,0,0,0
149551,1256720,1,1,2,0,0,0
149552,1256720,1,1,3,0,0,0
149553,1256720,1,1,4,0,0,0
149554,1256720,1,1,5,6,0,6
149555,1256720,1,1,6,0,1,6
149556,1256720,1,2,1,0,0,6
149557,1256720,1,2,2,0,0,6
149558,1256720,1,2,3,0,0,6
149559,1256720,1,2,4,4,0,10
149560,1256720,1,2,5,0,1,10
149561,1256720,1,2,6,0,1,10
149562,1256720,1,3,1,0,0,10
149563,1256720,1,3,2,0,0,10
149564,1256720,1,3,3,0,0,10
149565,1256720,1,3,4,0,0,10
149566,1256720,1,3,5,0,0,10
149567,1256720,1,3,6,0,0,10
149568,1256720,1,4,1,0,0,10
149569,1256720,1,4,2,0,0,10
149570,1256720,1,4,3,0,0,10
149571,1256720,1,4,4,0,0,10
149572,1256720,1,4,5,0,0,10
149573,1256720,1,4,6,0,0,10
149574,1256720,1,5,1,4,0,14
149575,1256720,1,5,2,4,0,18
149576,1256720,1,5,3,0,0,18
149577,1256720,1,5,4,0,0,18
149578,1256720,1,5,5,6,0,24
149579,1256720,1,5,6,0,1,24
149580,1256720,1,6,1,0,0,24
149581,1256720,1,6,2,0,0,24
149582,1256720,1,6,3,1,0,25
149583,1256720,1,6,4,1,0,26
149584,1256720,1,6,5,0,0,26
149585,1256720,1,6,6,0,0,26
149586,1256720,1,7,1,1,0,27
149587,1256720,1,7,2,0,0,27
149588,1256720,1,7,3,0,0,27
149589,1256720,1,7,4,2,0,29
149590,1256720,1,7,5,0,0,29
149591,1256720,1,7,6,0,1,29
149592,1256720,1,8,1,3,0,32
149593,1256720,1,8,2,0,0,32
149594,1256720,1,8,3,1,0,33
149595,1256720,1,8,4,1,0,34
149596,1256720,1,8,5,0,0,34
149597,1256720,1,8,6,0,0,34
149598,1256720,1,9,1,0,0,34
149599,1256720,1,9,2,0,0,34
149600,1256720,1,9,3,0,0,34
149601,1256720,1,9,4,1,0,35
149602,1256720,1,9,5,0,0,35
149603,1256720,1,9,6,0,0,35
149604,1256720,1,10,1,0,0,35
149605,1256720,1,10,2,2,0,37
149606,1256720,1,10,3,0,0,37
149607,1256720,1,10,4,1,0,38
149608,1256720,1,10,5,0,0,38
149609,1256720,1,10,6,1,0,39
149610,1256720,1,11,1,0,1,39
149611,1256720,1,11,2,0,0,39
149612,1256720,1,11,3,1,0,40
149613,1256720,1,11,4,1,0,41
149614,1256720,1,11,5,0,0,41
149615,1256720,1,11,6,0,0,41
149616,1256720,1,12,1,2,0,43
149617,1256720,1,12,2,0,0,43
149618,1256720,1,12,3,6,0,49
149619,1256720,1,12,4,0,1,49
149620,1256720,1,12,5,0,0,49
149621,1256720,1,12,6,0,0,49
149622,1256720,1,13,1,0,0,49
149623,1256720,1,13,2,6,0,55
149624,1256720,1,13,3,2,0,57
149625,1256720,1,13,4,0,0,57
149626,1256720,1,13,5,2,0,59
149627,1256720,1,13,6,0,0,59
149628,1256720,1,14,1,1,0,60
149629,1256720,1,14,2,6,0,66
149630,1256720,1,14,3,0,0,66
149631,1256720,1,14,4,1,0,67
149632,1256720,1,14,5,0,0,67
149633,1256720,1,14,6,4,0,71
149634,1256720,1,15,1,0,0,71
149635,1256720,1,15,2,0,0,71
149636,1256720,1,15,3,1,0,72
149637,1256720,1,15,4,1,0,73
149638,1256720,1,15,5,2,0,75
149639,1256720,1,15,6,6,0,81
149640,1256720,1,16,1,1,0,82
149641,1256720,1,16,2,0,0,82
149642,1256720,1,16,3,1,0,83
149643,1256720,1,16,4,0,0,83
149644,1256720,1,16,5,1,0,84
149645,1256720,1,16,6,0,0,84
149646,1256720,1,17,1,1,0,85
149647,1256720,1,17,2,0,0,85
149648,1256720,1,17,3,0,1,85
149649,1256720,1,17,4,1,0,86
149650,1256720,1,17,5,0,0,86
149651,1256720,1,17,6,1,0,87
149652,1256720,1,18,1,0,0,87
149653,1256720,1,18,2,2,0,89
149654,1256720,1,18,3,0,0,89
149655,1256720,1,18,4,1,0,90
149656,1256720,1,18,5,4,0,94
149657,1256720,1,18,6,1,0,95
149658,1256720,1,19,1,4,0,99
149659,1256720,1,19,2,1,0,100
149660,1256720,1,19,3,0,0,100
149661,1256720,1,19,4,0,0,100
149662,1256720,1,19,5,1,0,101
149663,1256720,1,19,6,1,0,102
149664,1256720,1,20,1,1,0,103
149665,1256720,1,20,2,0,0,103
149666,1256720,1,20,3,0,1,103
149667,1256720,1,20,4,0,1,103
149771,1256721,1,1,1,1,0,1
149772,1256721,1,1,2,4,0,5
149773,1256721,1,1,3,0,0,5
149774,1256721,1,1,4,1,0,6
149775,1256721,1,1,5,0,0,6
149776,1256721,1,1,6,0,0,6
149777,1256721,1,2,1,0,0,6
149778,1256721,1,2,2,0,0,6
149779,1256721,1,2,3,1,0,7
149780,1256721,1,2,4,0,0,7
149781,1256721,1,2,5,0,0,7
149782,1256721,1,2,6,0,0,7
149783,1256721,1,3,1,0,0,7
149784,1256721,1,3,2,0,0,7
149785,1256721,1,3,3,6,0,13
149786,1256721,1,3,4,1,0,14
149787,1256721,1,3,5,0,0,14
149788,1256721,1,3,6,1,0,15
149789,1256721,1,4,1,0,0,15
149790,1256721,1,4,2,4,0,19
149791,1256721,1,4,3,1,0,20
149792,1256721,1,4,4,4,0,24
149793,1256721,1,4,5,1,0,25
149794,1256721,1,4,6,0,0,25
149795,1256721,1,5,1,0,0,25
149796,1256721,1,5,2,2,0,27
149797,1256721,1,5,3,0,0,27
149798,1256721,1,5,4,1,0,28
149799,1256721,1,5,5,4,0,32
149800,1256721,1,5,6,0,0,32
149801,1256721,1,6,1,4,0,36
149802,1256721,1,6,2,0,1,36
149803,1256721,1,6,3,0,0,36
149804,1256721,1,6,4,4,0,40
149805,1256721,1,6,5,0,0,40
149806,1256721,1,6,6,0,1,40
149807,1256721,1,7,1,1,0,41
149808,1256721,1,7,2,1,0,42
149809,1256721,1,7,3,1,0,43
149810,1256721,1,7,4,1,0,44
149811,1256721,1,7,5,0,0,44
149812,1256721,1,7,6,0,0,44
149813,1256721,1,8,1,0,0,44
149814,1256721,1,8,2,1,0,45
149815,1256721,1,8,3,0,0,45
149816,1256721,1,8,4,1,0,46
149817,1256721,1,8,5,1,0,47
149818,1256721,1,8,6,1,0,48
149819,1256721,1,9,1,1,0,49
149820,1256721,1,9,2,2,0,51
149821,1256721,1,9,3,0,0,51
149822,1256721,1,9,4,0,0,51
149823,1256721,1,9,5,4,0,55
149824,1256721,1,9,6,1,0,56
149825,1256721,1,10,1,1,0,57
149826,1256721,1,10,2,2,0,59
149827,1256721,1,10,3,3,0,62
149828,1256721,1,10,4,1,0,63
149829,1256721,1,10,5,1,0,64
149830,1256721,1,10,6,0,0,64
149831,1256721,1,11,1,4,0,68
149832,1256721,1,11,2,0,0,68
149833,1256721,1,11,3,6,0,74
149834,1256721,1,11,4,6,0,80
149835,1256721,1,11,5,4,0,84
149836,1256721,1,11,6,4,0,88
149837,1256721,1,12,1,1,0,89
149838,1256721,1,12,2,0,0,89
149839,1256721,1,12,3,4,0,93
149840,1256721,1,12,4,4,0,97
149841,1256721,1,12,5,0,0,97
149842,1256721,1,12,6,0,0,97
149843,1256721,1,13,1,4,0,101
149844,1256721,1,13,2,0,1,101
149845,1256721,1,13,3,0,0,101
149846,1256721,1,13,4,0,0,101
149847,1256721,1,13,5,4,0,105
149848,1256721,1,13,6,0,0,105
149849,1256721,1,14,1,1,0,106
149850,1256721,1,14,2,0,0,106
149851,1256721,1,14,3,2,0,108
149852,1256721,1,14,4,6,0,114
149853,1256721,1,14,5,0,1,114
149854,1256721,1,14,6,1,0,115
149855,1256721,1,15,1,0,0,115
149856,1256721,1,15,2,1,0,116
149857,1256721,1,15,3,0,1,116
149858,1256721,1,15,4,0,0,116
149859,1256721,1,15,5,1,0,117
149860,1256721,1,15,6,1,0,118
149861,1256721,1,16,1,1,0,119
149862,1256721,1,16,2,4,0,123
149863,1256721,1,16,3,2,0,125
149864,1256721,1,16,4,1,0,126
149865,1256721,1,16,5,1,0,127
149866,1256721,1,16,6,1,0,128
149867,1256721,1,17,1,0,0,128
149868,1256721,1,17,2,4,0,132
149869,1256721,1,17,3,2,0,134
149870,1256721,1,17,4,6,0,140
149871,1256721,1,17,5,1,0,141
149872,1256721,1,17,6,5,0,146
149873,1256721,1,18,1,1,0,147
149874,1256721,1,18,2,0,0,147
149875,1256721,1,18,3,0,0,147
149876,1256721,1,18,4,0,1,147
149877,1256721,1,18,5,1,0,148
149878,1256721,1,18,6,5,0,153
149879,1256721,1,19,1,3,0,156
149880,1256721,1,19,2,2,0,158
149881,1256721,1,19,3,4,0,162
149882,1256721,1,19,4,0,1,162
149883,1256721,1,19,5,0,0,162
149884,1256721,1,19,6,1,0,163
149885,1256721,1,20,1,1,0,164
149886,1256721,1,20,2,0,1,164
149887,1256721,1,20,3,2,0,166
149888,1256721,1,20,4,0,0,166
149889,1256721,1,20,5,4,0,170
149890,1256721,1,20,6,1,0,171
150011,1256722,1,1,1,0,0,0
150012,1256722,1,1,2,1,0,1
150013,1256722,1,1,3,1,0,2
150014,1256722,1,1,4,0,0,2
150015,1256722,1,1,5,0,0,2
150016,1256722,1,1,6,1,0,3
150017,1256722,1,2,1,4,0,7
150018,1256722,1,2,2,0,0,7
150019,1256722,1,2,3,0,0,7
150020,1256722,1,2,4,4,0,11
150021,1256722,1,2,5,0,1,11
150022,1256722,1,2,6,1,0,12
150023,1256722,1,3,1,1,0,13
150024,1256722,1,3,2,1,0,14
150025,1256722,1,3,3,0,0,14
150026,1256722,1,3,4,0,0,14
150027,1256722,1,3,5,0,0,14
150028,1256722,1,3,6,1,0,15
150029,1256722,1,4,1,2,0,17
150030,1256722,1,4,2,1,0,18
150031,1256722,1,4,3,6,0,24
150032,1256722,1,4,4,4,0,28
150033,1256722,1,4,5,6,0,34
150034,1256722,1,4,6,0,0,34
150035,1256722,1,5,1,1,0,35
150036,1256722,1,5,2,4,0,39
150037,1256722,1,5,3,0,0,39
150038,1256722,1,5,4,6,0,45
150039,1256722,1,5,5,2,0,47
150040,1256722,1,5,6,1,0,48
150041,1256722,1,6,1,0,0,48
150042,1256722,1,6,2,0,1,48
150043,1256722,1,6,3,0,0,48
150044,1256722,1,6,4,6,0,54
150045,1256722,1,6,5,0,0,54
150046,1256722,1,6,6,0,0,54
150047,1256722,1,7,1,1,0,55
150048,1256722,1,7,2,2,0,57
150049,1256722,1,7,3,0,0,57
150050,1256722,1,7,4,2,0,59
150051,1256722,1,7,5,0,0,59
150052,1256722,1,7,6,1,0,60
150053,1256722,1,8,1,0,0,60
150054,1256722,1,8,2,6,0,66
150055,1256722,1,8,3,1,0,67
150056,1256722,1,8,4,1,0,68
150057,1256722,1,8,5,1,0,69
150058,1256722,1,8,6,1,0,70
150059,1256722,1,9,1,1,0,71
150060,1256722,1,9,2,0,0,71
150061,1256722,1,9,3,6,0,77
150062,1256722,1,9,4,4,0,81
150063,1256722,1,9,5,2,0,83
150064,1256722,1,9,6,1,0,84
150065,1256722,1,10,1,7,0,91
150066,1256722,1,10,2,1,0,92
150067,1256722,1,10,3,2,0,94
150068,1256722,1,10,4,1,0,95
150069,1256722,1,10,5,0,0,95
150070,1256722,1,10,6,1,0,96
150071,1256722,1,11,1,3,0,99
150072,1256722,1,11,2,0,0,99
150073,1256722,1,11,3,0,0,99
150074,1256722,1,11,4,1,0,100
150075,1256722,1,11,5,0,0,100
150076,1256722,1,11,6,1,0,101
150077,1256722,1,12,1,1,0,102
150078,1256722,1,12,2,6,0,108
150079,1256722,1,12,3,0,0,108
150080,1256722,1,12,4,1,0,109
150081,1256722,1,12,5,1,0,110
150082,1256722,1,12,6,1,0,111
150083,1256722,1,13,1,0,0,111
150084,1256722,1,13,2,0,0,111
150085,1256722,1,13,3,1,0,112
150086,1256722,1,13,4,1,0,113
150087,1256722,1,13,5,1,0,114
150088,1256722,1,13,6,0,0,114
150089,1256722,1,14,1,4,0,118
150090,1256722,1,14,2,1,0,119
150091,1256722,1,14,3,11,0,130
150092,1256722,1,14,4,6,0,136
150093,1256722,1,14,5,0,0,136
150094,1256722,1,14,6,4,0,140
150095,1256722,1,15,1,1,0,141
150096,1256722,1,15,2,2,0,143
150097,1256722,1,15,3,6,0,149
150098,1256722,1,15,4,1,0,150
150099,1256722,1,15,5,0,0,150
150100,1256722,1,15,6,3,0,153
150101,1256722,1,16,1,6,0,159
150102,1256722,1,16,2,4,0,163
150103,1256722,1,16,3,1,0,164
150104,1256722,1,16,4,0,0,164
150105,1256722,1,16,5,4,0,168
150106,1256722,1,16,6,1,0,169
150107,1256722,1,17,1,1,0,170
150108,1256722,1,17,2,0,1,170
150109,1256722,1,17,3,2,0,172
150110,1256722,1,17,4,6,0,178
150111,1256722,1,17,5,0,0,178
150112,1256722,1,17,6,2,0,180
150113,1256722,1,18,1,4,0,184
150114,1256722,1,18,2,0,0,184
150115,1256722,1,18,3,6,0,190
150116,1256722,1,18,4,6,0,196
150117,1256722,1,18,5,2,0,198
150118,1256722,1,18,6,1,0,199
150119,1256722,1,19,1,0,0,199
150120,1256722,1,19,2,0,0,199
150121,1256722,1,19,3,2,0,201
150122,1256722,1,19,4,2,0,203
150123,1256722,1,19,5,6,0,209
150124,1256722,1,19,6,1,1,210
150125,1256722,1,20,1,0,1,210
150126,1256722,1,20,2,1,0,211
150127,1256722,1,20,3,4,0,215
150128,1256722,1,20,4,4,0,219
150129,1256722,1,20,5,4,0,223
150130,1256722,1,20,6,1,0,224
150251,1256723,1,1,1,0,0,0
150252,1256723,1,1,2,0,0,0
150253,1256723,1,1,3,0,0,0
150254,1256723,1,1,4,3,0,3
150255,1256723,1,1,5,0,0,3
150256,1256723,1,1,6,4,0,7
150257,1256723,1,2,1,0,0,7
150258,1256723,1,2,2,0,0,7
150259,1256723,1,2,3,0,0,7
150260,1256723,1,2,4,1,0,8
150261,1256723,1,2,5,0,0,8
150262,1256723,1,2,6,0,1,8
150263,1256723,1,3,1,4,0,12
150264,1256723,1,3,2,0,0,12
150265,1256723,1,3,3,0,0,12
150266,1256723,1,3,4,1,0,13
150267,1256723,1,3,5,0,0,13
150268,1256723,1,3,6,0,0,13
150269,1256723,1,4,1,0,0,13
150270,1256723,1,4,2,2,0,15
150271,1256723,1,4,3,0,0,15
150272,1256723,1,4,4,0,0,15
150273,1256723,1,4,5,0,0,15
150274,1256723,1,4,6,0,0,15
150275,1256723,1,5,1,4,0,19
150276,1256723,1,5,2,1,0,20
150277,1256723,1,5,3,0,0,20
150278,1256723,1,5,4,4,0,24
150279,1256723,1,5,5,2,0,26
150280,1256723,1,5,6,6,0,32
150281,1256723,1,6,1,1,0,33
150282,1256723,1,6,2,4,0,37
150283,1256723,1,6,3,0,0,37
150284,1256723,1,6,4,1,0,38
150285,1256723,1,6,5,1,0,39
150286,1256723,1,6,6,6,0,45
150287,1256723,1,7,1,1,0,46
150288,1256723,1,7,2,4,0,50
150289,1256723,1,7,3,1,0,51
150290,1256723,1,7,4,0,0,51
150291,1256723,1,7,5,6,0,57
150292,1256723,1,7,6,0,0,57
150293,1256723,1,8,1,0,0,57
150294,1256723,1,8,2,1,0,58
150295,1256723,1,8,3,2,0,60
150296,1256723,1,8,4,1,0,61
150297,1256723,1,8,5,0,0,61
150298,1256723,1,8,6,4,0,65
150299,1256723,1,9,1,6,0,71
150300,1256723,1,9,2,0,0,71
150301,1256723,1,9,3,1,0,72
150302,1256723,1,9,4,1,0,73
150303,1256723,1,9,5,1,0,74
150304,1256723,1,9,6,6,0,80
150305,1256723,1,10,1,1,0,81
150306,1256723,1,10,2,0,0,81
150307,1256723,1,10,3,0,0,81
150308,1256723,1,10,4,1,0,82
150309,1256723,1,10,5,1,0,83
150310,1256723,1,10,6,1,0,84
150311,1256723,1,11,1,3,0,87
150312,1256723,1,11,2,4,0,91
150313,1256723,1,11,3,0,0,91
150314,1256723,1,11,4,0,0,91
150315,1256723,1,11,5,0,0,91
150316,1256723,1,11,6,2,0,93
150317,1256723,1,12,1,0,0,93
150318,1256723,1,12,2,0,0,93
150319,1256723,1,12,3,0,1,93
150320,1256723,1,12,4,1,0,94
150321,1256723,1,12,5,1,0,95
150322,1256723,1,12,6,1,0,96
150323,1256723,1,13,1,1,0,97
150324,1256723,1,13,2,0,0,97
150325,1256723,1,13,3,0,1,97
150326,1256723,1,13,4,1,0,98
150327,1256723,1,13,5,5,0,103
150328,1256723,1,13,6,0,0,103
150329,1256723,1,14,1,1,0,104
150330,1256723,1,14,2,1,0,105
150331,1256723,1,14,3,1,0,106
150332,1256723,1,14,4,1,0,107
150333,1256723,1,14,5,1,0,108
150334,1256723,1,14,6,1,0,109
150335,1256723,1,15,1,0,0,109
150336,1256723,1,15,2,0,0,109
150337,1256723,1,15,3,1,0,110
150338,1256723,1,15,4,1,0,111
150339,1256723,1,15,5,1,0,112
150340,1256723,1,15,6,6,0,118
150341,1256723,1,16,1,0,0,118
150342,1256723,1,16,2,6,0,124
150343,1256723,1,16,3,2,0,126
150344,1256723,1,16,4,1,0,127
150345,1256723,1,16,5,2,0,129
150346,1256723,1,16,6,0,0,129
150347,1256723,1,17,1,1,0,130
150348,1256723,1,17,2,0,0,130
150349,1256723,1,17,3,1,0,131
150350,1256723,1,17,4,2,0,133
150351,1256723,1,17,5,0,0,133
150352,1256723,1,17,6,1,0,134
150353,1256723,1,18,1,2,0,136
150354,1256723,1,18,2,6,0,142
150355,1256723,1,18,3,6,0,148
150356,1256723,1,18,4,6,0,154
150357,1256723,1,18,5,6,0,160
150358,1256723,1,18,6,2,0,162
150359,1256723,1,19,1,0,1,162
150360,1256723,1,19,2,3,0,165
150361,1256723,1,19,3,6,0,171
150362,1256723,1,19,4,1,0,172
150363,1256723,1,19,5,7,0,179
150364,1256723,1,19,6,1,0,180
150365,1256723,1,20,1,0,1,180
150366,1256723,1,20,2,1,0,181
150367,1256723,1,20,3,0,1,181
150368,1256723,1,20,4,0,0,181
150369,1256723,1,20,5,6,0,187
150370,1256723,1,20,6,6,0,193
150491,1256724,1,1,1,0,0,0
150492,1256724,1,1,2,0,0,0
150493,1256724,1,1,3,0,0,0
150494,1256724,1,1,4,1,0,1
150495,1256724,1,1,5,1,0,2
150496,1256724,1,1,6,1,0,3
150497,1256724,1,2,1,6,0,9
150498,1256724,1,2,2,1,0,10
150499,1256724,1,2,3,2,0,12
150500,1256724,1,2,4,6,0,18
150501,1256724,1,2,5,0,0,18
150502,1256724,1,2,6,4,0,22
150503,1256724,1,3,1,4,0,26
150504,1256724,1,3,2,1,0,27
150505,1256724,1,3,3,1,0,28
150506,1256724,1,3,4,1,0,29
150507,1256724,1,3,5,1,0,30
150508,1256724,1,3,6,1,0,31
150509,1256724,1,4,1,0,0,31
150510,1256724,1,4,2,0,0,31
150511,1256724,1,4,3,0,0,31
150512,1256724,1,4,4,1,0,32
150513,1256724,1,4,5,1,0,33
150514,1256724,1,4,6,0,0,33
150515,1256724,1,5,1,4,0,37
150516,1256724,1,5,2,0,0,37
150517,1256724,1,5,3,6,0,43
150518,1256724,1,5,4,2,0,45
150519,1256724,1,5,5,1,0,46
150520,1256724,1,5,6,1,0,47
150521,1256724,1,6,1,6,0,53
150522,1256724,1,6,2,1,0,54
150523,1256724,1,6,3,0,0,54
150524,1256724,1,6,4,0,0,54
150525,1256724,1,6,5,4,0,58
150526,1256724,1,6,6,0,0,58
150527,1256724,1,7,1,0,0,58
150528,1256724,1,7,2,1,0,59
150529,1256724,1,7,3,0,0,59
150530,1256724,1,7,4,0,1,59
150531,1256724,1,7,5,1,0,60
150532,1256724,1,7,6,0,0,60
150533,1256724,1,8,1,1,0,61
150534,1256724,1,8,2,6,0,67
150535,1256724,1,8,3,0,0,67
150536,1256724,1,8,4,0,0,67
150537,1256724,1,8,5,0,1,67
150538,1256724,1,8,6,2,0,69
150539,1256724,1,9,1,6,0,75
150540,1256724,1,9,2,1,0,76
150541,1256724,1,9,3,1,0,77
150542,1256724,1,9,4,1,0,78
150543,1256724,1,9,5,0,0,78
150544,1256724,1,9,6,0,0,78
150545,1256724,1,10,1,1,0,79
150546,1256724,1,10,2,4,0,83
150547,1256724,1,10,3,1,0,84
150548,1256724,1,10,4,0,0,84
150549,1256724,1,10,5,1,0,85
150550,1256724,1,10,6,1,0,86
150551,1256724,1,11,1,0,0,86
150552,1256724,1,11,2,2,0,88
150553,1256724,1,11,3,1,0,89
150554,1256724,1,11,4,0,1,89
150555,1256724,1,11,5,1,0,90
150556,1256724,1,11,6,1,0,91
150557,1256724,1,12,1,1,0,92
150558,1256724,1,12,2,0,0,92
150559,1256724,1,12,3,1,0,93
150560,1256724,1,12,4,1,0,94
150561,1256724,1,12,5,1,0,95
150562,1256724,1,12,6,0,0,95
150563,1256724,1,13,1,1,0,96
150564,1256724,1,13,2,0,0,96
150565,1256724,1,13,3,1,0,97
150566,1256724,1,13,4,1,0,98
150567,1256724,1,13,5,0,0,98
150568,1256724,1,13,6,1,0,99
150569,1256724,1,14,1,0,0,99
150570,1256724,1,14,2,1,0,100
150571,1256724,1,14,3,1,0,101
150572,1256724,1,14,4,0,0,101
150573,1256724,1,14,5,1,0,102
150574,1256724,1,14,6,1,0,103
150575,1256724,1,15,1,0,0,103
150576,1256724,1,15,2,1,0,104
150577,1256724,1,15,3,1,0,105
150578,1256724,1,15,4,0,1,105
150579,1256724,1,15,5,0,0,105
150580,1256724,1,15,6,0,0,105
150581,1256724,1,16,1,3,0,108
150582,1256724,1,16,2,1,0,109
150583,1256724,1,16,3,1,0,110
150584,1256724,1,16,4,1,0,111
150585,1256724,1,16,5,1,0,112
150586,1256724,1,16,6,1,0,113
150587,1256724,1,17,1,2,0,115
150588,1256724,1,17,2,6,0,121
150589,1256724,1,17,3,1,0,122
150590,1256724,1,17,4,4,0,126
150591,1256724,1,17,5,1,0,127
150592,1256724,1,17,6,4,0,131
150593,1256724,1,18,1,1,0,132
150594,1256724,1,18,2,1,0,133
150595,1256724,1,18,3,1,0,134
150596,1256724,1,18,4,6,0,140
150597,1256724,1,18,5,6,0,146
150598,1256724,1,18,6,0,0,146
150599,1256724,1,19,1,6,0,152
150600,1256724,1,19,2,2,0,154
150601,1256724,1,19,3,2,0,156
150602,1256724,1,19,4,2,0,158
150603,1256724,1,19,5,1,0,159
150604,1256724,1,19,6,1,0,160
150605,1256724,1,20,1,6,0,166
150606,1256724,1,20,2,1,0,167
150607,1256724,1,20,3,6,0,173
150608,1256724,1,20,4,4,0,177
150609,1256724,1,20,5,1,0,178
150610,1256724,1,20,6,1,0,179
150730,1257183,1,1,1,0,0,0
150731,1257183,1,1,2,0,0,0
150732,1257183,1,1,3,1,0,1
150733,1257183,1,1,4,0,0,1
150734,1257183,1,1,5,1,0,2
150735,1257183,1,1,6,4,0,6
150736,1257183,1,2,1,1,0,7
150737,1257183,1,2,2,1,0,8
150738,1257183,1,2,3,0,1,8
150739,1257183,1,2,4,0,0,8
150740,1257183,1,2,5,0,0,8
150741,1257183,1,2,6,0,0,8
150742,1257183,1,3,1,0,0,8
150743,1257183,1,3,2,0,0,8
150744,1257183,1,3,3,0,0,8
150745,1257183,1,3,4,4,0,12
150746,1257183,1,3,5,0,0,12
150747,1257183,1,3,6,1,0,13
150748,1257183,1,4,1,1,0,14
150749,1257183,1,4,2,5,0,19
150750,1257183,1,4,3,0,0,19
150751,1257183,1,4,4,1,0,20
150752,1257183,1,4,5,0,0,20
150753,1257183,1,4,6,1,0,21
150754,1257183,1,5,1,0,0,21
150755,1257183,1,5,2,4,0,25
150756,1257183,1,5,3,1,0,26
150757,1257183,1,5,4,1,0,27
150758,1257183,1,5,5,1,0,28
150759,1257183,1,5,6,4,0,32
150760,1257183,1,6,1,2,0,34
150761,1257183,1,6,2,1,0,35
150762,1257183,1,6,3,0,0,35
150763,1257183,1,6,4,4,0,39
150764,1257183,1,6,5,2,0,41
150765,1257183,1,6,6,1,0,42
150766,1257183,1,7,1,0,0,42
150767,1257183,1,7,2,0,1,42
150768,1257183,1,7,3,1,0,43
150769,1257183,1,7,4,1,0,44
150770,1257183,1,7,5,0,0,44
150771,1257183,1,7,6,1,0,45
150772,1257183,1,8,1,1,0,46
150773,1257183,1,8,2,2,0,48
150774,1257183,1,8,3,1,0,49
150775,1257183,1,8,4,1,0,50
150776,1257183,1,8,5,1,0,51
150777,1257183,1,8,6,4,0,55
150778,1257183,1,9,1,0,1,55
150779,1257183,1,9,2,1,0,56
150780,1257183,1,9,3,4,0,60
150781,1257183,1,9,4,0,0,60
150782,1257183,1,9,5,2,0,62
150783,1257183,1,9,6,1,0,63
150784,1257183,1,10,1,1,0,64
150785,1257183,1,10,2,0,0,64
150786,1257183,1,10,3,1,0,65
150787,1257183,1,10,4,1,0,66
150788,1257183,1,10,5,1,0,67
150789,1257183,1,10,6,0,0,67
150790,1257183,1,11,1,1,0,68
150791,1257183,1,11,2,1,0,69
150792,1257183,1,11,3,1,0,70
150793,1257183,1,11,4,2,0,72
150794,1257183,1,11,5,0,0,72
150795,1257183,1,11,6,2,0,74
150796,1257183,1,12,1,0,0,74
150797,1257183,1,12,2,0,0,74
150798,1257183,1,12,3,0,0,74
150799,1257183,1,12,4,1,0,75
150800,1257183,1,12,5,6,0,81
150801,1257183,1,12,6,1,0,82
150802,1257183,1,13,1,1,0,83
150803,1257183,1,13,2,2,0,85
150804,1257183,1,13,3,2,0,87
150805,1257183,1,13,4,2,0,89
150806,1257183,1,13,5,0,1,89
150807,1257183,1,13,6,0,0,89
150808,1257183,1,14,1,0,0,89
150809,1257183,1,14,2,0,0,89
150810,1257183,1,14,3,1,0,90
150811,1257183,1,14,4,1,0,91
150812,1257183,1,14,5,1,0,92
150813,1257183,1,14,6,1,0,93
150814,1257183,1,15,1,0,0,93
150815,1257183,1,15,2,0,0,93
150816,1257183,1,15,3,1,0,94
150817,1257183,1,15,4,1,0,95
150818,1257183,1,15,5,1,0,96
150819,1257183,1,15,6,0,0,96
150820,1257183,1,16,1,1,0,97
150821,1257183,1,16,2,1,0,98
150822,1257183,1,16,3,0,1,98
150823,1257183,1,16,4,1,0,99
150824,1257183,1,16,5,1,1,100
150825,1257183,1,16,6,4,0,104
150826,1257183,1,17,1,1,0,105
150827,1257183,1,17,2,1,0,106
150828,1257183,1,17,3,2,0,108
150829,1257183,1,17,4,0,0,108
150830,1257183,1,17,5,1,0,109
150831,1257183,1,17,6,2,0,111
150832,1257183,1,18,1,2,0,113
150833,1257183,1,18,2,6,0,119
150834,1257183,1,18,3,1,0,120
150835,1257183,1,18,4,0,0,120
150836,1257183,1,18,5,2,0,122
150837,1257183,1,18,6,2,1,124
150838,1257183,1,19,1,2,0,126
150839,1257183,1,19,2,1,0,127
150840,1257183,1,19,3,0,0,127
150841,1257183,1,19,4,0,0,127
150842,1257183,1,19,5,0,0,127
150843,1257183,1,19,6,2,0,129
150844,1257183,1,20,1,0,0,129
150845,1257183,1,20,2,4,0,133
150846,1257183,1,20,3,2,0,135
150847,1257183,1,20,4,6,0,141
150848,1257183,1,20,5,4,0,145
150849,1257183,1,20,6,4,0,149
150970,1257184,1,1,1,0,0,0
150971,1257184,1,1,2,0,0,0
150972,1257184,1,1,3,0,0,0
150973,1257184,1,1,4,4,0,4
150974,1257184,1,1,5,0,0,4
150975,1257184,1,1,6,0,0,4
150976,1257184,1,2,1,1,0,5
150977,1257184,1,2,2,0,0,5
150978,1257184,1,2,3,0,0,5
150979,1257184,1,2,4,2,0,7
150980,1257184,1,2,5,1,0,8
150981,1257184,1,2,6,1,0,9
150982,1257184,1,3,1,1,0,10
150983,1257184,1,3,2,2,0,12
150984,1257184,1,3,3,0,0,12
150985,1257184,1,3,4,0,0,12
150986,1257184,1,3,5,1,0,13
150987,1257184,1,3,6,1,0,14
150988,1257184,1,4,1,1,0,15
150989,1257184,1,4,2,0,0,15
150990,1257184,1,4,3,0,0,15
150991,1257184,1,4,4,2,0,17
150992,1257184,1,4,5,0,0,17
150993,1257184,1,4,6,1,0,18
150994,1257184,1,5,1,0,0,18
150995,1257184,1,5,2,1,0,19
150996,1257184,1,5,3,0,0,19
150997,1257184,1,5,4,0,1,19
150998,1257184,1,5,5,4,0,23
150999,1257184,1,5,6,0,0,23
151000,1257184,1,6,1,0,0,23
151001,1257184,1,6,2,0,0,23
151002,1257184,1,6,3,1,0,24
151003,1257184,1,6,4,1,0,25
151004,1257184,1,6,5,0,0,25
151005,1257184,1,6,6,0,0,25
151006,1257184,1,7,1,0,0,25
151007,1257184,1,7,2,0,0,25
151008,1257184,1,7,3,0,0,25
151009,1257184,1,7,4,0,0,25
151010,1257184,1,7,5,1,0,26
151011,1257184,1,7,6,1,0,27
151012,1257184,1,8,1,2,0,29
151013,1257184,1,8,2,2,0,31
151014,1257184,1,8,3,0,0,31
151015,1257184,1,8,4,1,0,32
151016,1257184,1,8,5,1,0,33
151017,1257184,1,8,6,0,0,33
151018,1257184,1,9,1,1,0,34
151019,1257184,1,9,2,4,0,38
151020,1257184,1,9,3,1,0,39
151021,1257184,1,9,4,1,0,40
151022,1257184,1,9,5,0,0,40
151023,1257184,1,9,6,0,0,40
151024,1257184,1,10,1,0,0,40
151025,1257184,1,10,2,1,0,41
151026,1257184,1,10,3,1,0,42
151027,1257184,1,10,4,0,0,42
151028,1257184,1,10,5,1,0,43
151029,1257184,1,10,6,4,0,47
151030,1257184,1,11,1,0,1,47
151031,1257184,1,11,2,0,0,47
151032,1257184,1,11,3,1,0,48
151033,1257184,1,11,4,1,0,49
151034,1257184,1,11,5,4,0,53
151035,1257184,1,11,6,1,0,54
151036,1257184,1,12,1,2,0,56
151037,1257184,1,12,2,0,0,56
151038,1257184,1,12,3,0,0,56
151039,1257184,1,12,4,1,0,57
151040,1257184,1,12,5,4,0,61
151041,1257184,1,12,6,4,0,65
151042,1257184,1,13,1,1,0,66
151043,1257184,1,13,2,2,0,68
151044,1257184,1,13,3,0,1,68
151045,1257184,1,13,4,0,0,68
151046,1257184,1,13,5,2,0,70
151047,1257184,1,13,6,1,0,71
151048,1257184,1,14,1,0,1,71
151049,1257184,1,14,2,2,0,73
151050,1257184,1,14,3,2,0,75
151051,1257184,1,14,4,1,0,76
151052,1257184,1,14,5,2,0,78
151053,1257184,1,14,6,1,0,79
151054,1257184,1,15,1,2,0,81
151055,1257184,1,15,2,1,0,82
151056,1257184,1,15,3,1,0,83
151057,1257184,1,15,4,0,1,83
151058,1257184,1,15,5,1,0,84
151059,1257184,1,15,6,1,0,85
151060,1257184,1,16,1,1,0,86
151061,1257184,1,16,2,0,0,86
151062,1257184,1,16,3,0,0,86
151063,1257184,1,16,4,1,0,87
151064,1257184,1,16,5,0,0,87
151065,1257184,1,16,6,1,0,88
151066,1257184,1,17,1,6,0,94
151067,1257184,1,17,2,1,0,95
151068,1257184,1,17,3,2,0,97
151069,1257184,1,17,4,4,0,101
151070,1257184,1,17,5,2,0,103
151071,1257184,1,17,6,2,0,105
151072,1257184,1,18,1,1,0,106
151073,1257184,1,18,2,1,0,107
151074,1257184,1,18,3,1,0,108
151075,1257184,1,18,4,0,1,108
151076,1257184,1,18,5,0,0,108
151077,1257184,1,18,6,6,0,114
151078,1257184,1,19,1,1,0,115
151079,1257184,1,19,2,0,0,115
151080,1257184,1,19,3,0,0,115
151081,1257184,1,19,4,1,0,116
151082,1257184,1,19,5,0,1,116
151083,1257184,1,19,6,0,0,116
151084,1257184,1,20,1,0,1,116
151085,1257184,1,20,2,0,0,116
151086,1257184,1,20,3,0,1,116
151087,1257184,1,20,4,1,0,117
151088,1257184,1,20,5,1,0,118
151089,1257184,1,20,6,0,0,118
151209,1257185,1,1,1,1,0,1
151210,1257185,1,1,2,0,0,1
151211,1257185,1,1,3,0,0,1
151212,1257185,1,1,4,0,0,1
151213,1257185,1,1,5,0,0,1
151214,1257185,1,1,6,4,0,5
151215,1257185,1,2,1,0,0,5
151216,1257185,1,2,2,4,0,9
151217,1257185,1,2,3,1,0,10
151218,1257185,1,2,4,1,0,11
151219,1257185,1,2,5,0,0,11
151220,1257185,1,2,6,0,0,11
151221,1257185,1,3,1,1,0,12
151222,1257185,1,3,2,0,0,12
151223,1257185,1,3,3,1,0,13
151224,1257185,1,3,4,1,0,14
151225,1257185,1,3,5,1,0,15
151226,1257185,1,3,6,0,0,15
151227,1257185,1,4,1,2,0,17
151228,1257185,1,4,2,1,0,18
151229,1257185,1,4,3,4,0,22
151230,1257185,1,4,4,4,0,26
151231,1257185,1,4,5,1,0,27
151232,1257185,1,4,6,1,0,28
151233,1257185,1,5,1,4,0,32
151234,1257185,1,5,2,0,0,32
151235,1257185,1,5,3,1,0,33
151236,1257185,1,5,4,2,0,35
151237,1257185,1,5,5,0,0,35
151238,1257185,1,5,6,0,1,35
151239,1257185,1,6,1,0,0,35
151240,1257185,1,6,2,1,0,36
151241,1257185,1,6,3,4,0,40
151242,1257185,1,6,4,1,0,41
151243,1257185,1,6,5,1,0,42
151244,1257185,1,6,6,1,0,43
151245,1257185,1,7,1,3,0,46
151246,1257185,1,7,2,1,0,47
151247,1257185,1,7,3,0,0,47
151248,1257185,1,7,4,2,0,49
151249,1257185,1,7,5,0,0,49
151250,1257185,1,7,6,0,0,49
151251,1257185,1,8,1,0,0,49
151252,1257185,1,8,2,1,0,50
151253,1257185,1,8,3,2,0,52
151254,1257185,1,8,4,1,0,53
151255,1257185,1,8,5,0,0,53
151256,1257185,1,8,6,1,0,54
151257,1257185,1,9,1,1,0,55
151258,1257185,1,9,2,1,0,56
151259,1257185,1,9,3,1,0,57
151260,1257185,1,9,4,0,0,57
151261,1257185,1,9,5,1,0,58
151262,1257185,1,9,6,1,0,59
151263,1257185,1,10,1,0,0,59
151264,1257185,1,10,2,0,0,59
151265,1257185,1,10,3,1,0,60
151266,1257185,1,10,4,4,0,64
151267,1257185,1,10,5,1,0,65
151268,1257185,1,10,6,1,0,66
151269,1257185,1,11,1,0,0,66
151270,1257185,1,11,2,1,0,67
151271,1257185,1,11,3,1,0,68
151272,1257185,1,11,4,1,0,69
151273,1257185,1,11,5,1,0,70
151274,1257185,1,11,6,2,0,72
151275,1257185,1,12,1,2,0,74
151276,1257185,1,12,2,2,0,76
151277,1257185,1,12,3,1,0,77
151278,1257185,1,12,4,1,0,78
151279,1257185,1,12,5,2,0,80
151280,1257185,1,12,6,1,0,81
151281,1257185,1,13,1,1,0,82
151282,1257185,1,13,2,4,0,86
151283,1257185,1,13,3,4,0,90
151284,1257185,1,13,4,1,0,91
151285,1257185,1,13,5,1,0,92
151286,1257185,1,13,6,1,0,93
151287,1257185,1,14,1,1,0,94
151288,1257185,1,14,2,1,0,95
151289,1257185,1,14,3,2,0,97
151290,1257185,1,14,4,1,0,98
151291,1257185,1,14,5,1,0,99
151292,1257185,1,14,6,1,0,100
151293,1257185,1,15,1,1,0,101
151294,1257185,1,15,2,0,0,101
151295,1257185,1,15,3,2,0,103
151296,1257185,1,15,4,1,0,104
151297,1257185,1,15,5,4,0,108
151298,1257185,1,15,6,1,0,109
151299,1257185,1,16,1,2,0,111
151300,1257185,1,16,2,0,0,111
151301,1257185,1,16,3,1,0,112
151302,1257185,1,16,4,0,0,112
151303,1257185,1,16,5,4,0,116
151304,1257185,1,16,6,0,0,116
151305,1257185,1,17,1,2,0,118
151306,1257185,1,17,2,9,0,127
151307,1257185,1,17,3,1,0,128
151308,1257185,1,17,4,0,0,128
151309,1257185,1,17,5,2,0,130
151310,1257185,1,17,6,0,0,130
151311,1257185,1,18,1,0,0,130
151312,1257185,1,18,2,6,0,136
151313,1257185,1,18,3,1,0,137
151314,1257185,1,18,4,1,0,138
151315,1257185,1,18,5,1,0,139
151316,1257185,1,18,6,1,0,140
151317,1257185,1,19,1,4,0,144
151318,1257185,1,19,2,2,0,146
151319,1257185,1,19,3,1,0,147
151320,1257185,1,19,4,4,0,151
151321,1257185,1,19,5,6,0,157
151322,1257185,1,19,6,1,0,158
151323,1257185,1,20,1,1,0,159
151324,1257185,1,20,2,2,0,161
151325,1257185,1,20,3,0,1,161
151326,1257185,1,20,4,0,1,161
151327,1257185,1,20,5,2,0,163
151328,1257185,1,20,6,2,0,165
151449,1257945,1,1,1,4,0,4
151450,1257945,1,1,2,0,0,4
151451,1257945,1,1,3,0,0,4
151452,1257945,1,1,4,0,0,4
151453,1257945,1,1,5,0,0,4
151454,1257945,1,1,6,0,0,4
151455,1257945,1,2,1,1,0,5
151456,1257945,1,2,2,4,0,9
151457,1257945,1,2,3,0,0,9
151458,1257945,1,2,4,2,0,11
151459,1257945,1,2,5,0,0,11
151460,1257945,1,2,6,0,1,11
151461,1257945,1,3,1,0,0,11
151462,1257945,1,3,2,1,0,12
151463,1257945,1,3,3,0,0,12
151464,1257945,1,3,4,0,1,12
151465,1257945,1,3,5,0,0,12
151466,1257945,1,3,6,0,0,12
151467,1257945,1,4,1,1,0,13
151468,1257945,1,4,2,0,0,13
151469,1257945,1,4,3,1,0,14
151470,1257945,1,4,4,0,0,14
151471,1257945,1,4,5,4,0,18
151472,1257945,1,4,6,0,0,18
151473,1257945,1,5,1,0,0,18
151474,1257945,1,5,2,0,0,18
151475,1257945,1,5,3,4,0,22
151476,1257945,1,5,4,0,0,22
151477,1257945,1,5,5,0,0,22
151478,1257945,1,5,6,0,0,22
151479,1257945,1,6,1,1,0,23
151480,1257945,1,6,2,0,0,23
151481,1257945,1,6,3,0,0,23
151482,1257945,1,6,4,0,0,23
151483,1257945,1,6,5,0,0,23
151484,1257945,1,6,6,0,0,23
151485,1257945,1,7,1,3,0,26
151486,1257945,1,7,2,4,0,30
151487,1257945,1,7,3,2,0,32
151488,1257945,1,7,4,1,0,33
151489,1257945,1,7,5,4,0,37
151490,1257945,1,7,6,0,0,37
151491,1257945,1,8,1,0,0,37
151492,1257945,1,8,2,0,0,37
151493,1257945,1,8,3,1,0,38
151494,1257945,1,8,4,0,0,38
151495,1257945,1,8,5,0,0,38
151496,1257945,1,8,6,0,0,38
151497,1257945,1,9,1,1,0,39
151498,1257945,1,9,2,0,0,39
151499,1257945,1,9,3,1,0,40
151500,1257945,1,9,4,0,0,40
151501,1257945,1,9,5,0,0,40
151502,1257945,1,9,6,1,0,41
151503,1257945,1,10,1,2,0,43
151504,1257945,1,10,2,1,0,44
151505,1257945,1,10,3,1,0,45
151506,1257945,1,10,4,0,0,45
151507,1257945,1,10,5,4,0,49
151508,1257945,1,10,6,1,0,50
151509,1257945,1,11,1,1,0,51
151510,1257945,1,11,2,2,0,53
151511,1257945,1,11,3,0,0,53
151512,1257945,1,11,4,0,0,53
151513,1257945,1,11,5,1,0,54
151514,1257945,1,11,6,0,0,54
151515,1257945,1,12,1,4,0,58
151516,1257945,1,12,2,1,0,59
151517,1257945,1,12,3,0,0,59
151518,1257945,1,12,4,1,0,60
151519,1257945,1,12,5,0,0,60
151520,1257945,1,12,6,2,0,62
151521,1257945,1,13,1,1,0,63
151522,1257945,1,13,2,1,0,64
151523,1257945,1,13,3,0,0,64
151524,1257945,1,13,4,0,0,64
151525,1257945,1,13,5,1,0,65
151526,1257945,1,13,6,0,0,65
151527,1257945,1,14,1,1,0,66
151528,1257945,1,14,2,1,0,67
151529,1257945,1,14,3,0,0,67
151530,1257945,1,14,4,6,0,73
151531,1257945,1,14,5,0,1,73
151532,1257945,1,14,6,0,0,73
151533,1257945,1,15,1,0,0,73
151534,1257945,1,15,2,1,0,74
151535,1257945,1,15,3,0,0,74
151536,1257945,1,15,4,1,0,75
151537,1257945,1,15,5,1,0,76
151538,1257945,1,15,6,1,0,77
151539,1257945,1,16,1,0,0,77
151540,1257945,1,16,2,1,0,78
151541,1257945,1,16,3,0,0,78
151542,1257945,1,16,4,1,0,79
151543,1257945,1,16,5,6,0,85
151544,1257945,1,16,6,6,0,91
151545,1257945,1,17,1,0,0,91
151546,1257945,1,17,2,5,0,96
151547,1257945,1,17,3,1,0,97
151548,1257945,1,17,4,0,0,97
151549,1257945,1,17,5,2,0,99
151550,1257945,1,17,6,0,1,99
151551,1257945,1,18,1,1,0,100
151552,1257945,1,18,2,1,0,101
151553,1257945,1,18,3,1,0,102
151554,1257945,1,18,4,0,0,102
151555,1257945,1,18,5,1,0,103
151556,1257945,1,18,6,6,0,109
151557,1257945,1,19,1,0,0,109
151558,1257945,1,19,2,2,0,111
151559,1257945,1,19,3,4,0,115
151560,1257945,1,19,4,1,0,116
151561,1257945,1,19,5,6,0,122
151562,1257945,1,19,6,4,0,126
151563,1257945,1,20,1,1,0,127
151564,1257945,1,20,2,1,0,128
151565,1257945,1,20,3,4,0,132
151566,1257945,1,20,4,2,0,134
151567,1257945,1,20,5,1,0,135
151568,1257945,1,20,6,1,0,136
151659,1257948,1,1,1,1,0,1
151660,1257948,1,1,2,1,0,2
151661,1257948,1,1,3,5,0,7
151662,1257948,1,1,4,2,0,9
151663,1257948,1,1,5,0,0,9
151664,1257948,1,1,6,1,0,10
151665,1257948,1,2,1,4,0,14
151666,1257948,1,2,2,4,0,18
151667,1257948,1,2,3,0,0,18
151668,1257948,1,2,4,2,0,20
151669,1257948,1,2,5,0,0,20
151670,1257948,1,2,6,0,1,20
151671,1257948,1,3,1,0,0,20
151672,1257948,1,3,2,1,0,21
151673,1257948,1,3,3,0,0,21
151674,1257948,1,3,4,2,0,23
151675,1257948,1,3,5,0,0,23
151676,1257948,1,3,6,4,0,27
151677,1257948,1,4,1,2,0,29
151678,1257948,1,4,2,1,0,30
151679,1257948,1,4,3,4,0,34
151680,1257948,1,4,4,4,0,38
151681,1257948,1,4,5,4,0,42
151682,1257948,1,4,6,1,0,43
151683,1257948,1,5,1,1,0,44
151684,1257948,1,5,2,0,0,44
151685,1257948,1,5,3,2,0,46
151686,1257948,1,5,4,0,0,46
151687,1257948,1,5,5,0,0,46
151688,1257948,1,5,6,0,0,46
151689,1257948,1,6,1,0,0,46
151690,1257948,1,6,2,1,0,47
151691,1257948,1,6,3,2,0,49
151692,1257948,1,6,4,1,0,50
151693,1257948,1,6,5,4,0,54
151694,1257948,1,6,6,6,0,60
151695,1257948,1,7,1,0,0,60
151696,1257948,1,7,2,1,0,61
151697,1257948,1,7,3,0,0,61
151698,1257948,1,7,4,1,0,62
151699,1257948,1,7,5,1,0,63
151700,1257948,1,7,6,0,1,63
151701,1257948,1,8,1,1,0,64
151702,1257948,1,8,2,2,0,66
151703,1257948,1,8,3,1,0,67
151704,1257948,1,8,4,0,0,67
151705,1257948,1,8,5,1,0,68
151706,1257948,1,8,6,4,0,72
151707,1257948,1,9,1,1,0,73
151708,1257948,1,9,2,0,0,73
151709,1257948,1,9,3,1,0,74
151710,1257948,1,9,4,1,0,75
151711,1257948,1,9,5,0,0,75
151712,1257948,1,9,6,0,0,75
151713,1257948,1,10,1,0,0,75
151714,1257948,1,10,2,1,0,76
151715,1257948,1,10,3,1,0,77
151716,1257948,1,10,4,2,0,79
151717,1257948,1,10,5,4,0,83
151718,1257948,1,10,6,2,0,85
151719,1257948,1,11,1,1,0,86
151720,1257948,1,11,2,0,0,86
151721,1257948,1,11,3,2,0,88
151722,1257948,1,11,4,0,0,88
151723,1257948,1,11,5,2,0,90
151724,1257948,1,11,6,2,0,92
151725,1257948,1,12,1,1,0,93
151726,1257948,1,12,2,0,0,93
151727,1257948,1,12,3,1,0,94
151728,1257948,1,12,4,8,0,102
151729,1257948,1,12,5,4,0,106
151730,1257948,1,12,6,1,0,107
151731,1257948,1,13,1,1,0,108
151732,1257948,1,13,2,0,0,108
151733,1257948,1,13,3,1,0,109
151734,1257948,1,13,4,1,0,110
151735,1257948,1,13,5,0,0,110
151736,1257948,1,13,6,7,0,117
151737,1257948,1,14,1,6,0,123
151738,1257948,1,14,2,1,0,124
151739,1257948,1,14,3,1,0,125
151740,1257948,1,14,4,6,0,131
151741,1257948,1,14,5,1,0,132
151742,1257948,1,14,6,1,0,133
151743,1257948,1,15,1,4,0,137
151744,1257948,1,15,2,4,0,141
151745,1257948,1,15,3,0,1,141
151746,1257948,1,15,4,1,0,142
151747,1257948,1,15,5,0,0,142
151748,1257948,1,15,6,0,0,142
151749,1257948,1,16,1,6,0,148
151750,1257948,1,16,2,6,0,154
151751,1257948,1,16,3,0,1,154
151752,1257948,1,16,4,0,0,154
151753,1257948,1,16,5,6,0,160
151754,1257948,1,16,6,6,0,166
151755,1257948,1,17,1,2,0,168
151756,1257948,1,17,2,2,0,170
151757,1257948,1,17,3,6,0,176
151758,1257948,1,17,4,0,1,176
151759,1257948,1,17,5,1,0,177
151760,1257948,1,17,6,1,0,178
151761,1257948,1,18,1,0,1,178
151762,1257948,1,18,2,1,0,179
151763,1257948,1,18,3,1,0,180
151764,1257948,1,18,4,4,0,184
151765,1257948,1,18,5,0,0,184
151766,1257948,1,18,6,1,0,185
151767,1257948,1,19,1,4,0,189
151768,1257948,1,19,2,1,0,190
151769,1257948,1,19,3,1,0,191
151770,1257948,1,19,4,2,0,193
151771,1257948,1,19,5,0,0,193
151772,1257948,1,19,6,1,0,194
151773,1257948,1,20,1,0,0,194
151774,1257948,1,20,2,1,0,195
151775,1257948,1,20,3,1,0,196
151776,1257948,1,20,4,7,0,203
151777,1257948,1,20,5,1,0,204
151778,1257948,1,20,6,2,0,206
151896,1257951,1,1,1,0,0,0
151897,1257951,1,1,2,1,0,1
151898,1257951,1,1,3,0,0,1
151899,1257951,1,1,4,6,0,7
151900,1257951,1,1,5,0,0,7
151901,1257951,1,1,6,0,0,7
151902,1257951,1,2,1,5,0,12
151903,1257951,1,2,2,4,0,16
151904,1257951,1,2,3,1,0,17
151905,1257951,1,2,4,5,0,22
151906,1257951,1,2,5,6,0,28
151907,1257951,1,2,6,0,0,28
151908,1257951,1,3,1,2,0,30
151909,1257951,1,3,2,0,1,30
151910,1257951,1,3,3,0,0,30
151911,1257951,1,3,4,1,0,31
151912,1257951,1,3,5,0,0,31
151913,1257951,1,3,6,4,0,35
151914,1257951,1,4,1,1,0,36
151915,1257951,1,4,2,1,0,37
151916,1257951,1,4,3,1,0,38
151917,1257951,1,4,4,1,0,39
151918,1257951,1,4,5,1,0,40
151919,1257951,1,4,6,1,0,41
151920,1257951,1,5,1,0,0,41
151921,1257951,1,5,2,1,0,42
151922,1257951,1,5,3,4,0,46
151923,1257951,1,5,4,1,0,47
151924,1257951,1,5,5,0,0,47
151925,1257951,1,5,6,1,0,48
151926,1257951,1,6,1,1,0,49
151927,1257951,1,6,2,6,0,55
151928,1257951,1,6,3,1,0,56
151929,1257951,1,6,4,0,0,56
151930,1257951,1,6,5,0,0,56
151931,1257951,1,6,6,0,0,56
151932,1257951,1,7,1,0,0,56
151933,1257951,1,7,2,1,0,57
151934,1257951,1,7,3,0,0,57
151935,1257951,1,7,4,1,0,58
151936,1257951,1,7,5,4,0,62
151937,1257951,1,7,6,0,0,62
151938,1257951,1,8,1,4,0,66
151939,1257951,1,8,2,1,0,67
151940,1257951,1,8,3,0,0,67
151941,1257951,1,8,4,6,0,73
151942,1257951,1,8,5,1,0,74
151943,1257951,1,8,6,0,0,74
151944,1257951,1,9,1,1,0,75
151945,1257951,1,9,2,0,0,75
151946,1257951,1,9,3,4,0,79
151947,1257951,1,9,4,4,0,83
151948,1257951,1,9,5,0,0,83
151949,1257951,1,9,6,0,0,83
151950,1257951,1,10,1,2,0,85
151951,1257951,1,10,2,2,0,87
151952,1257951,1,10,3,0,1,87
151953,1257951,1,10,4,2,0,89
151954,1257951,1,10,5,1,0,90
151955,1257951,1,10,6,1,0,91
151956,1257951,1,11,1,1,0,92
151957,1257951,1,11,2,0,0,92
151958,1257951,1,11,3,6,0,98
151959,1257951,1,11,4,1,0,99
151960,1257951,1,11,5,2,0,101
151961,1257951,1,11,6,6,0,107
151962,1257951,1,12,1,1,0,108
151963,1257951,1,12,2,1,0,109
151964,1257951,1,12,3,1,0,110
151965,1257951,1,12,4,1,0,111
151966,1257951,1,12,5,1,0,112
151967,1257951,1,12,6,1,0,113
151968,1257951,1,13,1,0,0,113
151969,1257951,1,13,2,1,0,114
151970,1257951,1,13,3,1,0,115
151971,1257951,1,13,4,6,0,121
151972,1257951,1,13,5,4,0,125
151973,1257951,1,13,6,1,0,126
151974,1257951,1,14,1,4,0,130
151975,1257951,1,14,2,6,0,136
151976,1257951,1,14,3,1,0,137
151977,1257951,1,14,4,0,0,137
151978,1257951,1,14,5,0,0,137
151979,1257951,1,14,6,0,0,137
151980,1257951,1,15,1,1,0,138
151981,1257951,1,15,2,9,0,147
151982,1257951,1,15,3,6,0,153
151983,1257951,1,15,4,1,0,154
151984,1257951,1,15,5,3,0,157
151985,1257951,1,15,6,0,0,157
151986,1257951,1,16,1,4,0,161
151987,1257951,1,16,2,1,0,162
151988,1257951,1,16,3,1,0,163
151989,1257951,1,16,4,0,1,163
151990,1257951,1,16,5,6,0,169
151991,1257951,1,16,6,0,0,169
151992,1257951,1,17,1,2,0,171
151993,1257951,1,17,2,4,0,175
151994,1257951,1,17,3,1,0,176
151995,1257951,1,17,4,1,0,177
151996,1257951,1,17,5,1,0,178
151997,1257951,1,17,6,6,0,184
151998,1257951,1,18,1,4,0,188
151999,1257951,1,18,2,6,0,194
152000,1257951,1,18,3,1,0,195
152001,1257951,1,18,4,6,0,201
152002,1257951,1,18,5,2,0,203
152003,1257951,1,18,6,3,0,206
152004,1257951,1,19,1,0,0,206
152005,1257951,1,19,2,1,0,207
152006,1257951,1,19,3,1,0,208
152007,1257951,1,19,4,6,0,214
152008,1257951,1,19,5,4,0,218
152009,1257951,1,19,6,4,0,222
152010,1257951,1,20,1,1,0,223
152011,1257951,1,20,2,2,0,225
152012,1257951,1,20,3,7,0,232
152013,1257951,1,20,4,0,0,232
152014,1257951,1,20,5,2,0,234
152015,1257951,1,20,6,4,0,238
152120,1262758,1,1,1,0,1,0
152121,1262758,1,1,2,1,0,1
152122,1262758,1,1,3,1,0,2
152123,1262758,1,1,4,2,0,4
152124,1262758,1,1,5,0,0,4
152125,1262758,1,1,6,0,0,4
152126,1262758,1,2,1,1,0,5
152127,1262758,1,2,2,1,0,6
152128,1262758,1,2,3,0,0,6
152129,1262758,1,2,4,1,0,7
152130,1262758,1,2,5,1,0,8
152131,1262758,1,2,6,4,0,12
152132,1262758,1,3,1,4,0,16
152133,1262758,1,3,2,0,0,16
152134,1262758,1,3,3,0,0,16
152135,1262758,1,3,4,1,0,17
152136,1262758,1,3,5,0,0,17
152137,1262758,1,3,6,1,0,18
152138,1262758,1,4,1,4,0,22
152139,1262758,1,4,2,0,0,22
152140,1262758,1,4,3,2,0,24
152141,1262758,1,4,4,4,0,28
152142,1262758,1,4,5,0,0,28
152143,1262758,1,4,6,1,0,29
152144,1262758,1,5,1,1,0,30
152145,1262758,1,5,2,0,0,30
152146,1262758,1,5,3,1,0,31
152147,1262758,1,5,4,2,0,33
152148,1262758,1,5,5,1,0,34
152149,1262758,1,5,6,1,0,35
152150,1262758,1,6,1,6,0,41
152151,1262758,1,6,2,5,0,46
152152,1262758,1,6,3,2,0,48
152153,1262758,1,6,4,2,0,50
152154,1262758,1,6,5,0,0,50
152155,1262758,1,6,6,1,0,51
152156,1262758,1,7,1,0,1,51
152157,1262758,1,7,2,1,0,52
152158,1262758,1,7,3,0,0,52
152159,1262758,1,7,4,0,0,52
152160,1262758,1,7,5,1,0,53
152161,1262758,1,7,6,2,0,55
152162,1262758,1,8,1,1,0,56
152163,1262758,1,8,2,0,0,56
152164,1262758,1,8,3,1,0,57
152165,1262758,1,8,4,1,0,58
152166,1262758,1,8,5,0,0,58
152167,1262758,1,8,6,1,0,59
152168,1262758,1,9,1,4,0,63
152169,1262758,1,9,2,0,0,63
152170,1262758,1,9,3,1,0,64
152171,1262758,1,9,4,1,0,65
152172,1262758,1,9,5,4,0,69
152173,1262758,1,9,6,1,0,70
152174,1262758,1,10,1,0,0,70
152175,1262758,1,10,2,4,0,74
152176,1262758,1,10,3,1,0,75
152177,1262758,1,10,4,1,0,76
152178,1262758,1,10,5,0,0,76
152179,1262758,1,10,6,2,0,78
152180,1262758,1,11,1,1,0,79
152181,1262758,1,11,2,4,0,83
152182,1262758,1,11,3,1,0,84
152183,1262758,1,11,4,1,0,85
152184,1262758,1,11,5,0,0,85
152185,1262758,1,11,6,2,0,87
152186,1262758,1,12,1,1,0,88
152187,1262758,1,12,2,6,0,94
152188,1262758,1,12,3,1,0,95
152189,1262758,1,12,4,1,0,96
152190,1262758,1,12,5,4,0,100
152191,1262758,1,12,6,1,0,101
152192,1262758,1,13,1,1,0,102
152193,1262758,1,13,2,1,0,103
152194,1262758,1,13,3,0,0,103
152195,1262758,1,13,4,1,0,104
152196,1262758,1,13,5,0,0,104
152197,1262758,1,13,6,1,0,105
152198,1262758,1,14,1,4,0,109
152199,1262758,1,14,2,0,0,109
152200,1262758,1,14,3,1,0,110
152201,1262758,1,14,4,0,0,110
152202,1262758,1,14,5,2,0,112
152203,1262758,1,14,6,1,0,113
152204,1262758,1,15,1,0,1,113
152205,1262758,1,15,2,1,0,114
152206,1262758,1,15,3,6,0,120
152207,1262758,1,15,4,0,0,120
152208,1262758,1,15,5,1,0,121
152209,1262758,1,15,6,0,0,121
152210,1262758,1,16,1,6,0,127
152211,1262758,1,16,2,0,1,127
152212,1262758,1,16,3,0,0,127
152213,1262758,1,16,4,1,0,128
152214,1262758,1,16,5,1,0,129
152215,1262758,1,16,6,1,0,130
152216,1262758,1,17,1,1,0,131
152217,1262758,1,17,2,0,0,131
152218,1262758,1,17,3,0,0,131
152219,1262758,1,17,4,4,0,135
152220,1262758,1,17,5,1,0,136
152221,1262758,1,17,6,1,0,137
152222,1262758,1,18,1,0,0,137
152223,1262758,1,18,2,2,0,139
152224,1262758,1,18,3,1,0,140
152225,1262758,1,18,4,0,0,140
152226,1262758,1,18,5,6,0,146
152227,1262758,1,18,6,1,0,147
152228,1262758,1,19,1,4,0,151
152229,1262758,1,19,2,1,0,152
152230,1262758,1,19,3,1,0,153
152231,1262758,1,19,4,0,1,153
152232,1262758,1,19,5,1,0,154
152233,1262758,1,19,6,1,0,155
152234,1262758,1,20,1,2,0,157
152235,1262758,1,20,2,1,0,158
152236,1262758,1,20,3,1,0,159
152237,1262758,1,20,4,2,0,161
152238,1262758,1,20,5,1,0,162
152239,1262758,1,20,6,2,0,164
152351,1262759,1,1,1,2,0,2
152352,1262759,1,1,2,1,0,3
152353,1262759,1,1,3,1,0,4
152354,1262759,1,1,4,4,0,8
152355,1262759,1,1,5,1,0,9
152356,1262759,1,1,6,0,0,9
152357,1262759,1,2,1,1,0,10
152358,1262759,1,2,2,1,0,11
152359,1262759,1,2,3,2,0,13
152360,1262759,1,2,4,1,0,14
152361,1262759,1,2,5,0,0,14
152362,1262759,1,2,6,1,0,15
152363,1262759,1,3,1,4,0,19
152364,1262759,1,3,2,1,0,20
152365,1262759,1,3,3,4,0,24
152366,1262759,1,3,4,0,0,24
152367,1262759,1,3,5,1,0,25
152368,1262759,1,3,6,2,0,27
152369,1262759,1,4,1,1,0,28
152370,1262759,1,4,2,3,0,31
152371,1262759,1,4,3,0,0,31
152372,1262759,1,4,4,0,0,31
152373,1262759,1,4,5,0,0,31
152374,1262759,1,4,6,0,0,31
152375,1262759,1,5,1,1,0,32
152376,1262759,1,5,2,1,0,33
152377,1262759,1,5,3,1,0,34
152378,1262759,1,5,4,4,0,38
152379,1262759,1,5,5,0,0,38
152380,1262759,1,5,6,0,0,38
152381,1262759,1,6,1,1,0,39
152382,1262759,1,6,2,1,0,40
152383,1262759,1,6,3,3,0,43
152384,1262759,1,6,4,1,0,44
152385,1262759,1,6,5,1,0,45
152386,1262759,1,6,6,0,0,45
152387,1262759,1,7,1,0,0,45
152388,1262759,1,7,2,1,0,46
152389,1262759,1,7,3,2,0,48
152390,1262759,1,7,4,1,0,49
152391,1262759,1,7,5,0,0,49
152392,1262759,1,7,6,0,1,49
152393,1262759,1,8,1,0,0,49
152394,1262759,1,8,2,0,0,49
152395,1262759,1,8,3,0,0,49
152396,1262759,1,8,4,1,0,50
152397,1262759,1,8,5,0,0,50
152398,1262759,1,8,6,1,0,51
152399,1262759,1,9,1,1,0,52
152400,1262759,1,9,2,0,0,52
152401,1262759,1,9,3,1,0,53
152402,1262759,1,9,4,1,0,54
152403,1262759,1,9,5,0,0,54
152404,1262759,1,9,6,0,0,54
152405,1262759,1,10,1,1,0,55
152406,1262759,1,10,2,0,0,55
152407,1262759,1,10,3,4,0,59
152408,1262759,1,10,4,1,0,60
152409,1262759,1,10,5,1,0,61
152410,1262759,1,10,6,0,0,61
152411,1262759,1,11,1,1,0,62
152412,1262759,1,11,2,1,0,63
152413,1262759,1,11,3,0,0,63
152414,1262759,1,11,4,1,0,64
152415,1262759,1,11,5,1,0,65
152416,1262759,1,11,6,6,0,71
152417,1262759,1,12,1,4,0,75
152418,1262759,1,12,2,0,0,75
152419,1262759,1,12,3,2,0,77
152420,1262759,1,12,4,2,0,79
152421,1262759,1,12,5,0,0,79
152422,1262759,1,12,6,2,0,81
152423,1262759,1,13,1,0,1,81
152424,1262759,1,13,2,0,0,81
152425,1262759,1,13,3,1,0,82
152426,1262759,1,13,4,1,0,83
152427,1262759,1,13,5,1,0,84
152428,1262759,1,13,6,1,0,85
152429,1262759,1,14,1,1,0,86
152430,1262759,1,14,2,1,0,87
152431,1262759,1,14,3,1,0,88
152432,1262759,1,14,4,0,0,88
152433,1262759,1,14,5,0,0,88
152434,1262759,1,14,6,0,0,88
152435,1262759,1,15,1,1,0,89
152436,1262759,1,15,2,1,0,90
152437,1262759,1,15,3,2,0,92
152438,1262759,1,15,4,0,0,92
152439,1262759,1,15,5,1,0,93
152440,1262759,1,15,6,1,0,94
152441,1262759,1,16,1,1,0,95
152442,1262759,1,16,2,4,0,99
152443,1262759,1,16,3,0,1,99
152444,1262759,1,16,4,0,0,99
152445,1262759,1,16,5,1,0,100
152446,1262759,1,16,6,0,0,100
152447,1262759,1,17,1,0,0,100
152448,1262759,1,17,2,1,0,101
152449,1262759,1,17,3,1,0,102
152450,1262759,1,17,4,2,1,104
152451,1262759,1,17,5,2,0,106
152452,1262759,1,17,6,1,0,107
152453,1262759,1,18,1,1,0,108
152454,1262759,1,18,2,2,0,110
152455,1262759,1,18,3,1,0,111
152456,1262759,1,18,4,2,0,113
152457,1262759,1,18,5,0,0,113
152458,1262759,1,18,6,1,0,114
152459,1262759,1,19,1,1,0,115
152460,1262759,1,19,2,2,0,117
152461,1262759,1,19,3,0,0,117
152462,1262759,1,19,4,2,0,119
152463,1262759,1,19,5,3,0,122
152464,1262759,1,19,6,6,0,128
152465,1262759,1,20,1,1,0,129
152466,1262759,1,20,2,0,0,129
152467,1262759,1,20,3,1,0,130
152468,1262759,1,20,4,0,1,130
152469,1262759,1,20,5,1,0,131
152470,1262759,1,20,6,1,0,132
152589,1262760,1,1,1,0,0,0
152590,1262760,1,1,2,4,0,4
152591,1262760,1,1,3,1,0,5
152592,1262760,1,1,4,0,1,5
152593,1262760,1,1,5,0,0,5
152594,1262760,1,1,6,0,0,5
152595,1262760,1,2,1,1,0,6
152596,1262760,1,2,2,4,0,10
152597,1262760,1,2,3,1,0,11
152598,1262760,1,2,4,1,0,12
152599,1262760,1,2,5,0,0,12
152600,1262760,1,2,6,0,0,12
152601,1262760,1,3,1,1,0,13
152602,1262760,1,3,2,0,0,13
152603,1262760,1,3,3,0,0,13
152604,1262760,1,3,4,0,0,13
152605,1262760,1,3,5,0,0,13
152606,1262760,1,3,6,1,0,14
152607,1262760,1,4,1,0,0,14
152608,1262760,1,4,2,1,0,15
152609,1262760,1,4,3,4,0,19
152610,1262760,1,4,4,2,0,21
152611,1262760,1,4,5,2,0,23
152612,1262760,1,4,6,0,1,23
152613,1262760,1,5,1,1,0,24
152614,1262760,1,5,2,0,0,24
152615,1262760,1,5,3,0,0,24
152616,1262760,1,5,4,0,1,24
152617,1262760,1,5,5,1,0,25
152618,1262760,1,5,6,0,1,25
152619,1262760,1,6,1,0,0,25
152620,1262760,1,6,2,1,0,26
152621,1262760,1,6,3,0,0,26
152622,1262760,1,6,4,1,0,27
152623,1262760,1,6,5,1,0,28
152624,1262760,1,6,6,1,0,29
152625,1262760,1,7,1,0,0,29
152626,1262760,1,7,2,1,0,30
152627,1262760,1,7,3,0,0,30
152628,1262760,1,7,4,1,0,31
152629,1262760,1,7,5,1,0,32
152630,1262760,1,7,6,1,0,33
152631,1262760,1,8,1,0,0,33
152632,1262760,1,8,2,1,0,34
152633,1262760,1,8,3,1,0,35
152634,1262760,1,8,4,0,0,35
152635,1262760,1,8,5,0,0,35
152636,1262760,1,8,6,0,0,35
152637,1262760,1,9,1,0,0,35
152638,1262760,1,9,2,0,0,35
152639,1262760,1,9,3,1,0,36
152640,1262760,1,9,4,0,0,36
152641,1262760,1,9,5,0,0,36
152642,1262760,1,9,6,0,1,36
152643,1262760,1,10,1,0,0,36
152644,1262760,1,10,2,1,0,37
152645,1262760,1,10,3,0,0,37
152646,1262760,1,10,4,0,0,37
152647,1262760,1,10,5,1,0,38
152648,1262760,1,10,6,1,0,39
152649,1262760,1,11,1,0,0,39
152650,1262760,1,11,2,1,0,40
152651,1262760,1,11,3,0,0,40
152652,1262760,1,11,4,1,0,41
152653,1262760,1,11,5,0,0,41
152654,1262760,1,11,6,1,0,42
152655,1262760,1,12,1,0,0,42
152656,1262760,1,12,2,0,0,42
152657,1262760,1,12,3,0,0,42
152658,1262760,1,12,4,0,0,42
152659,1262760,1,12,5,0,0,42
152660,1262760,1,12,6,1,0,43
152661,1262760,1,13,1,1,0,44
152662,1262760,1,13,2,1,0,45
152663,1262760,1,13,3,0,0,45
152664,1262760,1,13,4,1,0,46
152665,1262760,1,13,5,2,0,48
152666,1262760,1,13,6,0,0,48
152667,1262760,1,14,1,1,0,49
152668,1262760,1,14,2,0,0,49
152669,1262760,1,14,3,1,0,50
152670,1262760,1,14,4,0,0,50
152671,1262760,1,14,5,1,0,51
152672,1262760,1,14,6,2,0,53
152673,1262760,1,15,1,0,0,53
152674,1262760,1,15,2,1,0,54
152675,1262760,1,15,3,0,0,54
152676,1262760,1,15,4,1,0,55
152677,1262760,1,15,5,0,1,55
152678,1262760,1,15,6,0,0,55
152679,1262760,1,16,1,1,0,56
152680,1262760,1,16,2,4,0,60
152681,1262760,1,16,3,0,0,60
152682,1262760,1,16,4,1,0,61
152683,1262760,1,16,5,1,0,62
152684,1262760,1,16,6,0,1,62
152685,1262760,1,17,1,0,0,62
152686,1262760,1,17,2,1,0,63
152687,1262760,1,17,3,0,0,63
152688,1262760,1,17,4,0,1,63
152689,1262760,1,17,5,0,0,63
152690,1262760,1,17,6,0,0,63
152691,1262760,1,18,1,1,0,64
152692,1262760,1,18,2,0,0,64
152693,1262760,1,18,3,1,0,65
152694,1262760,1,18,4,0,0,65
152695,1262760,1,18,5,0,0,65
152696,1262760,1,18,6,1,0,66
152697,1262760,1,19,1,1,0,67
152698,1262760,1,19,2,2,0,69
152699,1262760,1,19,3,3,0,72
152700,1262760,1,19,4,1,0,73
152701,1262760,1,19,5,1,0,74
152702,1262760,1,19,6,1,0,75
152703,1262760,1,20,1,1,0,76
152704,1262760,1,20,2,1,0,77
152705,1262760,1,20,3,1,0,78
152706,1262760,1,20,4,1,0,79
152707,1262760,1,20,5,0,0,79
152708,1262760,1,20,6,2,0,81
152797,1263151,1,1,1,0,0,0
152798,1263151,1,1,2,0,0,0
152799,1263151,1,1,3,1,0,1
152800,1263151,1,1,4,0,0,1
152801,1263151,1,1,5,2,0,3
152802,1263151,1,1,6,1,0,4
152803,1263151,1,2,1,0,0,4
152804,1263151,1,2,2,3,0,7
152805,1263151,1,2,3,2,0,9
152806,1263151,1,2,4,4,0,13
152807,1263151,1,2,5,1,0,14
152808,1263151,1,2,6,1,0,15
152809,1263151,1,3,1,4,0,19
152810,1263151,1,3,2,1,0,20
152811,1263151,1,3,3,1,0,21
152812,1263151,1,3,4,6,0,27
152813,1263151,1,3,5,4,0,31
152814,1263151,1,3,6,1,0,32
152815,1263151,1,4,1,0,0,32
152816,1263151,1,4,2,1,0,33
152817,1263151,1,4,3,0,0,33
152818,1263151,1,4,4,0,1,33
152819,1263151,1,4,5,0,0,33
152820,1263151,1,4,6,0,0,33
152821,1263151,1,5,1,0,0,33
152822,1263151,1,5,2,4,0,37
152823,1263151,1,5,3,0,0,37
152824,1263151,1,5,4,2,0,39
152825,1263151,1,5,5,6,0,45
152826,1263151,1,5,6,1,0,46
152827,1263151,1,6,1,0,0,46
152828,1263151,1,6,2,1,0,47
152829,1263151,1,6,3,0,0,47
152830,1263151,1,6,4,4,0,51
152831,1263151,1,6,5,1,0,52
152832,1263151,1,6,6,1,0,53
152833,1263151,1,7,1,0,0,53
152834,1263151,1,7,2,6,0,59
152835,1263151,1,7,3,2,0,61
152836,1263151,1,7,4,0,1,61
152837,1263151,1,7,5,1,0,62
152838,1263151,1,7,6,0,0,62
152839,1263151,1,8,1,1,0,63
152840,1263151,1,8,2,1,0,64
152841,1263151,1,8,3,1,0,65
152842,1263151,1,8,4,1,0,66
152843,1263151,1,8,5,1,0,67
152844,1263151,1,8,6,1,0,68
152845,1263151,1,9,1,1,0,69
152846,1263151,1,9,2,4,0,73
152847,1263151,1,9,3,1,0,74
152848,1263151,1,9,4,0,0,74
152849,1263151,1,9,5,4,0,78
152850,1263151,1,9,6,2,0,80
152851,1263151,1,10,1,1,0,81
152852,1263151,1,10,2,0,0,81
152853,1263151,1,10,3,4,0,85
152854,1263151,1,10,4,1,0,86
152855,1263151,1,10,5,0,0,86
152856,1263151,1,10,6,0,0,86
152857,1263151,1,11,1,1,0,87
152858,1263151,1,11,2,1,0,88
152859,1263151,1,11,3,1,0,89
152860,1263151,1,11,4,1,0,90
152861,1263151,1,11,5,1,0,91
152862,1263151,1,11,6,4,0,95
152863,1263151,1,12,1,0,1,95
152864,1263151,1,12,2,1,0,96
152865,1263151,1,12,3,1,0,97
152866,1263151,1,12,4,1,0,98
152867,1263151,1,12,5,1,0,99
152868,1263151,1,12,6,1,0,100
152869,1263151,1,13,1,1,0,101
152870,1263151,1,13,2,0,0,101
152871,1263151,1,13,3,1,0,102
152872,1263151,1,13,4,1,0,103
152873,1263151,1,13,5,0,0,103
152874,1263151,1,13,6,1,0,104
152875,1263151,1,14,1,0,0,104
152876,1263151,1,14,2,1,0,105
152877,1263151,1,14,3,2,0,107
152878,1263151,1,14,4,1,0,108
152879,1263151,1,14,5,1,0,109
152880,1263151,1,14,6,0,0,109
152881,1263151,1,15,1,1,0,110
152882,1263151,1,15,2,1,0,111
152883,1263151,1,15,3,1,0,112
152884,1263151,1,15,4,0,1,112
152885,1263151,1,15,5,1,0,113
152886,1263151,1,15,6,1,0,114
152887,1263151,1,16,1,1,0,115
152888,1263151,1,16,2,0,0,115
152889,1263151,1,16,3,1,0,116
152890,1263151,1,16,4,2,0,118
152891,1263151,1,16,5,4,0,122
152892,1263151,1,16,6,0,0,122
152893,1263151,1,17,1,1,0,123
152894,1263151,1,17,2,0,0,123
152895,1263151,1,17,3,1,0,124
152896,1263151,1,17,4,2,0,126
152897,1263151,1,17,5,1,0,127
152898,1263151,1,17,6,6,0,133
152899,1263151,1,18,1,1,0,134
152900,1263151,1,18,2,1,0,135
152901,1263151,1,18,3,1,0,136
152902,1263151,1,18,4,1,0,137
152903,1263151,1,18,5,1,0,138
152904,1263151,1,18,6,2,0,140
152905,1263151,1,19,1,0,0,140
152906,1263151,1,19,2,0,1,140
152907,1263151,1,19,3,0,1,140
152908,1263151,1,19,4,1,0,141
152909,1263151,1,19,5,4,0,145
152910,1263151,1,19,6,2,0,147
152911,1263151,1,20,1,6,0,153
152912,1263151,1,20,2,1,0,154
152913,1263151,1,20,3,1,0,155
152914,1263151,1,20,4,4,0,159
152915,1263151,1,20,5,0,0,159
152916,1263151,1,20,6,1,0,160
153007,1263152,1,1,1,1,0,1
153008,1263152,1,1,2,1,0,2
153009,1263152,1,1,3,0,0,2
153010,1263152,1,1,4,0,0,2
153011,1263152,1,1,5,1,0,3
153012,1263152,1,1,6,0,0,3
153013,1263152,1,2,1,2,0,5
153014,1263152,1,2,2,1,0,6
153015,1263152,1,2,3,4,0,10
153016,1263152,1,2,4,1,0,11
153017,1263152,1,2,5,4,0,15
153018,1263152,1,2,6,0,0,15
153019,1263152,1,3,1,0,0,15
153020,1263152,1,3,2,4,0,19
153021,1263152,1,3,3,6,0,25
153022,1263152,1,3,4,4,0,29
153023,1263152,1,3,5,0,0,29
153024,1263152,1,3,6,0,0,29
153025,1263152,1,4,1,6,0,35
153026,1263152,1,4,2,4,0,39
153027,1263152,1,4,3,0,0,39
153028,1263152,1,4,4,4,0,43
153029,1263152,1,4,5,0,0,43
153030,1263152,1,4,6,4,0,47
153031,1263152,1,5,1,0,0,47
153032,1263152,1,5,2,0,0,47
153033,1263152,1,5,3,6,0,53
153034,1263152,1,5,4,0,0,53
153035,1263152,1,5,5,1,0,54
153036,1263152,1,5,6,4,0,58
153037,1263152,1,6,1,1,0,59
153038,1263152,1,6,2,2,0,61
153039,1263152,1,6,3,0,0,61
153040,1263152,1,6,4,5,0,66
153041,1263152,1,6,5,2,0,68
153042,1263152,1,6,6,1,0,69
153043,1263152,1,7,1,1,0,70
153044,1263152,1,7,2,1,0,71
153045,1263152,1,7,3,1,0,72
153046,1263152,1,7,4,1,0,73
153047,1263152,1,7,5,0,1,73
153048,1263152,1,7,6,4,0,77
153049,1263152,1,8,1,1,0,78
153050,1263152,1,8,2,1,0,79
153051,1263152,1,8,3,0,0,79
153052,1263152,1,8,4,1,0,80
153053,1263152,1,8,5,0,0,80
153054,1263152,1,8,6,1,0,81
153055,1263152,1,9,1,1,0,82
153056,1263152,1,9,2,0,0,82
153057,1263152,1,9,3,1,0,83
153058,1263152,1,9,4,1,0,84
153059,1263152,1,9,5,1,0,85
153060,1263152,1,9,6,1,0,86
153061,1263152,1,10,1,1,0,87
153062,1263152,1,10,2,1,0,88
153063,1263152,1,10,3,4,0,92
153064,1263152,1,10,4,1,0,93
153065,1263152,1,10,5,1,0,94
153066,1263152,1,10,6,1,0,95
153067,1263152,1,11,1,1,0,96
153068,1263152,1,11,2,0,1,96
153069,1263152,1,11,3,1,0,97
153070,1263152,1,11,4,4,0,101
153071,1263152,1,11,5,1,0,102
153072,1263152,1,11,6,1,0,103
153073,1263152,1,12,1,1,0,104
153074,1263152,1,12,2,0,0,104
153075,1263152,1,12,3,1,0,105
153076,1263152,1,12,4,0,0,105
153077,1263152,1,12,5,4,0,109
153078,1263152,1,12,6,1,0,110
153079,1263152,1,13,1,2,0,112
153080,1263152,1,13,2,6,0,118
153081,1263152,1,13,3,1,0,119
153082,1263152,1,13,4,1,0,120
153083,1263152,1,13,5,1,0,121
153084,1263152,1,13,6,1,0,122
153085,1263152,1,14,1,0,1,122
153086,1263152,1,14,2,0,0,122
153087,1263152,1,14,3,4,0,126
153088,1263152,1,14,4,0,0,126
153089,1263152,1,14,5,1,0,127
153090,1263152,1,14,6,0,0,127
153091,1263152,1,15,1,6,0,133
153092,1263152,1,15,2,2,0,135
153093,1263152,1,15,3,1,0,136
153094,1263152,1,15,4,1,0,137
153095,1263152,1,15,5,0,0,137
153096,1263152,1,15,6,1,0,138
153097,1263152,1,16,1,1,0,139
153098,1263152,1,16,2,0,1,139
153099,1263152,1,16,3,1,0,140
153100,1263152,1,16,4,4,0,144
153101,1263152,1,16,5,1,0,145
153102,1263152,1,16,6,0,0,145
153103,1263152,1,17,1,1,0,146
153104,1263152,1,17,2,1,0,147
153105,1263152,1,17,3,1,0,148
153106,1263152,1,17,4,1,0,149
153107,1263152,1,17,5,0,1,149
153108,1263152,1,17,6,1,0,150
153109,1263152,1,18,1,2,0,152
153110,1263152,1,18,2,0,1,152
153111,1263152,1,18,3,1,0,153
153112,1263152,1,18,4,2,0,155
153113,1263152,1,18,5,1,0,156
153114,1263152,1,18,6,1,0,157
153115,1263152,1,19,1,2,0,159
153116,1263152,1,19,2,1,0,160
153117,1263152,1,19,3,1,0,161
153118,1263152,1,19,4,0,0,161
153119,1263152,1,19,5,1,0,162
153120,1263152,1,19,6,1,0,163
153121,1263152,1,20,1,2,0,165
153122,1263152,1,20,2,0,0,165
153123,1263152,1,20,3,0,1,165
153124,1263152,1,20,4,1,0,166
153125,1263152,1,20,5,0,0,166
153126,1263152,1,20,6,0,0,166
153247,1263153,1,1,1,0,0,0
153248,1263153,1,1,2,0,0,0
153249,1263153,1,1,3,2,0,2
153250,1263153,1,1,4,0,0,2
153251,1263153,1,1,5,0,0,2
153252,1263153,1,1,6,5,0,7
153253,1263153,1,2,1,1,0,8
153254,1263153,1,2,2,1,0,9
153255,1263153,1,2,3,0,0,9
153256,1263153,1,2,4,1,0,10
153257,1263153,1,2,5,1,0,11
153258,1263153,1,2,6,4,0,15
153259,1263153,1,3,1,6,0,21
153260,1263153,1,3,2,4,0,25
153261,1263153,1,3,3,1,0,26
153262,1263153,1,3,4,1,0,27
153263,1263153,1,3,5,4,0,31
153264,1263153,1,3,6,0,0,31
153265,1263153,1,4,1,1,0,32
153266,1263153,1,4,2,1,0,33
153267,1263153,1,4,3,4,0,37
153268,1263153,1,4,4,0,0,37
153269,1263153,1,4,5,4,0,41
153270,1263153,1,4,6,1,0,42
153271,1263153,1,5,1,0,1,42
153272,1263153,1,5,2,0,0,42
153273,1263153,1,5,3,0,0,42
153274,1263153,1,5,4,1,0,43
153275,1263153,1,5,5,1,0,44
153276,1263153,1,5,6,0,1,44
153277,1263153,1,6,1,3,0,47
153278,1263153,1,6,2,0,0,47
153279,1263153,1,6,3,0,0,47
153280,1263153,1,6,4,2,0,49
153281,1263153,1,6,5,2,0,51
153282,1263153,1,6,6,0,0,51
153283,1263153,1,7,1,2,0,53
153284,1263153,1,7,2,1,0,54
153285,1263153,1,7,3,0,0,54
153286,1263153,1,7,4,1,0,55
153287,1263153,1,7,5,1,0,56
153288,1263153,1,7,6,1,0,57
153289,1263153,1,8,1,1,0,58
153290,1263153,1,8,2,1,0,59
153291,1263153,1,8,3,0,0,59
153292,1263153,1,8,4,2,0,61
153293,1263153,1,8,5,6,0,67
153294,1263153,1,8,6,1,0,68
153295,1263153,1,9,1,1,0,69
153296,1263153,1,9,2,1,0,70
153297,1263153,1,9,3,4,0,74
153298,1263153,1,9,4,1,0,75
153299,1263153,1,9,5,6,0,81
153300,1263153,1,9,6,4,0,85
153301,1263153,1,10,1,1,0,86
153302,1263153,1,10,2,0,0,86
153303,1263153,1,10,3,1,0,87
153304,1263153,1,10,4,0,1,87
153305,1263153,1,10,5,4,0,91
153306,1263153,1,10,6,0,0,91
153307,1263153,1,11,1,1,0,92
153308,1263153,1,11,2,0,0,92
153309,1263153,1,11,3,2,0,94
153310,1263153,1,11,4,1,0,95
153311,1263153,1,11,5,1,0,96
153312,1263153,1,11,6,1,0,97
153313,1263153,1,12,1,2,0,99
153314,1263153,1,12,2,1,0,100
153315,1263153,1,12,3,1,0,101
153316,1263153,1,12,4,0,0,101
153317,1263153,1,12,5,1,0,102
153318,1263153,1,12,6,1,0,103
153319,1263153,1,13,1,2,0,105
153320,1263153,1,13,2,4,0,109
153321,1263153,1,13,3,1,0,110
153322,1263153,1,13,4,4,0,114
153323,1263153,1,13,5,1,0,115
153324,1263153,1,13,6,2,0,117
153325,1263153,1,14,1,0,0,117
153326,1263153,1,14,2,1,0,118
153327,1263153,1,14,3,1,0,119
153328,1263153,1,14,4,1,0,120
153329,1263153,1,14,5,1,0,121
153330,1263153,1,14,6,1,0,122
153331,1263153,1,15,1,1,0,123
153332,1263153,1,15,2,2,0,125
153333,1263153,1,15,3,1,0,126
153334,1263153,1,15,4,2,0,128
153335,1263153,1,15,5,1,0,129
153336,1263153,1,15,6,2,0,131
153337,1263153,1,16,1,2,0,133
153338,1263153,1,16,2,0,0,133
153339,1263153,1,16,3,1,0,134
153340,1263153,1,16,4,4,0,138
153341,1263153,1,16,5,1,0,139
153342,1263153,1,16,6,1,0,140
153343,1263153,1,17,1,0,0,140
153344,1263153,1,17,2,1,0,141
153345,1263153,1,17,3,0,0,141
153346,1263153,1,17,4,2,0,143
153347,1263153,1,17,5,2,0,145
153348,1263153,1,17,6,1,0,146
153349,1263153,1,18,1,1,1,147
153350,1263153,1,18,2,3,0,150
153351,1263153,1,18,3,0,1,150
153352,1263153,1,18,4,0,0,150
153353,1263153,1,18,5,0,0,150
153354,1263153,1,18,6,0,0,150
153355,1263153,1,19,1,1,0,151
153356,1263153,1,19,2,0,1,151
153357,1263153,1,19,3,1,0,152
153358,1263153,1,19,4,2,0,154
153359,1263153,1,19,5,6,0,160
153360,1263153,1,19,6,1,1,161
153361,1263153,1,20,1,0,0,161
153362,1263153,1,20,2,0,0,161
153363,1263153,1,20,3,1,0,162
153364,1263153,1,20,4,2,1,164
153365,1263153,1,20,5,2,0,166
153366,1263153,1,20,6,1,0,167
153487,1263154,1,1,1,4,0,4
153488,1263154,1,1,2,0,0,4
153489,1263154,1,1,3,4,0,8
153490,1263154,1,1,4,6,0,14
153491,1263154,1,1,5,0,0,14
153492,1263154,1,1,6,6,0,20
153493,1263154,1,2,1,0,0,20
153494,1263154,1,2,2,6,0,26
153495,1263154,1,2,3,0,0,26
153496,1263154,1,2,4,1,0,27
153497,1263154,1,2,5,0,0,27
153498,1263154,1,2,6,0,0,27
153499,1263154,1,3,1,0,1,27
153500,1263154,1,3,2,4,0,31
153501,1263154,1,3,3,0,0,31
153502,1263154,1,3,4,0,0,31
153503,1263154,1,3,5,0,0,31
153504,1263154,1,3,6,1,0,32
153505,1263154,1,4,1,0,0,32
153506,1263154,1,4,2,0,0,32
153507,1263154,1,4,3,0,1,32
153508,1263154,1,4,4,1,0,33
153509,1263154,1,4,5,1,0,34
153510,1263154,1,4,6,1,0,35
153511,1263154,1,5,1,1,0,36
153512,1263154,1,5,2,0,0,36
153513,1263154,1,5,3,6,0,42
153514,1263154,1,5,4,0,0,42
153515,1263154,1,5,5,0,0,42
153516,1263154,1,5,6,4,0,46
153517,1263154,1,6,1,1,0,47
153518,1263154,1,6,2,6,0,53
153519,1263154,1,6,3,4,0,57
153520,1263154,1,6,4,0,0,57
153521,1263154,1,6,5,0,0,57
153522,1263154,1,6,6,0,0,57
153523,1263154,1,7,1,1,0,58
153524,1263154,1,7,2,0,0,58
153525,1263154,1,7,3,0,0,58
153526,1263154,1,7,4,0,0,58
153527,1263154,1,7,5,0,0,58
153528,1263154,1,7,6,0,0,58
153529,1263154,1,8,1,1,0,59
153530,1263154,1,8,2,1,0,60
153531,1263154,1,8,3,0,0,60
153532,1263154,1,8,4,0,0,60
153533,1263154,1,8,5,0,0,60
153534,1263154,1,8,6,0,0,60
153535,1263154,1,9,1,1,0,61
153536,1263154,1,9,2,1,0,62
153537,1263154,1,9,3,0,0,62
153538,1263154,1,9,4,0,0,62
153539,1263154,1,9,5,1,0,63
153540,1263154,1,9,6,0,1,63
153541,1263154,1,10,1,0,0,63
153542,1263154,1,10,2,1,0,64
153543,1263154,1,10,3,1,0,65
153544,1263154,1,10,4,1,0,66
153545,1263154,1,10,5,0,0,66
153546,1263154,1,10,6,1,0,67
153547,1263154,1,11,1,0,0,67
153548,1263154,1,11,2,1,0,68
153549,1263154,1,11,3,1,0,69
153550,1263154,1,11,4,1,0,70
153551,1263154,1,11,5,0,1,70
153552,1263154,1,11,6,1,0,71
153553,1263154,1,12,1,0,0,71
153554,1263154,1,12,2,1,0,72
153555,1263154,1,12,3,1,0,73
153556,1263154,1,12,4,1,0,74
153557,1263154,1,12,5,4,0,78
153558,1263154,1,12,6,1,0,79
153559,1263154,1,13,1,4,0,83
153560,1263154,1,13,2,1,0,84
153561,1263154,1,13,3,1,0,85
153562,1263154,1,13,4,0,0,85
153563,1263154,1,13,5,1,0,86
153564,1263154,1,13,6,1,0,87
153565,1263154,1,14,1,1,0,88
153566,1263154,1,14,2,1,0,89
153567,1263154,1,14,3,0,1,89
153568,1263154,1,14,4,0,0,89
153569,1263154,1,14,5,4,0,93
153570,1263154,1,14,6,1,0,94
153571,1263154,1,15,1,1,0,95
153572,1263154,1,15,2,0,0,95
153573,1263154,1,15,3,1,0,96
153574,1263154,1,15,4,1,0,97
153575,1263154,1,15,5,1,0,98
153576,1263154,1,15,6,1,0,99
153577,1263154,1,16,1,1,0,100
153578,1263154,1,16,2,1,0,101
153579,1263154,1,16,3,0,1,101
153580,1263154,1,16,4,0,0,101
153581,1263154,1,16,5,0,0,101
153582,1263154,1,16,6,0,0,101
153583,1263154,1,17,1,1,0,102
153584,1263154,1,17,2,1,0,103
153585,1263154,1,17,3,1,0,104
153586,1263154,1,17,4,1,0,105
153587,1263154,1,17,5,6,0,111
153588,1263154,1,17,6,1,0,112
153589,1263154,1,18,1,5,0,117
153590,1263154,1,18,2,1,0,118
153591,1263154,1,18,3,0,0,118
153592,1263154,1,18,4,4,0,122
153593,1263154,1,18,5,1,0,123
153594,1263154,1,18,6,1,0,124
153595,1263154,1,19,1,6,0,130
153596,1263154,1,19,2,6,0,136
153597,1263154,1,19,3,6,0,142
153598,1263154,1,19,4,2,0,144
153599,1263154,1,19,5,1,0,145
153600,1263154,1,19,6,4,0,149
153601,1263154,1,20,1,6,0,155
153602,1263154,1,20,2,1,0,156
153603,1263154,1,20,3,4,0,160
153604,1263154,1,20,4,1,0,161
153605,1263154,1,20,5,6,0,167
153606,1263154,1,20,6,0,0,167
153727,1263155,1,1,1,0,0,0
153728,1263155,1,1,2,0,0,0
153729,1263155,1,1,3,0,1,0
153730,1263155,1,1,4,1,0,1
153731,1263155,1,1,5,2,0,3
153732,1263155,1,1,6,0,0,3
153733,1263155,1,2,1,2,0,5
153734,1263155,1,2,2,0,0,5
153735,1263155,1,2,3,1,0,6
153736,1263155,1,2,4,0,0,6
153737,1263155,1,2,5,1,0,7
153738,1263155,1,2,6,0,0,7
153739,1263155,1,3,1,0,0,7
153740,1263155,1,3,2,2,0,9
153741,1263155,1,3,3,0,0,9
153742,1263155,1,3,4,4,0,13
153743,1263155,1,3,5,2,0,15
153744,1263155,1,3,6,0,0,15
153745,1263155,1,4,1,2,0,17
153746,1263155,1,4,2,1,0,18
153747,1263155,1,4,3,0,0,18
153748,1263155,1,4,4,1,0,19
153749,1263155,1,4,5,1,0,20
153750,1263155,1,4,6,1,0,21
153751,1263155,1,5,1,6,0,27
153752,1263155,1,5,2,1,0,28
153753,1263155,1,5,3,1,0,29
153754,1263155,1,5,4,1,0,30
153755,1263155,1,5,5,2,0,32
153756,1263155,1,5,6,2,0,34
153757,1263155,1,6,1,1,0,35
153758,1263155,1,6,2,4,0,39
153759,1263155,1,6,3,6,0,45
153760,1263155,1,6,4,4,0,49
153761,1263155,1,6,5,0,0,49
153762,1263155,1,6,6,0,0,49
153763,1263155,1,7,1,1,0,50
153764,1263155,1,7,2,6,0,56
153765,1263155,1,7,3,0,0,56
153766,1263155,1,7,4,1,0,57
153767,1263155,1,7,5,2,0,59
153768,1263155,1,7,6,1,0,60
153769,1263155,1,8,1,2,0,62
153770,1263155,1,8,2,1,0,63
153771,1263155,1,8,3,0,0,63
153772,1263155,1,8,4,1,0,64
153773,1263155,1,8,5,1,0,65
153774,1263155,1,8,6,6,0,71
153775,1263155,1,9,1,0,0,71
153776,1263155,1,9,2,1,0,72
153777,1263155,1,9,3,1,0,73
153778,1263155,1,9,4,2,0,75
153779,1263155,1,9,5,2,0,77
153780,1263155,1,9,6,0,0,77
153781,1263155,1,10,1,1,0,78
153782,1263155,1,10,2,1,0,79
153783,1263155,1,10,3,1,0,80
153784,1263155,1,10,4,4,0,84
153785,1263155,1,10,5,2,0,86
153786,1263155,1,10,6,1,0,87
153787,1263155,1,11,1,1,0,88
153788,1263155,1,11,2,6,0,94
153789,1263155,1,11,3,1,0,95
153790,1263155,1,11,4,0,0,95
153791,1263155,1,11,5,1,0,96
153792,1263155,1,11,6,2,0,98
153793,1263155,1,12,1,1,0,99
153794,1263155,1,12,2,1,0,100
153795,1263155,1,12,3,0,0,100
153796,1263155,1,12,4,6,0,106
153797,1263155,1,12,5,4,0,110
153798,1263155,1,12,6,2,0,112
153799,1263155,1,13,1,1,0,113
153800,1263155,1,13,2,3,0,116
153801,1263155,1,13,3,1,0,117
153802,1263155,1,13,4,0,0,117
153803,1263155,1,13,5,1,0,118
153804,1263155,1,13,6,1,0,119
153805,1263155,1,14,1,0,0,119
153806,1263155,1,14,2,4,0,123
153807,1263155,1,14,3,1,0,124
153808,1263155,1,14,4,1,0,125
153809,1263155,1,14,5,2,0,127
153810,1263155,1,14,6,1,0,128
153811,1263155,1,15,1,0,1,128
153812,1263155,1,15,2,4,0,132
153813,1263155,1,15,3,1,0,133
153814,1263155,1,15,4,1,0,134
153815,1263155,1,15,5,1,0,135
153816,1263155,1,15,6,1,0,136
153817,1263155,1,16,1,1,0,137
153818,1263155,1,16,2,1,0,138
153819,1263155,1,16,3,1,0,139
153820,1263155,1,16,4,1,0,140
153821,1263155,1,16,5,1,0,141
153822,1263155,1,16,6,1,0,142
153823,1263155,1,17,1,1,0,143
153824,1263155,1,17,2,1,0,144
153825,1263155,1,17,3,0,1,144
153826,1263155,1,17,4,1,0,145
153827,1263155,1,17,5,1,0,146
153828,1263155,1,17,6,1,0,147
153829,1263155,1,18,1,2,0,149
153830,1263155,1,18,2,0,1,149
153831,1263155,1,18,3,1,0,150
153832,1263155,1,18,4,1,0,151
153833,1263155,1,18,5,1,0,152
153834,1263155,1,18,6,1,0,153
153835,1263155,1,19,1,1,0,154
153836,1263155,1,19,2,1,0,155
153837,1263155,1,19,3,1,0,156
153838,1263155,1,19,4,0,0,156
153839,1263155,1,19,5,4,0,160
153840,1263155,1,19,6,0,0,160
153841,1263155,1,20,1,1,0,161
153842,1263155,1,20,2,1,0,162
153843,1263155,1,20,3,4,0,166
153844,1263155,1,20,4,1,0,167
153845,1263155,1,20,5,0,0,167
153846,1263155,1,20,6,1,0,168
153967,1263156,1,1,1,0,0,0
153968,1263156,1,1,2,0,0,0
153969,1263156,1,1,3,0,0,0
153970,1263156,1,1,4,4,0,4
153971,1263156,1,1,5,4,0,8
153972,1263156,1,1,6,0,0,8
153973,1263156,1,2,1,0,0,8
153974,1263156,1,2,2,0,1,8
153975,1263156,1,2,3,0,0,8
153976,1263156,1,2,4,0,0,8
153977,1263156,1,2,5,0,0,8
153978,1263156,1,2,6,1,0,9
153979,1263156,1,3,1,0,0,9
153980,1263156,1,3,2,0,0,9
153981,1263156,1,3,3,2,0,11
153982,1263156,1,3,4,0,0,11
153983,1263156,1,3,5,0,0,11
153984,1263156,1,3,6,0,0,11
153985,1263156,1,4,1,0,0,11
153986,1263156,1,4,2,0,0,11
153987,1263156,1,4,3,0,0,11
153988,1263156,1,4,4,0,0,11
153989,1263156,1,4,5,0,0,11
153990,1263156,1,4,6,0,0,11
153991,1263156,1,5,1,6,0,17
153992,1263156,1,5,2,0,0,17
153993,1263156,1,5,3,1,0,18
153994,1263156,1,5,4,0,0,18
153995,1263156,1,5,5,4,0,22
153996,1263156,1,5,6,0,0,22
153997,1263156,1,6,1,0,0,22
153998,1263156,1,6,2,0,0,22
153999,1263156,1,6,3,0,0,22
154000,1263156,1,6,4,1,0,23
154001,1263156,1,6,5,1,1,24
154002,1263156,1,6,6,0,0,24
154003,1263156,1,7,1,1,0,25
154004,1263156,1,7,2,1,0,26
154005,1263156,1,7,3,1,0,27
154006,1263156,1,7,4,1,0,28
154007,1263156,1,7,5,0,0,28
154008,1263156,1,7,6,6,0,34
154009,1263156,1,8,1,0,0,34
154010,1263156,1,8,2,1,0,35
154011,1263156,1,8,3,0,1,35
154012,1263156,1,8,4,1,0,36
154013,1263156,1,8,5,1,0,37
154014,1263156,1,8,6,1,0,38
154015,1263156,1,9,1,0,0,38
154016,1263156,1,9,2,1,0,39
154017,1263156,1,9,3,0,0,39
154018,1263156,1,9,4,1,0,40
154019,1263156,1,9,5,1,0,41
154020,1263156,1,9,6,1,0,42
154021,1263156,1,10,1,0,0,42
154022,1263156,1,10,2,1,0,43
154023,1263156,1,10,3,1,0,44
154024,1263156,1,10,4,4,0,48
154025,1263156,1,10,5,4,0,52
154026,1263156,1,10,6,1,0,53
154027,1263156,1,11,1,0,0,53
154028,1263156,1,11,2,0,0,53
154029,1263156,1,11,3,4,0,57
154030,1263156,1,11,4,0,0,57
154031,1263156,1,11,5,1,0,58
154032,1263156,1,11,6,1,0,59
154033,1263156,1,12,1,1,0,60
154034,1263156,1,12,2,0,0,60
154035,1263156,1,12,3,1,0,61
154036,1263156,1,12,4,4,0,65
154037,1263156,1,12,5,0,1,65
154038,1263156,1,12,6,1,0,66
154039,1263156,1,13,1,1,0,67
154040,1263156,1,13,2,0,0,67
154041,1263156,1,13,3,1,0,68
154042,1263156,1,13,4,1,0,69
154043,1263156,1,13,5,4,0,73
154044,1263156,1,13,6,0,0,73
154045,1263156,1,14,1,1,0,74
154046,1263156,1,14,2,0,0,74
154047,1263156,1,14,3,0,0,74
154048,1263156,1,14,4,0,0,74
154049,1263156,1,14,5,1,0,75
154050,1263156,1,14,6,1,0,76
154051,1263156,1,15,1,1,0,77
154052,1263156,1,15,2,1,0,78
154053,1263156,1,15,3,1,0,79
154054,1263156,1,15,4,6,0,85
154055,1263156,1,15,5,6,0,91
154056,1263156,1,15,6,1,0,92
154057,1263156,1,16,1,1,0,93
154058,1263156,1,16,2,1,0,94
154059,1263156,1,16,3,4,0,98
154060,1263156,1,16,4,1,0,99
154061,1263156,1,16,5,0,0,99
154062,1263156,1,16,6,2,1,101
154063,1263156,1,17,1,6,0,107
154064,1263156,1,17,2,6,0,113
154065,1263156,1,17,3,1,0,114
154066,1263156,1,17,4,2,0,116
154067,1263156,1,17,5,1,0,117
154068,1263156,1,17,6,0,0,117
154069,1263156,1,18,1,1,0,118
154070,1263156,1,18,2,1,0,119
154071,1263156,1,18,3,1,0,120
154072,1263156,1,18,4,0,0,120
154073,1263156,1,18,5,4,0,124
154074,1263156,1,18,6,1,0,125
154075,1263156,1,19,1,1,0,126
154076,1263156,1,19,2,2,0,128
154077,1263156,1,19,3,0,0,128
154078,1263156,1,19,4,6,0,134
154079,1263156,1,19,5,1,0,135
154080,1263156,1,19,6,1,0,136
154081,1263156,1,20,1,1,0,137
154082,1263156,1,20,2,0,1,137
154083,1263156,1,20,3,0,0,137
154084,1263156,1,20,4,1,0,138
154085,1263156,1,20,5,1,0,139
154086,1263156,1,20,6,6,0,145
154183,1263157,1,1,1,0,0,0
154184,1263157,1,1,2,1,0,1
154185,1263157,1,1,3,2,0,3
154186,1263157,1,1,4,0,0,3
154187,1263157,1,1,5,0,0,3
154188,1263157,1,1,6,6,0,9
154189,1263157,1,2,1,0,0,9
154190,1263157,1,2,2,0,0,9
154191,1263157,1,2,3,1,0,10
154192,1263157,1,2,4,1,0,11
154193,1263157,1,2,5,1,0,12
154194,1263157,1,2,6,0,0,12
154195,1263157,1,3,1,0,0,12
154196,1263157,1,3,2,0,0,12
154197,1263157,1,3,3,1,0,13
154198,1263157,1,3,4,0,1,13
154199,1263157,1,3,5,0,0,13
154200,1263157,1,3,6,0,0,13
154201,1263157,1,4,1,0,0,13
154202,1263157,1,4,2,4,0,17
154203,1263157,1,4,3,6,0,23
154204,1263157,1,4,4,1,0,24
154205,1263157,1,4,5,1,0,25
154206,1263157,1,4,6,2,0,27
154207,1263157,1,5,1,0,0,27
154208,1263157,1,5,2,1,0,28
154209,1263157,1,5,3,6,0,34
154210,1263157,1,5,4,1,0,35
154211,1263157,1,5,5,0,0,35
154212,1263157,1,5,6,2,0,37
154213,1263157,1,6,1,1,0,38
154214,1263157,1,6,2,6,0,44
154215,1263157,1,6,3,0,1,44
154216,1263157,1,6,4,1,0,45
154217,1263157,1,6,5,0,0,45
154218,1263157,1,6,6,1,0,46
154219,1263157,1,7,1,1,0,47
154220,1263157,1,7,2,1,0,48
154221,1263157,1,7,3,5,0,53
154222,1263157,1,7,4,0,0,53
154223,1263157,1,7,5,0,0,53
154224,1263157,1,7,6,0,0,53
154225,1263157,1,8,1,1,0,54
154226,1263157,1,8,2,4,0,58
154227,1263157,1,8,3,1,0,59
154228,1263157,1,8,4,0,1,59
154229,1263157,1,8,5,0,0,59
154230,1263157,1,8,6,0,0,59
154231,1263157,1,9,1,1,0,60
154232,1263157,1,9,2,1,0,61
154233,1263157,1,9,3,1,0,62
154234,1263157,1,9,4,1,0,63
154235,1263157,1,9,5,1,0,64
154236,1263157,1,9,6,1,0,65
154237,1263157,1,10,1,3,0,68
154238,1263157,1,10,2,0,0,68
154239,1263157,1,10,3,1,0,69
154240,1263157,1,10,4,2,0,71
154241,1263157,1,10,5,1,0,72
154242,1263157,1,10,6,1,0,73
154243,1263157,1,11,1,1,0,74
154244,1263157,1,11,2,0,0,74
154245,1263157,1,11,3,1,0,75
154246,1263157,1,11,4,2,0,77
154247,1263157,1,11,5,0,0,77
154248,1263157,1,11,6,1,0,78
154249,1263157,1,12,1,1,0,79
154250,1263157,1,12,2,1,0,80
154251,1263157,1,12,3,6,0,86
154252,1263157,1,12,4,0,0,86
154253,1263157,1,12,5,2,0,88
154254,1263157,1,12,6,0,0,88
154255,1263157,1,13,1,0,0,88
154256,1263157,1,13,2,6,0,94
154257,1263157,1,13,3,1,0,95
154258,1263157,1,13,4,7,0,102
154259,1263157,1,13,5,1,0,103
154260,1263157,1,13,6,1,0,104
154261,1263157,1,14,1,1,0,105
154262,1263157,1,14,2,1,0,106
154263,1263157,1,14,3,6,0,112
154264,1263157,1,14,4,2,0,114
154265,1263157,1,14,5,1,0,115
154266,1263157,1,14,6,3,0,118
154267,1263157,1,15,1,6,0,124
154268,1263157,1,15,2,1,0,125
154269,1263157,1,15,3,1,0,126
154270,1263157,1,15,4,0,0,126
154271,1263157,1,15,5,1,0,127
154272,1263157,1,15,6,2,0,129
154273,1263157,1,16,1,1,0,130
154274,1263157,1,16,2,1,0,131
154275,1263157,1,16,3,2,0,133
154276,1263157,1,16,4,1,0,134
154277,1263157,1,16,5,1,0,135
154278,1263157,1,16,6,0,0,135
154279,1263157,1,17,1,0,0,135
154280,1263157,1,17,2,1,0,136
154281,1263157,1,17,3,6,0,142
154282,1263157,1,17,4,0,0,142
154283,1263157,1,17,5,1,0,143
154284,1263157,1,17,6,6,0,149
154285,1263157,1,18,1,1,0,150
154286,1263157,1,18,2,6,0,156
154287,1263157,1,18,3,4,0,160
154288,1263157,1,18,4,2,0,162
154289,1263157,1,18,5,0,1,162
154290,1263157,1,18,6,2,0,164
154291,1263157,1,19,1,0,0,164
154292,1263157,1,19,2,4,0,168
154293,1263157,1,19,3,6,0,174
154294,1263157,1,19,4,1,0,175
154295,1263157,1,19,5,4,0,179
154296,1263157,1,19,6,1,0,180
154297,1263157,1,20,1,2,0,182
154298,1263157,1,20,2,4,0,186
154299,1263157,1,20,3,2,0,188
154300,1263157,1,20,4,1,0,189
154301,1263157,1,20,5,1,0,190
154302,1263157,1,20,6,6,0,196
154419,1263158,1,1,1,4,0,4
154420,1263158,1,1,2,0,0,4
154421,1263158,1,1,3,0,0,4
154422,1263158,1,1,4,4,0,8
154423,1263158,1,1,5,1,0,9
154424,1263158,1,1,6,1,0,10
154425,1263158,1,2,1,1,0,11
154426,1263158,1,2,2,1,0,12
154427,1263158,1,2,3,1,0,13
154428,1263158,1,2,4,4,0,17
154429,1263158,1,2,5,0,0,17
154430,1263158,1,2,6,1,0,18
154431,1263158,1,3,1,4,0,22
154432,1263158,1,3,2,1,0,23
154433,1263158,1,3,3,2,0,25
154434,1263158,1,3,4,0,0,25
154435,1263158,1,3,5,0,0,25
154436,1263158,1,3,6,1,0,26
154437,1263158,1,4,1,0,0,26
154438,1263158,1,4,2,0,0,26
154439,1263158,1,4,3,3,0,29
154440,1263158,1,4,4,1,0,30
154441,1263158,1,4,5,1,0,31
154442,1263158,1,4,6,1,0,32
154443,1263158,1,5,1,1,0,33
154444,1263158,1,5,2,1,0,34
154445,1263158,1,5,3,1,0,35
154446,1263158,1,5,4,4,0,39
154447,1263158,1,5,5,1,0,40
154448,1263158,1,5,6,1,1,41
154449,1263158,1,6,1,0,0,41
154450,1263158,1,6,2,1,0,42
154451,1263158,1,6,3,1,0,43
154452,1263158,1,6,4,0,0,43
154453,1263158,1,6,5,1,0,44
154454,1263158,1,6,6,1,0,45
154455,1263158,1,7,1,1,0,46
154456,1263158,1,7,2,0,0,46
154457,1263158,1,7,3,1,0,47
154458,1263158,1,7,4,1,0,48
154459,1263158,1,7,5,0,0,48
154460,1263158,1,7,6,4,0,52
154461,1263158,1,8,1,1,0,53
154462,1263158,1,8,2,1,0,54
154463,1263158,1,8,3,1,0,55
154464,1263158,1,8,4,0,0,55
154465,1263158,1,8,5,1,0,56
154466,1263158,1,8,6,0,0,56
154467,1263158,1,9,1,1,0,57
154468,1263158,1,9,2,1,0,58
154469,1263158,1,9,3,0,1,58
154470,1263158,1,9,4,4,0,62
154471,1263158,1,9,5,1,0,63
154472,1263158,1,9,6,0,0,63
154473,1263158,1,10,1,1,0,64
154474,1263158,1,10,2,0,0,64
154475,1263158,1,10,3,2,0,66
154476,1263158,1,10,4,4,0,70
154477,1263158,1,10,5,1,0,71
154478,1263158,1,10,6,1,0,72
154479,1263158,1,11,1,4,0,76
154480,1263158,1,11,2,0,0,76
154481,1263158,1,11,3,1,0,77
154482,1263158,1,11,4,1,0,78
154483,1263158,1,11,5,1,0,79
154484,1263158,1,11,6,0,0,79
154485,1263158,1,12,1,0,1,79
154486,1263158,1,12,2,0,0,79
154487,1263158,1,12,3,0,0,79
154488,1263158,1,12,4,1,0,80
154489,1263158,1,12,5,0,1,80
154490,1263158,1,12,6,1,0,81
154491,1263158,1,13,1,0,0,81
154492,1263158,1,13,2,2,0,83
154493,1263158,1,13,3,0,0,83
154494,1263158,1,13,4,0,0,83
154495,1263158,1,13,5,2,0,85
154496,1263158,1,13,6,1,0,86
154497,1263158,1,14,1,1,0,87
154498,1263158,1,14,2,0,0,87
154499,1263158,1,14,3,4,0,91
154500,1263158,1,14,4,0,0,91
154501,1263158,1,14,5,0,0,91
154502,1263158,1,14,6,1,0,92
154503,1263158,1,15,1,0,0,92
154504,1263158,1,15,2,1,0,93
154505,1263158,1,15,3,1,0,94
154506,1263158,1,15,4,0,0,94
154507,1263158,1,15,5,2,0,96
154508,1263158,1,15,6,3,0,99
154509,1263158,1,16,1,0,0,99
154510,1263158,1,16,2,1,0,100
154511,1263158,1,16,3,1,0,101
154512,1263158,1,16,4,1,0,102
154513,1263158,1,16,5,1,0,103
154514,1263158,1,16,6,6,0,109
154515,1263158,1,17,1,4,0,113
154516,1263158,1,17,2,1,0,114
154517,1263158,1,17,3,0,0,114
154518,1263158,1,17,4,2,0,116
154519,1263158,1,17,5,2,0,118
154520,1263158,1,17,6,6,0,124
154521,1263158,1,18,1,1,0,125
154522,1263158,1,18,2,1,0,126
154523,1263158,1,18,3,1,0,127
154524,1263158,1,18,4,0,0,127
154525,1263158,1,18,5,1,0,128
154526,1263158,1,18,6,2,0,130
154527,1263158,1,19,1,1,0,131
154528,1263158,1,19,2,1,0,132
154529,1263158,1,19,3,0,0,132
154530,1263158,1,19,4,1,0,133
154531,1263158,1,19,5,1,0,134
154532,1263158,1,19,6,3,0,137
154533,1263158,1,20,1,1,0,138
154534,1263158,1,20,2,1,0,139
154535,1263158,1,20,3,0,1,139
154536,1263158,1,20,4,1,0,140
154537,1263158,1,20,5,1,0,141
154538,1263158,1,20,6,0,1,141
154628,1263159,1,1,1,1,0,1
154629,1263159,1,1,2,0,0,1
154630,1263159,1,1,3,0,0,1
154631,1263159,1,1,4,0,0,1
154632,1263159,1,1,5,4,0,5
154633,1263159,1,1,6,2,0,7
154634,1263159,1,2,1,0,0,7
154635,1263159,1,2,2,1,0,8
154636,1263159,1,2,3,0,0,8
154637,1263159,1,2,4,4,0,12
154638,1263159,1,2,5,0,1,12
154639,1263159,1,2,6,1,0,13
154640,1263159,1,3,1,2,0,15
154641,1263159,1,3,2,4,0,19
154642,1263159,1,3,3,0,0,19
154643,1263159,1,3,4,1,0,20
154644,1263159,1,3,5,0,0,20
154645,1263159,1,3,6,1,0,21
154646,1263159,1,4,1,6,0,27
154647,1263159,1,4,2,4,0,31
154648,1263159,1,4,3,10,0,41
154649,1263159,1,4,4,4,0,45
154650,1263159,1,4,5,1,0,46
154651,1263159,1,4,6,0,0,46
154652,1263159,1,5,1,7,0,53
154653,1263159,1,5,2,1,0,54
154654,1263159,1,5,3,4,0,58
154655,1263159,1,5,4,0,0,58
154656,1263159,1,5,5,0,0,58
154657,1263159,1,5,6,2,0,60
154658,1263159,1,6,1,4,0,64
154659,1263159,1,6,2,1,0,65
154660,1263159,1,6,3,0,0,65
154661,1263159,1,6,4,1,0,66
154662,1263159,1,6,5,0,0,66
154663,1263159,1,6,6,6,0,72
154664,1263159,1,7,1,0,0,72
154665,1263159,1,7,2,1,0,73
154666,1263159,1,7,3,4,0,77
154667,1263159,1,7,4,0,0,77
154668,1263159,1,7,5,0,0,77
154669,1263159,1,7,6,1,0,78
154670,1263159,1,8,1,0,0,78
154671,1263159,1,8,2,1,0,79
154672,1263159,1,8,3,6,0,85
154673,1263159,1,8,4,0,0,85
154674,1263159,1,8,5,0,0,85
154675,1263159,1,8,6,1,0,86
154676,1263159,1,9,1,1,0,87
154677,1263159,1,9,2,0,0,87
154678,1263159,1,9,3,6,0,93
154679,1263159,1,9,4,1,0,94
154680,1263159,1,9,5,1,0,95
154681,1263159,1,9,6,1,0,96
154682,1263159,1,10,1,1,0,97
154683,1263159,1,10,2,4,0,101
154684,1263159,1,10,3,6,0,107
154685,1263159,1,10,4,4,0,111
154686,1263159,1,10,5,1,0,112
154687,1263159,1,10,6,0,0,112
154688,1263159,1,11,1,1,0,113
154689,1263159,1,11,2,0,0,113
154690,1263159,1,11,3,6,0,119
154691,1263159,1,11,4,4,0,123
154692,1263159,1,11,5,1,0,124
154693,1263159,1,11,6,0,0,124
154694,1263159,1,12,1,1,0,125
154695,1263159,1,12,2,1,0,126
154696,1263159,1,12,3,0,1,126
154697,1263159,1,12,4,0,1,126
154698,1263159,1,12,5,4,0,130
154699,1263159,1,12,6,1,0,131
154700,1263159,1,13,1,1,0,132
154701,1263159,1,13,2,1,0,133
154702,1263159,1,13,3,1,0,134
154703,1263159,1,13,4,1,1,135
154704,1263159,1,13,5,1,0,136
154705,1263159,1,13,6,1,0,137
154706,1263159,1,14,1,1,0,138
154707,1263159,1,14,2,0,0,138
154708,1263159,1,14,3,1,0,139
154709,1263159,1,14,4,1,0,140
154710,1263159,1,14,5,1,0,141
154711,1263159,1,14,6,0,0,141
154712,1263159,1,15,1,1,0,142
154713,1263159,1,15,2,2,0,144
154714,1263159,1,15,3,0,0,144
154715,1263159,1,15,4,0,0,144
154716,1263159,1,15,5,0,0,144
154717,1263159,1,15,6,2,0,146
154718,1263159,1,16,1,0,1,146
154719,1263159,1,16,2,1,0,147
154720,1263159,1,16,3,1,0,148
154721,1263159,1,16,4,1,0,149
154722,1263159,1,16,5,1,0,150
154723,1263159,1,16,6,4,0,154
154724,1263159,1,17,1,3,0,157
154725,1263159,1,17,2,6,0,163
154726,1263159,1,17,3,0,0,163
154727,1263159,1,17,4,1,0,164
154728,1263159,1,17,5,1,0,165
154729,1263159,1,17,6,1,0,166
154730,1263159,1,18,1,0,1,166
154731,1263159,1,18,2,0,0,166
154732,1263159,1,18,3,1,0,167
154733,1263159,1,18,4,0,0,167
154734,1263159,1,18,5,1,0,168
154735,1263159,1,18,6,0,0,168
154736,1263159,1,19,1,1,0,169
154737,1263159,1,19,2,0,0,169
154738,1263159,1,19,3,1,0,170
154739,1263159,1,19,4,4,0,174
154740,1263159,1,19,5,1,0,175
154741,1263159,1,19,6,1,0,176
154742,1263159,1,20,1,2,0,178
154743,1263159,1,20,2,6,0,184
154744,1263159,1,20,3,0,0,184
154745,1263159,1,20,4,4,0,188
154746,1263159,1,20,5,1,0,189
154747,1263159,1,20,6,0,0,189
154868,1263160,1,1,1,1,0,1
154869,1263160,1,1,2,1,0,2
154870,1263160,1,1,3,0,0,2
154871,1263160,1,1,4,0,0,2
154872,1263160,1,1,5,1,0,3
154873,1263160,1,1,6,6,0,9
154874,1263160,1,2,1,0,0,9
154875,1263160,1,2,2,0,0,9
154876,1263160,1,2,3,0,0,9
154877,1263160,1,2,4,1,0,10
154878,1263160,1,2,5,4,0,14
154879,1263160,1,2,6,1,0,15
154880,1263160,1,3,1,1,0,16
154881,1263160,1,3,2,0,0,16
154882,1263160,1,3,3,9,0,25
154883,1263160,1,3,4,0,0,25
154884,1263160,1,3,5,0,0,25
154885,1263160,1,3,6,6,0,31
154886,1263160,1,4,1,0,0,31
154887,1263160,1,4,2,6,0,37
154888,1263160,1,4,3,1,0,38
154889,1263160,1,4,4,1,0,39
154890,1263160,1,4,5,0,0,39
154891,1263160,1,4,6,1,0,40
154892,1263160,1,5,1,0,1,40
154893,1263160,1,5,2,4,0,44
154894,1263160,1,5,3,0,0,44
154895,1263160,1,5,4,6,0,50
154896,1263160,1,5,5,4,0,54
154897,1263160,1,5,6,6,0,60
154898,1263160,1,6,1,4,0,64
154899,1263160,1,6,2,6,0,70
154900,1263160,1,6,3,6,0,76
154901,1263160,1,6,4,1,0,77
154902,1263160,1,6,5,0,0,77
154903,1263160,1,6,6,4,0,81
154904,1263160,1,7,1,1,0,82
154905,1263160,1,7,2,1,0,83
154906,1263160,1,7,3,0,1,83
154907,1263160,1,7,4,1,0,84
154908,1263160,1,7,5,0,0,84
154909,1263160,1,7,6,0,0,84
154910,1263160,1,8,1,1,0,85
154911,1263160,1,8,2,1,0,86
154912,1263160,1,8,3,4,0,90
154913,1263160,1,8,4,0,0,90
154914,1263160,1,8,5,6,0,96
154915,1263160,1,8,6,6,0,102
154916,1263160,1,9,1,0,0,102
154917,1263160,1,9,2,0,0,102
154918,1263160,1,9,3,1,0,103
154919,1263160,1,9,4,6,0,109
154920,1263160,1,9,5,6,0,115
154921,1263160,1,9,6,0,0,115
154922,1263160,1,10,1,1,0,116
154923,1263160,1,10,2,1,0,117
154924,1263160,1,10,3,0,0,117
154925,1263160,1,10,4,0,0,117
154926,1263160,1,10,5,1,0,118
154927,1263160,1,10,6,1,0,119
154928,1263160,1,11,1,1,0,120
154929,1263160,1,11,2,1,0,121
154930,1263160,1,11,3,1,0,122
154931,1263160,1,11,4,0,0,122
154932,1263160,1,11,5,1,0,123
154933,1263160,1,11,6,1,1,124
154934,1263160,1,12,1,0,0,124
154935,1263160,1,12,2,0,0,124
154936,1263160,1,12,3,1,0,125
154937,1263160,1,12,4,1,0,126
154938,1263160,1,12,5,0,0,126
154939,1263160,1,12,6,1,0,127
154940,1263160,1,13,1,8,0,135
154941,1263160,1,13,2,6,0,141
154942,1263160,1,13,3,7,0,148
154943,1263160,1,13,4,4,0,152
154944,1263160,1,13,5,0,0,152
154945,1263160,1,13,6,0,0,152
154946,1263160,1,14,1,0,0,152
154947,1263160,1,14,2,3,0,155
154948,1263160,1,14,3,4,0,159
154949,1263160,1,14,4,2,0,161
154950,1263160,1,14,5,1,0,162
154951,1263160,1,14,6,0,0,162
154952,1263160,1,15,1,6,0,168
154953,1263160,1,15,2,0,0,168
154954,1263160,1,15,3,0,0,168
154955,1263160,1,15,4,0,1,168
154956,1263160,1,15,5,1,0,169
154957,1263160,1,15,6,0,0,169
154958,1263160,1,16,1,1,0,170
154959,1263160,1,16,2,1,0,171
154960,1263160,1,16,3,0,0,171
154961,1263160,1,16,4,1,0,172
154962,1263160,1,16,5,1,1,173
154963,1263160,1,16,6,0,0,173
154964,1263160,1,17,1,1,0,174
154965,1263160,1,17,2,1,0,175
154966,1263160,1,17,3,1,0,176
154967,1263160,1,17,4,0,0,176
154968,1263160,1,17,5,0,1,176
154969,1263160,1,17,6,1,0,177
154970,1263160,1,18,1,1,0,178
154971,1263160,1,18,2,1,0,179
154972,1263160,1,18,3,2,0,181
154973,1263160,1,18,4,1,1,182
154974,1263160,1,18,5,0,0,182
154975,1263160,1,18,6,1,0,183
154976,1263160,1,19,1,1,0,184
154977,1263160,1,19,2,0,0,184
154978,1263160,1,19,3,1,0,185
154979,1263160,1,19,4,1,0,186
154980,1263160,1,19,5,0,0,186
154981,1263160,1,19,6,4,0,190
154982,1263160,1,20,1,1,1,191
154983,1263160,1,20,2,0,0,191
154984,1263160,1,20,3,0,0,191
154985,1263160,1,20,4,1,0,192
154986,1263160,1,20,5,1,0,193
154987,1263160,1,20,6,6,0,199
155108,1263165,1,1,1,0,0,0
155109,1263165,1,1,2,1,0,1
155110,1263165,1,1,3,1,0,2
155111,1263165,1,1,4,1,0,3
155112,1263165,1,1,5,1,0,4
155113,1263165,1,1,6,1,0,5
155114,1263165,1,2,1,0,0,5
155115,1263165,1,2,2,4,0,9
155116,1263165,1,2,3,0,0,9
155117,1263165,1,2,4,0,0,9
155118,1263165,1,2,5,0,0,9
155119,1263165,1,2,6,4,0,13
155120,1263165,1,3,1,0,0,13
155121,1263165,1,3,2,0,0,13
155122,1263165,1,3,3,6,0,19
155123,1263165,1,3,4,7,0,26
155124,1263165,1,3,5,1,0,27
155125,1263165,1,3,6,1,0,28
155126,1263165,1,4,1,1,0,29
155127,1263165,1,4,2,1,0,30
155128,1263165,1,4,3,3,0,33
155129,1263165,1,4,4,5,0,38
155130,1263165,1,4,5,0,0,38
155131,1263165,1,4,6,1,0,39
155132,1263165,1,5,1,1,0,40
155133,1263165,1,5,2,0,0,40
155134,1263165,1,5,3,6,0,46
155135,1263165,1,5,4,0,1,46
155136,1263165,1,5,5,1,0,47
155137,1263165,1,5,6,1,0,48
155138,1263165,1,6,1,4,0,52
155139,1263165,1,6,2,0,0,52
155140,1263165,1,6,3,1,0,53
155141,1263165,1,6,4,1,0,54
155142,1263165,1,6,5,1,0,55
155143,1263165,1,6,6,0,0,55
155144,1263165,1,7,1,1,0,56
155145,1263165,1,7,2,0,0,56
155146,1263165,1,7,3,4,0,60
155147,1263165,1,7,4,4,0,64
155148,1263165,1,7,5,1,0,65
155149,1263165,1,7,6,1,0,66
155150,1263165,1,8,1,1,0,67
155151,1263165,1,8,2,0,0,67
155152,1263165,1,8,3,1,0,68
155153,1263165,1,8,4,1,0,69
155154,1263165,1,8,5,0,0,69
155155,1263165,1,8,6,1,0,70
155156,1263165,1,9,1,0,0,70
155157,1263165,1,9,2,1,0,71
155158,1263165,1,9,3,1,0,72
155159,1263165,1,9,4,0,0,72
155160,1263165,1,9,5,2,0,74
155161,1263165,1,9,6,2,0,76
155162,1263165,1,10,1,1,0,77
155163,1263165,1,10,2,0,0,77
155164,1263165,1,10,3,1,0,78
155165,1263165,1,10,4,1,0,79
155166,1263165,1,10,5,6,0,85
155167,1263165,1,10,6,0,0,85
155168,1263165,1,11,1,0,0,85
155169,1263165,1,11,2,1,0,86
155170,1263165,1,11,3,0,0,86
155171,1263165,1,11,4,1,0,87
155172,1263165,1,11,5,1,0,88
155173,1263165,1,11,6,1,0,89
155174,1263165,1,12,1,1,0,90
155175,1263165,1,12,2,1,0,91
155176,1263165,1,12,3,1,0,92
155177,1263165,1,12,4,1,0,93
155178,1263165,1,12,5,0,0,93
155179,1263165,1,12,6,1,0,94
155180,1263165,1,13,1,1,0,95
155181,1263165,1,13,2,0,0,95
155182,1263165,1,13,3,1,0,96
155183,1263165,1,13,4,1,0,97
155184,1263165,1,13,5,1,0,98
155185,1263165,1,13,6,4,0,102
155186,1263165,1,14,1,1,0,103
155187,1263165,1,14,2,1,0,104
155188,1263165,1,14,3,2,0,106
155189,1263165,1,14,4,1,0,107
155190,1263165,1,14,5,4,0,111
155191,1263165,1,14,6,1,0,112
155192,1263165,1,15,1,0,0,112
155193,1263165,1,15,2,1,1,113
155194,1263165,1,15,3,1,0,114
155195,1263165,1,15,4,1,0,115
155196,1263165,1,15,5,1,0,116
155197,1263165,1,15,6,1,0,117
155198,1263165,1,16,1,1,0,118
155199,1263165,1,16,2,4,0,122
155200,1263165,1,16,3,1,0,123
155201,1263165,1,16,4,6,0,129
155202,1263165,1,16,5,1,0,130
155203,1263165,1,16,6,4,0,134
155204,1263165,1,17,1,0,1,134
155205,1263165,1,17,2,1,0,135
155206,1263165,1,17,3,1,0,136
155207,1263165,1,17,4,1,0,137
155208,1263165,1,17,5,1,0,138
155209,1263165,1,17,6,1,0,139
155210,1263165,1,18,1,2,0,141
155211,1263165,1,18,2,1,0,142
155212,1263165,1,18,3,2,0,144
155213,1263165,1,18,4,1,0,145
155214,1263165,1,18,5,0,1,145
155215,1263165,1,18,6,0,1,145
155216,1263165,1,19,1,4,0,149
155217,1263165,1,19,2,0,0,149
155218,1263165,1,19,3,1,0,150
155219,1263165,1,19,4,0,1,150
155220,1263165,1,19,5,0,1,150
155221,1263165,1,19,6,0,0,150
155222,1263165,1,20,1,1,0,151
155223,1263165,1,20,2,1,0,152
155224,1263165,1,20,3,2,0,154
155225,1263165,1,20,4,1,0,155
155226,1263165,1,20,5,1,0,156
155227,1263165,1,20,6,1,1,157
155348,1263471,1,1,1,1,0,1
155349,1263471,1,1,2,0,0,1
155350,1263471,1,1,3,1,0,2
155351,1263471,1,1,4,3,0,5
155352,1263471,1,1,5,0,0,5
155353,1263471,1,1,6,0,0,5
155354,1263471,1,2,1,1,0,6
155355,1263471,1,2,2,2,0,8
155356,1263471,1,2,3,1,0,9
155357,1263471,1,2,4,0,0,9
155358,1263471,1,2,5,1,0,10
155359,1263471,1,2,6,0,0,10
155360,1263471,1,3,1,0,0,10
155361,1263471,1,3,2,1,0,11
155362,1263471,1,3,3,0,0,11
155363,1263471,1,3,4,2,0,13
155364,1263471,1,3,5,4,0,17
155365,1263471,1,3,6,1,0,18
155366,1263471,1,4,1,1,0,19
155367,1263471,1,4,2,1,0,20
155368,1263471,1,4,3,0,0,20
155369,1263471,1,4,4,1,0,21
155370,1263471,1,4,5,0,0,21
155371,1263471,1,4,6,0,0,21
155372,1263471,1,5,1,6,0,27
155373,1263471,1,5,2,1,0,28
155374,1263471,1,5,3,1,0,29
155375,1263471,1,5,4,1,0,30
155376,1263471,1,5,5,0,1,30
155377,1263471,1,5,6,0,0,30
155378,1263471,1,6,1,1,0,31
155379,1263471,1,6,2,1,0,32
155380,1263471,1,6,3,0,0,32
155381,1263471,1,6,4,0,0,32
155382,1263471,1,6,5,1,0,33
155383,1263471,1,6,6,4,0,37
155384,1263471,1,7,1,0,0,37
155385,1263471,1,7,2,6,0,43
155386,1263471,1,7,3,1,0,44
155387,1263471,1,7,4,4,0,48
155388,1263471,1,7,5,1,0,49
155389,1263471,1,7,6,0,0,49
155390,1263471,1,8,1,0,0,49
155391,1263471,1,8,2,0,0,49
155392,1263471,1,8,3,1,0,50
155393,1263471,1,8,4,1,0,51
155394,1263471,1,8,5,0,0,51
155395,1263471,1,8,6,2,0,53
155396,1263471,1,9,1,2,0,55
155397,1263471,1,9,2,2,0,57
155398,1263471,1,9,3,1,0,58
155399,1263471,1,9,4,1,0,59
155400,1263471,1,9,5,1,0,60
155401,1263471,1,9,6,1,0,61
155402,1263471,1,10,1,6,0,67
155403,1263471,1,10,2,1,0,68
155404,1263471,1,10,3,1,0,69
155405,1263471,1,10,4,0,0,69
155406,1263471,1,10,5,4,0,73
155407,1263471,1,10,6,2,0,75
155408,1263471,1,11,1,0,0,75
155409,1263471,1,11,2,5,0,80
155410,1263471,1,11,3,0,1,80
155411,1263471,1,11,4,0,0,80
155412,1263471,1,11,5,1,0,81
155413,1263471,1,11,6,2,0,83
155414,1263471,1,12,1,1,0,84
155415,1263471,1,12,2,4,0,88
155416,1263471,1,12,3,2,0,90
155417,1263471,1,12,4,0,1,90
155418,1263471,1,12,5,0,0,90
155419,1263471,1,12,6,2,0,92
155420,1263471,1,13,1,1,0,93
155421,1263471,1,13,2,2,0,95
155422,1263471,1,13,3,1,0,96
155423,1263471,1,13,4,0,0,96
155424,1263471,1,13,5,0,0,96
155425,1263471,1,13,6,1,0,97
155426,1263471,1,14,1,4,0,101
155427,1263471,1,14,2,1,0,102
155428,1263471,1,14,3,1,0,103
155429,1263471,1,14,4,2,0,105
155430,1263471,1,14,5,0,1,105
155431,1263471,1,14,6,1,0,106
155432,1263471,1,15,1,1,0,107
155433,1263471,1,15,2,0,1,107
155434,1263471,1,15,3,1,0,108
155435,1263471,1,15,4,1,0,109
155436,1263471,1,15,5,1,0,110
155437,1263471,1,15,6,1,0,111
155438,1263471,1,16,1,0,0,111
155439,1263471,1,16,2,6,0,117
155440,1263471,1,16,3,2,0,119
155441,1263471,1,16,4,4,0,123
155442,1263471,1,16,5,0,0,123
155443,1263471,1,16,6,1,0,124
155444,1263471,1,17,1,0,0,124
155445,1263471,1,17,2,4,0,128
155446,1263471,1,17,3,2,0,130
155447,1263471,1,17,4,6,0,136
155448,1263471,1,17,5,1,0,137
155449,1263471,1,17,6,3,0,140
155450,1263471,1,18,1,1,0,141
155451,1263471,1,18,2,0,0,141
155452,1263471,1,18,3,0,1,141
155453,1263471,1,18,4,0,1,141
155454,1263471,1,18,5,1,0,142
155455,1263471,1,18,6,1,0,143
155456,1263471,1,19,1,1,0,144
155457,1263471,1,19,2,0,0,144
155458,1263471,1,19,3,0,1,144
155459,1263471,1,19,4,1,0,145
155460,1263471,1,19,5,0,1,145
155461,1263471,1,19,6,1,0,146
155462,1263471,1,20,1,0,0,146
155463,1263471,1,20,2,0,0,146
155464,1263471,1,20,3,0,0,146
155465,1263471,1,20,4,1,0,147
155466,1263471,1,20,5,0,0,147
155467,1263471,1,20,6,2,0,149
155582,1263473,1,1,1,0,0,0
155583,1263473,1,1,2,1,0,1
155584,1263473,1,1,3,0,0,1
155585,1263473,1,1,4,0,0,1
155586,1263473,1,1,5,5,0,6
155587,1263473,1,1,6,2,0,8
155588,1263473,1,2,1,2,0,10
155589,1263473,1,2,2,2,0,12
155590,1263473,1,2,3,4,0,16
155591,1263473,1,2,4,1,0,17
155592,1263473,1,2,5,0,0,17
155593,1263473,1,2,6,0,0,17
155594,1263473,1,3,1,0,1,17
155595,1263473,1,3,2,0,0,17
155596,1263473,1,3,3,0,0,17
155597,1263473,1,3,4,6,0,23
155598,1263473,1,3,5,0,1,23
155599,1263473,1,3,6,0,0,23
155600,1263473,1,4,1,0,0,23
155601,1263473,1,4,2,0,0,23
155602,1263473,1,4,3,1,0,24
155603,1263473,1,4,4,0,0,24
155604,1263473,1,4,5,0,0,24
155605,1263473,1,4,6,1,0,25
155606,1263473,1,5,1,0,0,25
155607,1263473,1,5,2,0,0,25
155608,1263473,1,5,3,0,0,25
155609,1263473,1,5,4,2,0,27
155610,1263473,1,5,5,1,0,28
155611,1263473,1,5,6,2,0,30
155612,1263473,1,6,1,4,0,34
155613,1263473,1,6,2,0,0,34
155614,1263473,1,6,3,0,0,34
155615,1263473,1,6,4,0,0,34
155616,1263473,1,6,5,3,0,37
155617,1263473,1,6,6,0,0,37
155618,1263473,1,7,1,0,0,37
155619,1263473,1,7,2,1,0,38
155620,1263473,1,7,3,0,1,38
155621,1263473,1,7,4,0,0,38
155622,1263473,1,7,5,1,0,39
155623,1263473,1,7,6,0,0,39
155624,1263473,1,8,1,1,0,40
155625,1263473,1,8,2,0,1,40
155626,1263473,1,8,3,1,0,41
155627,1263473,1,8,4,1,0,42
155628,1263473,1,8,5,0,0,42
155629,1263473,1,8,6,0,0,42
155630,1263473,1,9,1,0,0,42
155631,1263473,1,9,2,1,0,43
155632,1263473,1,9,3,0,0,43
155633,1263473,1,9,4,1,0,44
155634,1263473,1,9,5,0,0,44
155635,1263473,1,9,6,4,0,48
155636,1263473,1,10,1,0,0,48
155637,1263473,1,10,2,0,0,48
155638,1263473,1,10,3,1,0,49
155639,1263473,1,10,4,0,0,49
155640,1263473,1,10,5,1,0,50
155641,1263473,1,10,6,1,0,51
155642,1263473,1,11,1,1,0,52
155643,1263473,1,11,2,0,0,52
155644,1263473,1,11,3,1,0,53
155645,1263473,1,11,4,1,0,54
155646,1263473,1,11,5,1,0,55
155647,1263473,1,11,6,0,0,55
155648,1263473,1,12,1,0,0,55
155649,1263473,1,12,2,1,0,56
155650,1263473,1,12,3,0,0,56
155651,1263473,1,12,4,1,0,57
155652,1263473,1,12,5,1,0,58
155653,1263473,1,12,6,0,0,58
155654,1263473,1,13,1,1,0,59
155655,1263473,1,13,2,1,0,60
155656,1263473,1,13,3,2,0,62
155657,1263473,1,13,4,1,0,63
155658,1263473,1,13,5,0,0,63
155659,1263473,1,13,6,0,0,63
155660,1263473,1,14,1,2,0,65
155661,1263473,1,14,2,0,0,65
155662,1263473,1,14,3,1,0,66
155663,1263473,1,14,4,1,0,67
155664,1263473,1,14,5,1,0,68
155665,1263473,1,14,6,1,0,69
155666,1263473,1,15,1,0,0,69
155667,1263473,1,15,2,2,0,71
155668,1263473,1,15,3,0,0,71
155669,1263473,1,15,4,1,0,72
155670,1263473,1,15,5,0,0,72
155671,1263473,1,15,6,4,0,76
155672,1263473,1,16,1,1,0,77
155673,1263473,1,16,2,0,0,77
155674,1263473,1,16,3,1,0,78
155675,1263473,1,16,4,1,0,79
155676,1263473,1,16,5,4,0,83
155677,1263473,1,16,6,4,0,87
155678,1263473,1,17,1,0,1,87
155679,1263473,1,17,2,0,0,87
155680,1263473,1,17,3,0,0,87
155681,1263473,1,17,4,0,0,87
155682,1263473,1,17,5,1,0,88
155683,1263473,1,17,6,1,0,89
155684,1263473,1,18,1,4,0,93
155685,1263473,1,18,2,1,0,94
155686,1263473,1,18,3,0,0,94
155687,1263473,1,18,4,1,0,95
155688,1263473,1,18,5,6,0,101
155689,1263473,1,18,6,1,0,102
155690,1263473,1,19,1,1,0,103
155691,1263473,1,19,2,0,0,103
155692,1263473,1,19,3,0,0,103
155693,1263473,1,19,4,2,0,105
155694,1263473,1,19,5,2,0,107
155695,1263473,1,19,6,4,0,111
155696,1263473,1,20,1,0,0,111
155697,1263473,1,20,2,4,0,115
155698,1263473,1,20,3,0,1,115
155699,1263473,1,20,4,1,0,116
155700,1263473,1,20,5,4,0,120
155701,1263473,1,20,6,1,0,121
155803,1263474,1,1,1,1,0,1
155804,1263474,1,1,2,0,0,1
155805,1263474,1,1,3,1,0,2
155806,1263474,1,1,4,1,0,3
155807,1263474,1,1,5,1,0,4
155808,1263474,1,1,6,4,0,8
155809,1263474,1,2,1,2,0,10
155810,1263474,1,2,2,0,0,10
155811,1263474,1,2,3,0,0,10
155812,1263474,1,2,4,1,0,11
155813,1263474,1,2,5,0,0,11
155814,1263474,1,2,6,1,0,12
155815,1263474,1,3,1,4,0,16
155816,1263474,1,3,2,1,0,17
155817,1263474,1,3,3,6,0,23
155818,1263474,1,3,4,1,0,24
155819,1263474,1,3,5,1,0,25
155820,1263474,1,3,6,1,0,26
155821,1263474,1,4,1,0,0,26
155822,1263474,1,4,2,0,0,26
155823,1263474,1,4,3,3,0,29
155824,1263474,1,4,4,4,0,33
155825,1263474,1,4,5,1,0,34
155826,1263474,1,4,6,1,0,35
155827,1263474,1,5,1,0,0,35
155828,1263474,1,5,2,0,0,35
155829,1263474,1,5,3,0,1,35
155830,1263474,1,5,4,0,0,35
155831,1263474,1,5,5,1,0,36
155832,1263474,1,5,6,0,0,36
155833,1263474,1,6,1,1,0,37
155834,1263474,1,6,2,0,0,37
155835,1263474,1,6,3,0,0,37
155836,1263474,1,6,4,0,0,37
155837,1263474,1,6,5,4,0,41
155838,1263474,1,6,6,0,0,41
155839,1263474,1,7,1,1,0,42
155840,1263474,1,7,2,0,0,42
155841,1263474,1,7,3,1,0,43
155842,1263474,1,7,4,0,0,43
155843,1263474,1,7,5,1,0,44
155844,1263474,1,7,6,1,0,45
155845,1263474,1,8,1,1,0,46
155846,1263474,1,8,2,1,0,47
155847,1263474,1,8,3,1,0,48
155848,1263474,1,8,4,2,0,50
155849,1263474,1,8,5,1,0,51
155850,1263474,1,8,6,6,0,57
155851,1263474,1,9,1,1,0,58
155852,1263474,1,9,2,1,0,59
155853,1263474,1,9,3,1,0,60
155854,1263474,1,9,4,1,0,61
155855,1263474,1,9,5,1,0,62
155856,1263474,1,9,6,1,0,63
155857,1263474,1,10,1,2,0,65
155858,1263474,1,10,2,0,0,65
155859,1263474,1,10,3,0,0,65
155860,1263474,1,10,4,1,0,66
155861,1263474,1,10,5,1,0,67
155862,1263474,1,10,6,6,0,73
155863,1263474,1,11,1,1,0,74
155864,1263474,1,11,2,1,0,75
155865,1263474,1,11,3,1,1,76
155866,1263474,1,11,4,0,0,76
155867,1263474,1,11,5,1,0,77
155868,1263474,1,11,6,0,0,77
155869,1263474,1,12,1,1,0,78
155870,1263474,1,12,2,0,0,78
155871,1263474,1,12,3,4,0,82
155872,1263474,1,12,4,0,0,82
155873,1263474,1,12,5,0,0,82
155874,1263474,1,12,6,1,0,83
155875,1263474,1,13,1,0,0,83
155876,1263474,1,13,2,1,0,84
155877,1263474,1,13,3,1,0,85
155878,1263474,1,13,4,1,0,86
155879,1263474,1,13,5,1,0,87
155880,1263474,1,13,6,1,0,88
155881,1263474,1,14,1,1,0,89
155882,1263474,1,14,2,1,0,90
155883,1263474,1,14,3,1,0,91
155884,1263474,1,14,4,0,0,91
155885,1263474,1,14,5,1,0,92
155886,1263474,1,14,6,1,0,93
155887,1263474,1,15,1,4,0,97
155888,1263474,1,15,2,4,0,101
155889,1263474,1,15,3,1,0,102
155890,1263474,1,15,4,1,0,103
155891,1263474,1,15,5,1,0,104
155892,1263474,1,15,6,0,0,104
155893,1263474,1,16,1,1,0,105
155894,1263474,1,16,2,4,0,109
155895,1263474,1,16,3,1,0,110
155896,1263474,1,16,4,0,1,110
155897,1263474,1,16,5,2,0,112
155898,1263474,1,16,6,0,0,112
155899,1263474,1,17,1,1,0,113
155900,1263474,1,17,2,0,1,113
155901,1263474,1,17,3,1,0,114
155902,1263474,1,17,4,0,0,114
155903,1263474,1,17,5,1,0,115
155904,1263474,1,17,6,1,0,116
155905,1263474,1,18,1,0,1,116
155906,1263474,1,18,2,1,0,117
155907,1263474,1,18,3,0,1,117
155908,1263474,1,18,4,1,0,118
155909,1263474,1,18,5,0,0,118
155910,1263474,1,18,6,1,0,119
155911,1263474,1,19,1,0,1,119
155912,1263474,1,19,2,0,0,119
155913,1263474,1,19,3,2,0,121
155914,1263474,1,19,4,1,0,122
155915,1263474,1,19,5,0,1,122
155916,1263474,1,19,6,0,0,122
155917,1263474,1,20,1,4,0,126
155918,1263474,1,20,2,1,0,127
155919,1263474,1,20,3,4,0,131
155920,1263474,1,20,4,1,0,132
155921,1263474,1,20,5,6,0,138
155922,1263474,1,20,6,1,0,139
156032,1263475,1,1,1,0,0,0
156033,1263475,1,1,2,0,0,0
156034,1263475,1,1,3,0,0,0
156035,1263475,1,1,4,1,0,1
156036,1263475,1,1,5,1,0,2
156037,1263475,1,1,6,1,0,3
156038,1263475,1,2,1,1,0,4
156039,1263475,1,2,2,0,0,4
156040,1263475,1,2,3,1,0,5
156041,1263475,1,2,4,1,0,6
156042,1263475,1,2,5,0,0,6
156043,1263475,1,2,6,0,0,6
156044,1263475,1,3,1,1,0,7
156045,1263475,1,3,2,0,0,7
156046,1263475,1,3,3,0,0,7
156047,1263475,1,3,4,0,0,7
156048,1263475,1,3,5,0,0,7
156049,1263475,1,3,6,0,0,7
156050,1263475,1,4,1,1,0,8
156051,1263475,1,4,2,1,0,9
156052,1263475,1,4,3,0,0,9
156053,1263475,1,4,4,2,0,11
156054,1263475,1,4,5,0,1,11
156055,1263475,1,4,6,0,0,11
156056,1263475,1,5,1,0,0,11
156057,1263475,1,5,2,0,0,11
156058,1263475,1,5,3,0,0,11
156059,1263475,1,5,4,1,0,12
156060,1263475,1,5,5,0,1,12
156061,1263475,1,5,6,1,0,13
156062,1263475,1,6,1,0,0,13
156063,1263475,1,6,2,0,0,13
156064,1263475,1,6,3,1,0,14
156065,1263475,1,6,4,0,0,14
156066,1263475,1,6,5,4,0,18
156067,1263475,1,6,6,4,0,22
156068,1263475,1,7,1,1,0,23
156069,1263475,1,7,2,2,0,25
156070,1263475,1,7,3,1,0,26
156071,1263475,1,7,4,4,0,30
156072,1263475,1,7,5,2,0,32
156073,1263475,1,7,6,4,0,36
156074,1263475,1,8,1,1,0,37
156075,1263475,1,8,2,1,0,38
156076,1263475,1,8,3,0,0,38
156077,1263475,1,8,4,1,0,39
156078,1263475,1,8,5,0,0,39
156079,1263475,1,8,6,1,0,40
156080,1263475,1,9,1,1,0,41
156081,1263475,1,9,2,1,0,42
156082,1263475,1,9,3,1,0,43
156083,1263475,1,9,4,1,0,44
156084,1263475,1,9,5,1,0,45
156085,1263475,1,9,6,6,0,51
156086,1263475,1,10,1,4,0,55
156087,1263475,1,10,2,0,1,55
156088,1263475,1,10,3,1,0,56
156089,1263475,1,10,4,0,0,56
156090,1263475,1,10,5,1,0,57
156091,1263475,1,10,6,1,0,58
156092,1263475,1,11,1,1,0,59
156093,1263475,1,11,2,0,0,59
156094,1263475,1,11,3,2,0,61
156095,1263475,1,11,4,6,0,67
156096,1263475,1,11,5,2,0,69
156097,1263475,1,11,6,0,0,69
156098,1263475,1,12,1,1,0,70
156099,1263475,1,12,2,1,0,71
156100,1263475,1,12,3,1,0,72
156101,1263475,1,12,4,4,0,76
156102,1263475,1,12,5,1,0,77
156103,1263475,1,12,6,1,0,78
156104,1263475,1,13,1,1,0,79
156105,1263475,1,13,2,0,1,79
156106,1263475,1,13,3,1,0,80
156107,1263475,1,13,4,2,0,82
156108,1263475,1,13,5,0,1,82
156109,1263475,1,13,6,2,0,84
156110,1263475,1,14,1,0,0,84
156111,1263475,1,14,2,1,0,85
156112,1263475,1,14,3,2,0,87
156113,1263475,1,14,4,0,0,87
156114,1263475,1,14,5,1,0,88
156115,1263475,1,14,6,0,0,88
156116,1263475,1,15,1,1,0,89
156117,1263475,1,15,2,2,0,91
156118,1263475,1,15,3,1,0,92
156119,1263475,1,15,4,1,0,93
156120,1263475,1,15,5,2,0,95
156121,1263475,1,15,6,1,0,96
156122,1263475,1,16,1,0,0,96
156123,1263475,1,16,2,4,0,100
156124,1263475,1,16,3,4,0,104
156125,1263475,1,16,4,2,0,106
156126,1263475,1,16,5,1,0,107
156127,1263475,1,16,6,1,0,108
156128,1263475,1,17,1,0,0,108
156129,1263475,1,17,2,7,0,115
156130,1263475,1,17,3,1,0,116
156131,1263475,1,17,4,4,0,120
156132,1263475,1,17,5,4,0,124
156133,1263475,1,17,6,1,0,125
156134,1263475,1,18,1,2,0,127
156135,1263475,1,18,2,1,0,128
156136,1263475,1,18,3,1,0,129
156137,1263475,1,18,4,1,0,130
156138,1263475,1,18,5,1,0,131
156139,1263475,1,18,6,6,0,137
156140,1263475,1,19,1,1,0,138
156141,1263475,1,19,2,2,0,140
156142,1263475,1,19,3,1,0,141
156143,1263475,1,19,4,5,0,146
156144,1263475,1,19,5,0,1,146
156145,1263475,1,19,6,1,0,147
156146,1263475,1,20,1,0,0,147
156147,1263475,1,20,2,0,0,147
156148,1263475,1,20,3,2,0,149
156149,1263475,1,20,4,1,0,150
156150,1263475,1,20,5,4,0,154
156151,1263475,1,20,6,0,0,154
156271,1267680,1,1,1,0,0,0
156272,1267680,1,1,2,1,0,1
156273,1267680,1,1,3,0,0,1
156274,1267680,1,1,4,0,0,1
156275,1267680,1,1,5,1,0,2
156276,1267680,1,1,6,1,0,3
156277,1267680,1,2,1,1,0,4
156278,1267680,1,2,2,6,0,10
156279,1267680,1,2,3,0,0,10
156280,1267680,1,2,4,0,0,10
156281,1267680,1,2,5,0,1,10
156282,1267680,1,2,6,2,0,12
156283,1267680,1,3,1,1,0,13
156284,1267680,1,3,2,0,0,13
156285,1267680,1,3,3,1,0,14
156286,1267680,1,3,4,5,0,19
156287,1267680,1,3,5,0,0,19
156288,1267680,1,3,6,4,0,23
156289,1267680,1,4,1,6,0,29
156290,1267680,1,4,2,1,0,30
156291,1267680,1,4,3,4,0,34
156292,1267680,1,4,4,1,0,35
156293,1267680,1,4,5,0,0,35
156294,1267680,1,4,6,3,0,38
156295,1267680,1,5,1,2,0,40
156296,1267680,1,5,2,0,0,40
156297,1267680,1,5,3,0,0,40
156298,1267680,1,5,4,1,0,41
156299,1267680,1,5,5,4,0,45
156300,1267680,1,5,6,1,0,46
156301,1267680,1,6,1,1,0,47
156302,1267680,1,6,2,0,0,47
156303,1267680,1,6,3,0,0,47
156304,1267680,1,6,4,1,0,48
156305,1267680,1,6,5,1,0,49
156306,1267680,1,6,6,1,0,50
156307,1267680,1,7,1,1,0,51
156308,1267680,1,7,2,0,0,51
156309,1267680,1,7,3,2,0,53
156310,1267680,1,7,4,1,0,54
156311,1267680,1,7,5,1,0,55
156312,1267680,1,7,6,1,0,56
156313,1267680,1,8,1,4,0,60
156314,1267680,1,8,2,1,0,61
156315,1267680,1,8,3,1,0,62
156316,1267680,1,8,4,6,0,68
156317,1267680,1,8,5,6,0,74
156318,1267680,1,8,6,0,0,74
156319,1267680,1,9,1,0,1,74
156320,1267680,1,9,2,0,0,74
156321,1267680,1,9,3,1,0,75
156322,1267680,1,9,4,1,0,76
156323,1267680,1,9,5,0,0,76
156324,1267680,1,9,6,1,0,77
156325,1267680,1,10,1,2,0,79
156326,1267680,1,10,2,1,0,80
156327,1267680,1,10,3,1,0,81
156328,1267680,1,10,4,4,0,85
156329,1267680,1,10,5,2,0,87
156330,1267680,1,10,6,4,0,91
156331,1267680,1,11,1,0,1,91
156332,1267680,1,11,2,1,0,92
156333,1267680,1,11,3,0,0,92
156334,1267680,1,11,4,0,0,92
156335,1267680,1,11,5,0,1,92
156336,1267680,1,11,6,0,0,92
156337,1267680,1,12,1,2,0,94
156338,1267680,1,12,2,1,0,95
156339,1267680,1,12,3,1,0,96
156340,1267680,1,12,4,1,0,97
156341,1267680,1,12,5,4,0,101
156342,1267680,1,12,6,0,0,101
156343,1267680,1,13,1,1,0,102
156344,1267680,1,13,2,1,0,103
156345,1267680,1,13,3,2,0,105
156346,1267680,1,13,4,2,0,107
156347,1267680,1,13,5,2,0,109
156348,1267680,1,13,6,1,0,110
156349,1267680,1,14,1,1,0,111
156350,1267680,1,14,2,0,1,111
156351,1267680,1,14,3,1,0,112
156352,1267680,1,14,4,1,0,113
156353,1267680,1,14,5,1,0,114
156354,1267680,1,14,6,5,0,119
156355,1267680,1,15,1,0,1,119
156356,1267680,1,15,2,0,0,119
156357,1267680,1,15,3,0,0,119
156358,1267680,1,15,4,0,0,119
156359,1267680,1,15,5,0,0,119
156360,1267680,1,15,6,1,0,120
156361,1267680,1,16,1,2,0,122
156362,1267680,1,16,2,1,0,123
156363,1267680,1,16,3,1,0,124
156364,1267680,1,16,4,2,0,126
156365,1267680,1,16,5,4,0,130
156366,1267680,1,16,6,0,0,130
156367,1267680,1,17,1,1,0,131
156368,1267680,1,17,2,2,0,133
156369,1267680,1,17,3,0,0,133
156370,1267680,1,17,4,1,0,134
156371,1267680,1,17,5,1,0,135
156372,1267680,1,17,6,1,0,136
156373,1267680,1,18,1,4,0,140
156374,1267680,1,18,2,0,1,140
156375,1267680,1,18,3,2,0,142
156376,1267680,1,18,4,1,0,143
156377,1267680,1,18,5,0,1,143
156378,1267680,1,18,6,0,0,143
156379,1267680,1,19,1,1,0,144
156380,1267680,1,19,2,0,1,144
156381,1267680,1,19,3,0,0,144
156382,1267680,1,19,4,4,0,148
156383,1267680,1,19,5,4,0,152
156384,1267680,1,19,6,0,1,152
156498,1267681,1,1,1,3,0,3
156499,1267681,1,1,2,0,0,3
156500,1267681,1,1,3,0,0,3
156501,1267681,1,1,4,1,0,4
156502,1267681,1,1,5,0,0,4
156503,1267681,1,1,6,0,0,4
156504,1267681,1,2,1,6,0,10
156505,1267681,1,2,2,4,0,14
156506,1267681,1,2,3,1,0,15
156507,1267681,1,2,4,0,0,15
156508,1267681,1,2,5,0,1,15
156509,1267681,1,2,6,0,0,15
156510,1267681,1,3,1,0,0,15
156511,1267681,1,3,2,1,0,16
156512,1267681,1,3,3,1,0,17
156513,1267681,1,3,4,4,0,21
156514,1267681,1,3,5,1,0,22
156515,1267681,1,3,6,0,0,22
156516,1267681,1,4,1,6,0,28
156517,1267681,1,4,2,1,0,29
156518,1267681,1,4,3,0,0,29
156519,1267681,1,4,4,0,0,29
156520,1267681,1,4,5,4,0,33
156521,1267681,1,4,6,0,0,33
156522,1267681,1,5,1,0,0,33
156523,1267681,1,5,2,1,0,34
156524,1267681,1,5,3,1,0,35
156525,1267681,1,5,4,1,0,36
156526,1267681,1,5,5,1,0,37
156527,1267681,1,5,6,4,0,41
156528,1267681,1,6,1,1,0,42
156529,1267681,1,6,2,0,1,42
156530,1267681,1,6,3,1,0,43
156531,1267681,1,6,4,0,0,43
156532,1267681,1,6,5,1,0,44
156533,1267681,1,6,6,4,0,48
156534,1267681,1,7,1,2,0,50
156535,1267681,1,7,2,1,0,51
156536,1267681,1,7,3,1,0,52
156537,1267681,1,7,4,1,0,53
156538,1267681,1,7,5,1,0,54
156539,1267681,1,7,6,0,0,54
156540,1267681,1,8,1,2,0,56
156541,1267681,1,8,2,0,0,56
156542,1267681,1,8,3,1,0,57
156543,1267681,1,8,4,1,0,58
156544,1267681,1,8,5,1,0,59
156545,1267681,1,8,6,2,0,61
156546,1267681,1,9,1,1,0,62
156547,1267681,1,9,2,1,0,63
156548,1267681,1,9,3,5,0,68
156549,1267681,1,9,4,1,0,69
156550,1267681,1,9,5,1,0,70
156551,1267681,1,9,6,1,0,71
156552,1267681,1,10,1,1,0,72
156553,1267681,1,10,2,1,0,73
156554,1267681,1,10,3,2,0,75
156555,1267681,1,10,4,1,0,76
156556,1267681,1,10,5,1,0,77
156557,1267681,1,10,6,0,0,77
156558,1267681,1,11,1,0,0,77
156559,1267681,1,11,2,4,0,81
156560,1267681,1,11,3,1,0,82
156561,1267681,1,11,4,1,0,83
156562,1267681,1,11,5,0,0,83
156563,1267681,1,11,6,0,0,83
156564,1267681,1,12,1,0,0,83
156565,1267681,1,12,2,0,0,83
156566,1267681,1,12,3,0,0,83
156567,1267681,1,12,4,1,0,84
156568,1267681,1,12,5,6,0,90
156569,1267681,1,12,6,0,0,90
156570,1267681,1,13,1,0,0,90
156571,1267681,1,13,2,2,0,92
156572,1267681,1,13,3,0,0,92
156573,1267681,1,13,4,1,0,93
156574,1267681,1,13,5,0,0,93
156575,1267681,1,13,6,1,0,94
156576,1267681,1,14,1,4,0,98
156577,1267681,1,14,2,1,0,99
156578,1267681,1,14,3,0,1,99
156579,1267681,1,14,4,1,0,100
156580,1267681,1,14,5,1,0,101
156581,1267681,1,14,6,0,0,101
156582,1267681,1,15,1,1,0,102
156583,1267681,1,15,2,1,0,103
156584,1267681,1,15,3,0,0,103
156585,1267681,1,15,4,1,0,104
156586,1267681,1,15,5,2,0,106
156587,1267681,1,15,6,6,0,112
156588,1267681,1,16,1,1,0,113
156589,1267681,1,16,2,6,0,119
156590,1267681,1,16,3,3,0,122
156591,1267681,1,16,4,0,1,122
156592,1267681,1,16,5,1,0,123
156593,1267681,1,16,6,1,0,124
156594,1267681,1,17,1,4,0,128
156595,1267681,1,17,2,3,0,131
156596,1267681,1,17,3,1,0,132
156597,1267681,1,17,4,1,0,133
156598,1267681,1,17,5,1,0,134
156599,1267681,1,17,6,1,0,135
156600,1267681,1,18,1,3,0,138
156601,1267681,1,18,2,0,0,138
156602,1267681,1,18,3,1,0,139
156603,1267681,1,18,4,0,1,139
156604,1267681,1,18,5,0,0,139
156605,1267681,1,18,6,1,0,140
156606,1267681,1,19,1,4,0,144
156607,1267681,1,19,2,1,0,145
156608,1267681,1,19,3,1,0,146
156609,1267681,1,19,4,2,0,148
156610,1267681,1,19,5,7,0,155
156611,1267681,1,19,6,1,0,156
156612,1267681,1,20,1,2,0,158
156613,1267681,1,20,2,1,0,159
156614,1267681,1,20,3,0,0,159
156615,1267681,1,20,4,6,0,165
156616,1267681,1,20,5,1,0,166
156617,1267681,1,20,6,0,1,166
156737,1267682,1,1,1,2,0,2
156738,1267682,1,1,2,1,0,3
156739,1267682,1,1,3,0,0,3
156740,1267682,1,1,4,1,0,4
156741,1267682,1,1,5,4,0,8
156742,1267682,1,1,6,0,0,8
156743,1267682,1,2,1,1,0,9
156744,1267682,1,2,2,0,0,9
156745,1267682,1,2,3,0,0,9
156746,1267682,1,2,4,1,0,10
156747,1267682,1,2,5,2,0,12
156748,1267682,1,2,6,3,0,15
156749,1267682,1,3,1,2,0,17
156750,1267682,1,3,2,1,0,18
156751,1267682,1,3,3,0,0,18
156752,1267682,1,3,4,0,0,18
156753,1267682,1,3,5,4,0,22
156754,1267682,1,3,6,6,0,28
156755,1267682,1,4,1,4,0,32
156756,1267682,1,4,2,4,0,36
156757,1267682,1,4,3,4,0,40
156758,1267682,1,4,4,4,0,44
156759,1267682,1,4,5,4,0,48
156760,1267682,1,4,6,0,0,48
156761,1267682,1,5,1,1,0,49
156762,1267682,1,5,2,1,0,50
156763,1267682,1,5,3,0,0,50
156764,1267682,1,5,4,0,0,50
156765,1267682,1,5,5,1,0,51
156766,1267682,1,5,6,0,0,51
156767,1267682,1,6,1,0,0,51
156768,1267682,1,6,2,4,0,55
156769,1267682,1,6,3,6,0,61
156770,1267682,1,6,4,1,0,62
156771,1267682,1,6,5,1,0,63
156772,1267682,1,6,6,0,1,63
156773,1267682,1,7,1,1,0,64
156774,1267682,1,7,2,1,0,65
156775,1267682,1,7,3,1,0,66
156776,1267682,1,7,4,0,0,66
156777,1267682,1,7,5,1,0,67
156778,1267682,1,7,6,1,0,68
156779,1267682,1,8,1,1,0,69
156780,1267682,1,8,2,0,0,69
156781,1267682,1,8,3,1,0,70
156782,1267682,1,8,4,1,0,71
156783,1267682,1,8,5,6,0,77
156784,1267682,1,8,6,1,0,78
156785,1267682,1,9,1,6,0,84
156786,1267682,1,9,2,2,0,86
156787,1267682,1,9,3,1,0,87
156788,1267682,1,9,4,2,0,89
156789,1267682,1,9,5,1,0,90
156790,1267682,1,9,6,1,0,91
156791,1267682,1,10,1,6,0,97
156792,1267682,1,10,2,1,0,98
156793,1267682,1,10,3,2,0,100
156794,1267682,1,10,4,0,0,100
156795,1267682,1,10,5,0,0,100
156796,1267682,1,10,6,1,0,101
156797,1267682,1,11,1,1,0,102
156798,1267682,1,11,2,1,0,103
156799,1267682,1,11,3,6,0,109
156800,1267682,1,11,4,6,0,115
156801,1267682,1,11,5,6,0,121
156802,1267682,1,11,6,1,0,122
156803,1267682,1,12,1,0,1,122
156804,1267682,1,12,2,1,0,123
156805,1267682,1,12,3,1,0,124
156806,1267682,1,12,4,1,0,125
156807,1267682,1,12,5,0,1,125
156808,1267682,1,12,6,1,0,126
156809,1267682,1,13,1,1,0,127
156810,1267682,1,13,2,1,0,128
156811,1267682,1,13,3,1,0,129
156812,1267682,1,13,4,1,0,130
156813,1267682,1,13,5,1,0,131
156814,1267682,1,13,6,1,0,132
156815,1267682,1,14,1,4,0,136
156816,1267682,1,14,2,1,0,137
156817,1267682,1,14,3,1,0,138
156818,1267682,1,14,4,1,0,139
156819,1267682,1,14,5,0,0,139
156820,1267682,1,14,6,0,0,139
156821,1267682,1,15,1,1,0,140
156822,1267682,1,15,2,4,0,144
156823,1267682,1,15,3,0,0,144
156824,1267682,1,15,4,1,0,145
156825,1267682,1,15,5,1,0,146
156826,1267682,1,15,6,0,0,146
156827,1267682,1,16,1,0,1,146
156828,1267682,1,16,2,1,0,147
156829,1267682,1,16,3,0,0,147
156830,1267682,1,16,4,0,0,147
156831,1267682,1,16,5,1,0,148
156832,1267682,1,16,6,1,0,149
156833,1267682,1,17,1,0,0,149
156834,1267682,1,17,2,1,0,150
156835,1267682,1,17,3,1,0,151
156836,1267682,1,17,4,0,0,151
156837,1267682,1,17,5,4,0,155
156838,1267682,1,17,6,1,0,156
156839,1267682,1,18,1,4,0,160
156840,1267682,1,18,2,1,0,161
156841,1267682,1,18,3,6,0,167
156842,1267682,1,18,4,0,0,167
156843,1267682,1,18,5,4,0,171
156844,1267682,1,18,6,4,0,175
156845,1267682,1,19,1,0,1,175
156846,1267682,1,19,2,0,0,175
156847,1267682,1,19,3,0,0,175
156848,1267682,1,19,4,0,0,175
156849,1267682,1,19,5,1,0,176
156850,1267682,1,19,6,1,0,177
156851,1267682,1,20,1,2,0,179
156852,1267682,1,20,2,2,0,181
156853,1267682,1,20,3,4,0,185
156854,1267682,1,20,4,6,0,191
156855,1267682,1,20,5,0,0,191
156856,1267682,1,20,6,2,0,193
156973,1270834,1,1,1,0,0,0
156974,1270834,1,1,2,6,0,6
156975,1270834,1,1,3,0,0,6
156976,1270834,1,1,4,0,0,6
156977,1270834,1,1,5,0,0,6
156978,1270834,1,1,6,0,0,6
156979,1270834,1,2,1,1,0,7
156980,1270834,1,2,2,0,0,7
156981,1270834,1,2,3,0,0,7
156982,1270834,1,2,4,1,0,8
156983,1270834,1,2,5,0,0,8
156984,1270834,1,2,6,1,0,9
156985,1270834,1,3,1,0,0,9
156986,1270834,1,3,2,0,0,9
156987,1270834,1,3,3,1,0,10
156988,1270834,1,3,4,0,0,10
156989,1270834,1,3,5,1,0,11
156990,1270834,1,3,6,4,0,15
156991,1270834,1,4,1,0,0,15
156992,1270834,1,4,2,0,0,15
156993,1270834,1,4,3,0,1,15
156994,1270834,1,4,4,3,0,18
156995,1270834,1,4,5,1,0,19
156996,1270834,1,4,6,0,0,19
156997,1270834,1,5,1,0,0,19
156998,1270834,1,5,2,6,0,25
156999,1270834,1,5,3,0,0,25
157000,1270834,1,5,4,0,0,25
157001,1270834,1,5,5,1,0,26
157002,1270834,1,5,6,0,0,26
157003,1270834,1,6,1,0,0,26
157004,1270834,1,6,2,0,0,26
157005,1270834,1,6,3,4,0,30
157006,1270834,1,6,4,2,0,32
157007,1270834,1,6,5,0,0,32
157008,1270834,1,6,6,1,0,33
157009,1270834,1,7,1,0,0,33
157010,1270834,1,7,2,1,0,34
157011,1270834,1,7,3,1,0,35
157012,1270834,1,7,4,2,0,37
157013,1270834,1,7,5,0,0,37
157014,1270834,1,7,6,0,1,37
157015,1270834,1,8,1,1,0,38
157016,1270834,1,8,2,1,0,39
157017,1270834,1,8,3,1,0,40
157018,1270834,1,8,4,0,0,40
157019,1270834,1,8,5,1,0,41
157020,1270834,1,8,6,0,0,41
157021,1270834,1,9,1,1,0,42
157022,1270834,1,9,2,4,0,46
157023,1270834,1,9,3,4,0,50
157024,1270834,1,9,4,1,0,51
157025,1270834,1,9,5,1,0,52
157026,1270834,1,9,6,0,0,52
157027,1270834,1,10,1,0,0,52
157028,1270834,1,10,2,1,0,53
157029,1270834,1,10,3,1,0,54
157030,1270834,1,10,4,2,0,56
157031,1270834,1,10,5,1,0,57
157032,1270834,1,10,6,1,0,58
157033,1270834,1,11,1,1,0,59
157034,1270834,1,11,2,0,0,59
157035,1270834,1,11,3,0,0,59
157036,1270834,1,11,4,1,0,60
157037,1270834,1,11,5,1,0,61
157038,1270834,1,11,6,0,0,61
157039,1270834,1,12,1,1,0,62
157040,1270834,1,12,2,0,0,62
157041,1270834,1,12,3,0,0,62
157042,1270834,1,12,4,2,0,64
157043,1270834,1,12,5,2,0,66
157044,1270834,1,12,6,1,0,67
157045,1270834,1,13,1,6,0,73
157046,1270834,1,13,2,0,1,73
157047,1270834,1,13,3,1,0,74
157048,1270834,1,13,4,0,0,74
157049,1270834,1,13,5,1,0,75
157050,1270834,1,13,6,1,0,76
157051,1270834,1,14,1,2,0,78
157052,1270834,1,14,2,0,0,78
157053,1270834,1,14,3,0,0,78
157054,1270834,1,14,4,4,0,82
157055,1270834,1,14,5,0,0,82
157056,1270834,1,14,6,1,0,83
157057,1270834,1,15,1,1,0,84
157058,1270834,1,15,2,2,0,86
157059,1270834,1,15,3,0,1,86
157060,1270834,1,15,4,1,0,87
157061,1270834,1,15,5,1,0,88
157062,1270834,1,15,6,1,0,89
157063,1270834,1,16,1,1,0,90
157064,1270834,1,16,2,2,0,92
157065,1270834,1,16,3,1,0,93
157066,1270834,1,16,4,1,0,94
157067,1270834,1,16,5,1,0,95
157068,1270834,1,16,6,1,0,96
157069,1270834,1,17,1,1,0,97
157070,1270834,1,17,2,1,0,98
157071,1270834,1,17,3,1,0,99
157072,1270834,1,17,4,4,0,103
157073,1270834,1,17,5,1,0,104
157074,1270834,1,17,6,0,1,104
157075,1270834,1,18,1,4,0,108
157076,1270834,1,18,2,0,0,108
157077,1270834,1,18,3,2,0,110
157078,1270834,1,18,4,2,0,112
157079,1270834,1,18,5,2,0,114
157080,1270834,1,18,6,0,1,114
157081,1270834,1,19,1,1,0,115
157082,1270834,1,19,2,1,0,116
157083,1270834,1,19,3,1,0,117
157084,1270834,1,19,4,1,0,118
157085,1270834,1,19,5,1,0,119
157086,1270834,1,19,6,1,0,120
157087,1270834,1,20,1,2,0,122
157088,1270834,1,20,2,1,0,123
157089,1270834,1,20,3,4,0,127
157090,1270834,1,20,4,3,0,130
157091,1270834,1,20,5,1,0,131
157092,1270834,1,20,6,0,1,131
157213,1270835,1,1,1,0,0,0
157214,1270835,1,1,2,0,0,0
157215,1270835,1,1,3,1,0,1
157216,1270835,1,1,4,0,0,1
157217,1270835,1,1,5,0,0,1
157218,1270835,1,1,6,0,0,1
157219,1270835,1,2,1,1,0,2
157220,1270835,1,2,2,4,0,6
157221,1270835,1,2,3,0,0,6
157222,1270835,1,2,4,4,0,10
157223,1270835,1,2,5,0,0,10
157224,1270835,1,2,6,1,0,11
157225,1270835,1,3,1,2,0,13
157226,1270835,1,3,2,0,0,13
157227,1270835,1,3,3,0,1,13
157228,1270835,1,3,4,0,0,13
157229,1270835,1,3,5,0,0,13
157230,1270835,1,3,6,0,0,13
157231,1270835,1,4,1,1,0,14
157232,1270835,1,4,2,0,0,14
157233,1270835,1,4,3,0,0,14
157234,1270835,1,4,4,1,0,15
157235,1270835,1,4,5,1,0,16
157236,1270835,1,4,6,4,0,20
157237,1270835,1,5,1,1,0,21
157238,1270835,1,5,2,4,0,25
157239,1270835,1,5,3,1,0,26
157240,1270835,1,5,4,0,0,26
157241,1270835,1,5,5,0,0,26
157242,1270835,1,5,6,1,0,27
157243,1270835,1,6,1,4,0,31
157244,1270835,1,6,2,0,0,31
157245,1270835,1,6,3,0,0,31
157246,1270835,1,6,4,0,1,31
157247,1270835,1,6,5,1,0,32
157248,1270835,1,6,6,0,0,32
157249,1270835,1,7,1,0,0,32
157250,1270835,1,7,2,0,0,32
157251,1270835,1,7,3,1,0,33
157252,1270835,1,7,4,0,0,33
157253,1270835,1,7,5,0,0,33
157254,1270835,1,7,6,1,0,34
157255,1270835,1,8,1,4,0,38
157256,1270835,1,8,2,1,0,39
157257,1270835,1,8,3,1,0,40
157258,1270835,1,8,4,0,0,40
157259,1270835,1,8,5,2,0,42
157260,1270835,1,8,6,1,0,43
157261,1270835,1,9,1,1,0,44
157262,1270835,1,9,2,0,0,44
157263,1270835,1,9,3,1,0,45
157264,1270835,1,9,4,0,0,45
157265,1270835,1,9,5,1,0,46
157266,1270835,1,9,6,0,0,46
157267,1270835,1,10,1,1,0,47
157268,1270835,1,10,2,1,0,48
157269,1270835,1,10,3,0,0,48
157270,1270835,1,10,4,4,0,52
157271,1270835,1,10,5,0,0,52
157272,1270835,1,10,6,1,0,53
157273,1270835,1,11,1,1,0,54
157274,1270835,1,11,2,6,0,60
157275,1270835,1,11,3,0,0,60
157276,1270835,1,11,4,1,0,61
157277,1270835,1,11,5,1,0,62
157278,1270835,1,11,6,0,0,62
157279,1270835,1,12,1,0,0,62
157280,1270835,1,12,2,1,0,63
157281,1270835,1,12,3,1,0,64
157282,1270835,1,12,4,1,0,65
157283,1270835,1,12,5,1,0,66
157284,1270835,1,12,6,1,0,67
157285,1270835,1,13,1,1,0,68
157286,1270835,1,13,2,4,0,72
157287,1270835,1,13,3,1,0,73
157288,1270835,1,13,4,2,0,75
157289,1270835,1,13,5,1,0,76
157290,1270835,1,13,6,1,0,77
157291,1270835,1,14,1,0,0,77
157292,1270835,1,14,2,0,0,77
157293,1270835,1,14,3,4,0,81
157294,1270835,1,14,4,2,0,83
157295,1270835,1,14,5,0,0,83
157296,1270835,1,14,6,4,0,87
157297,1270835,1,15,1,1,0,88
157298,1270835,1,15,2,0,1,88
157299,1270835,1,15,3,0,0,88
157300,1270835,1,15,4,0,0,88
157301,1270835,1,15,5,1,0,89
157302,1270835,1,15,6,1,0,90
157303,1270835,1,16,1,4,0,94
157304,1270835,1,16,2,1,0,95
157305,1270835,1,16,3,1,0,96
157306,1270835,1,16,4,1,0,97
157307,1270835,1,16,5,1,0,98
157308,1270835,1,16,6,1,0,99
157309,1270835,1,17,1,0,1,99
157310,1270835,1,17,2,1,0,100
157311,1270835,1,17,3,1,0,101
157312,1270835,1,17,4,0,0,101
157313,1270835,1,17,5,0,0,101
157314,1270835,1,17,6,1,0,102
157315,1270835,1,18,1,0,0,102
157316,1270835,1,18,2,1,0,103
157317,1270835,1,18,3,0,1,103
157318,1270835,1,18,4,0,1,103
157319,1270835,1,18,5,1,0,104
157320,1270835,1,18,6,1,0,105
157321,1270835,1,19,1,1,0,106
157322,1270835,1,19,2,0,1,106
157323,1270835,1,19,3,2,0,108
157324,1270835,1,19,4,0,0,108
157325,1270835,1,19,5,1,0,109
157326,1270835,1,19,6,1,0,110
157327,1270835,1,20,1,2,0,112
157328,1270835,1,20,2,1,0,113
157329,1270835,1,20,3,4,0,117
157330,1270835,1,20,4,0,0,117
157331,1270835,1,20,5,2,0,119
157332,1270835,1,20,6,2,0,121
157445,1270836,1,1,1,1,0,1
157446,1270836,1,1,2,0,0,1
157447,1270836,1,1,3,0,0,1
157448,1270836,1,1,4,0,0,1
157449,1270836,1,1,5,0,0,1
157450,1270836,1,1,6,1,0,2
157451,1270836,1,2,1,0,0,2
157452,1270836,1,2,2,0,0,2
157453,1270836,1,2,3,0,0,2
157454,1270836,1,2,4,0,0,2
157455,1270836,1,2,5,1,0,3
157456,1270836,1,2,6,0,1,3
157457,1270836,1,3,1,0,1,3
157458,1270836,1,3,2,0,0,3
157459,1270836,1,3,3,2,0,5
157460,1270836,1,3,4,2,0,7
157461,1270836,1,3,5,1,0,8
157462,1270836,1,3,6,1,0,9
157463,1270836,1,4,1,1,0,10
157464,1270836,1,4,2,1,0,11
157465,1270836,1,4,3,1,0,12
157466,1270836,1,4,4,0,0,12
157467,1270836,1,4,5,1,0,13
157468,1270836,1,4,6,2,0,15
157469,1270836,1,5,1,4,0,19
157470,1270836,1,5,2,1,0,20
157471,1270836,1,5,3,0,0,20
157472,1270836,1,5,4,0,0,20
157473,1270836,1,5,5,0,0,20
157474,1270836,1,5,6,0,0,20
157475,1270836,1,6,1,1,0,21
157476,1270836,1,6,2,0,0,21
157477,1270836,1,6,3,1,0,22
157478,1270836,1,6,4,2,0,24
157479,1270836,1,6,5,0,0,24
157480,1270836,1,6,6,4,0,28
157481,1270836,1,7,1,0,0,28
157482,1270836,1,7,2,1,0,29
157483,1270836,1,7,3,1,0,30
157484,1270836,1,7,4,0,0,30
157485,1270836,1,7,5,1,0,31
157486,1270836,1,7,6,1,0,32
157487,1270836,1,8,1,1,0,33
157488,1270836,1,8,2,4,0,37
157489,1270836,1,8,3,1,0,38
157490,1270836,1,8,4,4,0,42
157491,1270836,1,8,5,4,0,46
157492,1270836,1,8,6,1,0,47
157493,1270836,1,9,1,0,1,47
157494,1270836,1,9,2,1,0,48
157495,1270836,1,9,3,1,0,49
157496,1270836,1,9,4,0,0,49
157497,1270836,1,9,5,1,0,50
157498,1270836,1,9,6,0,0,50
157499,1270836,1,10,1,1,0,51
157500,1270836,1,10,2,0,0,51
157501,1270836,1,10,3,6,0,57
157502,1270836,1,10,4,1,0,58
157503,1270836,1,10,5,2,0,60
157504,1270836,1,10,6,0,0,60
157505,1270836,1,11,1,1,0,61
157506,1270836,1,11,2,1,0,62
157507,1270836,1,11,3,1,0,63
157508,1270836,1,11,4,2,0,65
157509,1270836,1,11,5,4,0,69
157510,1270836,1,11,6,2,0,71
157511,1270836,1,12,1,0,0,71
157512,1270836,1,12,2,2,0,73
157513,1270836,1,12,3,1,0,74
157514,1270836,1,12,4,1,0,75
157515,1270836,1,12,5,1,0,76
157516,1270836,1,12,6,0,1,76
157517,1270836,1,13,1,0,0,76
157518,1270836,1,13,2,0,0,76
157519,1270836,1,13,3,1,0,77
157520,1270836,1,13,4,1,0,78
157521,1270836,1,13,5,0,0,78
157522,1270836,1,13,6,1,0,79
157523,1270836,1,14,1,1,0,80
157524,1270836,1,14,2,1,0,81
157525,1270836,1,14,3,0,0,81
157526,1270836,1,14,4,0,1,81
157527,1270836,1,14,5,0,0,81
157528,1270836,1,14,6,0,0,81
157529,1270836,1,15,1,1,0,82
157530,1270836,1,15,2,1,0,83
157531,1270836,1,15,3,3,0,86
157532,1270836,1,15,4,1,0,87
157533,1270836,1,15,5,6,0,93
157534,1270836,1,15,6,0,0,93
157535,1270836,1,16,1,1,0,94
157536,1270836,1,16,2,1,0,95
157537,1270836,1,16,3,2,0,97
157538,1270836,1,16,4,0,1,97
157539,1270836,1,16,5,0,0,97
157540,1270836,1,16,6,1,0,98
157541,1270836,1,17,1,1,0,99
157542,1270836,1,17,2,2,0,101
157543,1270836,1,17,3,1,0,102
157544,1270836,1,17,4,1,0,103
157545,1270836,1,17,5,1,0,104
157546,1270836,1,17,6,0,0,104
157547,1270836,1,18,1,2,0,106
157548,1270836,1,18,2,0,0,106
157549,1270836,1,18,3,1,0,107
157550,1270836,1,18,4,1,0,108
157551,1270836,1,18,5,2,0,110
157552,1270836,1,18,6,4,0,114
157553,1270836,1,19,1,1,0,115
157554,1270836,1,19,2,2,0,117
157555,1270836,1,19,3,1,0,118
157556,1270836,1,19,4,0,0,118
157557,1270836,1,19,5,4,0,122
157558,1270836,1,19,6,0,0,122
157559,1270836,1,20,1,0,0,122
157560,1270836,1,20,2,1,0,123
157561,1270836,1,20,3,4,0,127
157562,1270836,1,20,4,0,1,127
157563,1270836,1,20,5,0,1,127
157564,1270836,1,20,6,0,1,127
157685,1270837,1,1,1,0,0,0
157686,1270837,1,1,2,0,0,0
157687,1270837,1,1,3,1,0,1
157688,1270837,1,1,4,0,0,1
157689,1270837,1,1,5,1,0,2
157690,1270837,1,1,6,0,0,2
157691,1270837,1,2,1,0,0,2
157692,1270837,1,2,2,0,0,2
157693,1270837,1,2,3,1,0,3
157694,1270837,1,2,4,4,0,7
157695,1270837,1,2,5,4,0,11
157696,1270837,1,2,6,1,0,12
157697,1270837,1,3,1,1,0,13
157698,1270837,1,3,2,6,0,19
157699,1270837,1,3,3,3,0,22
157700,1270837,1,3,4,0,0,22
157701,1270837,1,3,5,0,0,22
157702,1270837,1,3,6,0,0,22
157703,1270837,1,4,1,1,0,23
157704,1270837,1,4,2,1,0,24
157705,1270837,1,4,3,0,1,24
157706,1270837,1,4,4,2,0,26
157707,1270837,1,4,5,0,0,26
157708,1270837,1,4,6,0,0,26
157709,1270837,1,5,1,0,0,26
157710,1270837,1,5,2,0,0,26
157711,1270837,1,5,3,1,0,27
157712,1270837,1,5,4,0,0,27
157713,1270837,1,5,5,0,0,27
157714,1270837,1,5,6,2,0,29
157715,1270837,1,6,1,0,0,29
157716,1270837,1,6,2,0,0,29
157717,1270837,1,6,3,1,0,30
157718,1270837,1,6,4,0,0,30
157719,1270837,1,6,5,0,0,30
157720,1270837,1,6,6,0,0,30
157721,1270837,1,7,1,1,0,31
157722,1270837,1,7,2,1,0,32
157723,1270837,1,7,3,1,0,33
157724,1270837,1,7,4,2,0,35
157725,1270837,1,7,5,0,0,35
157726,1270837,1,7,6,2,0,37
157727,1270837,1,8,1,1,0,38
157728,1270837,1,8,2,0,0,38
157729,1270837,1,8,3,0,0,38
157730,1270837,1,8,4,0,0,38
157731,1270837,1,8,5,0,0,38
157732,1270837,1,8,6,1,0,39
157733,1270837,1,9,1,1,0,40
157734,1270837,1,9,2,1,0,41
157735,1270837,1,9,3,0,0,41
157736,1270837,1,9,4,2,0,43
157737,1270837,1,9,5,0,0,43
157738,1270837,1,9,6,0,0,43
157739,1270837,1,10,1,0,0,43
157740,1270837,1,10,2,1,0,44
157741,1270837,1,10,3,4,0,48
157742,1270837,1,10,4,0,0,48
157743,1270837,1,10,5,0,1,48
157744,1270837,1,10,6,0,0,48
157745,1270837,1,11,1,2,0,50
157746,1270837,1,11,2,0,0,50
157747,1270837,1,11,3,1,0,51
157748,1270837,1,11,4,0,0,51
157749,1270837,1,11,5,0,1,51
157750,1270837,1,11,6,0,1,51
157751,1270837,1,12,1,0,0,51
157752,1270837,1,12,2,1,0,52
157753,1270837,1,12,3,2,0,54
157754,1270837,1,12,4,0,0,54
157755,1270837,1,12,5,1,0,55
157756,1270837,1,12,6,1,0,56
157757,1270837,1,13,1,0,0,56
157758,1270837,1,13,2,1,0,57
157759,1270837,1,13,3,0,0,57
157760,1270837,1,13,4,2,0,59
157761,1270837,1,13,5,0,0,59
157762,1270837,1,13,6,1,0,60
157763,1270837,1,14,1,2,0,62
157764,1270837,1,14,2,2,0,64
157765,1270837,1,14,3,2,0,66
157766,1270837,1,14,4,1,0,67
157767,1270837,1,14,5,1,0,68
157768,1270837,1,14,6,0,0,68
157769,1270837,1,15,1,0,0,68
157770,1270837,1,15,2,0,0,68
157771,1270837,1,15,3,0,1,68
157772,1270837,1,15,4,1,0,69
157773,1270837,1,15,5,0,0,69
157774,1270837,1,15,6,1,0,70
157775,1270837,1,16,1,6,0,76
157776,1270837,1,16,2,1,0,77
157777,1270837,1,16,3,1,0,78
157778,1270837,1,16,4,0,1,78
157779,1270837,1,16,5,0,0,78
157780,1270837,1,16,6,1,0,79
157781,1270837,1,17,1,0,0,79
157782,1270837,1,17,2,1,0,80
157783,1270837,1,17,3,0,0,80
157784,1270837,1,17,4,1,0,81
157785,1270837,1,17,5,1,0,82
157786,1270837,1,17,6,0,0,82
157787,1270837,1,18,1,1,0,83
157788,1270837,1,18,2,0,1,83
157789,1270837,1,18,3,0,0,83
157790,1270837,1,18,4,1,0,84
157791,1270837,1,18,5,1,0,85
157792,1270837,1,18,6,0,0,85
157793,1270837,1,19,1,2,0,87
157794,1270837,1,19,2,1,0,88
157795,1270837,1,19,3,1,0,89
157796,1270837,1,19,4,0,0,89
157797,1270837,1,19,5,1,0,90
157798,1270837,1,19,6,0,0,90
157799,1270837,1,20,1,2,0,92
157800,1270837,1,20,2,4,0,96
157801,1270837,1,20,3,6,0,102
157802,1270837,1,20,4,2,0,104
157803,1270837,1,20,5,0,1,104
157804,1270837,1,20,6,0,1,104
157919,1270838,1,1,1,1,0,1
157920,1270838,1,1,2,0,0,1
157921,1270838,1,1,3,0,0,1
157922,1270838,1,1,4,2,0,3
157923,1270838,1,1,5,1,0,4
157924,1270838,1,1,6,4,0,8
157925,1270838,1,2,1,6,0,14
157926,1270838,1,2,2,0,0,14
157927,1270838,1,2,3,0,0,14
157928,1270838,1,2,4,2,0,16
157929,1270838,1,2,5,1,0,17
157930,1270838,1,2,6,2,0,19
157931,1270838,1,3,1,1,0,20
157932,1270838,1,3,2,4,0,24
157933,1270838,1,3,3,4,0,28
157934,1270838,1,3,4,0,0,28
157935,1270838,1,3,5,1,0,29
157936,1270838,1,3,6,4,0,33
157937,1270838,1,4,1,1,0,34
157938,1270838,1,4,2,0,0,34
157939,1270838,1,4,3,0,0,34
157940,1270838,1,4,4,0,0,34
157941,1270838,1,4,5,0,0,34
157942,1270838,1,4,6,1,0,35
157943,1270838,1,5,1,3,0,38
157944,1270838,1,5,2,1,0,39
157945,1270838,1,5,3,3,1,42
157946,1270838,1,5,4,0,0,42
157947,1270838,1,5,5,1,0,43
157948,1270838,1,5,6,0,0,43
157949,1270838,1,6,1,0,0,43
157950,1270838,1,6,2,1,0,44
157951,1270838,1,6,3,0,0,44
157952,1270838,1,6,4,1,0,45
157953,1270838,1,6,5,0,0,45
157954,1270838,1,6,6,1,0,46
157955,1270838,1,7,1,0,0,46
157956,1270838,1,7,2,1,0,47
157957,1270838,1,7,3,0,0,47
157958,1270838,1,7,4,1,0,48
157959,1270838,1,7,5,0,0,48
157960,1270838,1,7,6,1,0,49
157961,1270838,1,8,1,0,0,49
157962,1270838,1,8,2,2,0,51
157963,1270838,1,8,3,2,0,53
157964,1270838,1,8,4,1,0,54
157965,1270838,1,8,5,2,0,56
157966,1270838,1,8,6,0,0,56
157967,1270838,1,9,1,1,0,57
157968,1270838,1,9,2,0,1,57
157969,1270838,1,9,3,0,0,57
157970,1270838,1,9,4,0,0,57
157971,1270838,1,9,5,0,0,57
157972,1270838,1,9,6,0,0,57
157973,1270838,1,10,1,1,0,58
157974,1270838,1,10,2,0,0,58
157975,1270838,1,10,3,0,0,58
157976,1270838,1,10,4,1,0,59
157977,1270838,1,10,5,1,0,60
157978,1270838,1,10,6,0,1,60
157979,1270838,1,11,1,1,0,61
157980,1270838,1,11,2,0,0,61
157981,1270838,1,11,3,0,0,61
157982,1270838,1,11,4,3,0,64
157983,1270838,1,11,5,0,0,64
157984,1270838,1,11,6,1,0,65
157985,1270838,1,12,1,0,0,65
157986,1270838,1,12,2,1,0,66
157987,1270838,1,12,3,2,0,68
157988,1270838,1,12,4,6,0,74
157989,1270838,1,12,5,0,0,74
157990,1270838,1,12,6,1,0,75
157991,1270838,1,13,1,0,0,75
157992,1270838,1,13,2,2,0,77
157993,1270838,1,13,3,1,0,78
157994,1270838,1,13,4,1,0,79
157995,1270838,1,13,5,2,0,81
157996,1270838,1,13,6,1,0,82
157997,1270838,1,14,1,1,0,83
157998,1270838,1,14,2,1,0,84
157999,1270838,1,14,3,0,1,84
158000,1270838,1,14,4,1,0,85
158001,1270838,1,14,5,0,0,85
158002,1270838,1,14,6,6,0,91
158003,1270838,1,15,1,1,0,92
158004,1270838,1,15,2,0,0,92
158005,1270838,1,15,3,0,0,92
158006,1270838,1,15,4,4,0,96
158007,1270838,1,15,5,0,1,96
158008,1270838,1,15,6,6,0,102
158009,1270838,1,16,1,0,0,102
158010,1270838,1,16,2,1,0,103
158011,1270838,1,16,3,1,0,104
158012,1270838,1,16,4,0,0,104
158013,1270838,1,16,5,1,0,105
158014,1270838,1,16,6,0,0,105
158015,1270838,1,17,1,0,0,105
158016,1270838,1,17,2,0,0,105
158017,1270838,1,17,3,0,0,105
158018,1270838,1,17,4,1,0,106
158019,1270838,1,17,5,0,0,106
158020,1270838,1,17,6,0,0,106
158021,1270838,1,18,1,2,0,108
158022,1270838,1,18,2,1,0,109
158023,1270838,1,18,3,1,0,110
158024,1270838,1,18,4,0,1,110
158025,1270838,1,18,5,0,0,110
158026,1270838,1,18,6,0,0,110
158027,1270838,1,19,1,2,0,112
158028,1270838,1,19,2,0,0,112
158029,1270838,1,19,3,0,0,112
158030,1270838,1,19,4,0,0,112
158031,1270838,1,19,5,1,0,113
158032,1270838,1,19,6,1,0,114
158033,1270838,1,20,1,0,0,114
158034,1270838,1,20,2,0,0,114
158035,1270838,1,20,3,0,1,114
158036,1270838,1,20,4,4,0,118
158037,1270838,1,20,5,0,1,118
158038,1270838,1,20,6,4,0,122
158121,1271630,1,1,1,0,0,0
158122,1271630,1,1,2,4,0,4
158123,1271630,1,1,3,0,0,4
158124,1271630,1,1,4,0,0,4
158125,1271630,1,1,5,0,0,4
158126,1271630,1,1,6,1,0,5
158127,1271630,1,2,1,1,0,6
158128,1271630,1,2,2,0,0,6
158129,1271630,1,2,3,1,0,7
158130,1271630,1,2,4,1,0,8
158131,1271630,1,2,5,0,0,8
158132,1271630,1,2,6,1,0,9
158133,1271630,1,3,1,1,0,10
158134,1271630,1,3,2,0,0,10
158135,1271630,1,3,3,1,0,11
158136,1271630,1,3,4,4,0,15
158137,1271630,1,3,5,4,0,19
158138,1271630,1,3,6,4,0,23
158139,1271630,1,4,1,0,0,23
158140,1271630,1,4,2,0,0,23
158141,1271630,1,4,3,1,0,24
158142,1271630,1,4,4,1,0,25
158143,1271630,1,4,5,6,0,31
158144,1271630,1,4,6,0,0,31
158145,1271630,1,5,1,0,0,31
158146,1271630,1,5,2,6,0,37
158147,1271630,1,5,3,1,0,38
158148,1271630,1,5,4,1,0,39
158149,1271630,1,5,5,0,0,39
158150,1271630,1,5,6,1,0,40
158151,1271630,1,6,1,0,0,40
158152,1271630,1,6,2,1,0,41
158153,1271630,1,6,3,4,0,45
158154,1271630,1,6,4,0,0,45
158155,1271630,1,6,5,1,0,46
158156,1271630,1,6,6,1,0,47
158157,1271630,1,7,1,2,0,49
158158,1271630,1,7,2,1,0,50
158159,1271630,1,7,3,1,0,51
158160,1271630,1,7,4,1,0,52
158161,1271630,1,7,5,2,0,54
158162,1271630,1,7,6,0,0,54
158163,1271630,1,8,1,0,0,54
158164,1271630,1,8,2,1,0,55
158165,1271630,1,8,3,0,0,55
158166,1271630,1,8,4,1,0,56
158167,1271630,1,8,5,1,0,57
158168,1271630,1,8,6,1,0,58
158169,1271630,1,9,1,4,0,62
158170,1271630,1,9,2,1,0,63
158171,1271630,1,9,3,1,0,64
158172,1271630,1,9,4,2,0,66
158173,1271630,1,9,5,1,0,67
158174,1271630,1,9,6,2,0,69
158175,1271630,1,10,1,1,0,70
158176,1271630,1,10,2,1,0,71
158177,1271630,1,10,3,1,0,72
158178,1271630,1,10,4,1,0,73
158179,1271630,1,10,5,0,1,73
158180,1271630,1,10,6,0,0,73
158181,1271630,1,11,1,0,0,73
158182,1271630,1,11,2,2,0,75
158183,1271630,1,11,3,0,0,75
158184,1271630,1,11,4,2,0,77
158185,1271630,1,11,5,1,0,78
158186,1271630,1,11,6,1,0,79
158187,1271630,1,12,1,0,1,79
158188,1271630,1,12,2,2,0,81
158189,1271630,1,12,3,0,0,81
158190,1271630,1,12,4,1,0,82
158191,1271630,1,12,5,1,0,83
158192,1271630,1,12,6,1,0,84
158193,1271630,1,13,1,0,0,84
158194,1271630,1,13,2,1,0,85
158195,1271630,1,13,3,0,0,85
158196,1271630,1,13,4,1,0,86
158197,1271630,1,13,5,1,0,87
158198,1271630,1,13,6,0,1,87
158199,1271630,1,14,1,1,0,88
158200,1271630,1,14,2,1,0,89
158201,1271630,1,14,3,1,0,90
158202,1271630,1,14,4,1,0,91
158203,1271630,1,14,5,2,0,93
158204,1271630,1,14,6,1,0,94
158205,1271630,1,15,1,2,0,96
158206,1271630,1,15,2,1,0,97
158207,1271630,1,15,3,1,0,98
158208,1271630,1,15,4,1,0,99
158209,1271630,1,15,5,1,0,100
158210,1271630,1,15,6,7,0,107
158211,1271630,1,16,1,1,0,108
158212,1271630,1,16,2,0,0,108
158213,1271630,1,16,3,1,0,109
158214,1271630,1,16,4,6,0,115
158215,1271630,1,16,5,1,0,116
158216,1271630,1,16,6,1,0,117
158217,1271630,1,17,1,1,0,118
158218,1271630,1,17,2,1,0,119
158219,1271630,1,17,3,1,0,120
158220,1271630,1,17,4,4,0,124
158221,1271630,1,17,5,4,0,128
158222,1271630,1,17,6,2,0,130
158223,1271630,1,18,1,4,0,134
158224,1271630,1,18,2,1,0,135
158225,1271630,1,18,3,4,0,139
158226,1271630,1,18,4,6,0,145
158227,1271630,1,18,5,1,0,146
158228,1271630,1,18,6,1,0,147
158229,1271630,1,19,1,1,0,148
158230,1271630,1,19,2,2,0,150
158231,1271630,1,19,3,0,0,150
158232,1271630,1,19,4,2,0,152
158233,1271630,1,19,5,0,1,152
158234,1271630,1,19,6,1,0,153
158235,1271630,1,20,1,2,0,155
158236,1271630,1,20,2,1,0,156
158237,1271630,1,20,3,0,1,156
158238,1271630,1,20,4,1,0,157
158239,1271630,1,20,5,2,0,159
158240,1271630,1,20,6,4,0,163
158361,1271631,1,1,1,1,0,1
158362,1271631,1,1,2,0,0,1
158363,1271631,1,1,3,0,0,1
158364,1271631,1,1,4,0,0,1
158365,1271631,1,1,5,2,0,3
158366,1271631,1,1,6,1,0,4
158367,1271631,1,2,1,1,0,5
158368,1271631,1,2,2,2,0,7
158369,1271631,1,2,3,1,0,8
158370,1271631,1,2,4,1,0,9
158371,1271631,1,2,5,1,0,10
158372,1271631,1,2,6,0,1,10
158373,1271631,1,3,1,0,0,10
158374,1271631,1,3,2,4,0,14
158375,1271631,1,3,3,1,0,15
158376,1271631,1,3,4,0,0,15
158377,1271631,1,3,5,4,0,19
158378,1271631,1,3,6,6,0,25
158379,1271631,1,4,1,1,0,26
158380,1271631,1,4,2,0,0,26
158381,1271631,1,4,3,0,0,26
158382,1271631,1,4,4,0,0,26
158383,1271631,1,4,5,0,0,26
158384,1271631,1,4,6,1,0,27
158385,1271631,1,5,1,1,0,28
158386,1271631,1,5,2,0,0,28
158387,1271631,1,5,3,6,0,34
158388,1271631,1,5,4,4,0,38
158389,1271631,1,5,5,0,0,38
158390,1271631,1,5,6,0,1,38
158391,1271631,1,6,1,1,0,39
158392,1271631,1,6,2,1,0,40
158393,1271631,1,6,3,4,0,44
158394,1271631,1,6,4,6,0,50
158395,1271631,1,6,5,1,0,51
158396,1271631,1,6,6,1,0,52
158397,1271631,1,7,1,0,0,52
158398,1271631,1,7,2,1,0,53
158399,1271631,1,7,3,1,0,54
158400,1271631,1,7,4,1,0,55
158401,1271631,1,7,5,2,0,57
158402,1271631,1,7,6,1,0,58
158403,1271631,1,8,1,0,0,58
158404,1271631,1,8,2,0,0,58
158405,1271631,1,8,3,1,0,59
158406,1271631,1,8,4,0,1,59
158407,1271631,1,8,5,0,0,59
158408,1271631,1,8,6,1,0,60
158409,1271631,1,9,1,1,0,61
158410,1271631,1,9,2,1,0,62
158411,1271631,1,9,3,0,0,62
158412,1271631,1,9,4,1,0,63
158413,1271631,1,9,5,1,0,64
158414,1271631,1,9,6,1,0,65
158415,1271631,1,10,1,6,0,71
158416,1271631,1,10,2,0,1,71
158417,1271631,1,10,3,0,0,71
158418,1271631,1,10,4,1,0,72
158419,1271631,1,10,5,1,0,73
158420,1271631,1,10,6,2,0,75
158421,1271631,1,11,1,1,0,76
158422,1271631,1,11,2,1,0,77
158423,1271631,1,11,3,1,0,78
158424,1271631,1,11,4,0,0,78
158425,1271631,1,11,5,0,1,78
158426,1271631,1,11,6,0,0,78
158427,1271631,1,12,1,1,0,79
158428,1271631,1,12,2,0,0,79
158429,1271631,1,12,3,0,0,79
158430,1271631,1,12,4,3,0,82
158431,1271631,1,12,5,1,0,83
158432,1271631,1,12,6,0,0,83
158433,1271631,1,13,1,0,0,83
158434,1271631,1,13,2,1,0,84
158435,1271631,1,13,3,1,0,85
158436,1271631,1,13,4,1,0,86
158437,1271631,1,13,5,0,1,86
158438,1271631,1,13,6,1,0,87
158439,1271631,1,14,1,2,0,89
158440,1271631,1,14,2,0,0,89
158441,1271631,1,14,3,1,0,90
158442,1271631,1,14,4,1,0,91
158443,1271631,1,14,5,2,0,93
158444,1271631,1,14,6,1,0,94
158445,1271631,1,15,1,0,0,94
158446,1271631,1,15,2,1,0,95
158447,1271631,1,15,3,1,0,96
158448,1271631,1,15,4,1,0,97
158449,1271631,1,15,5,0,0,97
158450,1271631,1,15,6,0,0,97
158451,1271631,1,16,1,2,0,99
158452,1271631,1,16,2,1,0,100
158453,1271631,1,16,3,0,1,100
158454,1271631,1,16,4,0,0,100
158455,1271631,1,16,5,1,0,101
158456,1271631,1,16,6,1,0,102
158457,1271631,1,17,1,0,0,102
158458,1271631,1,17,2,0,0,102
158459,1271631,1,17,3,0,0,102
158460,1271631,1,17,4,1,0,103
158461,1271631,1,17,5,0,1,103
158462,1271631,1,17,6,0,0,103
158463,1271631,1,18,1,0,1,103
158464,1271631,1,18,2,0,0,103
158465,1271631,1,18,3,0,0,103
158466,1271631,1,18,4,0,0,103
158467,1271631,1,18,5,0,0,103
158468,1271631,1,18,6,0,0,103
158469,1271631,1,19,1,0,1,103
158555,1271632,1,1,1,1,0,1
158556,1271632,1,1,2,4,0,5
158557,1271632,1,1,3,2,0,7
158558,1271632,1,1,4,0,0,7
158559,1271632,1,1,5,4,0,11
158560,1271632,1,1,6,0,0,11
158561,1271632,1,2,1,1,0,12
158562,1271632,1,2,2,0,0,12
158563,1271632,1,2,3,4,0,16
158564,1271632,1,2,4,2,0,18
158565,1271632,1,2,5,0,1,18
158566,1271632,1,2,6,1,0,19
158567,1271632,1,3,1,0,0,19
158568,1271632,1,3,2,0,1,19
158569,1271632,1,3,3,0,0,19
158570,1271632,1,3,4,1,0,20
158571,1271632,1,3,5,1,0,21
158572,1271632,1,3,6,0,0,21
158573,1271632,1,4,1,2,0,23
158574,1271632,1,4,2,0,0,23
158575,1271632,1,4,3,1,0,24
158576,1271632,1,4,4,0,0,24
158577,1271632,1,4,5,4,0,28
158578,1271632,1,4,6,0,1,28
158579,1271632,1,5,1,4,0,32
158580,1271632,1,5,2,4,0,36
158581,1271632,1,5,3,0,0,36
158582,1271632,1,5,4,2,0,38
158583,1271632,1,5,5,1,0,39
158584,1271632,1,5,6,0,0,39
158585,1271632,1,6,1,1,0,40
158586,1271632,1,6,2,0,0,40
158587,1271632,1,6,3,2,0,42
158588,1271632,1,6,4,1,0,43
158589,1271632,1,6,5,4,0,47
158590,1271632,1,6,6,0,0,47
158591,1271632,1,7,1,1,0,48
158592,1271632,1,7,2,1,0,49
158593,1271632,1,7,3,0,0,49
158594,1271632,1,7,4,1,0,50
158595,1271632,1,7,5,1,0,51
158596,1271632,1,7,6,1,0,52
158597,1271632,1,8,1,0,0,52
158598,1271632,1,8,2,1,0,53
158599,1271632,1,8,3,0,0,53
158600,1271632,1,8,4,1,0,54
158601,1271632,1,8,5,1,0,55
158602,1271632,1,8,6,0,0,55
158603,1271632,1,9,1,1,0,56
158604,1271632,1,9,2,1,0,57
158605,1271632,1,9,3,1,0,58
158606,1271632,1,9,4,2,0,60
158607,1271632,1,9,5,1,0,61
158608,1271632,1,9,6,0,0,61
158609,1271632,1,10,1,1,0,62
158610,1271632,1,10,2,0,0,62
158611,1271632,1,10,3,0,1,62
158612,1271632,1,10,4,0,0,62
158613,1271632,1,10,5,0,0,62
158614,1271632,1,10,6,0,0,62
158615,1271632,1,11,1,1,0,63
158616,1271632,1,11,2,0,0,63
158617,1271632,1,11,3,1,0,64
158618,1271632,1,11,4,1,0,65
158619,1271632,1,11,5,0,0,65
158620,1271632,1,11,6,1,0,66
158621,1271632,1,12,1,1,0,67
158622,1271632,1,12,2,0,0,67
158623,1271632,1,12,3,1,0,68
158624,1271632,1,12,4,1,0,69
158625,1271632,1,12,5,1,0,70
158626,1271632,1,12,6,4,0,74
158627,1271632,1,13,1,1,0,75
158628,1271632,1,13,2,1,0,76
158629,1271632,1,13,3,1,0,77
158630,1271632,1,13,4,1,0,78
158631,1271632,1,13,5,2,0,80
158632,1271632,1,13,6,0,1,80
158633,1271632,1,14,1,1,0,81
158634,1271632,1,14,2,0,0,81
158635,1271632,1,14,3,2,0,83
158636,1271632,1,14,4,2,0,85
158637,1271632,1,14,5,0,1,85
158638,1271632,1,14,6,1,0,86
158639,1271632,1,15,1,0,0,86
158640,1271632,1,15,2,0,1,86
158641,1271632,1,15,3,0,0,86
158642,1271632,1,15,4,0,0,86
158643,1271632,1,15,5,0,0,86
158644,1271632,1,15,6,0,0,86
158645,1271632,1,16,1,0,0,86
158646,1271632,1,16,2,1,0,87
158647,1271632,1,16,3,0,0,87
158648,1271632,1,16,4,1,0,88
158649,1271632,1,16,5,0,0,88
158650,1271632,1,16,6,1,0,89
158651,1271632,1,17,1,1,0,90
158652,1271632,1,17,2,2,0,92
158653,1271632,1,17,3,1,0,93
158654,1271632,1,17,4,0,0,93
158655,1271632,1,17,5,0,0,93
158656,1271632,1,17,6,0,0,93
158657,1271632,1,18,1,1,0,94
158658,1271632,1,18,2,0,0,94
158659,1271632,1,18,3,1,0,95
158660,1271632,1,18,4,1,0,96
158661,1271632,1,18,5,4,0,100
158662,1271632,1,18,6,0,0,100
158663,1271632,1,19,1,1,0,101
158664,1271632,1,19,2,0,1,101
158665,1271632,1,19,3,2,0,103
158666,1271632,1,19,4,6,0,109
158667,1271632,1,19,5,1,0,110
158668,1271632,1,19,6,1,0,111
158669,1271632,1,20,1,1,0,112
158670,1271632,1,20,2,0,0,112
158671,1271632,1,20,3,0,0,112
158672,1271632,1,20,4,0,0,112
158673,1271632,1,20,5,2,0,114
158674,1271632,1,20,6,6,0,120
158763,1272093,1,1,1,0,0,0
158764,1272093,1,1,2,1,0,1
158765,1272093,1,1,3,0,1,1
158766,1272093,1,1,4,0,0,1
158767,1272093,1,1,5,1,0,2
158768,1272093,1,1,6,0,0,2
158769,1272093,1,2,1,0,0,2
158770,1272093,1,2,2,0,0,2
158771,1272093,1,2,3,0,0,2
158772,1272093,1,2,4,0,0,2
158773,1272093,1,2,5,4,0,6
158774,1272093,1,2,6,0,0,6
158775,1272093,1,3,1,0,0,6
158776,1272093,1,3,2,1,0,7
158777,1272093,1,3,3,0,0,7
158778,1272093,1,3,4,0,0,7
158779,1272093,1,3,5,0,1,7
158780,1272093,1,3,6,1,0,8
158781,1272093,1,4,1,0,0,8
158782,1272093,1,4,2,0,0,8
158783,1272093,1,4,3,0,1,8
158784,1272093,1,4,4,0,0,8
158785,1272093,1,4,5,1,0,9
158786,1272093,1,4,6,0,1,9
158787,1272093,1,5,1,0,0,9
158788,1272093,1,5,2,0,0,9
158789,1272093,1,5,3,1,0,10
158790,1272093,1,5,4,0,0,10
158791,1272093,1,5,5,0,0,10
158792,1272093,1,5,6,0,0,10
158793,1272093,1,6,1,0,0,10
158794,1272093,1,6,2,4,0,14
158795,1272093,1,6,3,1,0,15
158796,1272093,1,6,4,1,0,16
158797,1272093,1,6,5,1,0,17
158798,1272093,1,6,6,1,0,18
158799,1272093,1,7,1,1,0,19
158800,1272093,1,7,2,0,0,19
158801,1272093,1,7,3,2,0,21
158802,1272093,1,7,4,0,0,21
158803,1272093,1,7,5,1,0,22
158804,1272093,1,7,6,1,0,23
158805,1272093,1,8,1,1,0,24
158806,1272093,1,8,2,0,0,24
158807,1272093,1,8,3,2,0,26
158808,1272093,1,8,4,1,0,27
158809,1272093,1,8,5,1,0,28
158810,1272093,1,8,6,1,0,29
158811,1272093,1,9,1,1,0,30
158812,1272093,1,9,2,0,0,30
158813,1272093,1,9,3,0,0,30
158814,1272093,1,9,4,1,0,31
158815,1272093,1,9,5,1,0,32
158816,1272093,1,9,6,4,0,36
158817,1272093,1,10,1,1,0,37
158818,1272093,1,10,2,1,0,38
158819,1272093,1,10,3,1,0,39
158820,1272093,1,10,4,0,0,39
158821,1272093,1,10,5,1,0,40
158822,1272093,1,10,6,0,0,40
158823,1272093,1,11,1,1,0,41
158824,1272093,1,11,2,1,0,42
158825,1272093,1,11,3,1,0,43
158826,1272093,1,11,4,0,0,43
158827,1272093,1,11,5,0,1,43
158828,1272093,1,11,6,1,0,44
158829,1272093,1,12,1,1,0,45
158830,1272093,1,12,2,0,0,45
158831,1272093,1,12,3,0,0,45
158832,1272093,1,12,4,0,1,45
158833,1272093,1,12,5,0,0,45
158834,1272093,1,12,6,1,0,46
158835,1272093,1,13,1,1,0,47
158836,1272093,1,13,2,1,0,48
158837,1272093,1,13,3,1,0,49
158838,1272093,1,13,4,0,0,49
158839,1272093,1,13,5,0,0,49
158840,1272093,1,13,6,0,1,49
158841,1272093,1,14,1,0,0,49
158842,1272093,1,14,2,0,0,49
158843,1272093,1,14,3,0,0,49
158844,1272093,1,14,4,2,0,51
158845,1272093,1,14,5,1,0,52
158846,1272093,1,14,6,0,0,52
158847,1272093,1,15,1,0,1,52
158848,1272093,1,15,2,0,0,52
158849,1272093,1,15,3,1,0,53
158850,1272093,1,15,4,2,0,55
158851,1272093,1,15,5,0,1,55
158852,1272093,1,15,6,0,0,55
158853,1272093,1,16,1,1,0,56
158854,1272093,1,16,2,0,0,56
158855,1272093,1,16,3,0,0,56
158856,1272093,1,16,4,1,0,57
158857,1272093,1,16,5,0,0,57
158858,1272093,1,16,6,1,0,58
158859,1272093,1,17,1,1,0,59
158860,1272093,1,17,2,0,0,59
158861,1272093,1,17,3,0,0,59
158862,1272093,1,17,4,1,0,60
158863,1272093,1,17,5,0,1,60
158954,1272094,1,1,1,2,0,2
158955,1272094,1,1,2,0,0,2
158956,1272094,1,1,3,1,0,3
158957,1272094,1,1,4,0,0,3
158958,1272094,1,1,5,0,0,3
158959,1272094,1,1,6,0,0,3
158960,1272094,1,2,1,0,0,3
158961,1272094,1,2,2,1,0,4
158962,1272094,1,2,3,0,0,4
158963,1272094,1,2,4,0,0,4
158964,1272094,1,2,5,2,0,6
158965,1272094,1,2,6,0,0,6
158966,1272094,1,3,1,1,0,7
158967,1272094,1,3,2,4,0,11
158968,1272094,1,3,3,4,0,15
158969,1272094,1,3,4,0,0,15
158970,1272094,1,3,5,0,0,15
158971,1272094,1,3,6,0,0,15
158972,1272094,1,4,1,0,0,15
158973,1272094,1,4,2,0,0,15
158974,1272094,1,4,3,0,0,15
158975,1272094,1,4,4,1,0,16
158976,1272094,1,4,5,1,0,17
158977,1272094,1,4,6,4,0,21
158978,1272094,1,5,1,1,0,22
158979,1272094,1,5,2,1,0,23
158980,1272094,1,5,3,1,0,24
158981,1272094,1,5,4,0,0,24
158982,1272094,1,5,5,1,0,25
158983,1272094,1,5,6,2,0,27
158984,1272094,1,6,1,1,0,28
158985,1272094,1,6,2,4,0,32
158986,1272094,1,6,3,1,0,33
158987,1272094,1,6,4,2,0,35
158988,1272094,1,6,5,0,0,35
158989,1272094,1,6,6,1,0,36
158990,1272094,1,7,1,0,0,36
158991,1272094,1,7,2,2,0,38
158992,1272094,1,7,3,1,0,39
158993,1272094,1,7,4,1,0,40
158994,1272094,1,7,5,2,0,42
158995,1272094,1,7,6,0,0,42
158996,1272094,1,8,1,1,0,43
158997,1272094,1,8,2,0,0,43
158998,1272094,1,8,3,1,0,44
158999,1272094,1,8,4,1,0,45
159000,1272094,1,8,5,1,0,46
159001,1272094,1,8,6,1,0,47
159002,1272094,1,9,1,1,0,48
159003,1272094,1,9,2,1,0,49
159004,1272094,1,9,3,0,0,49
159005,1272094,1,9,4,2,0,51
159006,1272094,1,9,5,1,0,52
159007,1272094,1,9,6,1,0,53
159008,1272094,1,10,1,6,0,59
159009,1272094,1,10,2,0,0,59
159010,1272094,1,10,3,0,1,59
159011,1272094,1,10,4,0,1,59
159012,1272094,1,10,5,0,0,59
159013,1272094,1,10,6,1,0,60
159014,1272094,1,11,1,2,0,62
159015,1272094,1,11,2,4,0,66
159016,1272094,1,11,3,1,0,67
159017,1272094,1,11,4,1,0,68
159018,1272094,1,11,5,4,0,72
159019,1272094,1,11,6,0,1,72
159020,1272094,1,12,1,0,0,72
159021,1272094,1,12,2,1,0,73
159022,1272094,1,12,3,1,0,74
159023,1272094,1,12,4,1,0,75
159024,1272094,1,12,5,4,0,79
159025,1272094,1,12,6,4,0,83
159026,1272094,1,13,1,0,0,83
159027,1272094,1,13,2,0,0,83
159028,1272094,1,13,3,1,0,84
159029,1272094,1,13,4,1,0,85
159030,1272094,1,13,5,1,0,86
159031,1272094,1,13,6,0,0,86
159032,1272094,1,14,1,4,0,90
159033,1272094,1,14,2,0,0,90
159034,1272094,1,14,3,0,0,90
159035,1272094,1,14,4,1,0,91
159036,1272094,1,14,5,1,0,92
159037,1272094,1,14,6,0,0,92
159038,1272094,1,15,1,1,0,93
159039,1272094,1,15,2,4,0,97
159040,1272094,1,15,3,0,0,97
159041,1272094,1,15,4,1,0,98
159042,1272094,1,15,5,4,0,102
159043,1272094,1,15,6,1,0,103
159044,1272094,1,16,1,1,0,104
159045,1272094,1,16,2,1,0,105
159046,1272094,1,16,3,1,0,106
159047,1272094,1,16,4,0,0,106
159048,1272094,1,16,5,0,1,106
159049,1272094,1,16,6,1,0,107
159050,1272094,1,17,1,2,0,109
159051,1272094,1,17,2,0,1,109
159052,1272094,1,17,3,0,0,109
159053,1272094,1,17,4,0,0,109
159054,1272094,1,17,5,1,0,110
159055,1272094,1,17,6,0,0,110
159056,1272094,1,18,1,1,0,111
159057,1272094,1,18,2,1,0,112
159058,1272094,1,18,3,1,0,113
159059,1272094,1,18,4,1,0,114
159060,1272094,1,18,5,1,0,115
159061,1272094,1,18,6,2,0,117
159062,1272094,1,19,1,1,0,118
159063,1272094,1,19,2,1,0,119
159064,1272094,1,19,3,4,0,123
159065,1272094,1,19,4,4,0,127
159066,1272094,1,19,5,2,0,129
159067,1272094,1,19,6,1,0,130
159068,1272094,1,20,1,2,0,132
159069,1272094,1,20,2,1,0,133
159070,1272094,1,20,3,2,0,135
159071,1272094,1,20,4,4,0,139
159072,1272094,1,20,5,2,0,141
159073,1272094,1,20,6,0,1,141
159194,1272095,1,1,1,1,0,1
159195,1272095,1,1,2,1,0,2
159196,1272095,1,1,3,4,0,6
159197,1272095,1,1,4,0,0,6
159198,1272095,1,1,5,4,0,10
159199,1272095,1,1,6,1,0,11
159200,1272095,1,2,1,0,0,11
159201,1272095,1,2,2,4,0,15
159202,1272095,1,2,3,0,0,15
159203,1272095,1,2,4,1,0,16
159204,1272095,1,2,5,0,0,16
159205,1272095,1,2,6,0,0,16
159206,1272095,1,3,1,0,1,16
159207,1272095,1,3,2,0,0,16
159208,1272095,1,3,3,0,0,16
159209,1272095,1,3,4,0,0,16
159210,1272095,1,3,5,0,0,16
159211,1272095,1,3,6,0,0,16
159212,1272095,1,4,1,1,0,17
159213,1272095,1,4,2,4,0,21
159214,1272095,1,4,3,0,0,21
159215,1272095,1,4,4,0,0,21
159216,1272095,1,4,5,4,0,25
159217,1272095,1,4,6,0,0,25
159218,1272095,1,5,1,3,0,28
159219,1272095,1,5,2,2,0,30
159220,1272095,1,5,3,1,0,31
159221,1272095,1,5,4,4,0,35
159222,1272095,1,5,5,0,0,35
159223,1272095,1,5,6,0,0,35
159224,1272095,1,6,1,1,0,36
159225,1272095,1,6,2,1,0,37
159226,1272095,1,6,3,0,0,37
159227,1272095,1,6,4,1,0,38
159228,1272095,1,6,5,1,0,39
159229,1272095,1,6,6,1,0,40
159230,1272095,1,7,1,2,0,42
159231,1272095,1,7,2,0,0,42
159232,1272095,1,7,3,4,0,46
159233,1272095,1,7,4,0,1,46
159234,1272095,1,7,5,0,0,46
159235,1272095,1,7,6,0,1,46
159236,1272095,1,8,1,1,0,47
159237,1272095,1,8,2,0,0,47
159238,1272095,1,8,3,0,0,47
159239,1272095,1,8,4,1,0,48
159240,1272095,1,8,5,0,0,48
159241,1272095,1,8,6,1,0,49
159242,1272095,1,9,1,0,0,49
159243,1272095,1,9,2,0,0,49
159244,1272095,1,9,3,0,0,49
159245,1272095,1,9,4,2,0,51
159246,1272095,1,9,5,1,0,52
159247,1272095,1,9,6,1,0,53
159248,1272095,1,10,1,1,0,54
159249,1272095,1,10,2,4,0,58
159250,1272095,1,10,3,0,1,58
159251,1272095,1,10,4,0,0,58
159252,1272095,1,10,5,1,0,59
159253,1272095,1,10,6,1,0,60
159254,1272095,1,11,1,1,0,61
159255,1272095,1,11,2,0,0,61
159256,1272095,1,11,3,1,0,62
159257,1272095,1,11,4,0,0,62
159258,1272095,1,11,5,0,1,62
159259,1272095,1,11,6,0,0,62
159260,1272095,1,12,1,1,0,63
159261,1272095,1,12,2,1,0,64
159262,1272095,1,12,3,1,0,65
159263,1272095,1,12,4,1,0,66
159264,1272095,1,12,5,1,0,67
159265,1272095,1,12,6,0,0,67
159266,1272095,1,13,1,1,0,68
159267,1272095,1,13,2,0,0,68
159268,1272095,1,13,3,2,0,70
159269,1272095,1,13,4,1,0,71
159270,1272095,1,13,5,1,0,72
159271,1272095,1,13,6,1,0,73
159272,1272095,1,14,1,0,0,73
159273,1272095,1,14,2,1,0,74
159274,1272095,1,14,3,0,0,74
159275,1272095,1,14,4,2,0,76
159276,1272095,1,14,5,1,0,77
159277,1272095,1,14,6,0,0,77
159278,1272095,1,15,1,1,0,78
159279,1272095,1,15,2,0,0,78
159280,1272095,1,15,3,0,0,78
159281,1272095,1,15,4,1,0,79
159282,1272095,1,15,5,2,0,81
159283,1272095,1,15,6,1,0,82
159284,1272095,1,16,1,1,0,83
159285,1272095,1,16,2,1,0,84
159286,1272095,1,16,3,1,0,85
159287,1272095,1,16,4,1,0,86
159288,1272095,1,16,5,1,0,87
159289,1272095,1,16,6,1,0,88
159290,1272095,1,17,1,0,0,88
159291,1272095,1,17,2,2,0,90
159292,1272095,1,17,3,0,0,90
159293,1272095,1,17,4,1,0,91
159294,1272095,1,17,5,0,0,91
159295,1272095,1,17,6,4,0,95
159296,1272095,1,18,1,1,0,96
159297,1272095,1,18,2,1,0,97
159298,1272095,1,18,3,4,0,101
159299,1272095,1,18,4,2,0,103
159300,1272095,1,18,5,4,0,107
159301,1272095,1,18,6,1,0,108
159302,1272095,1,19,1,1,0,109
159303,1272095,1,19,2,0,0,109
159304,1272095,1,19,3,4,0,113
159305,1272095,1,19,4,3,0,116
159306,1272095,1,19,5,0,0,116
159307,1272095,1,19,6,1,0,117
159308,1272095,1,20,1,4,0,121
159309,1272095,1,20,2,1,0,122
159310,1272095,1,20,3,4,0,126
159311,1272095,1,20,4,1,0,127
159312,1272095,1,20,5,0,0,127
159313,1272095,1,20,6,1,0,128
159432,1272096,1,1,1,0,0,0
159433,1272096,1,1,2,0,0,0
159434,1272096,1,1,3,0,0,0
159435,1272096,1,1,4,0,0,0
159436,1272096,1,1,5,0,1,0
159437,1272096,1,1,6,0,0,0
159438,1272096,1,2,1,2,0,2
159439,1272096,1,2,2,1,0,3
159440,1272096,1,2,3,0,0,3
159441,1272096,1,2,4,0,0,3
159442,1272096,1,2,5,6,0,9
159443,1272096,1,2,6,1,0,10
159444,1272096,1,3,1,2,0,12
159445,1272096,1,3,2,3,0,15
159446,1272096,1,3,3,1,0,16
159447,1272096,1,3,4,0,1,16
159448,1272096,1,3,5,0,0,16
159449,1272096,1,3,6,0,0,16
159450,1272096,1,4,1,0,0,16
159451,1272096,1,4,2,0,0,16
159452,1272096,1,4,3,0,0,16
159453,1272096,1,4,4,1,0,17
159454,1272096,1,4,5,0,0,17
159455,1272096,1,4,6,0,0,17
159456,1272096,1,5,1,0,0,17
159457,1272096,1,5,2,1,0,18
159458,1272096,1,5,3,0,0,18
159459,1272096,1,5,4,1,0,19
159460,1272096,1,5,5,0,0,19
159461,1272096,1,5,6,0,0,19
159462,1272096,1,6,1,0,0,19
159463,1272096,1,6,2,1,0,20
159464,1272096,1,6,3,1,0,21
159465,1272096,1,6,4,0,0,21
159466,1272096,1,6,5,0,0,21
159467,1272096,1,6,6,1,0,22
159468,1272096,1,7,1,1,0,23
159469,1272096,1,7,2,0,0,23
159470,1272096,1,7,3,2,0,25
159471,1272096,1,7,4,4,0,29
159472,1272096,1,7,5,0,0,29
159473,1272096,1,7,6,1,0,30
159474,1272096,1,8,1,1,0,31
159475,1272096,1,8,2,0,0,31
159476,1272096,1,8,3,1,0,32
159477,1272096,1,8,4,1,0,33
159478,1272096,1,8,5,1,0,34
159479,1272096,1,8,6,1,0,35
159480,1272096,1,9,1,1,0,36
159481,1272096,1,9,2,0,0,36
159482,1272096,1,9,3,4,0,40
159483,1272096,1,9,4,0,0,40
159484,1272096,1,9,5,1,0,41
159485,1272096,1,9,6,1,0,42
159486,1272096,1,10,1,0,0,42
159487,1272096,1,10,2,1,0,43
159488,1272096,1,10,3,0,0,43
159489,1272096,1,10,4,1,0,44
159490,1272096,1,10,5,1,0,45
159491,1272096,1,10,6,1,0,46
159492,1272096,1,11,1,4,0,50
159493,1272096,1,11,2,1,0,51
159494,1272096,1,11,3,0,1,51
159495,1272096,1,11,4,0,0,51
159496,1272096,1,11,5,0,0,51
159497,1272096,1,11,6,1,0,52
159498,1272096,1,12,1,0,0,52
159499,1272096,1,12,2,0,1,52
159500,1272096,1,12,3,0,1,52
159501,1272096,1,12,4,0,0,52
159502,1272096,1,12,5,0,0,52
159503,1272096,1,12,6,0,0,52
159504,1272096,1,13,1,1,0,53
159505,1272096,1,13,2,1,0,54
159506,1272096,1,13,3,1,0,55
159507,1272096,1,13,4,1,0,56
159508,1272096,1,13,5,1,0,57
159509,1272096,1,13,6,0,0,57
159510,1272096,1,14,1,1,0,58
159511,1272096,1,14,2,1,0,59
159512,1272096,1,14,3,4,0,63
159513,1272096,1,14,4,0,0,63
159514,1272096,1,14,5,0,0,63
159515,1272096,1,14,6,2,0,65
159516,1272096,1,15,1,1,0,66
159517,1272096,1,15,2,0,0,66
159518,1272096,1,15,3,0,0,66
159519,1272096,1,15,4,6,0,72
159520,1272096,1,15,5,0,0,72
159521,1272096,1,15,6,0,0,72
159522,1272096,1,16,1,0,0,72
159523,1272096,1,16,2,0,1,72
159524,1272096,1,16,3,1,0,73
159525,1272096,1,16,4,1,0,74
159526,1272096,1,16,5,0,0,74
159527,1272096,1,16,6,0,1,74
159528,1272096,1,17,1,1,0,75
159529,1272096,1,17,2,1,0,76
159530,1272096,1,17,3,1,0,77
159531,1272096,1,17,4,1,0,78
159532,1272096,1,17,5,4,0,82
159533,1272096,1,17,6,0,0,82
159534,1272096,1,18,1,0,0,82
159535,1272096,1,18,2,1,0,83
159536,1272096,1,18,3,1,0,84
159537,1272096,1,18,4,1,0,85
159538,1272096,1,18,5,4,0,89
159539,1272096,1,18,6,0,0,89
159540,1272096,1,19,1,1,0,90
159541,1272096,1,19,2,0,0,90
159542,1272096,1,19,3,1,0,91
159543,1272096,1,19,4,0,0,91
159544,1272096,1,19,5,0,1,91
159545,1272096,1,19,6,1,0,92
159546,1272096,1,20,1,1,0,93
159547,1272096,1,20,2,0,1,93
159548,1272096,1,20,3,0,1,93
159664,1272097,1,1,1,0,0,0
159665,1272097,1,1,2,1,0,1
159666,1272097,1,1,3,1,0,2
159667,1272097,1,1,4,0,0,2
159668,1272097,1,1,5,0,0,2
159669,1272097,1,1,6,0,0,2
159670,1272097,1,2,1,1,0,3
159671,1272097,1,2,2,4,0,7
159672,1272097,1,2,3,6,0,13
159673,1272097,1,2,4,0,0,13
159674,1272097,1,2,5,0,0,13
159675,1272097,1,2,6,1,0,14
159676,1272097,1,3,1,0,0,14
159677,1272097,1,3,2,1,0,15
159678,1272097,1,3,3,0,0,15
159679,1272097,1,3,4,0,0,15
159680,1272097,1,3,5,4,0,19
159681,1272097,1,3,6,0,0,19
159682,1272097,1,4,1,0,0,19
159683,1272097,1,4,2,4,0,23
159684,1272097,1,4,3,6,0,29
159685,1272097,1,4,4,4,0,33
159686,1272097,1,4,5,1,0,34
159687,1272097,1,4,6,4,0,38
159688,1272097,1,5,1,4,0,42
159689,1272097,1,5,2,1,0,43
159690,1272097,1,5,3,1,0,44
159691,1272097,1,5,4,1,0,45
159692,1272097,1,5,5,2,0,47
159693,1272097,1,5,6,0,0,47
159694,1272097,1,6,1,6,0,53
159695,1272097,1,6,2,1,0,54
159696,1272097,1,6,3,4,0,58
159697,1272097,1,6,4,0,1,58
159698,1272097,1,6,5,0,0,58
159699,1272097,1,6,6,0,1,58
159700,1272097,1,7,1,4,0,62
159701,1272097,1,7,2,0,0,62
159702,1272097,1,7,3,0,0,62
159703,1272097,1,7,4,1,0,63
159704,1272097,1,7,5,0,0,63
159705,1272097,1,7,6,0,0,63
159706,1272097,1,8,1,0,0,63
159707,1272097,1,8,2,1,0,64
159708,1272097,1,8,3,1,0,65
159709,1272097,1,8,4,1,0,66
159710,1272097,1,8,5,1,0,67
159711,1272097,1,8,6,0,0,67
159712,1272097,1,9,1,0,0,67
159713,1272097,1,9,2,4,0,71
159714,1272097,1,9,3,0,0,71
159715,1272097,1,9,4,0,1,71
159716,1272097,1,9,5,0,0,71
159717,1272097,1,9,6,0,0,71
159718,1272097,1,10,1,1,0,72
159719,1272097,1,10,2,1,0,73
159720,1272097,1,10,3,1,0,74
159721,1272097,1,10,4,6,0,80
159722,1272097,1,10,5,1,0,81
159723,1272097,1,10,6,0,0,81
159724,1272097,1,11,1,1,0,82
159725,1272097,1,11,2,1,0,83
159726,1272097,1,11,3,0,0,83
159727,1272097,1,11,4,0,1,83
159728,1272097,1,11,5,1,0,84
159729,1272097,1,11,6,1,0,85
159730,1272097,1,12,1,1,0,86
159731,1272097,1,12,2,1,0,87
159732,1272097,1,12,3,1,0,88
159733,1272097,1,12,4,0,0,88
159734,1272097,1,12,5,0,0,88
159735,1272097,1,12,6,1,0,89
159736,1272097,1,13,1,1,0,90
159737,1272097,1,13,2,0,0,90
159738,1272097,1,13,3,0,0,90
159739,1272097,1,13,4,0,0,90
159740,1272097,1,13,5,1,0,91
159741,1272097,1,13,6,1,0,92
159742,1272097,1,14,1,1,0,93
159743,1272097,1,14,2,0,0,93
159744,1272097,1,14,3,0,0,93
159745,1272097,1,14,4,0,0,93
159746,1272097,1,14,5,1,0,94
159747,1272097,1,14,6,2,0,96
159748,1272097,1,15,1,4,0,100
159749,1272097,1,15,2,2,0,102
159750,1272097,1,15,3,1,0,103
159751,1272097,1,15,4,1,0,104
159752,1272097,1,15,5,1,0,105
159753,1272097,1,15,6,2,0,107
159754,1272097,1,16,1,4,0,111
159755,1272097,1,16,2,1,0,112
159756,1272097,1,16,3,1,0,113
159757,1272097,1,16,4,1,0,114
159758,1272097,1,16,5,1,0,115
159759,1272097,1,16,6,1,0,116
159760,1272097,1,17,1,1,0,117
159761,1272097,1,17,2,1,0,118
159762,1272097,1,17,3,0,1,118
159763,1272097,1,17,4,4,0,122
159764,1272097,1,17,5,1,0,123
159765,1272097,1,17,6,2,0,125
159766,1272097,1,18,1,0,0,125
159767,1272097,1,18,2,4,0,129
159768,1272097,1,18,3,0,0,129
159769,1272097,1,18,4,1,0,130
159770,1272097,1,18,5,2,0,132
159771,1272097,1,18,6,1,0,133
159772,1272097,1,19,1,2,0,135
159773,1272097,1,19,2,0,0,135
159774,1272097,1,19,3,4,0,139
159775,1272097,1,19,4,6,0,145
159776,1272097,1,19,5,0,0,145
159777,1272097,1,19,6,6,0,151
159778,1272097,1,20,1,0,0,151
159779,1272097,1,20,2,4,0,155
159780,1272097,1,20,3,1,0,156
159781,1272097,1,20,4,2,0,158
159782,1272097,1,20,5,1,0,159
159783,1272097,1,20,6,2,0,161
159904,1272373,1,1,1,1,0,1
159905,1272373,1,1,2,0,0,1
159906,1272373,1,1,3,1,0,2
159907,1272373,1,1,4,0,0,2
159908,1272373,1,1,5,0,0,2
159909,1272373,1,1,6,0,1,2
159910,1272373,1,2,1,0,0,2
159911,1272373,1,2,2,0,0,2
159912,1272373,1,2,3,0,0,2
159913,1272373,1,2,4,0,0,2
159914,1272373,1,2,5,0,0,2
159915,1272373,1,2,6,0,0,2
159916,1272373,1,3,1,0,0,2
159917,1272373,1,3,2,1,0,3
159918,1272373,1,3,3,1,0,4
159919,1272373,1,3,4,1,0,5
159920,1272373,1,3,5,0,1,5
159921,1272373,1,3,6,1,0,6
159922,1272373,1,4,1,0,0,6
159923,1272373,1,4,2,4,0,10
159924,1272373,1,4,3,1,0,11
159925,1272373,1,4,4,4,0,15
159926,1272373,1,4,5,1,0,16
159927,1272373,1,4,6,0,0,16
159928,1272373,1,5,1,4,0,20
159929,1272373,1,5,2,2,0,22
159930,1272373,1,5,3,4,0,26
159931,1272373,1,5,4,4,0,30
159932,1272373,1,5,5,1,0,31
159933,1272373,1,5,6,1,0,32
159934,1272373,1,6,1,2,0,34
159935,1272373,1,6,2,0,0,34
159936,1272373,1,6,3,1,0,35
159937,1272373,1,6,4,2,0,37
159938,1272373,1,6,5,1,0,38
159939,1272373,1,6,6,0,0,38
159940,1272373,1,7,1,2,0,40
159941,1272373,1,7,2,3,0,43
159942,1272373,1,7,3,0,0,43
159943,1272373,1,7,4,0,0,43
159944,1272373,1,7,5,0,0,43
159945,1272373,1,7,6,0,1,43
159946,1272373,1,8,1,1,0,44
159947,1272373,1,8,2,2,0,46
159948,1272373,1,8,3,0,0,46
159949,1272373,1,8,4,0,0,46
159950,1272373,1,8,5,1,0,47
159951,1272373,1,8,6,1,0,48
159952,1272373,1,9,1,1,0,49
159953,1272373,1,9,2,1,0,50
159954,1272373,1,9,3,1,0,51
159955,1272373,1,9,4,6,0,57
159956,1272373,1,9,5,1,0,58
159957,1272373,1,9,6,1,0,59
159958,1272373,1,10,1,1,0,60
159959,1272373,1,10,2,0,0,60
159960,1272373,1,10,3,4,0,64
159961,1272373,1,10,4,1,0,65
159962,1272373,1,10,5,0,0,65
159963,1272373,1,10,6,0,0,65
159964,1272373,1,11,1,1,0,66
159965,1272373,1,11,2,6,0,72
159966,1272373,1,11,3,1,0,73
159967,1272373,1,11,4,0,1,73
159968,1272373,1,11,5,1,0,74
159969,1272373,1,11,6,1,0,75
159970,1272373,1,12,1,0,0,75
159971,1272373,1,12,2,0,0,75
159972,1272373,1,12,3,0,0,75
159973,1272373,1,12,4,1,0,76
159974,1272373,1,12,5,2,0,78
159975,1272373,1,12,6,1,0,79
159976,1272373,1,13,1,0,1,79
159977,1272373,1,13,2,1,0,80
159978,1272373,1,13,3,0,0,80
159979,1272373,1,13,4,0,0,80
159980,1272373,1,13,5,1,0,81
159981,1272373,1,13,6,0,0,81
159982,1272373,1,14,1,0,0,81
159983,1272373,1,14,2,1,0,82
159984,1272373,1,14,3,1,0,83
159985,1272373,1,14,4,0,0,83
159986,1272373,1,14,5,0,0,83
159987,1272373,1,14,6,1,0,84
159988,1272373,1,15,1,1,0,85
159989,1272373,1,15,2,1,0,86
159990,1272373,1,15,3,0,0,86
159991,1272373,1,15,4,1,0,87
159992,1272373,1,15,5,1,0,88
159993,1272373,1,15,6,0,0,88
159994,1272373,1,16,1,1,0,89
159995,1272373,1,16,2,0,1,89
159996,1272373,1,16,3,1,0,90
159997,1272373,1,16,4,0,0,90
159998,1272373,1,16,5,1,0,91
159999,1272373,1,16,6,1,0,92
160000,1272373,1,17,1,4,0,96
160001,1272373,1,17,2,0,0,96
160002,1272373,1,17,3,2,0,98
160003,1272373,1,17,4,2,0,100
160004,1272373,1,17,5,1,0,101
160005,1272373,1,17,6,0,0,101
160006,1272373,1,18,1,2,0,103
160007,1272373,1,18,2,1,0,104
160008,1272373,1,18,3,0,0,104
160009,1272373,1,18,4,1,0,105
160010,1272373,1,18,5,1,0,106
160011,1272373,1,18,6,1,0,107
160012,1272373,1,19,1,1,0,108
160013,1272373,1,19,2,1,0,109
160014,1272373,1,19,3,2,0,111
160015,1272373,1,19,4,1,0,112
160016,1272373,1,19,5,0,0,112
160017,1272373,1,19,6,1,1,113
160018,1272373,1,20,1,1,0,114
160019,1272373,1,20,2,1,0,115
160020,1272373,1,20,3,1,0,116
160021,1272373,1,20,4,1,0,117
160022,1272373,1,20,5,0,0,117
160023,1272373,1,20,6,0,0,117
160144,1272374,1,1,1,1,0,1
160145,1272374,1,1,2,4,0,5
160146,1272374,1,1,3,0,0,5
160147,1272374,1,1,4,0,0,5
160148,1272374,1,1,5,0,0,5
160149,1272374,1,1,6,1,0,6
160150,1272374,1,2,1,3,0,9
160151,1272374,1,2,2,2,0,11
160152,1272374,1,2,3,1,0,12
160153,1272374,1,2,4,4,0,16
160154,1272374,1,2,5,0,0,16
160155,1272374,1,2,6,0,0,16
160156,1272374,1,3,1,1,0,17
160157,1272374,1,3,2,1,0,18
160158,1272374,1,3,3,0,0,18
160159,1272374,1,3,4,1,0,19
160160,1272374,1,3,5,0,0,19
160161,1272374,1,3,6,1,0,20
160162,1272374,1,4,1,4,0,24
160163,1272374,1,4,2,0,0,24
160164,1272374,1,4,3,2,0,26
160165,1272374,1,4,4,0,0,26
160166,1272374,1,4,5,1,0,27
160167,1272374,1,4,6,0,0,27
160168,1272374,1,5,1,4,0,31
160169,1272374,1,5,2,0,0,31
160170,1272374,1,5,3,2,0,33
160171,1272374,1,5,4,1,0,34
160172,1272374,1,5,5,1,0,35
160173,1272374,1,5,6,0,1,35
160174,1272374,1,6,1,0,0,35
160175,1272374,1,6,2,1,0,36
160176,1272374,1,6,3,1,0,37
160177,1272374,1,6,4,1,0,38
160178,1272374,1,6,5,0,0,38
160179,1272374,1,6,6,1,1,39
160180,1272374,1,7,1,1,0,40
160181,1272374,1,7,2,1,0,41
160182,1272374,1,7,3,0,0,41
160183,1272374,1,7,4,0,1,41
160184,1272374,1,7,5,2,0,43
160185,1272374,1,7,6,0,0,43
160186,1272374,1,8,1,2,0,45
160187,1272374,1,8,2,0,0,45
160188,1272374,1,8,3,1,0,46
160189,1272374,1,8,4,1,0,47
160190,1272374,1,8,5,1,0,48
160191,1272374,1,8,6,1,0,49
160192,1272374,1,9,1,1,0,50
160193,1272374,1,9,2,1,0,51
160194,1272374,1,9,3,0,0,51
160195,1272374,1,9,4,1,0,52
160196,1272374,1,9,5,1,0,53
160197,1272374,1,9,6,1,0,54
160198,1272374,1,10,1,4,0,58
160199,1272374,1,10,2,1,0,59
160200,1272374,1,10,3,1,0,60
160201,1272374,1,10,4,4,0,64
160202,1272374,1,10,5,0,1,64
160203,1272374,1,10,6,0,0,64
160204,1272374,1,11,1,0,1,64
160205,1272374,1,11,2,0,0,64
160206,1272374,1,11,3,0,0,64
160207,1272374,1,11,4,0,0,64
160208,1272374,1,11,5,0,0,64
160209,1272374,1,11,6,1,0,65
160210,1272374,1,12,1,1,0,66
160211,1272374,1,12,2,0,0,66
160212,1272374,1,12,3,1,0,67
160213,1272374,1,12,4,1,0,68
160214,1272374,1,12,5,0,0,68
160215,1272374,1,12,6,1,0,69
160216,1272374,1,13,1,6,0,75
160217,1272374,1,13,2,1,0,76
160218,1272374,1,13,3,0,0,76
160219,1272374,1,13,4,0,0,76
160220,1272374,1,13,5,1,0,77
160221,1272374,1,13,6,0,0,77
160222,1272374,1,14,1,1,0,78
160223,1272374,1,14,2,4,0,82
160224,1272374,1,14,3,1,0,83
160225,1272374,1,14,4,1,0,84
160226,1272374,1,14,5,1,0,85
160227,1272374,1,14,6,0,0,85
160228,1272374,1,15,1,1,0,86
160229,1272374,1,15,2,1,0,87
160230,1272374,1,15,3,1,0,88
160231,1272374,1,15,4,4,0,92
160232,1272374,1,15,5,0,0,92
160233,1272374,1,15,6,1,0,93
160234,1272374,1,16,1,1,0,94
160235,1272374,1,16,2,1,0,95
160236,1272374,1,16,3,6,0,101
160237,1272374,1,16,4,0,0,101
160238,1272374,1,16,5,1,0,102
160239,1272374,1,16,6,1,0,103
160240,1272374,1,17,1,2,0,105
160241,1272374,1,17,2,0,0,105
160242,1272374,1,17,3,6,0,111
160243,1272374,1,17,4,1,0,112
160244,1272374,1,17,5,0,0,112
160245,1272374,1,17,6,4,0,116
160246,1272374,1,18,1,2,0,118
160247,1272374,1,18,2,1,0,119
160248,1272374,1,18,3,1,0,120
160249,1272374,1,18,4,1,0,121
160250,1272374,1,18,5,0,0,121
160251,1272374,1,18,6,4,0,125
160252,1272374,1,19,1,1,0,126
160253,1272374,1,19,2,1,0,127
160254,1272374,1,19,3,1,0,128
160255,1272374,1,19,4,0,0,128
160256,1272374,1,19,5,6,0,134
160257,1272374,1,19,6,4,0,138
160258,1272374,1,20,1,4,0,142
160259,1272374,1,20,2,1,0,143
160260,1272374,1,20,3,0,0,143
160261,1272374,1,20,4,4,0,147
160262,1272374,1,20,5,2,0,149
160263,1272374,1,20,6,3,0,152
160375,1272375,1,1,1,0,0,0
160376,1272375,1,1,2,0,0,0
160377,1272375,1,1,3,0,0,0
160378,1272375,1,1,4,6,0,6
160379,1272375,1,1,5,0,0,6
160380,1272375,1,1,6,1,0,7
160381,1272375,1,2,1,0,0,7
160382,1272375,1,2,2,4,0,11
160383,1272375,1,2,3,0,0,11
160384,1272375,1,2,4,0,0,11
160385,1272375,1,2,5,0,0,11
160386,1272375,1,2,6,1,0,12
160387,1272375,1,3,1,0,0,12
160388,1272375,1,3,2,0,0,12
160389,1272375,1,3,3,0,0,12
160390,1272375,1,3,4,0,0,12
160391,1272375,1,3,5,0,0,12
160392,1272375,1,3,6,0,0,12
160393,1272375,1,4,1,0,0,12
160394,1272375,1,4,2,0,0,12
160395,1272375,1,4,3,6,0,18
160396,1272375,1,4,4,1,0,19
160397,1272375,1,4,5,1,0,20
160398,1272375,1,4,6,0,0,20
160399,1272375,1,5,1,0,0,20
160400,1272375,1,5,2,6,0,26
160401,1272375,1,5,3,1,0,27
160402,1272375,1,5,4,0,0,27
160403,1272375,1,5,5,1,0,28
160404,1272375,1,5,6,1,0,29
160405,1272375,1,6,1,1,0,30
160406,1272375,1,6,2,1,0,31
160407,1272375,1,6,3,1,0,32
160408,1272375,1,6,4,0,0,32
160409,1272375,1,6,5,0,1,32
160410,1272375,1,6,6,1,0,33
160411,1272375,1,7,1,0,0,33
160412,1272375,1,7,2,4,0,37
160413,1272375,1,7,3,4,0,41
160414,1272375,1,7,4,0,0,41
160415,1272375,1,7,5,1,0,42
160416,1272375,1,7,6,0,0,42
160417,1272375,1,8,1,0,0,42
160418,1272375,1,8,2,0,0,42
160419,1272375,1,8,3,1,0,43
160420,1272375,1,8,4,1,0,44
160421,1272375,1,8,5,1,0,45
160422,1272375,1,8,6,0,0,45
160423,1272375,1,9,1,1,0,46
160424,1272375,1,9,2,1,0,47
160425,1272375,1,9,3,1,0,48
160426,1272375,1,9,4,0,0,48
160427,1272375,1,9,5,0,0,48
160428,1272375,1,9,6,4,0,52
160429,1272375,1,10,1,1,0,53
160430,1272375,1,10,2,1,0,54
160431,1272375,1,10,3,4,0,58
160432,1272375,1,10,4,1,0,59
160433,1272375,1,10,5,0,0,59
160434,1272375,1,10,6,1,0,60
160435,1272375,1,11,1,1,0,61
160436,1272375,1,11,2,0,0,61
160437,1272375,1,11,3,0,0,61
160438,1272375,1,11,4,1,0,62
160439,1272375,1,11,5,1,0,63
160440,1272375,1,11,6,1,0,64
160441,1272375,1,12,1,1,0,65
160442,1272375,1,12,2,0,0,65
160443,1272375,1,12,3,0,0,65
160444,1272375,1,12,4,1,0,66
160445,1272375,1,12,5,2,0,68
160446,1272375,1,12,6,4,0,72
160447,1272375,1,13,1,1,0,73
160448,1272375,1,13,2,4,0,77
160449,1272375,1,13,3,1,0,78
160450,1272375,1,13,4,1,0,79
160451,1272375,1,13,5,1,0,80
160452,1272375,1,13,6,6,0,86
160453,1272375,1,14,1,1,0,87
160454,1272375,1,14,2,1,0,88
160455,1272375,1,14,3,0,0,88
160456,1272375,1,14,4,1,0,89
160457,1272375,1,14,5,4,0,93
160458,1272375,1,14,6,4,0,97
160459,1272375,1,15,1,0,0,97
160460,1272375,1,15,2,6,0,103
160461,1272375,1,15,3,1,0,104
160462,1272375,1,15,4,1,0,105
160463,1272375,1,15,5,0,0,105
160464,1272375,1,15,6,1,0,106
160465,1272375,1,16,1,1,0,107
160466,1272375,1,16,2,2,0,109
160467,1272375,1,16,3,0,1,109
160468,1272375,1,16,4,1,0,110
160469,1272375,1,16,5,1,0,111
160470,1272375,1,16,6,1,0,112
160471,1272375,1,17,1,4,0,116
160472,1272375,1,17,2,4,0,120
160473,1272375,1,17,3,1,0,121
160474,1272375,1,17,4,6,0,127
160475,1272375,1,17,5,1,0,128
160476,1272375,1,17,6,1,0,129
160477,1272375,1,18,1,1,0,130
160478,1272375,1,18,2,0,0,130
160479,1272375,1,18,3,1,0,131
160480,1272375,1,18,4,0,0,131
160481,1272375,1,18,5,2,0,133
160482,1272375,1,18,6,4,0,137
160483,1272375,1,19,1,7,0,144
160484,1272375,1,19,2,4,0,148
160485,1272375,1,19,3,0,0,148
160486,1272375,1,19,4,7,0,155
160487,1272375,1,19,5,6,0,161
160488,1272375,1,19,6,1,0,162
160489,1272375,1,20,1,2,0,164
160490,1272375,1,20,2,1,0,165
160491,1272375,1,20,3,1,0,166
160492,1272375,1,20,4,2,0,168
160493,1272375,1,20,5,6,0,174
160494,1272375,1,20,6,4,0,178
160605,1272376,1,1,1,0,0,0
160606,1272376,1,1,2,1,0,1
160607,1272376,1,1,3,0,0,1
160608,1272376,1,1,4,4,0,5
160609,1272376,1,1,5,1,0,6
160610,1272376,1,1,6,1,0,7
160611,1272376,1,2,1,1,0,8
160612,1272376,1,2,2,1,0,9
160613,1272376,1,2,3,4,0,13
160614,1272376,1,2,4,1,0,14
160615,1272376,1,2,5,0,0,14
160616,1272376,1,2,6,0,0,14
160617,1272376,1,3,1,0,0,14
160618,1272376,1,3,2,1,0,15
160619,1272376,1,3,3,1,0,16
160620,1272376,1,3,4,1,0,17
160621,1272376,1,3,5,1,0,18
160622,1272376,1,3,6,1,0,19
160623,1272376,1,4,1,1,0,20
160624,1272376,1,4,2,6,0,26
160625,1272376,1,4,3,0,0,26
160626,1272376,1,4,4,3,0,29
160627,1272376,1,4,5,3,0,32
160628,1272376,1,4,6,0,0,32
160629,1272376,1,5,1,4,0,36
160630,1272376,1,5,2,1,0,37
160631,1272376,1,5,3,1,0,38
160632,1272376,1,5,4,4,0,42
160633,1272376,1,5,5,1,0,43
160634,1272376,1,5,6,1,0,44
160635,1272376,1,6,1,4,0,48
160636,1272376,1,6,2,4,0,52
160637,1272376,1,6,3,4,0,56
160638,1272376,1,6,4,0,0,56
160639,1272376,1,6,5,0,0,56
160640,1272376,1,6,6,1,0,57
160641,1272376,1,7,1,6,0,63
160642,1272376,1,7,2,1,0,64
160643,1272376,1,7,3,0,0,64
160644,1272376,1,7,4,1,0,65
160645,1272376,1,7,5,1,0,66
160646,1272376,1,7,6,1,0,67
160647,1272376,1,8,1,1,0,68
160648,1272376,1,8,2,1,0,69
160649,1272376,1,8,3,1,0,70
160650,1272376,1,8,4,0,0,70
160651,1272376,1,8,5,4,0,74
160652,1272376,1,8,6,1,0,75
160653,1272376,1,9,1,0,0,75
160654,1272376,1,9,2,4,0,79
160655,1272376,1,9,3,0,0,79
160656,1272376,1,9,4,1,0,80
160657,1272376,1,9,5,0,0,80
160658,1272376,1,9,6,0,0,80
160659,1272376,1,10,1,1,0,81
160660,1272376,1,10,2,1,0,82
160661,1272376,1,10,3,1,0,83
160662,1272376,1,10,4,4,0,87
160663,1272376,1,10,5,1,0,88
160664,1272376,1,10,6,1,0,89
160665,1272376,1,11,1,0,1,89
160666,1272376,1,11,2,1,0,90
160667,1272376,1,11,3,1,0,91
160668,1272376,1,11,4,1,0,92
160669,1272376,1,11,5,1,0,93
160670,1272376,1,11,6,1,0,94
160671,1272376,1,12,1,0,0,94
160672,1272376,1,12,2,2,0,96
160673,1272376,1,12,3,1,0,97
160674,1272376,1,12,4,1,0,98
160675,1272376,1,12,5,1,0,99
160676,1272376,1,12,6,1,0,100
160677,1272376,1,13,1,1,0,101
160678,1272376,1,13,2,1,0,102
160679,1272376,1,13,3,4,0,106
160680,1272376,1,13,4,2,0,108
160681,1272376,1,13,5,6,0,114
160682,1272376,1,13,6,0,0,114
160683,1272376,1,14,1,0,0,114
160684,1272376,1,14,2,0,1,114
160685,1272376,1,14,3,1,0,115
160686,1272376,1,14,4,1,0,116
160687,1272376,1,14,5,1,0,117
160688,1272376,1,14,6,1,0,118
160689,1272376,1,15,1,6,0,124
160690,1272376,1,15,2,1,0,125
160691,1272376,1,15,3,4,0,129
160692,1272376,1,15,4,4,0,133
160693,1272376,1,15,5,1,0,134
160694,1272376,1,15,6,0,0,134
160695,1272376,1,16,1,0,0,134
160696,1272376,1,16,2,4,0,138
160697,1272376,1,16,3,1,0,139
160698,1272376,1,16,4,1,0,140
160699,1272376,1,16,5,1,0,141
160700,1272376,1,16,6,1,0,142
160701,1272376,1,17,1,1,0,143
160702,1272376,1,17,2,1,0,144
160703,1272376,1,17,3,0,1,144
160704,1272376,1,17,4,0,0,144
160705,1272376,1,17,5,1,0,145
160706,1272376,1,17,6,1,0,146
160707,1272376,1,18,1,1,0,147
160708,1272376,1,18,2,0,1,147
160709,1272376,1,18,3,0,0,147
160710,1272376,1,18,4,0,0,147
160711,1272376,1,18,5,4,0,151
160712,1272376,1,18,6,1,0,152
160713,1272376,1,19,1,4,0,156
160714,1272376,1,19,2,0,0,156
160715,1272376,1,19,3,2,0,158
160716,1272376,1,19,4,1,0,159
160717,1272376,1,19,5,2,0,161
160718,1272376,1,19,6,2,0,163
160719,1272376,1,20,1,1,0,164
160720,1272376,1,20,2,0,0,164
160721,1272376,1,20,3,0,0,164
160722,1272376,1,20,4,2,0,166
160723,1272376,1,20,5,6,0,172
160724,1272376,1,20,6,2,0,174
160845,1272377,1,1,1,0,0,0
160846,1272377,1,1,2,0,0,0
160847,1272377,1,1,3,0,0,0
160848,1272377,1,1,4,1,0,1
160849,1272377,1,1,5,0,0,1
160850,1272377,1,1,6,0,0,1
160851,1272377,1,2,1,0,0,1
160852,1272377,1,2,2,0,0,1
160853,1272377,1,2,3,0,0,1
160854,1272377,1,2,4,2,1,3
160855,1272377,1,2,5,0,1,3
160856,1272377,1,2,6,0,0,3
160857,1272377,1,3,1,1,0,4
160858,1272377,1,3,2,0,0,4
160859,1272377,1,3,3,0,0,4
160860,1272377,1,3,4,2,0,6
160861,1272377,1,3,5,4,0,10
160862,1272377,1,3,6,1,0,11
160863,1272377,1,4,1,0,0,11
160864,1272377,1,4,2,0,0,11
160865,1272377,1,4,3,1,0,12
160866,1272377,1,4,4,4,0,16
160867,1272377,1,4,5,1,0,17
160868,1272377,1,4,6,0,0,17
160869,1272377,1,5,1,4,0,21
160870,1272377,1,5,2,0,0,21
160871,1272377,1,5,3,0,0,21
160872,1272377,1,5,4,2,0,23
160873,1272377,1,5,5,0,0,23
160874,1272377,1,5,6,0,0,23
160875,1272377,1,6,1,1,0,24
160876,1272377,1,6,2,0,0,24
160877,1272377,1,6,3,4,0,28
160878,1272377,1,6,4,6,0,34
160879,1272377,1,6,5,0,0,34
160880,1272377,1,6,6,0,0,34
160881,1272377,1,7,1,0,0,34
160882,1272377,1,7,2,0,0,34
160883,1272377,1,7,3,0,0,34
160884,1272377,1,7,4,0,0,34
160885,1272377,1,7,5,0,0,34
160886,1272377,1,7,6,0,1,34
160887,1272377,1,8,1,1,0,35
160888,1272377,1,8,2,0,0,35
160889,1272377,1,8,3,1,0,36
160890,1272377,1,8,4,0,0,36
160891,1272377,1,8,5,1,0,37
160892,1272377,1,8,6,1,0,38
160893,1272377,1,9,1,0,0,38
160894,1272377,1,9,2,1,0,39
160895,1272377,1,9,3,1,0,40
160896,1272377,1,9,4,0,0,40
160897,1272377,1,9,5,1,0,41
160898,1272377,1,9,6,0,0,41
160899,1272377,1,10,1,1,0,42
160900,1272377,1,10,2,1,0,43
160901,1272377,1,10,3,6,0,49
160902,1272377,1,10,4,1,0,50
160903,1272377,1,10,5,0,0,50
160904,1272377,1,10,6,1,0,51
160905,1272377,1,11,1,2,0,53
160906,1272377,1,11,2,4,0,57
160907,1272377,1,11,3,1,0,58
160908,1272377,1,11,4,1,0,59
160909,1272377,1,11,5,4,0,63
160910,1272377,1,11,6,1,0,64
160911,1272377,1,12,1,0,0,64
160912,1272377,1,12,2,0,0,64
160913,1272377,1,12,3,1,0,65
160914,1272377,1,12,4,0,0,65
160915,1272377,1,12,5,1,0,66
160916,1272377,1,12,6,0,0,66
160917,1272377,1,13,1,1,0,67
160918,1272377,1,13,2,1,0,68
160919,1272377,1,13,3,1,0,69
160920,1272377,1,13,4,2,0,71
160921,1272377,1,13,5,1,0,72
160922,1272377,1,13,6,1,0,73
160923,1272377,1,14,1,1,0,74
160924,1272377,1,14,2,0,0,74
160925,1272377,1,14,3,4,0,78
160926,1272377,1,14,4,0,0,78
160927,1272377,1,14,5,1,0,79
160928,1272377,1,14,6,1,0,80
160929,1272377,1,15,1,1,0,81
160930,1272377,1,15,2,1,0,82
160931,1272377,1,15,3,1,0,83
160932,1272377,1,15,4,2,0,85
160933,1272377,1,15,5,1,0,86
160934,1272377,1,15,6,1,0,87
160935,1272377,1,16,1,4,0,91
160936,1272377,1,16,2,0,1,91
160937,1272377,1,16,3,1,0,92
160938,1272377,1,16,4,0,0,92
160939,1272377,1,16,5,4,0,96
160940,1272377,1,16,6,0,0,96
160941,1272377,1,17,1,1,0,97
160942,1272377,1,17,2,0,0,97
160943,1272377,1,17,3,0,0,97
160944,1272377,1,17,4,1,0,98
160945,1272377,1,17,5,4,0,102
160946,1272377,1,17,6,0,0,102
160947,1272377,1,18,1,4,0,106
160948,1272377,1,18,2,1,0,107
160949,1272377,1,18,3,1,0,108
160950,1272377,1,18,4,0,0,108
160951,1272377,1,18,5,1,0,109
160952,1272377,1,18,6,1,0,110
160953,1272377,1,19,1,0,0,110
160954,1272377,1,19,2,1,0,111
160955,1272377,1,19,3,0,0,111
160956,1272377,1,19,4,2,0,113
160957,1272377,1,19,5,1,0,114
160958,1272377,1,19,6,1,0,115
160959,1272377,1,20,1,2,0,117
160960,1272377,1,20,2,1,0,118
160961,1272377,1,20,3,2,0,120
160962,1272377,1,20,4,1,0,121
160963,1272377,1,20,5,2,0,123
160964,1272377,1,20,6,1,0,124
161085,1273714,1,1,1,0,0,0
161086,1273714,1,1,2,1,0,1
161087,1273714,1,1,3,0,1,1
161088,1273714,1,1,4,0,0,1
161089,1273714,1,1,5,0,0,1
161090,1273714,1,1,6,0,0,1
161091,1273714,1,2,1,0,0,1
161092,1273714,1,2,2,1,0,2
161093,1273714,1,2,3,0,0,2
161094,1273714,1,2,4,4,0,6
161095,1273714,1,2,5,1,0,7
161096,1273714,1,2,6,0,0,7
161097,1273714,1,3,1,0,0,7
161098,1273714,1,3,2,0,0,7
161099,1273714,1,3,3,0,0,7
161100,1273714,1,3,4,1,0,8
161101,1273714,1,3,5,0,0,8
161102,1273714,1,3,6,0,0,8
161103,1273714,1,4,1,1,0,9
161104,1273714,1,4,2,1,0,10
161105,1273714,1,4,3,1,0,11
161106,1273714,1,4,4,1,0,12
161107,1273714,1,4,5,4,0,16
161108,1273714,1,4,6,2,0,18
161109,1273714,1,5,1,0,0,18
161110,1273714,1,5,2,0,0,18
161111,1273714,1,5,3,4,0,22
161112,1273714,1,5,4,0,1,22
161113,1273714,1,5,5,0,0,22
161114,1273714,1,5,6,2,0,24
161115,1273714,1,6,1,1,0,25
161116,1273714,1,6,2,0,0,25
161117,1273714,1,6,3,0,0,25
161118,1273714,1,6,4,0,0,25
161119,1273714,1,6,5,0,0,25
161120,1273714,1,6,6,0,0,25
161121,1273714,1,7,1,4,0,29
161122,1273714,1,7,2,1,0,30
161123,1273714,1,7,3,1,0,31
161124,1273714,1,7,4,1,0,32
161125,1273714,1,7,5,5,0,37
161126,1273714,1,7,6,0,0,37
161127,1273714,1,8,1,1,0,38
161128,1273714,1,8,2,1,0,39
161129,1273714,1,8,3,0,0,39
161130,1273714,1,8,4,1,0,40
161131,1273714,1,8,5,1,0,41
161132,1273714,1,8,6,1,0,42
161133,1273714,1,9,1,1,0,43
161134,1273714,1,9,2,1,0,44
161135,1273714,1,9,3,4,0,48
161136,1273714,1,9,4,1,0,49
161137,1273714,1,9,5,1,0,50
161138,1273714,1,9,6,0,0,50
161139,1273714,1,10,1,1,0,51
161140,1273714,1,10,2,0,1,51
161141,1273714,1,10,3,0,1,51
161142,1273714,1,10,4,0,1,51
161143,1273714,1,10,5,0,1,51
161144,1273714,1,10,6,1,0,52
161145,1273714,1,11,1,0,0,52
161146,1273714,1,11,2,0,0,52
161147,1273714,1,11,3,0,0,52
161148,1273714,1,11,4,0,0,52
161149,1273714,1,11,5,0,0,52
161150,1273714,1,11,6,1,0,53
161151,1273714,1,12,1,0,0,53
161152,1273714,1,12,2,0,0,53
161153,1273714,1,12,3,4,0,57
161154,1273714,1,12,4,1,0,58
161155,1273714,1,12,5,0,0,58
161156,1273714,1,12,6,1,0,59
161157,1273714,1,13,1,0,0,59
161158,1273714,1,13,2,2,0,61
161159,1273714,1,13,3,1,0,62
161160,1273714,1,13,4,4,0,66
161161,1273714,1,13,5,4,0,70
161162,1273714,1,13,6,1,0,71
161163,1273714,1,14,1,0,0,71
161164,1273714,1,14,2,1,0,72
161165,1273714,1,14,3,0,0,72
161166,1273714,1,14,4,1,0,73
161167,1273714,1,14,5,1,0,74
161168,1273714,1,14,6,0,0,74
161169,1273714,1,15,1,4,0,78
161170,1273714,1,15,2,0,0,78
161171,1273714,1,15,3,0,0,78
161172,1273714,1,15,4,1,0,79
161173,1273714,1,15,5,0,0,79
161174,1273714,1,15,6,1,0,80
161175,1273714,1,16,1,1,0,81
161176,1273714,1,16,2,1,0,82
161177,1273714,1,16,3,2,0,84
161178,1273714,1,16,4,1,0,85
161179,1273714,1,16,5,1,0,86
161180,1273714,1,16,6,1,0,87
161181,1273714,1,17,1,1,0,88
161182,1273714,1,17,2,0,0,88
161183,1273714,1,17,3,0,1,88
161184,1273714,1,17,4,0,0,88
161185,1273714,1,17,5,1,0,89
161186,1273714,1,17,6,1,0,90
161187,1273714,1,18,1,0,0,90
161188,1273714,1,18,2,1,0,91
161189,1273714,1,18,3,4,0,95
161190,1273714,1,18,4,1,0,96
161191,1273714,1,18,5,2,0,98
161192,1273714,1,18,6,1,0,99
161193,1273714,1,19,1,0,0,99
161194,1273714,1,19,2,1,0,100
161195,1273714,1,19,3,0,0,100
161196,1273714,1,19,4,0,0,100
161197,1273714,1,19,5,1,0,101
161198,1273714,1,19,6,1,0,102
161199,1273714,1,20,1,2,0,104
161200,1273714,1,20,2,0,0,104
161201,1273714,1,20,3,1,0,105
161202,1273714,1,20,4,0,1,105
161203,1273714,1,20,5,1,1,106
161204,1273714,1,20,6,0,1,106
161296,1273719,1,1,1,1,0,1
161297,1273719,1,1,2,0,1,1
161298,1273719,1,1,3,1,0,2
161299,1273719,1,1,4,1,0,3
161300,1273719,1,1,5,0,0,3
161301,1273719,1,1,6,1,0,4
161302,1273719,1,2,1,0,0,4
161303,1273719,1,2,2,4,0,8
161304,1273719,1,2,3,0,1,8
161305,1273719,1,2,4,0,1,8
161306,1273719,1,2,5,0,0,8
161307,1273719,1,2,6,1,0,9
161308,1273719,1,3,1,0,0,9
161309,1273719,1,3,2,0,0,9
161310,1273719,1,3,3,0,0,9
161311,1273719,1,3,4,1,0,10
161312,1273719,1,3,5,0,0,10
161313,1273719,1,3,6,1,0,11
161314,1273719,1,4,1,0,0,11
161315,1273719,1,4,2,0,0,11
161316,1273719,1,4,3,1,0,12
161317,1273719,1,4,4,1,0,13
161318,1273719,1,4,5,4,0,17
161319,1273719,1,4,6,0,0,17
161320,1273719,1,5,1,4,0,21
161321,1273719,1,5,2,4,0,25
161322,1273719,1,5,3,0,0,25
161323,1273719,1,5,4,1,0,26
161324,1273719,1,5,5,4,0,30
161325,1273719,1,5,6,0,0,30
161326,1273719,1,6,1,1,0,31
161327,1273719,1,6,2,0,0,31
161328,1273719,1,6,3,4,0,35
161329,1273719,1,6,4,4,0,39
161330,1273719,1,6,5,4,0,43
161331,1273719,1,6,6,4,0,47
161332,1273719,1,7,1,2,0,49
161333,1273719,1,7,2,1,0,50
161334,1273719,1,7,3,1,0,51
161335,1273719,1,7,4,1,0,52
161336,1273719,1,7,5,1,0,53
161337,1273719,1,7,6,1,0,54
161338,1273719,1,8,1,1,0,55
161339,1273719,1,8,2,0,0,55
161340,1273719,1,8,3,1,0,56
161341,1273719,1,8,4,1,0,57
161342,1273719,1,8,5,2,0,59
161343,1273719,1,8,6,6,0,65
161344,1273719,1,9,1,1,0,66
161345,1273719,1,9,2,0,0,66
161346,1273719,1,9,3,0,0,66
161347,1273719,1,9,4,0,0,66
161348,1273719,1,9,5,1,0,67
161349,1273719,1,9,6,1,0,68
161350,1273719,1,10,1,1,0,69
161351,1273719,1,10,2,1,0,70
161352,1273719,1,10,3,4,0,74
161353,1273719,1,10,4,1,0,75
161354,1273719,1,10,5,1,0,76
161355,1273719,1,10,6,2,0,78
161356,1273719,1,11,1,0,0,78
161357,1273719,1,11,2,0,0,78
161358,1273719,1,11,3,0,0,78
161359,1273719,1,11,4,1,0,79
161360,1273719,1,11,5,1,0,80
161361,1273719,1,11,6,0,0,80
161362,1273719,1,12,1,0,0,80
161363,1273719,1,12,2,6,0,86
161364,1273719,1,12,3,2,0,88
161365,1273719,1,12,4,1,0,89
161366,1273719,1,12,5,4,0,93
161367,1273719,1,12,6,2,0,95
161368,1273719,1,13,1,1,0,96
161369,1273719,1,13,2,1,0,97
161370,1273719,1,13,3,1,0,98
161371,1273719,1,13,4,1,0,99
161372,1273719,1,13,5,1,0,100
161373,1273719,1,13,6,2,0,102
161374,1273719,1,14,1,2,0,104
161375,1273719,1,14,2,1,0,105
161376,1273719,1,14,3,2,0,107
161377,1273719,1,14,4,4,0,111
161378,1273719,1,14,5,4,0,115
161379,1273719,1,14,6,1,0,116
161380,1273719,1,15,1,2,0,118
161381,1273719,1,15,2,4,0,122
161382,1273719,1,15,3,1,0,123
161383,1273719,1,15,4,4,0,127
161384,1273719,1,15,5,1,0,128
161385,1273719,1,15,6,2,0,130
161386,1273719,1,16,1,1,0,131
161387,1273719,1,16,2,0,1,131
161388,1273719,1,16,3,1,0,132
161389,1273719,1,16,4,4,0,136
161390,1273719,1,16,5,0,0,136
161391,1273719,1,16,6,1,0,137
161392,1273719,1,17,1,5,0,142
161393,1273719,1,17,2,1,0,143
161394,1273719,1,17,3,0,0,143
161395,1273719,1,17,4,0,1,143
161396,1273719,1,17,5,1,0,144
161397,1273719,1,17,6,1,0,145
161398,1273719,1,18,1,0,0,145
161399,1273719,1,18,2,1,0,146
161400,1273719,1,18,3,1,0,147
161401,1273719,1,18,4,1,0,148
161402,1273719,1,18,5,1,0,149
161403,1273719,1,18,6,1,0,150
161404,1273719,1,19,1,4,0,154
161405,1273719,1,19,2,1,0,155
161406,1273719,1,19,3,1,0,156
161407,1273719,1,19,4,1,0,157
161408,1273719,1,19,5,0,1,157
161409,1273719,1,19,6,0,0,157
161410,1273719,1,20,1,1,0,158
161411,1273719,1,20,2,2,0,160
161412,1273719,1,20,3,0,1,160
161413,1273719,1,20,4,1,0,161
161414,1273719,1,20,5,6,0,167
161415,1273719,1,20,6,4,0,171
161527,1273723,1,1,1,1,0,1
161528,1273723,1,1,2,2,0,3
161529,1273723,1,1,3,0,0,3
161530,1273723,1,1,4,0,1,3
161531,1273723,1,1,5,5,0,8
161532,1273723,1,1,6,0,0,8
161533,1273723,1,2,1,0,0,8
161534,1273723,1,2,2,0,0,8
161535,1273723,1,2,3,0,0,8
161536,1273723,1,2,4,4,0,12
161537,1273723,1,2,5,4,0,16
161538,1273723,1,2,6,1,0,17
161539,1273723,1,3,1,1,0,18
161540,1273723,1,3,2,1,0,19
161541,1273723,1,3,3,0,1,19
161542,1273723,1,3,4,1,0,20
161543,1273723,1,3,5,0,1,20
161544,1273723,1,3,6,0,0,20
161545,1273723,1,4,1,0,0,20
161546,1273723,1,4,2,0,0,20
161547,1273723,1,4,3,0,0,20
161548,1273723,1,4,4,0,0,20
161549,1273723,1,4,5,6,0,26
161550,1273723,1,4,6,0,0,26
161551,1273723,1,5,1,1,0,27
161552,1273723,1,5,2,4,0,31
161553,1273723,1,5,3,0,1,31
161554,1273723,1,5,4,0,0,31
161555,1273723,1,5,5,1,0,32
161556,1273723,1,5,6,0,1,32
161557,1273723,1,6,1,4,0,36
161558,1273723,1,6,2,1,0,37
161559,1273723,1,6,3,0,0,37
161560,1273723,1,6,4,0,0,37
161561,1273723,1,6,5,0,1,37
161562,1273723,1,6,6,0,0,37
161563,1273723,1,7,1,0,0,37
161564,1273723,1,7,2,1,0,38
161565,1273723,1,7,3,2,0,40
161566,1273723,1,7,4,0,0,40
161567,1273723,1,7,5,0,0,40
161568,1273723,1,7,6,0,1,40
161569,1273723,1,8,1,0,0,40
161570,1273723,1,8,2,1,0,41
161571,1273723,1,8,3,0,0,41
161572,1273723,1,8,4,0,0,41
161573,1273723,1,8,5,1,0,42
161574,1273723,1,8,6,1,0,43
161575,1273723,1,9,1,0,0,43
161576,1273723,1,9,2,0,0,43
161577,1273723,1,9,3,1,0,44
161578,1273723,1,9,4,0,0,44
161579,1273723,1,9,5,0,0,44
161580,1273723,1,9,6,0,0,44
161581,1273723,1,10,1,0,1,44
161582,1273723,1,10,2,0,0,44
161583,1273723,1,10,3,0,1,44
161584,1273723,1,10,4,0,0,44
161585,1273723,1,10,5,0,0,44
161586,1273723,1,10,6,0,1,44
161630,1273724,1,1,1,2,0,2
161631,1273724,1,1,2,0,0,2
161632,1273724,1,1,3,4,0,6
161633,1273724,1,1,4,4,0,10
161634,1273724,1,1,5,1,0,11
161635,1273724,1,1,6,0,0,11
161636,1273724,1,2,1,1,0,12
161637,1273724,1,2,2,1,0,13
161638,1273724,1,2,3,0,1,13
161639,1273724,1,2,4,1,0,14
161640,1273724,1,2,5,1,0,15
161641,1273724,1,2,6,1,0,16
161642,1273724,1,3,1,0,1,16
161643,1273724,1,3,2,1,0,17
161644,1273724,1,3,3,0,0,17
161645,1273724,1,3,4,0,0,17
161646,1273724,1,3,5,0,0,17
161647,1273724,1,3,6,0,0,17
161648,1273724,1,4,1,0,0,17
161649,1273724,1,4,2,1,0,18
161650,1273724,1,4,3,0,0,18
161651,1273724,1,4,4,4,0,22
161652,1273724,1,4,5,0,0,22
161653,1273724,1,4,6,1,0,23
161654,1273724,1,5,1,0,1,23
161655,1273724,1,5,2,0,0,23
161656,1273724,1,5,3,0,0,23
161657,1273724,1,5,4,0,0,23
161658,1273724,1,5,5,0,0,23
161659,1273724,1,5,6,0,0,23
161660,1273724,1,6,1,0,0,23
161661,1273724,1,6,2,0,0,23
161662,1273724,1,6,3,0,0,23
161663,1273724,1,6,4,4,0,27
161664,1273724,1,6,5,1,0,28
161665,1273724,1,6,6,1,0,29
161666,1273724,1,7,1,1,0,30
161667,1273724,1,7,2,1,0,31
161668,1273724,1,7,3,3,0,34
161669,1273724,1,7,4,1,0,35
161670,1273724,1,7,5,4,0,39
161671,1273724,1,7,6,0,0,39
161672,1273724,1,8,1,1,0,40
161673,1273724,1,8,2,4,0,44
161674,1273724,1,8,3,1,0,45
161675,1273724,1,8,4,0,0,45
161676,1273724,1,8,5,1,0,46
161677,1273724,1,8,6,0,1,46
161678,1273724,1,9,1,0,0,46
161679,1273724,1,9,2,2,0,48
161680,1273724,1,9,3,4,0,52
161681,1273724,1,9,4,1,0,53
161682,1273724,1,9,5,1,0,54
161683,1273724,1,9,6,0,0,54
161684,1273724,1,10,1,0,0,54
161685,1273724,1,10,2,2,0,56
161686,1273724,1,10,3,1,0,57
161687,1273724,1,10,4,0,0,57
161688,1273724,1,10,5,1,0,58
161689,1273724,1,10,6,1,0,59
161690,1273724,1,11,1,0,0,59
161691,1273724,1,11,2,2,0,61
161692,1273724,1,11,3,1,0,62
161693,1273724,1,11,4,1,0,63
161694,1273724,1,11,5,0,0,63
161695,1273724,1,11,6,0,0,63
161696,1273724,1,12,1,1,0,64
161697,1273724,1,12,2,1,0,65
161698,1273724,1,12,3,0,0,65
161699,1273724,1,12,4,1,0,66
161700,1273724,1,12,5,1,0,67
161701,1273724,1,12,6,4,0,71
161702,1273724,1,13,1,1,0,72
161703,1273724,1,13,2,1,0,73
161704,1273724,1,13,3,1,0,74
161705,1273724,1,13,4,1,0,75
161706,1273724,1,13,5,2,0,77
161707,1273724,1,13,6,0,0,77
161708,1273724,1,14,1,1,0,78
161709,1273724,1,14,2,2,0,80
161710,1273724,1,14,3,0,1,80
161711,1273724,1,14,4,1,0,81
161712,1273724,1,14,5,1,0,82
161713,1273724,1,14,6,0,1,82
161714,1273724,1,15,1,1,0,83
161715,1273724,1,15,2,0,0,83
161716,1273724,1,15,3,0,1,83
161717,1273724,1,15,4,0,0,83
161718,1273724,1,15,5,0,0,83
161719,1273724,1,15,6,0,0,83
161720,1273724,1,16,1,1,0,84
161721,1273724,1,16,2,0,0,84
161722,1273724,1,16,3,1,0,85
161723,1273724,1,16,4,0,0,85
161724,1273724,1,16,5,1,0,86
161725,1273724,1,16,6,0,0,86
161726,1273724,1,17,1,6,0,92
161727,1273724,1,17,2,2,0,94
161728,1273724,1,17,3,0,0,94
161729,1273724,1,17,4,4,0,98
161730,1273724,1,17,5,0,0,98
161731,1273724,1,17,6,0,0,98
161732,1273724,1,18,1,0,1,98
161733,1273724,1,18,2,0,0,98
161734,1273724,1,18,3,0,0,98
161735,1273724,1,18,4,0,0,98
161736,1273724,1,18,5,1,0,99
161737,1273724,1,18,6,2,0,101
161738,1273724,1,19,1,0,0,101
161739,1273724,1,19,2,2,0,103
161740,1273724,1,19,3,0,0,103
161741,1273724,1,19,4,1,0,104
161742,1273724,1,19,5,1,0,105
161743,1273724,1,19,6,1,0,106
161744,1273724,1,20,1,2,0,108
161745,1273724,1,20,2,6,0,114
161746,1273724,1,20,3,1,0,115
161747,1273724,1,20,4,0,1,115
161748,1273724,1,20,5,1,0,116
161749,1273724,1,20,6,2,0,118
161868,1273725,1,1,1,0,0,0
161869,1273725,1,1,2,0,0,0
161870,1273725,1,1,3,1,0,1
161871,1273725,1,1,4,0,0,1
161872,1273725,1,1,5,0,0,1
161873,1273725,1,1,6,6,0,7
161874,1273725,1,2,1,1,0,8
161875,1273725,1,2,2,0,0,8
161876,1273725,1,2,3,0,1,8
161877,1273725,1,2,4,1,0,9
161878,1273725,1,2,5,0,0,9
161879,1273725,1,2,6,0,0,9
161880,1273725,1,3,1,0,0,9
161881,1273725,1,3,2,0,1,9
161882,1273725,1,3,3,0,0,9
161883,1273725,1,3,4,0,0,9
161884,1273725,1,3,5,0,0,9
161885,1273725,1,3,6,0,0,9
161886,1273725,1,4,1,4,0,13
161887,1273725,1,4,2,4,0,17
161888,1273725,1,4,3,0,0,17
161889,1273725,1,4,4,0,0,17
161890,1273725,1,4,5,1,0,18
161891,1273725,1,4,6,1,0,19
161892,1273725,1,5,1,4,0,23
161893,1273725,1,5,2,4,0,27
161894,1273725,1,5,3,0,0,27
161895,1273725,1,5,4,0,1,27
161896,1273725,1,5,5,0,0,27
161897,1273725,1,5,6,0,0,27
161898,1273725,1,6,1,0,0,27
161899,1273725,1,6,2,0,0,27
161900,1273725,1,6,3,0,0,27
161901,1273725,1,6,4,0,0,27
161902,1273725,1,6,5,4,0,31
161903,1273725,1,6,6,0,1,31
161904,1273725,1,7,1,0,0,31
161905,1273725,1,7,2,0,0,31
161906,1273725,1,7,3,0,0,31
161907,1273725,1,7,4,1,0,32
161908,1273725,1,7,5,1,0,33
161909,1273725,1,7,6,0,0,33
161910,1273725,1,8,1,4,0,37
161911,1273725,1,8,2,0,1,37
161912,1273725,1,8,3,0,0,37
161913,1273725,1,8,4,0,0,37
161914,1273725,1,8,5,0,0,37
161915,1273725,1,8,6,1,0,38
161916,1273725,1,9,1,2,0,40
161917,1273725,1,9,2,1,0,41
161918,1273725,1,9,3,0,0,41
161919,1273725,1,9,4,0,0,41
161920,1273725,1,9,5,1,1,42
161921,1273725,1,9,6,0,0,42
161922,1273725,1,10,1,2,0,44
161923,1273725,1,10,2,0,0,44
161924,1273725,1,10,3,0,0,44
161925,1273725,1,10,4,0,0,44
161926,1273725,1,10,5,0,0,44
161927,1273725,1,10,6,0,0,44
161928,1273725,1,11,1,0,1,44
161929,1273725,1,11,2,0,0,44
161930,1273725,1,11,3,0,0,44
161931,1273725,1,11,4,0,0,44
161932,1273725,1,11,5,0,0,44
161933,1273725,1,11,6,1,0,45
161934,1273725,1,12,1,1,0,46
161935,1273725,1,12,2,1,0,47
161936,1273725,1,12,3,1,0,48
161937,1273725,1,12,4,1,0,49
161938,1273725,1,12,5,0,0,49
161939,1273725,1,12,6,0,0,49
161940,1273725,1,13,1,0,1,49
161941,1273725,1,13,2,0,1,49
161942,1273725,1,13,3,0,0,49
161943,1273725,1,13,4,0,0,49
161944,1273725,1,13,5,1,0,50
161945,1273725,1,13,6,0,0,50
161946,1273725,1,14,1,1,0,51
161947,1273725,1,14,2,2,0,53
161948,1273725,1,14,3,0,0,53
161949,1273725,1,14,4,1,0,54
161950,1273725,1,14,5,0,0,54
161951,1273725,1,14,6,1,0,55
161952,1273725,1,15,1,0,0,55
161953,1273725,1,15,2,0,1,55
162004,1273726,1,1,1,0,0,0
162005,1273726,1,1,2,0,0,0
162006,1273726,1,1,3,1,0,1
162007,1273726,1,1,4,0,0,1
162008,1273726,1,1,5,1,0,2
162009,1273726,1,1,6,0,0,2
162010,1273726,1,2,1,0,0,2
162011,1273726,1,2,2,0,0,2
162012,1273726,1,2,3,0,0,2
162013,1273726,1,2,4,4,0,6
162014,1273726,1,2,5,1,0,7
162015,1273726,1,2,6,2,0,9
162016,1273726,1,3,1,1,0,10
162017,1273726,1,3,2,1,0,11
162018,1273726,1,3,3,1,0,12
162019,1273726,1,3,4,0,0,12
162020,1273726,1,3,5,8,0,20
162021,1273726,1,3,6,1,0,21
162022,1273726,1,4,1,3,0,24
162023,1273726,1,4,2,0,0,24
162024,1273726,1,4,3,1,0,25
162025,1273726,1,4,4,0,0,25
162026,1273726,1,4,5,4,0,29
162027,1273726,1,4,6,0,0,29
162028,1273726,1,5,1,1,0,30
162029,1273726,1,5,2,2,0,32
162030,1273726,1,5,3,1,0,33
162031,1273726,1,5,4,4,0,37
162032,1273726,1,5,5,1,0,38
162033,1273726,1,5,6,0,0,38
162034,1273726,1,6,1,1,0,39
162035,1273726,1,6,2,0,0,39
162036,1273726,1,6,3,0,0,39
162037,1273726,1,6,4,1,0,40
162038,1273726,1,6,5,0,1,40
162039,1273726,1,6,6,1,0,41
162040,1273726,1,7,1,4,0,45
162041,1273726,1,7,2,1,0,46
162042,1273726,1,7,3,4,0,50
162043,1273726,1,7,4,1,0,51
162044,1273726,1,7,5,0,0,51
162045,1273726,1,7,6,4,0,55
162046,1273726,1,8,1,0,0,55
162047,1273726,1,8,2,1,0,56
162048,1273726,1,8,3,0,0,56
162049,1273726,1,8,4,0,1,56
162050,1273726,1,8,5,1,0,57
162051,1273726,1,8,6,1,0,58
162052,1273726,1,9,1,1,0,59
162053,1273726,1,9,2,1,0,60
162054,1273726,1,9,3,2,0,62
162055,1273726,1,9,4,1,0,63
162056,1273726,1,9,5,1,0,64
162057,1273726,1,9,6,1,0,65
162058,1273726,1,10,1,2,0,67
162059,1273726,1,10,2,2,0,69
162060,1273726,1,10,3,1,0,70
162061,1273726,1,10,4,1,0,71
162062,1273726,1,10,5,1,0,72
162063,1273726,1,10,6,0,0,72
162064,1273726,1,11,1,1,0,73
162065,1273726,1,11,2,1,0,74
162066,1273726,1,11,3,1,0,75
162067,1273726,1,11,4,6,0,81
162068,1273726,1,11,5,1,0,82
162069,1273726,1,11,6,1,0,83
162070,1273726,1,12,1,1,0,84
162071,1273726,1,12,2,0,0,84
162072,1273726,1,12,3,1,0,85
162073,1273726,1,12,4,1,0,86
162074,1273726,1,12,5,1,0,87
162075,1273726,1,12,6,0,0,87
162076,1273726,1,13,1,6,0,93
162077,1273726,1,13,2,0,0,93
162078,1273726,1,13,3,1,0,94
162079,1273726,1,13,4,0,0,94
162080,1273726,1,13,5,1,0,95
162081,1273726,1,13,6,1,0,96
162082,1273726,1,14,1,1,0,97
162083,1273726,1,14,2,1,0,98
162084,1273726,1,14,3,1,0,99
162085,1273726,1,14,4,4,0,103
162086,1273726,1,14,5,0,0,103
162087,1273726,1,14,6,4,0,107
162088,1273726,1,15,1,4,0,111
162089,1273726,1,15,2,4,0,115
162090,1273726,1,15,3,1,0,116
162091,1273726,1,15,4,1,0,117
162092,1273726,1,15,5,1,0,118
162093,1273726,1,15,6,0,0,118
162094,1273726,1,16,1,1,0,119
162095,1273726,1,16,2,4,0,123
162096,1273726,1,16,3,1,0,124
162097,1273726,1,16,4,2,0,126
162098,1273726,1,16,5,2,0,128
162099,1273726,1,16,6,1,0,129
162100,1273726,1,17,1,0,1,129
162101,1273726,1,17,2,1,0,130
162102,1273726,1,17,3,1,0,131
162103,1273726,1,17,4,4,0,135
162104,1273726,1,17,5,1,0,136
162105,1273726,1,17,6,4,0,140
162106,1273726,1,18,1,1,0,141
162107,1273726,1,18,2,1,0,142
162108,1273726,1,18,3,4,0,146
162109,1273726,1,18,4,1,0,147
162110,1273726,1,18,5,1,0,148
162111,1273726,1,18,6,1,0,149
162112,1273726,1,19,1,1,0,150
162113,1273726,1,19,2,0,0,150
162114,1273726,1,19,3,0,1,150
162115,1273726,1,19,4,1,0,151
162116,1273726,1,19,5,4,0,155
162117,1273726,1,19,6,4,0,159
162118,1273726,1,20,1,0,0,159
162119,1273726,1,20,2,2,0,161
162120,1273726,1,20,3,1,0,162
162121,1273726,1,20,4,4,0,166
162122,1273726,1,20,5,1,0,167
162123,1273726,1,20,6,4,0,171
162237,1273727,1,1,1,0,0,0
162238,1273727,1,1,2,0,0,0
162239,1273727,1,1,3,1,0,1
162240,1273727,1,1,4,0,1,1
162241,1273727,1,1,5,0,0,1
162242,1273727,1,1,6,1,0,2
162243,1273727,1,2,1,1,0,3
162244,1273727,1,2,2,0,0,3
162245,1273727,1,2,3,1,0,4
162246,1273727,1,2,4,1,0,5
162247,1273727,1,2,5,0,0,5
162248,1273727,1,2,6,1,0,6
162249,1273727,1,3,1,0,1,6
162250,1273727,1,3,2,0,0,6
162251,1273727,1,3,3,0,0,6
162252,1273727,1,3,4,1,0,7
162253,1273727,1,3,5,1,0,8
162254,1273727,1,3,6,6,0,14
162255,1273727,1,4,1,0,0,14
162256,1273727,1,4,2,0,0,14
162257,1273727,1,4,3,1,0,15
162258,1273727,1,4,4,1,0,16
162259,1273727,1,4,5,1,0,17
162260,1273727,1,4,6,4,0,21
162261,1273727,1,5,1,2,0,23
162262,1273727,1,5,2,0,0,23
162263,1273727,1,5,3,0,0,23
162264,1273727,1,5,4,0,0,23
162265,1273727,1,5,5,6,0,29
162266,1273727,1,5,6,1,0,30
162267,1273727,1,6,1,0,0,30
162268,1273727,1,6,2,1,0,31
162269,1273727,1,6,3,0,0,31
162270,1273727,1,6,4,0,1,31
162271,1273727,1,6,5,1,0,32
162272,1273727,1,6,6,4,0,36
162273,1273727,1,7,1,0,0,36
162274,1273727,1,7,2,0,0,36
162275,1273727,1,7,3,0,0,36
162276,1273727,1,7,4,2,0,38
162277,1273727,1,7,5,0,0,38
162278,1273727,1,7,6,1,0,39
162279,1273727,1,8,1,0,0,39
162280,1273727,1,8,2,1,0,40
162281,1273727,1,8,3,1,0,41
162282,1273727,1,8,4,0,0,41
162283,1273727,1,8,5,1,0,42
162284,1273727,1,8,6,1,0,43
162285,1273727,1,9,1,1,0,44
162286,1273727,1,9,2,0,0,44
162287,1273727,1,9,3,2,0,46
162288,1273727,1,9,4,1,0,47
162289,1273727,1,9,5,1,0,48
162290,1273727,1,9,6,4,0,52
162291,1273727,1,10,1,1,0,53
162292,1273727,1,10,2,4,0,57
162293,1273727,1,10,3,1,0,58
162294,1273727,1,10,4,1,0,59
162295,1273727,1,10,5,0,0,59
162296,1273727,1,10,6,1,0,60
162297,1273727,1,11,1,1,0,61
162298,1273727,1,11,2,2,0,63
162299,1273727,1,11,3,1,0,64
162300,1273727,1,11,4,1,0,65
162301,1273727,1,11,5,0,0,65
162302,1273727,1,11,6,1,0,66
162303,1273727,1,12,1,0,0,66
162304,1273727,1,12,2,6,0,72
162305,1273727,1,12,3,6,0,78
162306,1273727,1,12,4,2,0,80
162307,1273727,1,12,5,1,0,81
162308,1273727,1,12,6,0,0,81
162309,1273727,1,13,1,2,0,83
162310,1273727,1,13,2,1,1,84
162311,1273727,1,13,3,0,0,84
162312,1273727,1,13,4,1,0,85
162313,1273727,1,13,5,1,0,86
162314,1273727,1,13,6,1,0,87
162315,1273727,1,14,1,1,0,88
162316,1273727,1,14,2,0,0,88
162317,1273727,1,14,3,2,0,90
162318,1273727,1,14,4,1,0,91
162319,1273727,1,14,5,5,0,96
162320,1273727,1,14,6,0,0,96
162321,1273727,1,15,1,0,0,96
162322,1273727,1,15,2,0,0,96
162323,1273727,1,15,3,1,0,97
162324,1273727,1,15,4,1,0,98
162325,1273727,1,15,5,1,0,99
162326,1273727,1,15,6,1,0,100
162327,1273727,1,16,1,0,0,100
162328,1273727,1,16,2,4,0,104
162329,1273727,1,16,3,0,0,104
162330,1273727,1,16,4,4,0,108
162331,1273727,1,16,5,1,0,109
162332,1273727,1,16,6,1,0,110
162333,1273727,1,17,1,1,0,111
162334,1273727,1,17,2,1,0,112
162335,1273727,1,17,3,1,0,113
162336,1273727,1,17,4,0,0,113
162337,1273727,1,17,5,0,0,113
162338,1273727,1,17,6,1,0,114
162339,1273727,1,18,1,2,0,116
162340,1273727,1,18,2,4,0,120
162341,1273727,1,18,3,1,0,121
162342,1273727,1,18,4,4,0,125
162343,1273727,1,18,5,0,1,125
162344,1273727,1,18,6,2,0,127
162345,1273727,1,19,1,1,0,128
162346,1273727,1,19,2,4,0,132
162347,1273727,1,19,3,1,0,133
162348,1273727,1,19,4,0,1,133
162349,1273727,1,19,5,1,0,134
162350,1273727,1,19,6,10,0,144
162351,1273727,1,20,1,0,0,144
162352,1273727,1,20,2,2,0,146
162353,1273727,1,20,3,0,1,146
162354,1273727,1,20,4,2,0,148
162355,1273727,1,20,5,2,0,150
162356,1273727,1,20,6,1,0,151
162464,1273729,1,1,1,1,0,1
162465,1273729,1,1,2,1,0,2
162466,1273729,1,1,3,1,0,3
162467,1273729,1,1,4,0,0,3
162468,1273729,1,1,5,0,0,3
162469,1273729,1,1,6,1,0,4
162470,1273729,1,2,1,0,0,4
162471,1273729,1,2,2,0,0,4
162472,1273729,1,2,3,0,0,4
162473,1273729,1,2,4,1,0,5
162474,1273729,1,2,5,1,0,6
162475,1273729,1,2,6,0,0,6
162476,1273729,1,3,1,0,0,6
162477,1273729,1,3,2,0,0,6
162478,1273729,1,3,3,0,0,6
162479,1273729,1,3,4,0,0,6
162480,1273729,1,3,5,0,0,6
162481,1273729,1,3,6,0,0,6
162482,1273729,1,4,1,0,0,6
162483,1273729,1,4,2,1,0,7
162484,1273729,1,4,3,0,0,7
162485,1273729,1,4,4,4,0,11
162486,1273729,1,4,5,6,0,17
162487,1273729,1,4,6,1,0,18
162488,1273729,1,5,1,2,0,20
162489,1273729,1,5,2,0,0,20
162490,1273729,1,5,3,0,0,20
162491,1273729,1,5,4,6,0,26
162492,1273729,1,5,5,6,0,32
162493,1273729,1,5,6,4,0,36
162494,1273729,1,6,1,1,0,37
162495,1273729,1,6,2,0,0,37
162496,1273729,1,6,3,4,0,41
162497,1273729,1,6,4,1,0,42
162498,1273729,1,6,5,0,0,42
162499,1273729,1,6,6,1,0,43
162500,1273729,1,7,1,1,0,44
162501,1273729,1,7,2,1,0,45
162502,1273729,1,7,3,0,0,45
162503,1273729,1,7,4,1,0,46
162504,1273729,1,7,5,0,0,46
162505,1273729,1,7,6,0,0,46
162506,1273729,1,8,1,0,0,46
162507,1273729,1,8,2,0,0,46
162508,1273729,1,8,3,0,0,46
162509,1273729,1,8,4,1,0,47
162510,1273729,1,8,5,0,0,47
162511,1273729,1,8,6,0,0,47
162512,1273729,1,9,1,0,0,47
162513,1273729,1,9,2,1,0,48
162514,1273729,1,9,3,1,0,49
162515,1273729,1,9,4,1,0,50
162516,1273729,1,9,5,6,0,56
162517,1273729,1,9,6,0,0,56
162518,1273729,1,10,1,1,0,57
162519,1273729,1,10,2,1,0,58
162520,1273729,1,10,3,0,0,58
162521,1273729,1,10,4,1,0,59
162522,1273729,1,10,5,6,0,65
162523,1273729,1,10,6,0,0,65
162524,1273729,1,11,1,1,0,66
162525,1273729,1,11,2,6,0,72
162526,1273729,1,11,3,1,1,73
162527,1273729,1,11,4,1,0,74
162528,1273729,1,11,5,0,0,74
162529,1273729,1,11,6,0,0,74
162530,1273729,1,12,1,4,0,78
162531,1273729,1,12,2,4,0,82
162532,1273729,1,12,3,1,0,83
162533,1273729,1,12,4,1,0,84
162534,1273729,1,12,5,0,0,84
162535,1273729,1,12,6,2,0,86
162536,1273729,1,13,1,1,0,87
162537,1273729,1,13,2,0,1,87
162538,1273729,1,13,3,0,0,87
162539,1273729,1,13,4,1,0,88
162540,1273729,1,13,5,1,0,89
162541,1273729,1,13,6,0,0,89
162542,1273729,1,14,1,0,0,89
162543,1273729,1,14,2,0,1,89
162544,1273729,1,14,3,2,0,91
162545,1273729,1,14,4,1,0,92
162546,1273729,1,14,5,1,0,93
162547,1273729,1,14,6,0,0,93
162548,1273729,1,15,1,0,0,93
162549,1273729,1,15,2,1,0,94
162550,1273729,1,15,3,0,0,94
162551,1273729,1,15,4,0,0,94
162552,1273729,1,15,5,1,0,95
162553,1273729,1,15,6,0,0,95
162554,1273729,1,16,1,0,0,95
162555,1273729,1,16,2,6,0,101
162556,1273729,1,16,3,1,0,102
162557,1273729,1,16,4,6,0,108
162558,1273729,1,16,5,2,0,110
162559,1273729,1,16,6,1,0,111
162560,1273729,1,17,1,5,0,116
162561,1273729,1,17,2,1,0,117
162562,1273729,1,17,3,1,0,118
162563,1273729,1,17,4,1,0,119
162564,1273729,1,17,5,2,0,121
162565,1273729,1,17,6,0,0,121
162566,1273729,1,18,1,0,1,121
162567,1273729,1,18,2,4,0,125
162568,1273729,1,18,3,0,0,125
162569,1273729,1,18,4,1,0,126
162570,1273729,1,18,5,4,0,130
162571,1273729,1,18,6,1,0,131
162572,1273729,1,19,1,1,0,132
162573,1273729,1,19,2,0,1,132
162574,1273729,1,19,3,0,0,132
162575,1273729,1,19,4,1,1,133
162576,1273729,1,19,5,1,0,134
162577,1273729,1,19,6,2,0,136
162578,1273729,1,20,1,1,0,137
162579,1273729,1,20,2,0,1,137
162580,1273729,1,20,3,0,1,137
162581,1273729,1,20,4,4,0,141
162582,1273729,1,20,5,0,0,141
162583,1273729,1,20,6,2,0,143
162694,1273730,1,1,1,0,0,0
162695,1273730,1,1,2,0,0,0
162696,1273730,1,1,3,0,0,0
162697,1273730,1,1,4,0,0,0
162698,1273730,1,1,5,0,0,0
162699,1273730,1,1,6,0,0,0
162700,1273730,1,2,1,0,0,0
162701,1273730,1,2,2,1,0,1
162702,1273730,1,2,3,0,0,1
162703,1273730,1,2,4,1,0,2
162704,1273730,1,2,5,1,0,3
162705,1273730,1,2,6,4,0,7
162706,1273730,1,3,1,0,0,7
162707,1273730,1,3,2,2,0,9
162708,1273730,1,3,3,1,0,10
162709,1273730,1,3,4,1,0,11
162710,1273730,1,3,5,4,0,15
162711,1273730,1,3,6,0,0,15
162712,1273730,1,4,1,0,0,15
162713,1273730,1,4,2,0,0,15
162714,1273730,1,4,3,0,0,15
162715,1273730,1,4,4,1,0,16
162716,1273730,1,4,5,1,0,17
162717,1273730,1,4,6,4,0,21
162718,1273730,1,5,1,6,0,27
162719,1273730,1,5,2,1,0,28
162720,1273730,1,5,3,1,0,29
162721,1273730,1,5,4,0,0,29
162722,1273730,1,5,5,1,0,30
162723,1273730,1,5,6,6,0,36
162724,1273730,1,6,1,0,0,36
162725,1273730,1,6,2,0,1,36
162726,1273730,1,6,3,1,0,37
162727,1273730,1,6,4,1,0,38
162728,1273730,1,6,5,0,0,38
162729,1273730,1,6,6,4,0,42
162730,1273730,1,7,1,1,0,43
162731,1273730,1,7,2,1,0,44
162732,1273730,1,7,3,0,0,44
162733,1273730,1,7,4,1,0,45
162734,1273730,1,7,5,0,0,45
162735,1273730,1,7,6,0,0,45
162736,1273730,1,8,1,1,0,46
162737,1273730,1,8,2,0,0,46
162738,1273730,1,8,3,0,0,46
162739,1273730,1,8,4,2,0,48
162740,1273730,1,8,5,0,0,48
162741,1273730,1,8,6,0,0,48
162742,1273730,1,9,1,6,0,54
162743,1273730,1,9,2,0,1,54
162744,1273730,1,9,3,0,0,54
162745,1273730,1,9,4,1,0,55
162746,1273730,1,9,5,1,0,56
162747,1273730,1,9,6,0,0,56
162748,1273730,1,10,1,0,1,56
162749,1273730,1,10,2,2,0,58
162750,1273730,1,10,3,0,0,58
162751,1273730,1,10,4,1,0,59
162752,1273730,1,10,5,1,0,60
162753,1273730,1,10,6,0,0,60
162754,1273730,1,11,1,0,0,60
162755,1273730,1,11,2,1,0,61
162756,1273730,1,11,3,0,0,61
162757,1273730,1,11,4,1,0,62
162758,1273730,1,11,5,0,0,62
162759,1273730,1,11,6,1,0,63
162760,1273730,1,12,1,0,0,63
162761,1273730,1,12,2,1,0,64
162762,1273730,1,12,3,0,0,64
162763,1273730,1,12,4,4,0,68
162764,1273730,1,12,5,6,0,74
162765,1273730,1,12,6,1,0,75
162766,1273730,1,13,1,1,0,76
162767,1273730,1,13,2,0,0,76
162768,1273730,1,13,3,2,0,78
162769,1273730,1,13,4,4,0,82
162770,1273730,1,13,5,4,0,86
162771,1273730,1,13,6,4,0,90
162772,1273730,1,14,1,0,1,90
162773,1273730,1,14,2,0,0,90
162774,1273730,1,14,3,0,0,90
162775,1273730,1,14,4,1,0,91
162776,1273730,1,14,5,3,0,94
162777,1273730,1,14,6,1,0,95
162778,1273730,1,15,1,1,0,96
162779,1273730,1,15,2,1,0,97
162780,1273730,1,15,3,1,0,98
162781,1273730,1,15,4,1,0,99
162782,1273730,1,15,5,1,0,100
162783,1273730,1,15,6,0,0,100
162784,1273730,1,16,1,1,0,101
162785,1273730,1,16,2,1,0,102
162786,1273730,1,16,3,1,0,103
162787,1273730,1,16,4,1,0,104
162788,1273730,1,16,5,1,0,105
162789,1273730,1,16,6,2,0,107
162790,1273730,1,17,1,1,0,108
162791,1273730,1,17,2,1,0,109
162792,1273730,1,17,3,1,0,110
162793,1273730,1,17,4,1,0,111
162794,1273730,1,17,5,1,0,112
162795,1273730,1,17,6,4,0,116
162796,1273730,1,18,1,0,1,116
162797,1273730,1,18,2,0,0,116
162798,1273730,1,18,3,0,1,116
162799,1273730,1,18,4,2,0,118
162800,1273730,1,18,5,0,0,118
162801,1273730,1,18,6,1,0,119
162802,1273730,1,19,1,0,0,119
162803,1273730,1,19,2,0,0,119
162804,1273730,1,19,3,1,0,120
162805,1273730,1,19,4,1,0,121
162806,1273730,1,19,5,4,0,125
162807,1273730,1,19,6,0,1,125
162808,1273730,1,20,1,1,0,126
162809,1273730,1,20,2,2,0,128
162810,1273730,1,20,3,1,0,129
162811,1273730,1,20,4,1,0,130
162812,1273730,1,20,5,4,0,134
162813,1273730,1,20,6,0,1,134
162926,1273731,1,1,1,0,0,0
162927,1273731,1,1,2,0,0,0
162928,1273731,1,1,3,1,0,1
162929,1273731,1,1,4,1,0,2
162930,1273731,1,1,5,4,0,6
162931,1273731,1,1,6,4,0,10
162932,1273731,1,2,1,0,0,10
162933,1273731,1,2,2,0,0,10
162934,1273731,1,2,3,2,0,12
162935,1273731,1,2,4,1,0,13
162936,1273731,1,2,5,0,0,13
162937,1273731,1,2,6,0,0,13
162938,1273731,1,3,1,1,0,14
162939,1273731,1,3,2,0,1,14
162940,1273731,1,3,3,0,1,14
162941,1273731,1,3,4,0,0,14
162942,1273731,1,3,5,0,0,14
162943,1273731,1,3,6,1,0,15
162944,1273731,1,4,1,0,0,15
162945,1273731,1,4,2,1,0,16
162946,1273731,1,4,3,0,0,16
162947,1273731,1,4,4,1,0,17
162948,1273731,1,4,5,0,0,17
162949,1273731,1,4,6,1,0,18
162950,1273731,1,5,1,1,0,19
162951,1273731,1,5,2,0,0,19
162952,1273731,1,5,3,0,0,19
162953,1273731,1,5,4,1,0,20
162954,1273731,1,5,5,0,0,20
162955,1273731,1,5,6,4,0,24
162956,1273731,1,6,1,2,0,26
162957,1273731,1,6,2,0,1,26
162958,1273731,1,6,3,0,0,26
162959,1273731,1,6,4,0,0,26
162960,1273731,1,6,5,0,0,26
162961,1273731,1,6,6,1,0,27
162962,1273731,1,7,1,0,0,27
162963,1273731,1,7,2,0,0,27
162964,1273731,1,7,3,1,0,28
162965,1273731,1,7,4,1,0,29
162966,1273731,1,7,5,1,0,30
162967,1273731,1,7,6,0,0,30
162968,1273731,1,8,1,2,0,32
162969,1273731,1,8,2,5,0,37
162970,1273731,1,8,3,1,0,38
162971,1273731,1,8,4,1,0,39
162972,1273731,1,8,5,1,0,40
162973,1273731,1,8,6,2,0,42
162974,1273731,1,9,1,1,0,43
162975,1273731,1,9,2,1,0,44
162976,1273731,1,9,3,4,0,48
162977,1273731,1,9,4,0,0,48
162978,1273731,1,9,5,1,0,49
162979,1273731,1,9,6,0,0,49
162980,1273731,1,10,1,1,0,50
162981,1273731,1,10,2,1,0,51
162982,1273731,1,10,3,2,0,53
162983,1273731,1,10,4,1,0,54
162984,1273731,1,10,5,4,0,58
162985,1273731,1,10,6,2,0,60
162986,1273731,1,11,1,1,0,61
162987,1273731,1,11,2,0,0,61
162988,1273731,1,11,3,2,0,63
162989,1273731,1,11,4,0,1,63
162990,1273731,1,11,5,0,0,63
162991,1273731,1,11,6,0,0,63
162992,1273731,1,12,1,1,0,64
162993,1273731,1,12,2,0,0,64
162994,1273731,1,12,3,1,0,65
162995,1273731,1,12,4,0,0,65
162996,1273731,1,12,5,0,0,65
162997,1273731,1,12,6,1,0,66
162998,1273731,1,13,1,1,0,67
162999,1273731,1,13,2,4,0,71
163000,1273731,1,13,3,1,0,72
163001,1273731,1,13,4,1,1,73
163002,1273731,1,13,5,2,0,75
163003,1273731,1,13,6,1,0,76
163004,1273731,1,14,1,0,0,76
163005,1273731,1,14,2,1,0,77
163006,1273731,1,14,3,1,0,78
163007,1273731,1,14,4,2,0,80
163008,1273731,1,14,5,0,0,80
163009,1273731,1,14,6,0,0,80
163010,1273731,1,15,1,1,0,81
163011,1273731,1,15,2,0,0,81
163012,1273731,1,15,3,1,0,82
163013,1273731,1,15,4,1,0,83
163014,1273731,1,15,5,0,1,83
163015,1273731,1,15,6,0,0,83
163016,1273731,1,16,1,1,0,84
163017,1273731,1,16,2,0,0,84
163018,1273731,1,16,3,1,0,85
163019,1273731,1,16,4,1,0,86
163020,1273731,1,16,5,0,0,86
163021,1273731,1,16,6,4,0,90
163022,1273731,1,17,1,1,0,91
163023,1273731,1,17,2,1,0,92
163024,1273731,1,17,3,1,0,93
163025,1273731,1,17,4,4,0,97
163026,1273731,1,17,5,0,0,97
163027,1273731,1,17,6,1,0,98
163028,1273731,1,18,1,0,1,98
163029,1273731,1,18,2,1,0,99
163030,1273731,1,18,3,1,0,100
163031,1273731,1,18,4,2,0,102
163032,1273731,1,18,5,0,0,102
163033,1273731,1,18,6,0,0,102
163034,1273731,1,19,1,1,0,103
163035,1273731,1,19,2,6,0,109
163036,1273731,1,19,3,0,0,109
163037,1273731,1,19,4,0,0,109
163038,1273731,1,19,5,6,0,115
163039,1273731,1,19,6,4,0,119
163040,1273731,1,20,1,1,0,120
163041,1273731,1,20,2,2,0,122
163042,1273731,1,20,3,0,0,122
163043,1273731,1,20,4,2,0,124
163044,1273731,1,20,5,0,1,124
163045,1273731,1,20,6,0,1,124
163131,1273733,1,1,1,1,0,1
163132,1273733,1,1,2,2,0,3
163133,1273733,1,1,3,0,0,3
163134,1273733,1,1,4,2,0,5
163135,1273733,1,1,5,1,0,6
163136,1273733,1,1,6,0,0,6
163137,1273733,1,2,1,0,0,6
163138,1273733,1,2,2,0,0,6
163139,1273733,1,2,3,0,0,6
163140,1273733,1,2,4,1,0,7
163141,1273733,1,2,5,0,0,7
163142,1273733,1,2,6,4,0,11
163143,1273733,1,3,1,0,0,11
163144,1273733,1,3,2,4,0,15
163145,1273733,1,3,3,0,1,15
163146,1273733,1,3,4,9,0,24
163147,1273733,1,3,5,0,0,24
163148,1273733,1,3,6,1,0,25
163149,1273733,1,4,1,6,0,31
163150,1273733,1,4,2,0,0,31
163151,1273733,1,4,3,4,0,35
163152,1273733,1,4,4,6,0,41
163153,1273733,1,4,5,0,0,41
163154,1273733,1,4,6,0,0,41
163155,1273733,1,5,1,0,0,41
163156,1273733,1,5,2,0,0,41
163157,1273733,1,5,3,0,0,41
163158,1273733,1,5,4,0,0,41
163159,1273733,1,5,5,4,0,45
163160,1273733,1,5,6,1,0,46
163161,1273733,1,6,1,0,0,46
163162,1273733,1,6,2,0,0,46
163163,1273733,1,6,3,1,0,47
163164,1273733,1,6,4,4,0,51
163165,1273733,1,6,5,1,0,52
163166,1273733,1,6,6,1,0,53
163167,1273733,1,7,1,1,0,54
163168,1273733,1,7,2,2,0,56
163169,1273733,1,7,3,1,0,57
163170,1273733,1,7,4,2,0,59
163171,1273733,1,7,5,1,0,60
163172,1273733,1,7,6,0,0,60
163173,1273733,1,8,1,1,0,61
163174,1273733,1,8,2,0,0,61
163175,1273733,1,8,3,0,0,61
163176,1273733,1,8,4,1,0,62
163177,1273733,1,8,5,1,0,63
163178,1273733,1,8,6,1,0,64
163179,1273733,1,9,1,1,0,65
163180,1273733,1,9,2,0,0,65
163181,1273733,1,9,3,1,0,66
163182,1273733,1,9,4,4,0,70
163183,1273733,1,9,5,4,0,74
163184,1273733,1,9,6,1,0,75
163185,1273733,1,10,1,1,0,76
163186,1273733,1,10,2,1,0,77
163187,1273733,1,10,3,1,0,78
163188,1273733,1,10,4,0,1,78
163189,1273733,1,10,5,0,0,78
163190,1273733,1,10,6,1,0,79
163191,1273733,1,11,1,1,0,80
163192,1273733,1,11,2,6,0,86
163193,1273733,1,11,3,0,1,86
163194,1273733,1,11,4,1,0,87
163195,1273733,1,11,5,1,0,88
163196,1273733,1,11,6,0,0,88
163197,1273733,1,12,1,0,0,88
163198,1273733,1,12,2,1,0,89
163199,1273733,1,12,3,0,0,89
163200,1273733,1,12,4,1,0,90
163201,1273733,1,12,5,0,1,90
163202,1273733,1,12,6,0,0,90
163203,1273733,1,13,1,4,0,94
163204,1273733,1,13,2,0,1,94
163205,1273733,1,13,3,0,0,94
163206,1273733,1,13,4,0,0,94
163207,1273733,1,13,5,0,0,94
163208,1273733,1,13,6,1,0,95
163209,1273733,1,14,1,0,0,95
163210,1273733,1,14,2,0,0,95
163211,1273733,1,14,3,0,0,95
163212,1273733,1,14,4,0,0,95
163213,1273733,1,14,5,1,0,96
163214,1273733,1,14,6,1,0,97
163215,1273733,1,15,1,0,0,97
163216,1273733,1,15,2,2,0,99
163217,1273733,1,15,3,4,0,103
163218,1273733,1,15,4,1,0,104
163219,1273733,1,15,5,0,0,104
163220,1273733,1,15,6,1,0,105
163221,1273733,1,16,1,0,0,105
163222,1273733,1,16,2,2,0,107
163223,1273733,1,16,3,1,0,108
163224,1273733,1,16,4,0,0,108
163225,1273733,1,16,5,1,0,109
163226,1273733,1,16,6,2,0,111
163227,1273733,1,17,1,1,0,112
163228,1273733,1,17,2,4,0,116
163229,1273733,1,17,3,4,0,120
163230,1273733,1,17,4,6,0,126
163231,1273733,1,17,5,0,0,126
163232,1273733,1,17,6,2,0,128
163233,1273733,1,18,1,2,0,130
163234,1273733,1,18,2,0,0,130
163235,1273733,1,18,3,4,0,134
163236,1273733,1,18,4,0,1,134
163237,1273733,1,18,5,0,0,134
163238,1273733,1,18,6,1,0,135
163239,1273733,1,19,1,1,0,136
163240,1273733,1,19,2,4,0,140
163241,1273733,1,19,3,1,0,141
163242,1273733,1,19,4,1,0,142
163243,1273733,1,19,5,0,0,142
163244,1273733,1,19,6,2,0,144
163245,1273733,1,20,1,4,0,148
163246,1273733,1,20,2,1,0,149
163247,1273733,1,20,3,1,0,150
163248,1273733,1,20,4,2,0,152
163249,1273733,1,20,5,1,0,153
163250,1273733,1,20,6,1,0,154
163353,1273734,1,1,1,1,0,1
163354,1273734,1,1,2,0,0,1
163355,1273734,1,1,3,1,0,2
163356,1273734,1,1,4,0,0,2
163357,1273734,1,1,5,1,0,3
163358,1273734,1,1,6,1,0,4
163359,1273734,1,2,1,0,0,4
163360,1273734,1,2,2,1,0,5
163361,1273734,1,2,3,0,0,5
163362,1273734,1,2,4,0,0,5
163363,1273734,1,2,5,0,0,5
163364,1273734,1,2,6,4,0,9
163365,1273734,1,3,1,0,0,9
163366,1273734,1,3,2,1,0,10
163367,1273734,1,3,3,1,0,11
163368,1273734,1,3,4,1,0,12
163369,1273734,1,3,5,0,0,12
163370,1273734,1,3,6,0,1,12
163371,1273734,1,4,1,2,0,14
163372,1273734,1,4,2,2,0,16
163373,1273734,1,4,3,0,0,16
163374,1273734,1,4,4,0,0,16
163375,1273734,1,4,5,0,0,16
163376,1273734,1,4,6,1,0,17
163377,1273734,1,5,1,1,0,18
163378,1273734,1,5,2,0,1,18
163379,1273734,1,5,3,1,0,19
163380,1273734,1,5,4,0,0,19
163381,1273734,1,5,5,1,0,20
163382,1273734,1,5,6,1,0,21
163383,1273734,1,6,1,4,0,25
163384,1273734,1,6,2,1,0,26
163385,1273734,1,6,3,0,0,26
163386,1273734,1,6,4,0,0,26
163387,1273734,1,6,5,1,0,27
163388,1273734,1,6,6,2,0,29
163389,1273734,1,7,1,1,0,30
163390,1273734,1,7,2,1,0,31
163391,1273734,1,7,3,1,0,32
163392,1273734,1,7,4,0,1,32
163393,1273734,1,7,5,0,0,32
163394,1273734,1,7,6,1,0,33
163395,1273734,1,8,1,1,0,34
163396,1273734,1,8,2,0,0,34
163397,1273734,1,8,3,1,0,35
163398,1273734,1,8,4,2,0,37
163399,1273734,1,8,5,1,0,38
163400,1273734,1,8,6,1,0,39
163401,1273734,1,9,1,1,0,40
163402,1273734,1,9,2,2,0,42
163403,1273734,1,9,3,0,0,42
163404,1273734,1,9,4,0,0,42
163405,1273734,1,9,5,1,0,43
163406,1273734,1,9,6,1,0,44
163407,1273734,1,10,1,1,0,45
163408,1273734,1,10,2,0,0,45
163409,1273734,1,10,3,1,0,46
163410,1273734,1,10,4,1,0,47
163411,1273734,1,10,5,1,0,48
163412,1273734,1,10,6,0,0,48
163413,1273734,1,11,1,1,0,49
163414,1273734,1,11,2,1,0,50
163415,1273734,1,11,3,0,0,50
163416,1273734,1,11,4,1,0,51
163417,1273734,1,11,5,1,0,52
163418,1273734,1,11,6,4,0,56
163419,1273734,1,12,1,1,0,57
163420,1273734,1,12,2,1,0,58
163421,1273734,1,12,3,1,0,59
163422,1273734,1,12,4,1,0,60
163423,1273734,1,12,5,1,0,61
163424,1273734,1,12,6,0,0,61
163425,1273734,1,13,1,0,0,61
163426,1273734,1,13,2,0,0,61
163427,1273734,1,13,3,1,0,62
163428,1273734,1,13,4,0,1,62
163429,1273734,1,13,5,1,0,63
163430,1273734,1,13,6,1,0,64
163431,1273734,1,14,1,1,0,65
163432,1273734,1,14,2,1,0,66
163433,1273734,1,14,3,0,0,66
163434,1273734,1,14,4,2,0,68
163435,1273734,1,14,5,1,0,69
163436,1273734,1,14,6,1,0,70
163437,1273734,1,15,1,2,0,72
163438,1273734,1,15,2,1,0,73
163439,1273734,1,15,3,4,0,77
163440,1273734,1,15,4,1,0,78
163441,1273734,1,15,5,5,0,83
163442,1273734,1,15,6,1,0,84
163443,1273734,1,16,1,6,0,90
163444,1273734,1,16,2,6,0,96
163445,1273734,1,16,3,1,0,97
163446,1273734,1,16,4,2,0,99
163447,1273734,1,16,5,0,0,99
163448,1273734,1,16,6,0,0,99
163449,1273734,1,17,1,1,0,100
163450,1273734,1,17,2,0,0,100
163451,1273734,1,17,3,0,0,100
163452,1273734,1,17,4,1,0,101
163453,1273734,1,17,5,0,0,101
163454,1273734,1,17,6,2,0,103
163455,1273734,1,18,1,6,0,109
163456,1273734,1,18,2,1,0,110
163457,1273734,1,18,3,6,0,116
163458,1273734,1,18,4,1,0,117
163459,1273734,1,18,5,1,0,118
163460,1273734,1,18,6,1,0,119
163461,1273734,1,19,1,0,1,119
163462,1273734,1,19,2,0,1,119
163463,1273734,1,19,3,1,0,120
163464,1273734,1,19,4,1,0,121
163465,1273734,1,19,5,1,0,122
163466,1273734,1,19,6,1,0,123
163467,1273734,1,20,1,0,1,123
163468,1273734,1,20,2,6,0,129
163469,1273734,1,20,3,6,0,135
163470,1273734,1,20,4,1,0,136
163471,1273734,1,20,5,0,0,136
163472,1273734,1,20,6,6,0,142
163593,1273735,1,1,1,2,0,2
163594,1273735,1,1,2,0,0,2
163595,1273735,1,1,3,1,0,3
163596,1273735,1,1,4,1,0,4
163597,1273735,1,1,5,1,0,5
163598,1273735,1,1,6,0,0,5
163599,1273735,1,2,1,2,0,7
163600,1273735,1,2,2,0,0,7
163601,1273735,1,2,3,0,1,7
163602,1273735,1,2,4,1,0,8
163603,1273735,1,2,5,0,0,8
163604,1273735,1,2,6,0,0,8
163605,1273735,1,3,1,0,0,8
163606,1273735,1,3,2,5,0,13
163607,1273735,1,3,3,0,0,13
163608,1273735,1,3,4,0,1,13
163609,1273735,1,3,5,0,0,13
163610,1273735,1,3,6,0,0,13
163611,1273735,1,4,1,6,0,19
163612,1273735,1,4,2,1,0,20
163613,1273735,1,4,3,0,0,20
163614,1273735,1,4,4,0,0,20
163615,1273735,1,4,5,6,0,26
163616,1273735,1,4,6,4,0,30
163617,1273735,1,5,1,2,0,32
163618,1273735,1,5,2,1,0,33
163619,1273735,1,5,3,0,1,33
163620,1273735,1,5,4,0,0,33
163621,1273735,1,5,5,0,0,33
163622,1273735,1,5,6,6,0,39
163623,1273735,1,6,1,0,1,39
163624,1273735,1,6,2,4,0,43
163625,1273735,1,6,3,1,0,44
163626,1273735,1,6,4,1,0,45
163627,1273735,1,6,5,0,0,45
163628,1273735,1,6,6,4,0,49
163629,1273735,1,7,1,0,0,49
163630,1273735,1,7,2,2,0,51
163631,1273735,1,7,3,0,0,51
163632,1273735,1,7,4,0,0,51
163633,1273735,1,7,5,0,0,51
163634,1273735,1,7,6,0,0,51
163635,1273735,1,8,1,0,0,51
163636,1273735,1,8,2,0,0,51
163637,1273735,1,8,3,1,0,52
163638,1273735,1,8,4,0,0,52
163639,1273735,1,8,5,1,0,53
163640,1273735,1,8,6,2,0,55
163641,1273735,1,9,1,1,0,56
163642,1273735,1,9,2,0,0,56
163643,1273735,1,9,3,4,0,60
163644,1273735,1,9,4,0,0,60
163645,1273735,1,9,5,0,0,60
163646,1273735,1,9,6,4,0,64
163647,1273735,1,10,1,0,1,64
163648,1273735,1,10,2,0,0,64
163649,1273735,1,10,3,0,0,64
163650,1273735,1,10,4,0,0,64
163651,1273735,1,10,5,1,0,65
163652,1273735,1,10,6,0,0,65
163653,1273735,1,11,1,1,0,66
163654,1273735,1,11,2,1,0,67
163655,1273735,1,11,3,0,0,67
163656,1273735,1,11,4,0,0,67
163657,1273735,1,11,5,0,0,67
163658,1273735,1,11,6,0,0,67
163659,1273735,1,12,1,0,0,67
163660,1273735,1,12,2,0,0,67
163661,1273735,1,12,3,0,0,67
163662,1273735,1,12,4,0,0,67
163663,1273735,1,12,5,0,0,67
163664,1273735,1,12,6,0,0,67
163665,1273735,1,13,1,2,0,69
163666,1273735,1,13,2,0,0,69
163667,1273735,1,13,3,1,0,70
163668,1273735,1,13,4,6,0,76
163669,1273735,1,13,5,0,1,76
163670,1273735,1,13,6,0,0,76
163671,1273735,1,14,1,4,0,80
163672,1273735,1,14,2,0,0,80
163673,1273735,1,14,3,0,0,80
163674,1273735,1,14,4,5,0,85
163675,1273735,1,14,5,0,0,85
163676,1273735,1,14,6,1,0,86
163677,1273735,1,15,1,5,0,91
163678,1273735,1,15,2,0,0,91
163679,1273735,1,15,3,1,0,92
163680,1273735,1,15,4,0,0,92
163681,1273735,1,15,5,0,0,92
163682,1273735,1,15,6,1,0,93
163683,1273735,1,16,1,0,0,93
163684,1273735,1,16,2,5,0,98
163685,1273735,1,16,3,1,0,99
163686,1273735,1,16,4,1,0,100
163687,1273735,1,16,5,1,0,101
163688,1273735,1,16,6,0,0,101
163689,1273735,1,17,1,1,0,102
163690,1273735,1,17,2,1,0,103
163691,1273735,1,17,3,0,0,103
163692,1273735,1,17,4,0,0,103
163693,1273735,1,17,5,0,0,103
163694,1273735,1,17,6,1,0,104
163695,1273735,1,18,1,6,0,110
163696,1273735,1,18,2,4,0,114
163697,1273735,1,18,3,2,0,116
163698,1273735,1,18,4,2,0,118
163699,1273735,1,18,5,4,0,122
163700,1273735,1,18,6,3,0,125
163701,1273735,1,19,1,1,0,126
163702,1273735,1,19,2,1,0,127
163703,1273735,1,19,3,4,0,131
163704,1273735,1,19,4,4,0,135
163705,1273735,1,19,5,1,0,136
163706,1273735,1,19,6,4,0,140
163707,1273735,1,20,1,1,0,141
163708,1273735,1,20,2,1,0,142
163709,1273735,1,20,3,1,0,143
163710,1273735,1,20,4,1,0,144
163711,1273735,1,20,5,1,0,145
163712,1273735,1,20,6,2,0,147
163827,1273736,1,1,1,1,0,1
163828,1273736,1,1,2,1,0,2
163829,1273736,1,1,3,1,0,3
163830,1273736,1,1,4,1,0,4
163831,1273736,1,1,5,0,0,4
163832,1273736,1,1,6,1,0,5
163833,1273736,1,2,1,0,0,5
163834,1273736,1,2,2,4,0,9
163835,1273736,1,2,3,1,0,10
163836,1273736,1,2,4,0,0,10
163837,1273736,1,2,5,0,0,10
163838,1273736,1,2,6,4,0,14
163839,1273736,1,3,1,1,0,15
163840,1273736,1,3,2,0,0,15
163841,1273736,1,3,3,0,0,15
163842,1273736,1,3,4,1,0,16
163843,1273736,1,3,5,0,0,16
163844,1273736,1,3,6,1,0,17
163845,1273736,1,4,1,1,0,18
163846,1273736,1,4,2,1,0,19
163847,1273736,1,4,3,0,0,19
163848,1273736,1,4,4,1,0,20
163849,1273736,1,4,5,0,1,20
163850,1273736,1,4,6,0,0,20
163851,1273736,1,5,1,0,0,20
163852,1273736,1,5,2,0,0,20
163853,1273736,1,5,3,4,0,24
163854,1273736,1,5,4,1,0,25
163855,1273736,1,5,5,1,0,26
163856,1273736,1,5,6,0,0,26
163857,1273736,1,6,1,1,0,27
163858,1273736,1,6,2,1,0,28
163859,1273736,1,6,3,4,0,32
163860,1273736,1,6,4,4,0,36
163861,1273736,1,6,5,2,0,38
163862,1273736,1,6,6,1,0,39
163863,1273736,1,7,1,1,0,40
163864,1273736,1,7,2,1,0,41
163865,1273736,1,7,3,1,0,42
163866,1273736,1,7,4,1,0,43
163867,1273736,1,7,5,1,0,44
163868,1273736,1,7,6,0,0,44
163869,1273736,1,8,1,0,0,44
163870,1273736,1,8,2,0,0,44
163871,1273736,1,8,3,1,0,45
163872,1273736,1,8,4,0,0,45
163873,1273736,1,8,5,1,0,46
163874,1273736,1,8,6,0,0,46
163875,1273736,1,9,1,6,0,52
163876,1273736,1,9,2,1,0,53
163877,1273736,1,9,3,6,0,59
163878,1273736,1,9,4,1,0,60
163879,1273736,1,9,5,1,1,61
163880,1273736,1,9,6,0,0,61
163881,1273736,1,10,1,1,0,62
163882,1273736,1,10,2,0,0,62
163883,1273736,1,10,3,0,1,62
163884,1273736,1,10,4,0,0,62
163885,1273736,1,10,5,1,0,63
163886,1273736,1,10,6,4,0,67
163887,1273736,1,11,1,1,0,68
163888,1273736,1,11,2,1,0,69
163889,1273736,1,11,3,0,0,69
163890,1273736,1,11,4,1,0,70
163891,1273736,1,11,5,1,0,71
163892,1273736,1,11,6,1,0,72
163893,1273736,1,12,1,4,0,76
163894,1273736,1,12,2,0,0,76
163895,1273736,1,12,3,1,0,77
163896,1273736,1,12,4,0,1,77
163897,1273736,1,12,5,1,0,78
163898,1273736,1,12,6,1,0,79
163899,1273736,1,13,1,6,0,85
163900,1273736,1,13,2,1,0,86
163901,1273736,1,13,3,1,0,87
163902,1273736,1,13,4,1,0,88
163903,1273736,1,13,5,1,0,89
163904,1273736,1,13,6,0,0,89
163905,1273736,1,14,1,1,0,90
163906,1273736,1,14,2,0,0,90
163907,1273736,1,14,3,1,0,91
163908,1273736,1,14,4,0,1,91
163909,1273736,1,14,5,0,0,91
163910,1273736,1,14,6,1,0,92
163911,1273736,1,15,1,0,0,92
163912,1273736,1,15,2,0,0,92
163913,1273736,1,15,3,0,0,92
163914,1273736,1,15,4,0,0,92
163915,1273736,1,15,5,1,0,93
163916,1273736,1,15,6,1,0,94
163917,1273736,1,16,1,0,0,94
163918,1273736,1,16,2,1,0,95
163919,1273736,1,16,3,1,0,96
163920,1273736,1,16,4,1,0,97
163921,1273736,1,16,5,0,0,97
163922,1273736,1,16,6,4,0,101
163923,1273736,1,17,1,4,0,105
163924,1273736,1,17,2,1,0,106
163925,1273736,1,17,3,4,0,110
163926,1273736,1,17,4,0,1,110
163927,1273736,1,17,5,1,0,111
163928,1273736,1,17,6,1,0,112
163929,1273736,1,18,1,1,0,113
163930,1273736,1,18,2,6,0,119
163931,1273736,1,18,3,1,0,120
163932,1273736,1,18,4,1,0,121
163933,1273736,1,18,5,4,0,125
163934,1273736,1,18,6,4,0,129
163935,1273736,1,19,1,2,0,131
163936,1273736,1,19,2,0,1,131
163937,1273736,1,19,3,0,0,131
163938,1273736,1,19,4,0,1,131
163939,1273736,1,19,5,2,0,133
163940,1273736,1,19,6,1,0,134
163941,1273736,1,20,1,1,0,135
163942,1273736,1,20,2,2,0,137
163943,1273736,1,20,3,4,0,141
163944,1273736,1,20,4,1,0,142
163945,1273736,1,20,5,0,1,142
163946,1273736,1,20,6,0,1,142
164066,1273737,1,1,1,1,0,1
164067,1273737,1,1,2,0,0,1
164068,1273737,1,1,3,0,0,1
164069,1273737,1,1,4,0,0,1
164070,1273737,1,1,5,4,0,5
164071,1273737,1,1,6,1,0,6
164072,1273737,1,2,1,1,0,7
164073,1273737,1,2,2,0,1,7
164074,1273737,1,2,3,0,0,7
164075,1273737,1,2,4,0,0,7
164076,1273737,1,2,5,0,0,7
164077,1273737,1,2,6,1,0,8
164078,1273737,1,3,1,0,1,8
164079,1273737,1,3,2,0,0,8
164080,1273737,1,3,3,1,0,9
164081,1273737,1,3,4,1,0,10
164082,1273737,1,3,5,0,0,10
164083,1273737,1,3,6,1,0,11
164084,1273737,1,4,1,2,0,13
164085,1273737,1,4,2,0,0,13
164086,1273737,1,4,3,0,0,13
164087,1273737,1,4,4,2,0,15
164088,1273737,1,4,5,0,1,15
164089,1273737,1,4,6,0,0,15
164090,1273737,1,5,1,0,0,15
164091,1273737,1,5,2,2,0,17
164092,1273737,1,5,3,0,0,17
164093,1273737,1,5,4,0,0,17
164094,1273737,1,5,5,0,0,17
164095,1273737,1,5,6,2,0,19
164096,1273737,1,6,1,0,0,19
164097,1273737,1,6,2,2,0,21
164098,1273737,1,6,3,0,0,21
164099,1273737,1,6,4,0,0,21
164100,1273737,1,6,5,0,0,21
164101,1273737,1,6,6,0,0,21
164102,1273737,1,7,1,0,1,21
164103,1273737,1,7,2,0,0,21
164104,1273737,1,7,3,1,0,22
164105,1273737,1,7,4,1,0,23
164106,1273737,1,7,5,4,0,27
164107,1273737,1,7,6,0,0,27
164108,1273737,1,8,1,1,0,28
164109,1273737,1,8,2,1,0,29
164110,1273737,1,8,3,2,0,31
164111,1273737,1,8,4,0,0,31
164112,1273737,1,8,5,1,0,32
164113,1273737,1,8,6,0,0,32
164114,1273737,1,9,1,1,0,33
164115,1273737,1,9,2,0,0,33
164116,1273737,1,9,3,2,0,35
164117,1273737,1,9,4,1,0,36
164118,1273737,1,9,5,0,0,36
164119,1273737,1,9,6,1,0,37
164120,1273737,1,10,1,0,0,37
164121,1273737,1,10,2,1,0,38
164122,1273737,1,10,3,1,0,39
164123,1273737,1,10,4,0,0,39
164124,1273737,1,10,5,1,0,40
164125,1273737,1,10,6,1,0,41
164126,1273737,1,11,1,1,0,42
164127,1273737,1,11,2,1,0,43
164128,1273737,1,11,3,0,0,43
164129,1273737,1,11,4,4,0,47
164130,1273737,1,11,5,1,0,48
164131,1273737,1,11,6,1,0,49
164132,1273737,1,12,1,1,0,50
164133,1273737,1,12,2,1,0,51
164134,1273737,1,12,3,0,0,51
164135,1273737,1,12,4,0,1,51
164136,1273737,1,12,5,0,0,51
164137,1273737,1,12,6,0,0,51
164138,1273737,1,13,1,1,0,52
164139,1273737,1,13,2,0,0,52
164140,1273737,1,13,3,0,0,52
164141,1273737,1,13,4,0,0,52
164142,1273737,1,13,5,1,0,53
164143,1273737,1,13,6,0,0,53
164144,1273737,1,14,1,0,0,53
164145,1273737,1,14,2,1,0,54
164146,1273737,1,14,3,1,0,55
164147,1273737,1,14,4,1,0,56
164148,1273737,1,14,5,1,0,57
164149,1273737,1,14,6,0,0,57
164150,1273737,1,15,1,4,0,61
164151,1273737,1,15,2,4,0,65
164152,1273737,1,15,3,0,0,65
164153,1273737,1,15,4,1,0,66
164154,1273737,1,15,5,1,0,67
164155,1273737,1,15,6,0,0,67
164156,1273737,1,16,1,0,0,67
164157,1273737,1,16,2,1,0,68
164158,1273737,1,16,3,1,0,69
164159,1273737,1,16,4,1,0,70
164160,1273737,1,16,5,4,0,74
164161,1273737,1,16,6,1,0,75
164162,1273737,1,17,1,1,0,76
164163,1273737,1,17,2,7,0,83
164164,1273737,1,17,3,6,0,89
164165,1273737,1,17,4,1,0,90
164166,1273737,1,17,5,1,0,91
164167,1273737,1,17,6,4,0,95
164168,1273737,1,18,1,1,0,96
164169,1273737,1,18,2,1,0,97
164170,1273737,1,18,3,1,0,98
164171,1273737,1,18,4,0,1,98
164172,1273737,1,18,5,6,0,104
164173,1273737,1,18,6,6,0,110
164174,1273737,1,19,1,0,1,110
164175,1273737,1,19,2,0,1,110
164176,1273737,1,19,3,1,0,111
164177,1273737,1,19,4,1,0,112
164178,1273737,1,19,5,0,0,112
164179,1273737,1,19,6,0,0,112
164180,1273737,1,20,1,4,0,116
164181,1273737,1,20,2,2,0,118
164182,1273737,1,20,3,1,0,119
164183,1273737,1,20,4,0,1,119
164184,1273737,1,20,5,6,0,125
164185,1273737,1,20,6,0,1,125
164256,1273739,1,1,1,0,0,0
164257,1273739,1,1,2,1,0,1
164258,1273739,1,1,3,0,0,1
164259,1273739,1,1,4,0,0,1
164260,1273739,1,1,5,0,0,1
164261,1273739,1,1,6,0,0,1
164262,1273739,1,2,1,0,0,1
164263,1273739,1,2,2,0,0,1
164264,1273739,1,2,3,0,0,1
164265,1273739,1,2,4,4,0,5
164266,1273739,1,2,5,0,0,5
164267,1273739,1,2,6,1,0,6
164268,1273739,1,3,1,1,0,7
164269,1273739,1,3,2,4,0,11
164270,1273739,1,3,3,0,0,11
164271,1273739,1,3,4,0,0,11
164272,1273739,1,3,5,0,1,11
164273,1273739,1,3,6,1,0,12
164274,1273739,1,4,1,0,0,12
164275,1273739,1,4,2,1,0,13
164276,1273739,1,4,3,1,0,14
164277,1273739,1,4,4,0,0,14
164278,1273739,1,4,5,0,0,14
164279,1273739,1,4,6,0,0,14
164280,1273739,1,5,1,4,0,18
164281,1273739,1,5,2,1,0,19
164282,1273739,1,5,3,0,0,19
164283,1273739,1,5,4,0,0,19
164284,1273739,1,5,5,4,0,23
164285,1273739,1,5,6,6,0,29
164286,1273739,1,6,1,4,0,33
164287,1273739,1,6,2,0,0,33
164288,1273739,1,6,3,1,0,34
164289,1273739,1,6,4,1,0,35
164290,1273739,1,6,5,0,1,35
164291,1273739,1,6,6,0,0,35
164292,1273739,1,7,1,1,0,36
164293,1273739,1,7,2,0,0,36
164294,1273739,1,7,3,0,0,36
164295,1273739,1,7,4,0,0,36
164296,1273739,1,7,5,0,0,36
164297,1273739,1,7,6,1,0,37
164298,1273739,1,8,1,2,0,39
164299,1273739,1,8,2,1,0,40
164300,1273739,1,8,3,0,0,40
164301,1273739,1,8,4,0,1,40
164302,1273739,1,8,5,0,0,40
164303,1273739,1,8,6,1,0,41
164304,1273739,1,9,1,0,0,41
164305,1273739,1,9,2,0,0,41
164306,1273739,1,9,3,1,0,42
164307,1273739,1,9,4,0,0,42
164308,1273739,1,9,5,0,0,42
164309,1273739,1,9,6,1,0,43
164310,1273739,1,10,1,0,0,43
164311,1273739,1,10,2,0,0,43
164312,1273739,1,10,3,1,0,44
164313,1273739,1,10,4,1,0,45
164314,1273739,1,10,5,2,0,47
164315,1273739,1,10,6,1,0,48
164316,1273739,1,11,1,0,1,48
164317,1273739,1,11,2,1,0,49
164318,1273739,1,11,3,0,0,49
164319,1273739,1,11,4,1,0,50
164320,1273739,1,11,5,1,0,51
164321,1273739,1,11,6,1,0,52
164322,1273739,1,12,1,1,0,53
164323,1273739,1,12,2,2,0,55
164324,1273739,1,12,3,0,0,55
164325,1273739,1,12,4,1,0,56
164326,1273739,1,12,5,1,0,57
164327,1273739,1,12,6,1,0,58
164328,1273739,1,13,1,0,0,58
164329,1273739,1,13,2,1,0,59
164330,1273739,1,13,3,1,0,60
164331,1273739,1,13,4,0,0,60
164332,1273739,1,13,5,1,0,61
164333,1273739,1,13,6,1,0,62
164334,1273739,1,14,1,1,0,63
164335,1273739,1,14,2,1,0,64
164336,1273739,1,14,3,0,0,64
164337,1273739,1,14,4,1,0,65
164338,1273739,1,14,5,1,0,66
164339,1273739,1,14,6,1,0,67
164340,1273739,1,15,1,1,0,68
164341,1273739,1,15,2,1,0,69
164342,1273739,1,15,3,1,1,70
164343,1273739,1,15,4,1,0,71
164344,1273739,1,15,5,2,0,73
164345,1273739,1,15,6,0,0,73
164346,1273739,1,16,1,1,0,74
164347,1273739,1,16,2,2,0,76
164348,1273739,1,16,3,0,0,76
164349,1273739,1,16,4,0,0,76
164350,1273739,1,16,5,1,0,77
164351,1273739,1,16,6,1,0,78
164352,1273739,1,17,1,1,0,79
164353,1273739,1,17,2,0,0,79
164354,1273739,1,17,3,1,0,80
164355,1273739,1,17,4,1,0,81
164356,1273739,1,17,5,1,0,82
164357,1273739,1,17,6,4,0,86
164358,1273739,1,18,1,1,0,87
164359,1273739,1,18,2,0,0,87
164360,1273739,1,18,3,1,0,88
164361,1273739,1,18,4,1,0,89
164362,1273739,1,18,5,1,0,90
164363,1273739,1,18,6,4,0,94
164364,1273739,1,19,1,0,1,94
164365,1273739,1,19,2,0,0,94
164366,1273739,1,19,3,0,0,94
164367,1273739,1,19,4,0,1,94
164368,1273739,1,19,5,4,0,98
164369,1273739,1,19,6,1,0,99
164370,1273739,1,20,1,2,0,101
164371,1273739,1,20,2,0,0,101
164372,1273739,1,20,3,6,0,107
164373,1273739,1,20,4,0,0,107
164374,1273739,1,20,5,2,0,109
164375,1273739,1,20,6,1,0,110
164463,1273740,1,1,1,2,0,2
164464,1273740,1,1,2,0,0,2
164465,1273740,1,1,3,4,0,6
164466,1273740,1,1,4,1,0,7
164467,1273740,1,1,5,3,0,10
164468,1273740,1,1,6,2,0,12
164469,1273740,1,2,1,1,0,13
164470,1273740,1,2,2,0,1,13
164471,1273740,1,2,3,0,0,13
164472,1273740,1,2,4,1,0,14
164473,1273740,1,2,5,0,0,14
164474,1273740,1,2,6,1,0,15
164475,1273740,1,3,1,4,0,19
164476,1273740,1,3,2,0,0,19
164477,1273740,1,3,3,4,0,23
164478,1273740,1,3,4,0,0,23
164479,1273740,1,3,5,2,0,25
164480,1273740,1,3,6,0,0,25
164481,1273740,1,4,1,1,0,26
164482,1273740,1,4,2,0,0,26
164483,1273740,1,4,3,0,0,26
164484,1273740,1,4,4,0,0,26
164485,1273740,1,4,5,1,0,27
164486,1273740,1,4,6,2,0,29
164487,1273740,1,5,1,0,0,29
164488,1273740,1,5,2,1,0,30
164489,1273740,1,5,3,4,0,34
164490,1273740,1,5,4,0,0,34
164491,1273740,1,5,5,0,0,34
164492,1273740,1,5,6,0,1,34
164493,1273740,1,6,1,1,0,35
164494,1273740,1,6,2,0,1,35
164495,1273740,1,6,3,0,0,35
164496,1273740,1,6,4,1,0,36
164497,1273740,1,6,5,0,0,36
164498,1273740,1,6,6,0,0,36
164499,1273740,1,7,1,0,0,36
164500,1273740,1,7,2,0,0,36
164501,1273740,1,7,3,0,0,36
164502,1273740,1,7,4,0,0,36
164503,1273740,1,7,5,1,0,37
164504,1273740,1,7,6,0,0,37
164505,1273740,1,8,1,1,0,38
164506,1273740,1,8,2,1,0,39
164507,1273740,1,8,3,0,0,39
164508,1273740,1,8,4,1,0,40
164509,1273740,1,8,5,0,0,40
164510,1273740,1,8,6,1,0,41
164511,1273740,1,9,1,0,0,41
164512,1273740,1,9,2,1,0,42
164513,1273740,1,9,3,1,0,43
164514,1273740,1,9,4,0,0,43
164515,1273740,1,9,5,1,0,44
164516,1273740,1,9,6,0,0,44
164517,1273740,1,10,1,0,0,44
164518,1273740,1,10,2,1,0,45
164519,1273740,1,10,3,0,0,45
164520,1273740,1,10,4,0,0,45
164521,1273740,1,10,5,1,0,46
164522,1273740,1,10,6,1,0,47
164523,1273740,1,11,1,4,0,51
164524,1273740,1,11,2,2,0,53
164525,1273740,1,11,3,3,0,56
164526,1273740,1,11,4,1,0,57
164527,1273740,1,11,5,1,0,58
164528,1273740,1,11,6,1,0,59
164529,1273740,1,12,1,0,0,59
164530,1273740,1,12,2,0,0,59
164531,1273740,1,12,3,1,0,60
164532,1273740,1,12,4,0,0,60
164533,1273740,1,12,5,0,0,60
164534,1273740,1,12,6,1,0,61
164535,1273740,1,13,1,1,0,62
164536,1273740,1,13,2,4,0,66
164537,1273740,1,13,3,6,0,72
164538,1273740,1,13,4,2,0,74
164539,1273740,1,13,5,0,0,74
164540,1273740,1,13,6,1,0,75
164541,1273740,1,14,1,1,0,76
164542,1273740,1,14,2,1,0,77
164543,1273740,1,14,3,1,0,78
164544,1273740,1,14,4,4,0,82
164545,1273740,1,14,5,1,0,83
164546,1273740,1,14,6,0,0,83
164547,1273740,1,15,1,6,0,89
164548,1273740,1,15,2,1,0,90
164549,1273740,1,15,3,6,0,96
164550,1273740,1,15,4,1,0,97
164551,1273740,1,15,5,2,0,99
164552,1273740,1,15,6,6,0,105
164553,1273740,1,16,1,0,0,105
164554,1273740,1,16,2,1,0,106
164555,1273740,1,16,3,2,0,108
164556,1273740,1,16,4,0,0,108
164557,1273740,1,16,5,1,0,109
164558,1273740,1,16,6,1,0,110
164559,1273740,1,17,1,6,0,116
164560,1273740,1,17,2,1,0,117
164561,1273740,1,17,3,3,0,120
164562,1273740,1,17,4,0,0,120
164563,1273740,1,17,5,1,0,121
164564,1273740,1,17,6,1,0,122
164565,1273740,1,18,1,1,0,123
164566,1273740,1,18,2,6,0,129
164567,1273740,1,18,3,6,0,135
164568,1273740,1,18,4,4,0,139
164569,1273740,1,18,5,1,0,140
164570,1273740,1,18,6,1,0,141
164571,1273740,1,19,1,6,0,147
164572,1273740,1,19,2,0,1,147
164573,1273740,1,19,3,0,0,147
164574,1273740,1,19,4,1,0,148
164575,1273740,1,19,5,0,0,148
164576,1273740,1,19,6,1,0,149
164577,1273740,1,20,1,4,0,153
164578,1273740,1,20,2,2,0,155
164579,1273740,1,20,3,2,0,157
164580,1273740,1,20,4,0,0,157
164581,1273740,1,20,5,0,0,157
164582,1273740,1,20,6,6,0,163
164697,1273741,1,1,1,0,0,0
164698,1273741,1,1,2,1,0,1
164699,1273741,1,1,3,0,0,1
164700,1273741,1,1,4,2,0,3
164701,1273741,1,1,5,0,0,3
164702,1273741,1,1,6,1,0,4
164703,1273741,1,2,1,0,0,4
164704,1273741,1,2,2,4,0,8
164705,1273741,1,2,3,1,0,9
164706,1273741,1,2,4,0,0,9
164707,1273741,1,2,5,0,0,9
164708,1273741,1,2,6,0,0,9
164709,1273741,1,3,1,0,0,9
164710,1273741,1,3,2,1,0,10
164711,1273741,1,3,3,1,0,11
164712,1273741,1,3,4,1,0,12
164713,1273741,1,3,5,4,0,16
164714,1273741,1,3,6,1,0,17
164715,1273741,1,4,1,1,0,18
164716,1273741,1,4,2,1,0,19
164717,1273741,1,4,3,1,0,20
164718,1273741,1,4,4,1,0,21
164719,1273741,1,4,5,1,1,22
164720,1273741,1,4,6,0,1,22
164721,1273741,1,5,1,0,0,22
164722,1273741,1,5,2,0,0,22
164723,1273741,1,5,3,2,0,24
164724,1273741,1,5,4,0,0,24
164725,1273741,1,5,5,0,0,24
164726,1273741,1,5,6,0,0,24
164727,1273741,1,6,1,0,0,24
164728,1273741,1,6,2,0,0,24
164729,1273741,1,6,3,0,1,24
164730,1273741,1,6,4,2,0,26
164731,1273741,1,6,5,2,0,28
164732,1273741,1,6,6,0,0,28
164733,1273741,1,7,1,0,0,28
164734,1273741,1,7,2,1,0,29
164735,1273741,1,7,3,1,0,30
164736,1273741,1,7,4,1,0,31
164737,1273741,1,7,5,0,0,31
164738,1273741,1,7,6,0,0,31
164739,1273741,1,8,1,1,0,32
164740,1273741,1,8,2,0,0,32
164741,1273741,1,8,3,1,0,33
164742,1273741,1,8,4,0,0,33
164743,1273741,1,8,5,1,0,34
164744,1273741,1,8,6,0,1,34
164745,1273741,1,9,1,0,1,34
164746,1273741,1,9,2,0,0,34
164747,1273741,1,9,3,0,0,34
164748,1273741,1,9,4,1,0,35
164749,1273741,1,9,5,0,0,35
164750,1273741,1,9,6,1,0,36
164751,1273741,1,10,1,0,0,36
164752,1273741,1,10,2,0,0,36
164753,1273741,1,10,3,0,0,36
164754,1273741,1,10,4,2,0,38
164755,1273741,1,10,5,0,0,38
164756,1273741,1,10,6,2,0,40
164757,1273741,1,11,1,0,0,40
164758,1273741,1,11,2,1,0,41
164759,1273741,1,11,3,0,0,41
164760,1273741,1,11,4,0,0,41
164761,1273741,1,11,5,1,0,42
164762,1273741,1,11,6,1,0,43
164763,1273741,1,12,1,2,0,45
164764,1273741,1,12,2,0,0,45
164765,1273741,1,12,3,0,1,45
164766,1273741,1,12,4,1,0,46
164767,1273741,1,12,5,0,0,46
164768,1273741,1,12,6,0,0,46
164769,1273741,1,13,1,4,0,50
164770,1273741,1,13,2,2,0,52
164771,1273741,1,13,3,0,0,52
164772,1273741,1,13,4,1,0,53
164773,1273741,1,13,5,1,0,54
164774,1273741,1,13,6,0,0,54
164775,1273741,1,14,1,1,0,55
164776,1273741,1,14,2,0,0,55
164777,1273741,1,14,3,1,0,56
164778,1273741,1,14,4,0,0,56
164779,1273741,1,14,5,0,0,56
164780,1273741,1,14,6,0,0,56
164781,1273741,1,15,1,1,0,57
164782,1273741,1,15,2,0,0,57
164783,1273741,1,15,3,0,0,57
164784,1273741,1,15,4,1,0,58
164785,1273741,1,15,5,3,0,61
164786,1273741,1,15,6,1,0,62
164787,1273741,1,16,1,2,0,64
164788,1273741,1,16,2,0,1,64
164789,1273741,1,16,3,1,0,65
164790,1273741,1,16,4,1,0,66
164791,1273741,1,16,5,4,0,70
164792,1273741,1,16,6,1,0,71
164793,1273741,1,17,1,1,0,72
164794,1273741,1,17,2,1,0,73
164795,1273741,1,17,3,2,0,75
164796,1273741,1,17,4,0,0,75
164797,1273741,1,17,5,1,0,76
164798,1273741,1,17,6,1,0,77
164799,1273741,1,18,1,0,0,77
164800,1273741,1,18,2,0,1,77
164801,1273741,1,18,3,6,0,83
164802,1273741,1,18,4,0,0,83
164803,1273741,1,18,5,0,0,83
164804,1273741,1,18,6,1,0,84
164805,1273741,1,19,1,0,1,84
164806,1273741,1,19,2,0,1,84
164888,1273744,1,1,1,0,0,0
164889,1273744,1,1,2,1,0,1
164890,1273744,1,1,3,1,0,2
164891,1273744,1,1,4,0,0,2
164892,1273744,1,1,5,1,0,3
164893,1273744,1,1,6,4,0,7
164894,1273744,1,2,1,1,0,8
164895,1273744,1,2,2,4,0,12
164896,1273744,1,2,3,1,0,13
164897,1273744,1,2,4,0,0,13
164898,1273744,1,2,5,6,0,19
164899,1273744,1,2,6,4,0,23
164900,1273744,1,3,1,0,0,23
164901,1273744,1,3,2,1,0,24
164902,1273744,1,3,3,1,0,25
164903,1273744,1,3,4,0,0,25
164904,1273744,1,3,5,4,0,29
164905,1273744,1,3,6,1,0,30
164906,1273744,1,4,1,1,0,31
164907,1273744,1,4,2,1,0,32
164908,1273744,1,4,3,0,0,32
164909,1273744,1,4,4,1,0,33
164910,1273744,1,4,5,1,0,34
164911,1273744,1,4,6,1,0,35
164912,1273744,1,5,1,2,0,37
164913,1273744,1,5,2,1,0,38
164914,1273744,1,5,3,4,0,42
164915,1273744,1,5,4,0,0,42
164916,1273744,1,5,5,6,0,48
164917,1273744,1,5,6,4,0,52
164918,1273744,1,6,1,1,0,53
164919,1273744,1,6,2,0,0,53
164920,1273744,1,6,3,0,0,53
164921,1273744,1,6,4,0,0,53
164922,1273744,1,6,5,0,0,53
164923,1273744,1,6,6,0,0,53
164924,1273744,1,7,1,2,0,55
164925,1273744,1,7,2,0,0,55
164926,1273744,1,7,3,1,0,56
164927,1273744,1,7,4,1,0,57
164928,1273744,1,7,5,1,0,58
164929,1273744,1,7,6,1,0,59
164930,1273744,1,8,1,1,0,60
164931,1273744,1,8,2,1,0,61
164932,1273744,1,8,3,1,0,62
164933,1273744,1,8,4,2,0,64
164934,1273744,1,8,5,0,0,64
164935,1273744,1,8,6,1,0,65
164936,1273744,1,9,1,1,0,66
164937,1273744,1,9,2,1,0,67
164938,1273744,1,9,3,4,0,71
164939,1273744,1,9,4,1,0,72
164940,1273744,1,9,5,1,0,73
164941,1273744,1,9,6,1,0,74
164942,1273744,1,10,1,4,0,78
164943,1273744,1,10,2,1,0,79
164944,1273744,1,10,3,1,0,80
164945,1273744,1,10,4,1,0,81
164946,1273744,1,10,5,3,0,84
164947,1273744,1,10,6,1,0,85
164948,1273744,1,11,1,1,0,86
164949,1273744,1,11,2,0,0,86
164950,1273744,1,11,3,4,0,90
164951,1273744,1,11,4,1,0,91
164952,1273744,1,11,5,0,0,91
164953,1273744,1,11,6,0,0,91
164954,1273744,1,12,1,0,0,91
164955,1273744,1,12,2,4,0,95
164956,1273744,1,12,3,1,0,96
164957,1273744,1,12,4,6,0,102
164958,1273744,1,12,5,1,0,103
164959,1273744,1,12,6,4,0,107
164960,1273744,1,13,1,4,0,111
164961,1273744,1,13,2,1,0,112
164962,1273744,1,13,3,1,0,113
164963,1273744,1,13,4,1,0,114
164964,1273744,1,13,5,1,0,115
164965,1273744,1,13,6,4,0,119
164966,1273744,1,14,1,1,0,120
164967,1273744,1,14,2,1,0,121
164968,1273744,1,14,3,1,0,122
164969,1273744,1,14,4,1,0,123
164970,1273744,1,14,5,6,0,129
164971,1273744,1,14,6,6,0,135
164972,1273744,1,15,1,4,0,139
164973,1273744,1,15,2,1,0,140
164974,1273744,1,15,3,0,0,140
164975,1273744,1,15,4,0,1,140
164976,1273744,1,15,5,1,0,141
164977,1273744,1,15,6,1,0,142
164978,1273744,1,16,1,0,0,142
164979,1273744,1,16,2,1,0,143
164980,1273744,1,16,3,0,0,143
164981,1273744,1,16,4,0,0,143
164982,1273744,1,16,5,1,0,144
164983,1273744,1,16,6,1,0,145
164984,1273744,1,17,1,1,0,146
164985,1273744,1,17,2,1,0,147
164986,1273744,1,17,3,0,1,147
164987,1273744,1,17,4,1,0,148
164988,1273744,1,17,5,6,0,154
164989,1273744,1,17,6,6,0,160
164990,1273744,1,18,1,4,0,164
164991,1273744,1,18,2,1,0,165
164992,1273744,1,18,3,1,0,166
164993,1273744,1,18,4,4,0,170
164994,1273744,1,18,5,4,0,174
164995,1273744,1,18,6,1,0,175
164996,1273744,1,19,1,2,0,177
164997,1273744,1,19,2,7,0,184
164998,1273744,1,19,3,1,0,185
164999,1273744,1,19,4,1,0,186
165000,1273744,1,19,5,6,0,192
165001,1273744,1,19,6,2,0,194
165002,1273744,1,20,1,4,0,198
165003,1273744,1,20,2,6,0,204
165004,1273744,1,20,3,0,0,204
165005,1273744,1,20,4,1,0,205
165006,1273744,1,20,5,4,0,209
165007,1273744,1,20,6,1,0,210
165128,1273745,1,1,1,0,0,0
165129,1273745,1,1,2,1,0,1
165130,1273745,1,1,3,0,1,1
165131,1273745,1,1,4,0,0,1
165132,1273745,1,1,5,1,0,2
165133,1273745,1,1,6,0,0,2
165134,1273745,1,2,1,0,0,2
165135,1273745,1,2,2,0,0,2
165136,1273745,1,2,3,4,0,6
165137,1273745,1,2,4,0,0,6
165138,1273745,1,2,5,0,0,6
165139,1273745,1,2,6,0,1,6
165140,1273745,1,3,1,1,0,7
165141,1273745,1,3,2,2,0,9
165142,1273745,1,3,3,0,0,9
165143,1273745,1,3,4,1,0,10
165144,1273745,1,3,5,0,1,10
165145,1273745,1,3,6,0,0,10
165146,1273745,1,4,1,4,0,14
165147,1273745,1,4,2,0,0,14
165148,1273745,1,4,3,0,0,14
165149,1273745,1,4,4,4,0,18
165150,1273745,1,4,5,0,0,18
165151,1273745,1,4,6,1,0,19
165152,1273745,1,5,1,1,0,20
165153,1273745,1,5,2,0,0,20
165154,1273745,1,5,3,0,0,20
165155,1273745,1,5,4,0,0,20
165156,1273745,1,5,5,4,0,24
165157,1273745,1,5,6,4,0,28
165158,1273745,1,6,1,4,0,32
165159,1273745,1,6,2,0,0,32
165160,1273745,1,6,3,0,1,32
165161,1273745,1,6,4,0,0,32
165162,1273745,1,6,5,0,0,32
165163,1273745,1,6,6,1,0,33
165164,1273745,1,7,1,0,1,33
165165,1273745,1,7,2,0,0,33
165166,1273745,1,7,3,2,0,35
165167,1273745,1,7,4,1,0,36
165168,1273745,1,7,5,1,0,37
165169,1273745,1,7,6,1,0,38
165170,1273745,1,8,1,2,0,40
165171,1273745,1,8,2,4,0,44
165172,1273745,1,8,3,0,0,44
165173,1273745,1,8,4,1,0,45
165174,1273745,1,8,5,0,0,45
165175,1273745,1,8,6,2,0,47
165176,1273745,1,9,1,0,0,47
165177,1273745,1,9,2,6,0,53
165178,1273745,1,9,3,0,0,53
165179,1273745,1,9,4,1,0,54
165180,1273745,1,9,5,0,0,54
165181,1273745,1,9,6,0,0,54
165182,1273745,1,10,1,0,0,54
165183,1273745,1,10,2,0,0,54
165184,1273745,1,10,3,0,0,54
165185,1273745,1,10,4,2,0,56
165186,1273745,1,10,5,1,0,57
165187,1273745,1,10,6,1,0,58
165188,1273745,1,11,1,0,0,58
165189,1273745,1,11,2,3,0,61
165190,1273745,1,11,3,0,0,61
165191,1273745,1,11,4,1,0,62
165192,1273745,1,11,5,0,1,62
165193,1273745,1,11,6,0,1,62
165194,1273745,1,12,1,1,0,63
165195,1273745,1,12,2,0,0,63
165196,1273745,1,12,3,0,0,63
165197,1273745,1,12,4,0,0,63
165198,1273745,1,12,5,0,0,63
165199,1273745,1,12,6,1,0,64
165200,1273745,1,13,1,1,0,65
165201,1273745,1,13,2,0,1,65
165202,1273745,1,13,3,0,0,65
165203,1273745,1,13,4,0,0,65
165204,1273745,1,13,5,0,0,65
165205,1273745,1,13,6,0,0,65
165206,1273745,1,14,1,0,0,65
165207,1273745,1,14,2,1,0,66
165208,1273745,1,14,3,0,0,66
165209,1273745,1,14,4,2,0,68
165210,1273745,1,14,5,0,0,68
165211,1273745,1,14,6,2,0,70
165212,1273745,1,15,1,0,0,70
165213,1273745,1,15,2,2,0,72
165214,1273745,1,15,3,1,0,73
165215,1273745,1,15,4,0,1,73
165216,1273745,1,15,5,0,0,73
165217,1273745,1,15,6,0,1,73
165256,1273746,1,1,1,0,0,0
165257,1273746,1,1,2,1,0,1
165258,1273746,1,1,3,4,0,5
165259,1273746,1,1,4,0,0,5
165260,1273746,1,1,5,0,0,5
165261,1273746,1,1,6,1,0,6
165262,1273746,1,2,1,2,0,8
165263,1273746,1,2,2,0,0,8
165264,1273746,1,2,3,0,0,8
165265,1273746,1,2,4,2,0,10
165266,1273746,1,2,5,0,0,10
165267,1273746,1,2,6,4,0,14
165268,1273746,1,3,1,2,0,16
165269,1273746,1,3,2,0,0,16
165270,1273746,1,3,3,2,0,18
165271,1273746,1,3,4,2,0,20
165272,1273746,1,3,5,1,0,21
165273,1273746,1,3,6,0,0,21
165274,1273746,1,4,1,1,0,22
165275,1273746,1,4,2,1,0,23
165276,1273746,1,4,3,1,0,24
165277,1273746,1,4,4,0,0,24
165278,1273746,1,4,5,1,0,25
165279,1273746,1,4,6,4,0,29
165280,1273746,1,5,1,6,0,35
165281,1273746,1,5,2,3,0,38
165282,1273746,1,5,3,0,0,38
165283,1273746,1,5,4,2,0,40
165284,1273746,1,5,5,0,0,40
165285,1273746,1,5,6,2,0,42
165286,1273746,1,6,1,0,0,42
165287,1273746,1,6,2,0,1,42
165288,1273746,1,6,3,0,0,42
165289,1273746,1,6,4,1,0,43
165290,1273746,1,6,5,1,0,44
165291,1273746,1,6,6,4,0,48
165292,1273746,1,7,1,1,0,49
165293,1273746,1,7,2,4,0,53
165294,1273746,1,7,3,2,0,55
165295,1273746,1,7,4,1,0,56
165296,1273746,1,7,5,4,0,60
165297,1273746,1,7,6,1,0,61
165298,1273746,1,8,1,2,0,63
165299,1273746,1,8,2,0,0,63
165300,1273746,1,8,3,0,0,63
165301,1273746,1,8,4,1,0,64
165302,1273746,1,8,5,2,0,66
165303,1273746,1,8,6,1,0,67
165304,1273746,1,9,1,0,0,67
165305,1273746,1,9,2,4,0,71
165306,1273746,1,9,3,1,0,72
165307,1273746,1,9,4,3,0,75
165308,1273746,1,9,5,0,0,75
165309,1273746,1,9,6,2,0,77
165310,1273746,1,10,1,1,0,78
165311,1273746,1,10,2,0,0,78
165312,1273746,1,10,3,1,0,79
165313,1273746,1,10,4,2,0,81
165314,1273746,1,10,5,0,0,81
165315,1273746,1,10,6,1,0,82
165316,1273746,1,11,1,1,0,83
165317,1273746,1,11,2,1,0,84
165318,1273746,1,11,3,1,0,85
165319,1273746,1,11,4,1,0,86
165320,1273746,1,11,5,1,0,87
165321,1273746,1,11,6,4,0,91
165322,1273746,1,12,1,2,0,93
165323,1273746,1,12,2,1,0,94
165324,1273746,1,12,3,1,0,95
165325,1273746,1,12,4,4,0,99
165326,1273746,1,12,5,1,0,100
165327,1273746,1,12,6,1,0,101
165328,1273746,1,13,1,0,0,101
165329,1273746,1,13,2,4,0,105
165330,1273746,1,13,3,1,0,106
165331,1273746,1,13,4,1,0,107
165332,1273746,1,13,5,1,0,108
165333,1273746,1,13,6,4,0,112
165334,1273746,1,14,1,1,0,113
165335,1273746,1,14,2,1,0,114
165336,1273746,1,14,3,2,0,116
165337,1273746,1,14,4,1,0,117
165338,1273746,1,14,5,1,0,118
165339,1273746,1,14,6,2,0,120
165340,1273746,1,15,1,4,0,124
165341,1273746,1,15,2,2,0,126
165342,1273746,1,15,3,1,0,127
165343,1273746,1,15,4,4,0,131
165344,1273746,1,15,5,0,0,131
165345,1273746,1,15,6,1,0,132
165346,1273746,1,16,1,0,0,132
165347,1273746,1,16,2,1,0,133
165348,1273746,1,16,3,0,1,133
165349,1273746,1,16,4,1,0,134
165350,1273746,1,16,5,1,0,135
165351,1273746,1,16,6,2,0,137
165352,1273746,1,17,1,1,0,138
165353,1273746,1,17,2,7,0,145
165354,1273746,1,17,3,1,0,146
165355,1273746,1,17,4,1,0,147
165356,1273746,1,17,5,2,0,149
165357,1273746,1,17,6,4,0,153
165358,1273746,1,18,1,1,0,154
165359,1273746,1,18,2,1,0,155
165360,1273746,1,18,3,6,0,161
165361,1273746,1,18,4,4,0,165
165362,1273746,1,18,5,1,0,166
165363,1273746,1,18,6,4,0,170
165364,1273746,1,19,1,4,0,174
165365,1273746,1,19,2,1,0,175
165366,1273746,1,19,3,4,0,179
165367,1273746,1,19,4,0,1,179
165368,1273746,1,19,5,0,0,179
165369,1273746,1,19,6,1,0,180
165370,1273746,1,20,1,1,0,181
165371,1273746,1,20,2,2,0,183
165372,1273746,1,20,3,1,0,184
165373,1273746,1,20,4,2,0,186
165374,1273746,1,20,5,1,0,187
165375,1273746,1,20,6,2,0,189
165496,1273749,1,1,1,2,0,2
165497,1273749,1,1,2,1,0,3
165498,1273749,1,1,3,1,0,4
165499,1273749,1,1,4,0,0,4
165500,1273749,1,1,5,0,0,4
165501,1273749,1,1,6,0,0,4
165502,1273749,1,2,1,4,0,8
165503,1273749,1,2,2,4,0,12
165504,1273749,1,2,3,4,0,16
165505,1273749,1,2,4,1,0,17
165506,1273749,1,2,5,6,0,23
165507,1273749,1,2,6,1,0,24
165508,1273749,1,3,1,6,0,30
165509,1273749,1,3,2,0,1,30
165510,1273749,1,3,3,0,0,30
165511,1273749,1,3,4,4,0,34
165512,1273749,1,3,5,1,0,35
165513,1273749,1,3,6,0,0,35
165514,1273749,1,4,1,0,1,35
165515,1273749,1,4,2,0,0,35
165516,1273749,1,4,3,0,1,35
165517,1273749,1,4,4,1,0,36
165518,1273749,1,4,5,1,0,37
165519,1273749,1,4,6,0,0,37
165520,1273749,1,5,1,1,0,38
165521,1273749,1,5,2,1,0,39
165522,1273749,1,5,3,0,0,39
165523,1273749,1,5,4,1,0,40
165524,1273749,1,5,5,4,0,44
165525,1273749,1,5,6,0,0,44
165526,1273749,1,6,1,1,0,45
165527,1273749,1,6,2,0,0,45
165528,1273749,1,6,3,1,0,46
165529,1273749,1,6,4,4,0,50
165530,1273749,1,6,5,0,0,50
165531,1273749,1,6,6,0,0,50
165532,1273749,1,7,1,1,0,51
165533,1273749,1,7,2,0,0,51
165534,1273749,1,7,3,0,0,51
165535,1273749,1,7,4,1,0,52
165536,1273749,1,7,5,1,0,53
165537,1273749,1,7,6,0,0,53
165538,1273749,1,8,1,1,0,54
165539,1273749,1,8,2,1,0,55
165540,1273749,1,8,3,1,0,56
165541,1273749,1,8,4,0,0,56
165542,1273749,1,8,5,1,0,57
165543,1273749,1,8,6,0,0,57
165544,1273749,1,9,1,1,0,58
165545,1273749,1,9,2,1,0,59
165546,1273749,1,9,3,1,0,60
165547,1273749,1,9,4,4,0,64
165548,1273749,1,9,5,1,0,65
165549,1273749,1,9,6,0,0,65
165550,1273749,1,10,1,1,0,66
165551,1273749,1,10,2,4,0,70
165552,1273749,1,10,3,0,1,70
165553,1273749,1,10,4,1,0,71
165554,1273749,1,10,5,1,0,72
165555,1273749,1,10,6,2,0,74
165556,1273749,1,11,1,0,0,74
165557,1273749,1,11,2,1,0,75
165558,1273749,1,11,3,2,0,77
165559,1273749,1,11,4,0,0,77
165560,1273749,1,11,5,2,0,79
165561,1273749,1,11,6,2,0,81
165562,1273749,1,12,1,0,0,81
165563,1273749,1,12,2,1,0,82
165564,1273749,1,12,3,0,0,82
165565,1273749,1,12,4,0,0,82
165566,1273749,1,12,5,1,0,83
165567,1273749,1,12,6,4,0,87
165568,1273749,1,13,1,0,0,87
165569,1273749,1,13,2,2,0,89
165570,1273749,1,13,3,1,0,90
165571,1273749,1,13,4,1,0,91
165572,1273749,1,13,5,0,1,91
165573,1273749,1,13,6,1,0,92
165574,1273749,1,14,1,0,0,92
165575,1273749,1,14,2,1,0,93
165576,1273749,1,14,3,0,0,93
165577,1273749,1,14,4,1,0,94
165578,1273749,1,14,5,0,0,94
165579,1273749,1,14,6,0,0,94
165580,1273749,1,15,1,2,0,96
165581,1273749,1,15,2,0,0,96
165582,1273749,1,15,3,0,0,96
165583,1273749,1,15,4,2,0,98
165584,1273749,1,15,5,1,0,99
165585,1273749,1,15,6,0,0,99
165586,1273749,1,16,1,1,0,100
165587,1273749,1,16,2,1,0,101
165588,1273749,1,16,3,1,0,102
165589,1273749,1,16,4,0,0,102
165590,1273749,1,16,5,6,0,108
165591,1273749,1,16,6,1,0,109
165592,1273749,1,17,1,1,0,110
165593,1273749,1,17,2,2,0,112
165594,1273749,1,17,3,4,0,116
165595,1273749,1,17,4,0,0,116
165596,1273749,1,17,5,6,0,122
165597,1273749,1,17,6,1,0,123
165598,1273749,1,18,1,2,0,125
165599,1273749,1,18,2,1,0,126
165600,1273749,1,18,3,0,1,126
165601,1273749,1,18,4,4,0,130
165602,1273749,1,18,5,5,0,135
165603,1273749,1,18,6,1,0,136
165604,1273749,1,19,1,1,0,137
165605,1273749,1,19,2,4,0,141
165606,1273749,1,19,3,0,0,141
165607,1273749,1,19,4,1,0,142
165608,1273749,1,19,5,1,0,143
165609,1273749,1,19,6,0,0,143
165610,1273749,1,20,1,0,0,143
165611,1273749,1,20,2,0,1,143
165612,1273749,1,20,3,1,0,144
165613,1273749,1,20,4,1,0,145
165614,1273749,1,20,5,6,0,151
165615,1273749,1,20,6,6,0,157
165714,1273750,1,1,1,0,0,0
165715,1273750,1,1,2,1,0,1
165716,1273750,1,1,3,0,0,1
165717,1273750,1,1,4,4,0,5
165718,1273750,1,1,5,1,0,6
165719,1273750,1,1,6,0,0,6
165720,1273750,1,2,1,0,0,6
165721,1273750,1,2,2,1,0,7
165722,1273750,1,2,3,1,0,8
165723,1273750,1,2,4,0,0,8
165724,1273750,1,2,5,1,0,9
165725,1273750,1,2,6,0,0,9
165726,1273750,1,3,1,4,0,13
165727,1273750,1,3,2,2,0,15
165728,1273750,1,3,3,0,0,15
165729,1273750,1,3,4,0,1,15
165730,1273750,1,3,5,1,0,16
165731,1273750,1,3,6,0,0,16
165732,1273750,1,4,1,4,0,20
165733,1273750,1,4,2,0,0,20
165734,1273750,1,4,3,0,0,20
165735,1273750,1,4,4,0,0,20
165736,1273750,1,4,5,0,0,20
165737,1273750,1,4,6,1,0,21
165738,1273750,1,5,1,1,0,22
165739,1273750,1,5,2,1,0,23
165740,1273750,1,5,3,0,0,23
165741,1273750,1,5,4,1,0,24
165742,1273750,1,5,5,1,0,25
165743,1273750,1,5,6,1,0,26
165744,1273750,1,6,1,4,0,30
165745,1273750,1,6,2,6,0,36
165746,1273750,1,6,3,1,0,37
165747,1273750,1,6,4,1,0,38
165748,1273750,1,6,5,1,0,39
165749,1273750,1,6,6,1,0,40
165750,1273750,1,7,1,1,0,41
165751,1273750,1,7,2,1,0,42
165752,1273750,1,7,3,4,0,46
165753,1273750,1,7,4,1,0,47
165754,1273750,1,7,5,1,0,48
165755,1273750,1,7,6,1,0,49
165756,1273750,1,8,1,1,0,50
165757,1273750,1,8,2,4,0,54
165758,1273750,1,8,3,0,0,54
165759,1273750,1,8,4,1,0,55
165760,1273750,1,8,5,1,0,56
165761,1273750,1,8,6,0,0,56
165762,1273750,1,9,1,1,0,57
165763,1273750,1,9,2,0,0,57
165764,1273750,1,9,3,1,0,58
165765,1273750,1,9,4,1,0,59
165766,1273750,1,9,5,2,0,61
165767,1273750,1,9,6,4,0,65
165768,1273750,1,10,1,1,0,66
165769,1273750,1,10,2,1,0,67
165770,1273750,1,10,3,4,0,71
165771,1273750,1,10,4,1,0,72
165772,1273750,1,10,5,0,0,72
165773,1273750,1,10,6,1,0,73
165774,1273750,1,11,1,1,0,74
165775,1273750,1,11,2,1,0,75
165776,1273750,1,11,3,6,0,81
165777,1273750,1,11,4,1,0,82
165778,1273750,1,11,5,1,0,83
165779,1273750,1,11,6,2,0,85
165780,1273750,1,12,1,1,0,86
165781,1273750,1,12,2,0,1,86
165782,1273750,1,12,3,2,0,88
165783,1273750,1,12,4,1,0,89
165784,1273750,1,12,5,1,0,90
165785,1273750,1,12,6,1,0,91
165786,1273750,1,13,1,1,0,92
165787,1273750,1,13,2,1,0,93
165788,1273750,1,13,3,1,0,94
165789,1273750,1,13,4,2,0,96
165790,1273750,1,13,5,1,0,97
165791,1273750,1,13,6,6,0,103
165792,1273750,1,14,1,1,0,104
165793,1273750,1,14,2,1,0,105
165794,1273750,1,14,3,1,0,106
165795,1273750,1,14,4,1,0,107
165796,1273750,1,14,5,6,0,113
165797,1273750,1,14,6,1,0,114
165798,1273750,1,15,1,1,0,115
165799,1273750,1,15,2,0,0,115
165800,1273750,1,15,3,1,0,116
165801,1273750,1,15,4,1,0,117
165802,1273750,1,15,5,0,0,117
165803,1273750,1,15,6,1,0,118
165804,1273750,1,16,1,6,0,124
165805,1273750,1,16,2,6,0,130
165806,1273750,1,16,3,2,0,132
165807,1273750,1,16,4,1,0,133
165808,1273750,1,16,5,6,0,139
165809,1273750,1,16,6,0,0,139
165810,1273750,1,17,1,0,0,139
165811,1273750,1,17,2,1,0,140
165812,1273750,1,17,3,4,0,144
165813,1273750,1,17,4,0,0,144
165814,1273750,1,17,5,2,0,146
165815,1273750,1,17,6,4,0,150
165816,1273750,1,18,1,1,0,151
165817,1273750,1,18,2,3,0,154
165818,1273750,1,18,3,0,0,154
165819,1273750,1,18,4,1,0,155
165820,1273750,1,18,5,1,0,156
165821,1273750,1,18,6,4,0,160
165822,1273750,1,19,1,0,0,160
165823,1273750,1,19,2,2,0,162
165824,1273750,1,19,3,6,0,168
165825,1273750,1,19,4,1,0,169
165826,1273750,1,19,5,2,0,171
165827,1273750,1,19,6,2,0,173
165828,1273750,1,20,1,1,0,174
165829,1273750,1,20,2,1,0,175
165830,1273750,1,20,3,6,0,181
165831,1273750,1,20,4,1,0,182
165832,1273750,1,20,5,6,0,188
165833,1273750,1,20,6,1,0,189
165954,1273751,1,1,1,2,0,2
165955,1273751,1,1,2,4,0,6
165956,1273751,1,1,3,0,0,6
165957,1273751,1,1,4,0,0,6
165958,1273751,1,1,5,0,0,6
165959,1273751,1,1,6,0,0,6
165960,1273751,1,2,1,1,0,7
165961,1273751,1,2,2,0,0,7
165962,1273751,1,2,3,0,0,7
165963,1273751,1,2,4,0,0,7
165964,1273751,1,2,5,0,0,7
165965,1273751,1,2,6,0,0,7
165966,1273751,1,3,1,1,0,8
165967,1273751,1,3,2,0,1,8
165968,1273751,1,3,3,0,0,8
165969,1273751,1,3,4,4,0,12
165970,1273751,1,3,5,0,0,12
165971,1273751,1,3,6,0,0,12
165972,1273751,1,4,1,0,1,12
165973,1273751,1,4,2,0,0,12
165974,1273751,1,4,3,0,0,12
165975,1273751,1,4,4,0,0,12
165976,1273751,1,4,5,0,0,12
165977,1273751,1,4,6,4,0,16
165978,1273751,1,5,1,1,0,17
165979,1273751,1,5,2,1,0,18
165980,1273751,1,5,3,0,0,18
165981,1273751,1,5,4,0,0,18
165982,1273751,1,5,5,1,0,19
165983,1273751,1,5,6,0,0,19
165984,1273751,1,6,1,0,1,19
165985,1273751,1,6,2,2,0,21
165986,1273751,1,6,3,0,0,21
165987,1273751,1,6,4,0,0,21
165988,1273751,1,6,5,0,0,21
165989,1273751,1,6,6,2,0,23
165990,1273751,1,7,1,2,0,25
165991,1273751,1,7,2,1,0,26
165992,1273751,1,7,3,1,0,27
165993,1273751,1,7,4,0,0,27
165994,1273751,1,7,5,1,0,28
165995,1273751,1,7,6,0,0,28
165996,1273751,1,8,1,1,0,29
165997,1273751,1,8,2,1,0,30
165998,1273751,1,8,3,1,0,31
165999,1273751,1,8,4,4,0,35
166000,1273751,1,8,5,0,0,35
166001,1273751,1,8,6,1,0,36
166002,1273751,1,9,1,1,0,37
166003,1273751,1,9,2,1,0,38
166004,1273751,1,9,3,1,0,39
166005,1273751,1,9,4,1,0,40
166006,1273751,1,9,5,4,0,44
166007,1273751,1,9,6,4,0,48
166008,1273751,1,10,1,1,0,49
166009,1273751,1,10,2,4,0,53
166010,1273751,1,10,3,1,0,54
166011,1273751,1,10,4,1,0,55
166012,1273751,1,10,5,1,0,56
166013,1273751,1,10,6,0,1,56
166014,1273751,1,11,1,1,0,57
166015,1273751,1,11,2,1,0,58
166016,1273751,1,11,3,0,0,58
166017,1273751,1,11,4,0,0,58
166018,1273751,1,11,5,1,0,59
166019,1273751,1,11,6,2,0,61
166020,1273751,1,12,1,0,0,61
166021,1273751,1,12,2,2,0,63
166022,1273751,1,12,3,0,0,63
166023,1273751,1,12,4,1,0,64
166024,1273751,1,12,5,1,0,65
166025,1273751,1,12,6,1,0,66
166026,1273751,1,13,1,0,0,66
166027,1273751,1,13,2,0,0,66
166028,1273751,1,13,3,0,0,66
166029,1273751,1,13,4,0,0,66
166030,1273751,1,13,5,1,0,67
166031,1273751,1,13,6,1,0,68
166032,1273751,1,14,1,6,0,74
166033,1273751,1,14,2,1,0,75
166034,1273751,1,14,3,1,0,76
166035,1273751,1,14,4,6,0,82
166036,1273751,1,14,5,2,0,84
166037,1273751,1,14,6,3,0,87
166038,1273751,1,15,1,0,0,87
166039,1273751,1,15,2,0,0,87
166040,1273751,1,15,3,1,0,88
166041,1273751,1,15,4,0,0,88
166042,1273751,1,15,5,1,0,89
166043,1273751,1,15,6,2,0,91
166044,1273751,1,16,1,0,0,91
166045,1273751,1,16,2,1,0,92
166046,1273751,1,16,3,1,0,93
166047,1273751,1,16,4,2,0,95
166048,1273751,1,16,5,0,0,95
166049,1273751,1,16,6,1,0,96
166050,1273751,1,17,1,1,0,97
166051,1273751,1,17,2,1,0,98
166052,1273751,1,17,3,0,0,98
166053,1273751,1,17,4,1,0,99
166054,1273751,1,17,5,1,0,100
166055,1273751,1,17,6,1,0,101
166056,1273751,1,18,1,1,0,102
166057,1273751,1,18,2,6,0,108
166058,1273751,1,18,3,2,0,110
166059,1273751,1,18,4,4,0,114
166060,1273751,1,18,5,1,0,115
166061,1273751,1,18,6,0,1,115
166062,1273751,1,19,1,4,0,119
166063,1273751,1,19,2,0,1,119
166064,1273751,1,19,3,2,0,121
166065,1273751,1,19,4,0,1,121
166066,1273751,1,19,5,1,0,122
166067,1273751,1,19,6,0,0,122
166068,1273751,1,20,1,2,0,124
166069,1273751,1,20,2,0,0,124
166070,1273751,1,20,3,0,0,124
166071,1273751,1,20,4,0,0,124
166072,1273751,1,20,5,0,0,124
166073,1273751,1,20,6,0,1,124
166183,1273754,1,1,1,1,0,1
166184,1273754,1,1,2,0,0,1
166185,1273754,1,1,3,1,0,2
166186,1273754,1,1,4,0,0,2
166187,1273754,1,1,5,0,0,2
166188,1273754,1,1,6,4,0,6
166189,1273754,1,2,1,0,0,6
166190,1273754,1,2,2,0,0,6
166191,1273754,1,2,3,0,0,6
166192,1273754,1,2,4,2,0,8
166193,1273754,1,2,5,0,0,8
166194,1273754,1,2,6,4,0,12
166195,1273754,1,3,1,0,0,12
166196,1273754,1,3,2,1,0,13
166197,1273754,1,3,3,0,0,13
166198,1273754,1,3,4,0,0,13
166199,1273754,1,3,5,0,0,13
166200,1273754,1,3,6,0,0,13
166201,1273754,1,4,1,4,0,17
166202,1273754,1,4,2,4,0,21
166203,1273754,1,4,3,0,0,21
166204,1273754,1,4,4,7,0,28
166205,1273754,1,4,5,0,0,28
166206,1273754,1,4,6,1,0,29
166207,1273754,1,5,1,1,0,30
166208,1273754,1,5,2,4,0,34
166209,1273754,1,5,3,0,0,34
166210,1273754,1,5,4,1,0,35
166211,1273754,1,5,5,1,0,36
166212,1273754,1,5,6,1,0,37
166213,1273754,1,6,1,0,1,37
166214,1273754,1,6,2,1,0,38
166215,1273754,1,6,3,0,0,38
166216,1273754,1,6,4,1,0,39
166217,1273754,1,6,5,0,0,39
166218,1273754,1,6,6,1,0,40
166219,1273754,1,7,1,1,0,41
166220,1273754,1,7,2,1,0,42
166221,1273754,1,7,3,0,0,42
166222,1273754,1,7,4,1,0,43
166223,1273754,1,7,5,1,0,44
166224,1273754,1,7,6,1,0,45
166225,1273754,1,8,1,1,0,46
166226,1273754,1,8,2,0,0,46
166227,1273754,1,8,3,4,0,50
166228,1273754,1,8,4,2,0,52
166229,1273754,1,8,5,0,0,52
166230,1273754,1,8,6,1,0,53
166231,1273754,1,9,1,0,1,53
166232,1273754,1,9,2,1,0,54
166233,1273754,1,9,3,1,0,55
166234,1273754,1,9,4,0,0,55
166235,1273754,1,9,5,1,0,56
166236,1273754,1,9,6,4,0,60
166237,1273754,1,10,1,1,0,61
166238,1273754,1,10,2,0,0,61
166239,1273754,1,10,3,1,0,62
166240,1273754,1,10,4,0,0,62
166241,1273754,1,10,5,1,0,63
166242,1273754,1,10,6,4,0,67
166243,1273754,1,11,1,1,0,68
166244,1273754,1,11,2,4,0,72
166245,1273754,1,11,3,0,0,72
166246,1273754,1,11,4,4,0,76
166247,1273754,1,11,5,1,0,77
166248,1273754,1,11,6,1,0,78
166249,1273754,1,12,1,1,0,79
166250,1273754,1,12,2,3,0,82
166251,1273754,1,12,3,1,0,83
166252,1273754,1,12,4,1,0,84
166253,1273754,1,12,5,0,0,84
166254,1273754,1,12,6,1,0,85
166255,1273754,1,13,1,2,0,87
166256,1273754,1,13,2,1,0,88
166257,1273754,1,13,3,1,0,89
166258,1273754,1,13,4,0,0,89
166259,1273754,1,13,5,1,0,90
166260,1273754,1,13,6,4,0,94
166261,1273754,1,14,1,1,0,95
166262,1273754,1,14,2,1,0,96
166263,1273754,1,14,3,0,0,96
166264,1273754,1,14,4,2,0,98
166265,1273754,1,14,5,1,0,99
166266,1273754,1,14,6,1,0,100
166267,1273754,1,15,1,2,0,102
166268,1273754,1,15,2,1,0,103
166269,1273754,1,15,3,1,0,104
166270,1273754,1,15,4,4,0,108
166271,1273754,1,15,5,1,0,109
166272,1273754,1,15,6,1,0,110
166273,1273754,1,16,1,6,0,116
166274,1273754,1,16,2,0,1,116
166275,1273754,1,16,3,1,0,117
166276,1273754,1,16,4,0,0,117
166277,1273754,1,16,5,1,0,118
166278,1273754,1,16,6,1,0,119
166279,1273754,1,17,1,2,0,121
166280,1273754,1,17,2,6,0,127
166281,1273754,1,17,3,0,0,127
166282,1273754,1,17,4,0,0,127
166283,1273754,1,17,5,2,0,129
166284,1273754,1,17,6,1,0,130
166285,1273754,1,18,1,6,0,136
166286,1273754,1,18,2,1,0,137
166287,1273754,1,18,3,1,0,138
166288,1273754,1,18,4,1,0,139
166289,1273754,1,18,5,1,0,140
166290,1273754,1,18,6,6,0,146
166291,1273754,1,19,1,1,0,147
166292,1273754,1,19,2,2,0,149
166293,1273754,1,19,3,4,0,153
166294,1273754,1,19,4,1,0,154
166295,1273754,1,19,5,0,0,154
166296,1273754,1,19,6,1,0,155
166297,1273754,1,20,1,1,0,156
166298,1273754,1,20,2,0,1,156
166299,1273754,1,20,3,4,0,160
166300,1273754,1,20,4,1,0,161
166301,1273754,1,20,5,3,0,164
166302,1273754,1,20,6,2,0,166
166417,1273755,1,1,1,1,0,1
166418,1273755,1,1,2,0,0,1
166419,1273755,1,1,3,0,0,1
166420,1273755,1,1,4,4,0,5
166421,1273755,1,1,5,1,0,6
166422,1273755,1,1,6,0,0,6
166423,1273755,1,2,1,0,0,6
166424,1273755,1,2,2,4,0,10
166425,1273755,1,2,3,1,0,11
166426,1273755,1,2,4,0,0,11
166427,1273755,1,2,5,0,0,11
166428,1273755,1,2,6,0,0,11
166429,1273755,1,3,1,0,0,11
166430,1273755,1,3,2,1,0,12
166431,1273755,1,3,3,4,0,16
166432,1273755,1,3,4,1,0,17
166433,1273755,1,3,5,0,0,17
166434,1273755,1,3,6,4,0,21
166435,1273755,1,4,1,2,0,23
166436,1273755,1,4,2,4,0,27
166437,1273755,1,4,3,1,0,28
166438,1273755,1,4,4,1,0,29
166439,1273755,1,4,5,0,0,29
166440,1273755,1,4,6,0,0,29
166441,1273755,1,5,1,6,0,35
166442,1273755,1,5,2,1,0,36
166443,1273755,1,5,3,1,0,37
166444,1273755,1,5,4,0,0,37
166445,1273755,1,5,5,1,0,38
166446,1273755,1,5,6,0,0,38
166447,1273755,1,6,1,1,0,39
166448,1273755,1,6,2,3,0,42
166449,1273755,1,6,3,4,0,46
166450,1273755,1,6,4,0,0,46
166451,1273755,1,6,5,0,0,46
166452,1273755,1,6,6,1,0,47
166453,1273755,1,7,1,1,0,48
166454,1273755,1,7,2,1,0,49
166455,1273755,1,7,3,0,0,49
166456,1273755,1,7,4,1,0,50
166457,1273755,1,7,5,0,0,50
166458,1273755,1,7,6,1,0,51
166459,1273755,1,8,1,2,0,53
166460,1273755,1,8,2,4,0,57
166461,1273755,1,8,3,0,0,57
166462,1273755,1,8,4,2,0,59
166463,1273755,1,8,5,2,0,61
166464,1273755,1,8,6,1,0,62
166465,1273755,1,9,1,1,0,63
166466,1273755,1,9,2,1,0,64
166467,1273755,1,9,3,1,0,65
166468,1273755,1,9,4,1,0,66
166469,1273755,1,9,5,1,0,67
166470,1273755,1,9,6,1,0,68
166471,1273755,1,10,1,0,0,68
166472,1273755,1,10,2,1,0,69
166473,1273755,1,10,3,1,0,70
166474,1273755,1,10,4,1,0,71
166475,1273755,1,10,5,0,0,71
166476,1273755,1,10,6,0,1,71
166477,1273755,1,11,1,0,0,71
166478,1273755,1,11,2,1,0,72
166479,1273755,1,11,3,0,0,72
166480,1273755,1,11,4,1,0,73
166481,1273755,1,11,5,0,0,73
166482,1273755,1,11,6,2,0,75
166483,1273755,1,12,1,1,0,76
166484,1273755,1,12,2,2,0,78
166485,1273755,1,12,3,6,0,84
166486,1273755,1,12,4,4,0,88
166487,1273755,1,12,5,0,0,88
166488,1273755,1,12,6,1,0,89
166489,1273755,1,13,1,1,0,90
166490,1273755,1,13,2,0,0,90
166491,1273755,1,13,3,1,0,91
166492,1273755,1,13,4,0,0,91
166493,1273755,1,13,5,1,0,92
166494,1273755,1,13,6,0,0,92
166495,1273755,1,14,1,1,0,93
166496,1273755,1,14,2,5,0,98
166497,1273755,1,14,3,0,0,98
166498,1273755,1,14,4,1,0,99
166499,1273755,1,14,5,6,0,105
166500,1273755,1,14,6,1,0,106
166501,1273755,1,15,1,1,0,107
166502,1273755,1,15,2,6,0,113
166503,1273755,1,15,3,1,0,114
166504,1273755,1,15,4,1,0,115
166505,1273755,1,15,5,0,0,115
166506,1273755,1,15,6,2,0,117
166507,1273755,1,16,1,1,0,118
166508,1273755,1,16,2,1,0,119
166509,1273755,1,16,3,1,0,120
166510,1273755,1,16,4,1,0,121
166511,1273755,1,16,5,0,0,121
166512,1273755,1,16,6,1,0,122
166513,1273755,1,17,1,0,0,122
166514,1273755,1,17,2,6,0,128
166515,1273755,1,17,3,2,0,130
166516,1273755,1,17,4,1,0,131
166517,1273755,1,17,5,11,0,142
166518,1273755,1,17,6,1,0,143
166519,1273755,1,18,1,0,0,143
166520,1273755,1,18,2,0,1,143
166521,1273755,1,18,3,6,0,149
166522,1273755,1,18,4,2,0,151
166523,1273755,1,18,5,4,0,155
166524,1273755,1,18,6,3,0,158
166525,1273755,1,19,1,0,1,158
166526,1273755,1,19,2,1,0,159
166527,1273755,1,19,3,1,0,160
166528,1273755,1,19,4,0,0,160
166529,1273755,1,19,5,0,0,160
166530,1273755,1,19,6,1,0,161
166531,1273755,1,20,1,1,0,162
166532,1273755,1,20,2,0,1,162
166533,1273755,1,20,3,1,0,163
166534,1273755,1,20,4,6,0,169
166535,1273755,1,20,5,6,0,175
166536,1273755,1,20,6,1,0,176
166651,1273756,1,1,1,0,0,0
166652,1273756,1,1,2,4,0,4
166653,1273756,1,1,3,1,0,5
166654,1273756,1,1,4,0,0,5
166655,1273756,1,1,5,3,0,8
166656,1273756,1,1,6,1,0,9
166657,1273756,1,2,1,0,0,9
166658,1273756,1,2,2,0,0,9
166659,1273756,1,2,3,0,0,9
166660,1273756,1,2,4,0,0,9
166661,1273756,1,2,5,4,0,13
166662,1273756,1,2,6,0,0,13
166663,1273756,1,3,1,6,0,19
166664,1273756,1,3,2,1,0,20
166665,1273756,1,3,3,0,0,20
166666,1273756,1,3,4,1,0,21
166667,1273756,1,3,5,1,0,22
166668,1273756,1,3,6,1,0,23
166669,1273756,1,4,1,4,0,27
166670,1273756,1,4,2,1,0,28
166671,1273756,1,4,3,0,0,28
166672,1273756,1,4,4,0,0,28
166673,1273756,1,4,5,0,1,28
166674,1273756,1,4,6,0,0,28
166675,1273756,1,5,1,0,0,28
166676,1273756,1,5,2,0,0,28
166677,1273756,1,5,3,0,0,28
166678,1273756,1,5,4,1,0,29
166679,1273756,1,5,5,1,0,30
166680,1273756,1,5,6,0,0,30
166681,1273756,1,6,1,0,0,30
166682,1273756,1,6,2,0,0,30
166683,1273756,1,6,3,0,0,30
166684,1273756,1,6,4,0,0,30
166685,1273756,1,6,5,0,0,30
166686,1273756,1,6,6,2,0,32
166687,1273756,1,7,1,1,0,33
166688,1273756,1,7,2,1,0,34
166689,1273756,1,7,3,0,0,34
166690,1273756,1,7,4,1,0,35
166691,1273756,1,7,5,1,0,36
166692,1273756,1,7,6,1,0,37
166693,1273756,1,8,1,1,0,38
166694,1273756,1,8,2,1,0,39
166695,1273756,1,8,3,0,0,39
166696,1273756,1,8,4,0,0,39
166697,1273756,1,8,5,1,0,40
166698,1273756,1,8,6,0,0,40
166699,1273756,1,9,1,1,0,41
166700,1273756,1,9,2,1,0,42
166701,1273756,1,9,3,1,0,43
166702,1273756,1,9,4,4,0,47
166703,1273756,1,9,5,4,0,51
166704,1273756,1,9,6,0,0,51
166705,1273756,1,10,1,1,0,52
166706,1273756,1,10,2,1,0,53
166707,1273756,1,10,3,1,0,54
166708,1273756,1,10,4,1,0,55
166709,1273756,1,10,5,1,0,56
166710,1273756,1,10,6,1,0,57
166711,1273756,1,11,1,1,0,58
166712,1273756,1,11,2,1,0,59
166713,1273756,1,11,3,2,0,61
166714,1273756,1,11,4,4,0,65
166715,1273756,1,11,5,4,0,69
166716,1273756,1,11,6,7,0,76
166717,1273756,1,12,1,0,1,76
166718,1273756,1,12,2,0,0,76
166719,1273756,1,12,3,1,0,77
166720,1273756,1,12,4,1,0,78
166721,1273756,1,12,5,2,0,80
166722,1273756,1,12,6,1,0,81
166723,1273756,1,13,1,1,0,82
166724,1273756,1,13,2,1,0,83
166725,1273756,1,13,3,6,0,89
166726,1273756,1,13,4,6,0,95
166727,1273756,1,13,5,1,0,96
166728,1273756,1,13,6,1,0,97
166729,1273756,1,14,1,0,0,97
166730,1273756,1,14,2,0,0,97
166731,1273756,1,14,3,1,0,98
166732,1273756,1,14,4,1,0,99
166733,1273756,1,14,5,1,0,100
166734,1273756,1,14,6,2,0,102
166735,1273756,1,15,1,6,0,108
166736,1273756,1,15,2,0,0,108
166737,1273756,1,15,3,1,0,109
166738,1273756,1,15,4,1,0,110
166739,1273756,1,15,5,4,0,114
166740,1273756,1,15,6,0,0,114
166741,1273756,1,16,1,4,0,118
166742,1273756,1,16,2,4,0,122
166743,1273756,1,16,3,6,0,128
166744,1273756,1,16,4,0,0,128
166745,1273756,1,16,5,4,0,132
166746,1273756,1,16,6,4,0,136
166747,1273756,1,17,1,2,0,138
166748,1273756,1,17,2,1,0,139
166749,1273756,1,17,3,1,0,140
166750,1273756,1,17,4,1,0,141
166751,1273756,1,17,5,1,0,142
166752,1273756,1,17,6,2,0,144
166753,1273756,1,18,1,0,0,144
166754,1273756,1,18,2,0,1,144
166755,1273756,1,18,3,4,0,148
166756,1273756,1,18,4,0,0,148
166757,1273756,1,18,5,0,1,148
166758,1273756,1,18,6,1,0,149
166759,1273756,1,19,1,1,0,150
166760,1273756,1,19,2,1,0,151
166761,1273756,1,19,3,6,0,157
166762,1273756,1,19,4,1,0,158
166763,1273756,1,19,5,1,0,159
166764,1273756,1,19,6,3,0,162
166765,1273756,1,20,1,4,0,166
166766,1273756,1,20,2,0,0,166
166767,1273756,1,20,3,1,0,167
166768,1273756,1,20,4,0,0,167
166769,1273756,1,20,5,3,0,170
166770,1273756,1,20,6,2,0,172
166884,1276904,1,1,1,1,0,1
166885,1276904,1,1,2,1,0,2
166886,1276904,1,1,3,0,0,2
166887,1276904,1,1,4,4,0,6
166888,1276904,1,1,5,1,0,7
166889,1276904,1,1,6,2,0,9
166890,1276904,1,2,1,1,0,10
166891,1276904,1,2,2,4,0,14
166892,1276904,1,2,3,4,0,18
166893,1276904,1,2,4,0,0,18
166894,1276904,1,2,5,0,0,18
166895,1276904,1,2,6,2,0,20
166896,1276904,1,3,1,1,0,21
166897,1276904,1,3,2,0,0,21
166898,1276904,1,3,3,4,0,25
166899,1276904,1,3,4,4,0,29
166900,1276904,1,3,5,0,1,29
166901,1276904,1,3,6,0,0,29
166902,1276904,1,4,1,0,0,29
166903,1276904,1,4,2,0,0,29
166904,1276904,1,4,3,2,0,31
166905,1276904,1,4,4,0,0,31
166906,1276904,1,4,5,2,0,33
166907,1276904,1,4,6,0,0,33
166908,1276904,1,5,1,6,0,39
166909,1276904,1,5,2,6,0,45
166910,1276904,1,5,3,0,0,45
166911,1276904,1,5,4,1,0,46
166912,1276904,1,5,5,0,1,46
166913,1276904,1,5,6,4,0,50
166914,1276904,1,6,1,0,0,50
166915,1276904,1,6,2,4,0,54
166916,1276904,1,6,3,2,0,56
166917,1276904,1,6,4,4,0,60
166918,1276904,1,6,5,2,0,62
166919,1276904,1,6,6,4,0,66
166920,1276904,1,7,1,0,0,66
166921,1276904,1,7,2,6,0,72
166922,1276904,1,7,3,0,0,72
166923,1276904,1,7,4,1,0,73
166924,1276904,1,7,5,0,0,73
166925,1276904,1,7,6,2,0,75
166926,1276904,1,8,1,4,0,79
166927,1276904,1,8,2,1,0,80
166928,1276904,1,8,3,0,0,80
166929,1276904,1,8,4,1,0,81
166930,1276904,1,8,5,4,0,85
166931,1276904,1,8,6,1,0,86
166932,1276904,1,9,1,1,0,87
166933,1276904,1,9,2,1,0,88
166934,1276904,1,9,3,1,0,89
166935,1276904,1,9,4,0,1,89
166936,1276904,1,9,5,1,0,90
166937,1276904,1,9,6,1,0,91
166938,1276904,1,10,1,1,0,92
166939,1276904,1,10,2,4,0,96
166940,1276904,1,10,3,0,0,96
166941,1276904,1,10,4,5,0,101
166942,1276904,1,10,5,2,0,103
166943,1276904,1,10,6,2,0,105
166944,1276904,1,11,1,5,0,110
166945,1276904,1,11,2,2,0,112
166946,1276904,1,11,3,1,0,113
166947,1276904,1,11,4,6,0,119
166948,1276904,1,11,5,1,0,120
166949,1276904,1,11,6,0,0,120
166950,1276904,1,12,1,4,0,124
166951,1276904,1,12,2,1,0,125
166952,1276904,1,12,3,1,0,126
166953,1276904,1,12,4,0,1,126
166954,1276904,1,12,5,0,0,126
166955,1276904,1,12,6,0,0,126
166956,1276904,1,13,1,4,0,130
166957,1276904,1,13,2,4,0,134
166958,1276904,1,13,3,1,0,135
166959,1276904,1,13,4,4,0,139
166960,1276904,1,13,5,1,0,140
166961,1276904,1,13,6,1,0,141
166962,1276904,1,14,1,1,0,142
166963,1276904,1,14,2,1,0,143
166964,1276904,1,14,3,4,0,147
166965,1276904,1,14,4,1,0,148
166966,1276904,1,14,5,1,0,149
166967,1276904,1,14,6,1,0,150
166968,1276904,1,15,1,2,0,152
166969,1276904,1,15,2,1,0,153
166970,1276904,1,15,3,1,0,154
166971,1276904,1,15,4,2,0,156
166972,1276904,1,15,5,0,0,156
166973,1276904,1,15,6,1,0,157
166974,1276904,1,16,1,0,0,157
166975,1276904,1,16,2,1,0,158
166976,1276904,1,16,3,0,0,158
166977,1276904,1,16,4,5,0,163
166978,1276904,1,16,5,1,0,164
166979,1276904,1,16,6,1,0,165
166980,1276904,1,17,1,0,0,165
166981,1276904,1,17,2,1,0,166
166982,1276904,1,17,3,5,0,171
166983,1276904,1,17,4,0,1,171
166984,1276904,1,17,5,6,0,177
166985,1276904,1,17,6,1,0,178
166986,1276904,1,18,1,0,0,178
166987,1276904,1,18,2,1,0,179
166988,1276904,1,18,3,1,0,180
166989,1276904,1,18,4,0,1,180
166990,1276904,1,18,5,1,0,181
166991,1276904,1,18,6,1,0,182
166992,1276904,1,19,1,1,0,183
166993,1276904,1,19,2,0,0,183
166994,1276904,1,19,3,0,0,183
166995,1276904,1,19,4,1,0,184
166996,1276904,1,19,5,1,0,185
166997,1276904,1,19,6,2,0,187
166998,1276904,1,20,1,4,0,191
166999,1276904,1,20,2,4,0,195
167000,1276904,1,20,3,0,1,195
167001,1276904,1,20,4,0,1,195
167002,1276904,1,20,5,1,0,196
167003,1276904,1,20,6,2,0,198
167121,1276905,1,1,1,0,0,0
167122,1276905,1,1,2,1,0,1
167123,1276905,1,1,3,1,0,2
167124,1276905,1,1,4,0,0,2
167125,1276905,1,1,5,0,0,2
167126,1276905,1,1,6,6,0,8
167127,1276905,1,2,1,2,0,10
167128,1276905,1,2,2,0,0,10
167129,1276905,1,2,3,0,0,10
167130,1276905,1,2,4,1,0,11
167131,1276905,1,2,5,4,0,15
167132,1276905,1,2,6,0,0,15
167133,1276905,1,3,1,6,0,21
167134,1276905,1,3,2,1,0,22
167135,1276905,1,3,3,4,0,26
167136,1276905,1,3,4,0,0,26
167137,1276905,1,3,5,1,0,27
167138,1276905,1,3,6,5,0,32
167139,1276905,1,4,1,1,0,33
167140,1276905,1,4,2,1,0,34
167141,1276905,1,4,3,4,0,38
167142,1276905,1,4,4,0,0,38
167143,1276905,1,4,5,4,0,42
167144,1276905,1,4,6,1,0,43
167145,1276905,1,5,1,0,0,43
167146,1276905,1,5,2,4,0,47
167147,1276905,1,5,3,0,0,47
167148,1276905,1,5,4,2,0,49
167149,1276905,1,5,5,0,1,49
167150,1276905,1,5,6,0,0,49
167151,1276905,1,6,1,6,0,55
167152,1276905,1,6,2,4,0,59
167153,1276905,1,6,3,0,0,59
167154,1276905,1,6,4,0,0,59
167155,1276905,1,6,5,1,0,60
167156,1276905,1,6,6,1,0,61
167157,1276905,1,7,1,0,1,61
167158,1276905,1,7,2,0,1,61
167159,1276905,1,7,3,0,0,61
167160,1276905,1,7,4,0,0,61
167161,1276905,1,7,5,0,0,61
167162,1276905,1,7,6,0,0,61
167163,1276905,1,8,1,0,0,61
167164,1276905,1,8,2,4,0,65
167165,1276905,1,8,3,1,0,66
167166,1276905,1,8,4,1,0,67
167167,1276905,1,8,5,1,0,68
167168,1276905,1,8,6,1,0,69
167169,1276905,1,9,1,1,0,70
167170,1276905,1,9,2,0,0,70
167171,1276905,1,9,3,0,0,70
167172,1276905,1,9,4,1,0,71
167173,1276905,1,9,5,1,0,72
167174,1276905,1,9,6,1,0,73
167175,1276905,1,10,1,4,0,77
167176,1276905,1,10,2,1,0,78
167177,1276905,1,10,3,2,0,80
167178,1276905,1,10,4,4,0,84
167179,1276905,1,10,5,1,0,85
167180,1276905,1,10,6,1,0,86
167181,1276905,1,11,1,2,0,88
167182,1276905,1,11,2,1,0,89
167183,1276905,1,11,3,0,1,89
167184,1276905,1,11,4,0,1,89
167185,1276905,1,11,5,0,0,89
167186,1276905,1,11,6,0,0,89
167187,1276905,1,12,1,1,0,90
167188,1276905,1,12,2,0,0,90
167189,1276905,1,12,3,1,0,91
167190,1276905,1,12,4,0,0,91
167191,1276905,1,12,5,0,0,91
167192,1276905,1,12,6,0,0,91
167193,1276905,1,13,1,2,0,93
167194,1276905,1,13,2,1,0,94
167195,1276905,1,13,3,2,0,96
167196,1276905,1,13,4,0,0,96
167197,1276905,1,13,5,1,0,97
167198,1276905,1,13,6,4,0,101
167199,1276905,1,14,1,1,0,102
167200,1276905,1,14,2,1,0,103
167201,1276905,1,14,3,2,0,105
167202,1276905,1,14,4,0,0,105
167203,1276905,1,14,5,1,0,106
167204,1276905,1,14,6,1,0,107
167205,1276905,1,15,1,0,0,107
167206,1276905,1,15,2,1,0,108
167207,1276905,1,15,3,4,0,112
167208,1276905,1,15,4,1,0,113
167209,1276905,1,15,5,1,0,114
167210,1276905,1,15,6,1,0,115
167211,1276905,1,16,1,7,1,122
167212,1276905,1,16,2,1,0,123
167213,1276905,1,16,3,4,0,127
167214,1276905,1,16,4,0,0,127
167215,1276905,1,16,5,1,0,128
167216,1276905,1,16,6,4,0,132
167217,1276905,1,17,1,4,0,136
167218,1276905,1,17,2,1,0,137
167219,1276905,1,17,3,2,0,139
167220,1276905,1,17,4,0,0,139
167221,1276905,1,17,5,6,0,145
167222,1276905,1,17,6,0,1,145
167223,1276905,1,18,1,1,0,146
167224,1276905,1,18,2,0,0,146
167225,1276905,1,18,3,1,0,147
167226,1276905,1,18,4,2,0,149
167227,1276905,1,18,5,2,0,151
167228,1276905,1,18,6,1,0,152
167229,1276905,1,19,1,1,0,153
167230,1276905,1,19,2,1,0,154
167231,1276905,1,19,3,0,0,154
167232,1276905,1,19,4,4,0,158
167233,1276905,1,19,5,1,0,159
167234,1276905,1,19,6,0,1,159
167235,1276905,1,20,1,2,0,161
167236,1276905,1,20,2,1,0,162
167237,1276905,1,20,3,4,0,166
167238,1276905,1,20,4,0,0,166
167239,1276905,1,20,5,2,0,168
167240,1276905,1,20,6,2,0,170
167343,1276906,1,1,1,0,0,0
167344,1276906,1,1,2,0,0,0
167345,1276906,1,1,3,0,0,0
167346,1276906,1,1,4,2,0,2
167347,1276906,1,1,5,0,0,2
167348,1276906,1,1,6,0,0,2
167349,1276906,1,2,1,4,0,6
167350,1276906,1,2,2,0,0,6
167351,1276906,1,2,3,1,0,7
167352,1276906,1,2,4,1,0,8
167353,1276906,1,2,5,6,0,14
167354,1276906,1,2,6,5,0,19
167355,1276906,1,3,1,0,0,19
167356,1276906,1,3,2,0,0,19
167357,1276906,1,3,3,0,0,19
167358,1276906,1,3,4,1,0,20
167359,1276906,1,3,5,1,0,21
167360,1276906,1,3,6,6,0,27
167361,1276906,1,4,1,3,0,30
167362,1276906,1,4,2,1,0,31
167363,1276906,1,4,3,0,0,31
167364,1276906,1,4,4,0,1,31
167365,1276906,1,4,5,0,0,31
167366,1276906,1,4,6,1,0,32
167367,1276906,1,5,1,6,0,38
167368,1276906,1,5,2,0,0,38
167369,1276906,1,5,3,4,0,42
167370,1276906,1,5,4,0,0,42
167371,1276906,1,5,5,0,0,42
167372,1276906,1,5,6,1,0,43
167373,1276906,1,6,1,1,0,44
167374,1276906,1,6,2,4,0,48
167375,1276906,1,6,3,0,0,48
167376,1276906,1,6,4,2,0,50
167377,1276906,1,6,5,1,0,51
167378,1276906,1,6,6,1,0,52
167379,1276906,1,7,1,2,0,54
167380,1276906,1,7,2,1,0,55
167381,1276906,1,7,3,4,0,59
167382,1276906,1,7,4,1,0,60
167383,1276906,1,7,5,0,0,60
167384,1276906,1,7,6,1,0,61
167385,1276906,1,8,1,0,1,61
167386,1276906,1,8,2,4,0,65
167387,1276906,1,8,3,2,0,67
167388,1276906,1,8,4,0,0,67
167389,1276906,1,8,5,4,0,71
167390,1276906,1,8,6,0,0,71
167391,1276906,1,9,1,1,0,72
167392,1276906,1,9,2,6,0,78
167393,1276906,1,9,3,0,0,78
167394,1276906,1,9,4,2,0,80
167395,1276906,1,9,5,1,0,81
167396,1276906,1,9,6,1,0,82
167397,1276906,1,10,1,1,0,83
167398,1276906,1,10,2,1,0,84
167399,1276906,1,10,3,0,1,84
167400,1276906,1,10,4,1,0,85
167401,1276906,1,10,5,1,0,86
167402,1276906,1,10,6,0,0,86
167403,1276906,1,11,1,0,0,86
167404,1276906,1,11,2,0,0,86
167405,1276906,1,11,3,2,0,88
167406,1276906,1,11,4,6,0,94
167407,1276906,1,11,5,1,0,95
167408,1276906,1,11,6,3,0,98
167409,1276906,1,12,1,4,0,102
167410,1276906,1,12,2,6,0,108
167411,1276906,1,12,3,1,0,109
167412,1276906,1,12,4,1,0,110
167413,1276906,1,12,5,0,0,110
167414,1276906,1,12,6,1,0,111
167415,1276906,1,13,1,0,0,111
167416,1276906,1,13,2,2,0,113
167417,1276906,1,13,3,4,0,117
167418,1276906,1,13,4,6,0,123
167419,1276906,1,13,5,1,0,124
167420,1276906,1,13,6,1,0,125
167421,1276906,1,14,1,6,0,131
167422,1276906,1,14,2,2,0,133
167423,1276906,1,14,3,0,0,133
167424,1276906,1,14,4,1,0,134
167425,1276906,1,14,5,2,0,136
167426,1276906,1,14,6,6,0,142
167427,1276906,1,15,1,1,0,143
167428,1276906,1,15,2,6,0,149
167429,1276906,1,15,3,1,0,150
167430,1276906,1,15,4,1,0,151
167431,1276906,1,15,5,0,0,151
167432,1276906,1,15,6,1,0,152
167433,1276906,1,16,1,2,0,154
167434,1276906,1,16,2,0,0,154
167435,1276906,1,16,3,6,0,160
167436,1276906,1,16,4,6,0,166
167437,1276906,1,16,5,1,0,167
167438,1276906,1,16,6,0,0,167
167439,1276906,1,17,1,0,0,167
167440,1276906,1,17,2,1,0,168
167441,1276906,1,17,3,0,1,168
167442,1276906,1,17,4,1,0,169
167443,1276906,1,17,5,0,1,169
167444,1276906,1,17,6,0,0,169
167445,1276906,1,18,1,4,0,173
167446,1276906,1,18,2,7,0,180
167447,1276906,1,18,3,2,0,182
167448,1276906,1,18,4,1,0,183
167449,1276906,1,18,5,6,0,189
167450,1276906,1,18,6,1,0,190
167451,1276906,1,19,1,1,0,191
167452,1276906,1,19,2,2,0,193
167453,1276906,1,19,3,4,0,197
167454,1276906,1,19,4,0,0,197
167455,1276906,1,19,5,0,1,197
167456,1276906,1,19,6,1,0,198
167457,1276906,1,20,1,3,0,201
167458,1276906,1,20,2,2,0,203
167459,1276906,1,20,3,1,0,204
167460,1276906,1,20,4,4,0,208
167461,1276906,1,20,5,6,0,214
167462,1276906,1,20,6,1,1,215
167583,1276913,1,1,1,0,0,0
167584,1276913,1,1,2,1,0,1
167585,1276913,1,1,3,4,0,5
167586,1276913,1,1,4,1,0,6
167587,1276913,1,1,5,1,0,7
167588,1276913,1,1,6,6,0,13
167589,1276913,1,2,1,1,0,14
167590,1276913,1,2,2,1,0,15
167591,1276913,1,2,3,0,0,15
167592,1276913,1,2,4,0,0,15
167593,1276913,1,2,5,0,0,15
167594,1276913,1,2,6,1,0,16
167595,1276913,1,3,1,2,0,18
167596,1276913,1,3,2,6,0,24
167597,1276913,1,3,3,4,0,28
167598,1276913,1,3,4,0,1,28
167599,1276913,1,3,5,1,0,29
167600,1276913,1,3,6,0,0,29
167601,1276913,1,4,1,1,0,30
167602,1276913,1,4,2,0,0,30
167603,1276913,1,4,3,1,0,31
167604,1276913,1,4,4,6,0,37
167605,1276913,1,4,5,1,0,38
167606,1276913,1,4,6,1,0,39
167607,1276913,1,5,1,1,0,40
167608,1276913,1,5,2,1,0,41
167609,1276913,1,5,3,0,1,41
167610,1276913,1,5,4,0,0,41
167611,1276913,1,5,5,0,0,41
167612,1276913,1,5,6,2,0,43
167613,1276913,1,6,1,1,0,44
167614,1276913,1,6,2,1,0,45
167615,1276913,1,6,3,1,0,46
167616,1276913,1,6,4,1,0,47
167617,1276913,1,6,5,1,0,48
167618,1276913,1,6,6,0,0,48
167619,1276913,1,7,1,1,0,49
167620,1276913,1,7,2,1,0,50
167621,1276913,1,7,3,1,0,51
167622,1276913,1,7,4,1,0,52
167623,1276913,1,7,5,1,0,53
167624,1276913,1,7,6,6,0,59
167625,1276913,1,8,1,6,0,65
167626,1276913,1,8,2,0,0,65
167627,1276913,1,8,3,1,0,66
167628,1276913,1,8,4,0,0,66
167629,1276913,1,8,5,6,0,72
167630,1276913,1,8,6,1,0,73
167631,1276913,1,9,1,0,0,73
167632,1276913,1,9,2,1,0,74
167633,1276913,1,9,3,1,0,75
167634,1276913,1,9,4,0,0,75
167635,1276913,1,9,5,1,0,76
167636,1276913,1,9,6,1,0,77
167637,1276913,1,10,1,6,0,83
167638,1276913,1,10,2,1,0,84
167639,1276913,1,10,3,4,0,88
167640,1276913,1,10,4,6,0,94
167641,1276913,1,10,5,1,0,95
167642,1276913,1,10,6,3,0,98
167643,1276913,1,11,1,0,0,98
167644,1276913,1,11,2,1,0,99
167645,1276913,1,11,3,1,0,100
167646,1276913,1,11,4,0,0,100
167647,1276913,1,11,5,0,0,100
167648,1276913,1,11,6,1,0,101
167649,1276913,1,12,1,0,0,101
167650,1276913,1,12,2,1,0,102
167651,1276913,1,12,3,0,0,102
167652,1276913,1,12,4,6,0,108
167653,1276913,1,12,5,4,0,112
167654,1276913,1,12,6,0,1,112
167655,1276913,1,13,1,1,0,113
167656,1276913,1,13,2,0,0,113
167657,1276913,1,13,3,1,0,114
167658,1276913,1,13,4,1,0,115
167659,1276913,1,13,5,4,0,119
167660,1276913,1,13,6,1,0,120
167661,1276913,1,14,1,1,0,121
167662,1276913,1,14,2,3,0,124
167663,1276913,1,14,3,1,0,125
167664,1276913,1,14,4,2,0,127
167665,1276913,1,14,5,6,0,133
167666,1276913,1,14,6,1,0,134
167667,1276913,1,15,1,0,0,134
167668,1276913,1,15,2,2,0,136
167669,1276913,1,15,3,6,0,142
167670,1276913,1,15,4,4,0,146
167671,1276913,1,15,5,1,0,147
167672,1276913,1,15,6,1,0,148
167673,1276913,1,16,1,1,0,149
167674,1276913,1,16,2,1,0,150
167675,1276913,1,16,3,6,0,156
167676,1276913,1,16,4,2,0,158
167677,1276913,1,16,5,1,0,159
167678,1276913,1,16,6,9,0,168
167679,1276913,1,17,1,6,0,174
167680,1276913,1,17,2,6,0,180
167681,1276913,1,17,3,3,0,183
167682,1276913,1,17,4,6,0,189
167683,1276913,1,17,5,6,0,195
167684,1276913,1,17,6,6,0,201
167685,1276913,1,18,1,4,0,205
167686,1276913,1,18,2,4,0,209
167687,1276913,1,18,3,9,0,218
167688,1276913,1,18,4,0,0,218
167689,1276913,1,18,5,0,1,218
167690,1276913,1,18,6,0,0,218
167691,1276913,1,19,1,1,0,219
167692,1276913,1,19,2,1,0,220
167693,1276913,1,19,3,6,0,226
167694,1276913,1,19,4,0,0,226
167695,1276913,1,19,5,0,0,226
167696,1276913,1,19,6,1,0,227
167697,1276913,1,20,1,1,0,228
167698,1276913,1,20,2,4,0,232
167699,1276913,1,20,3,0,1,232
167700,1276913,1,20,4,1,0,233
167701,1276913,1,20,5,0,1,233
167702,1276913,1,20,6,1,0,234
167823,1276914,1,1,1,0,0,0
167824,1276914,1,1,2,1,0,1
167825,1276914,1,1,3,1,0,2
167826,1276914,1,1,4,1,0,3
167827,1276914,1,1,5,2,0,5
167828,1276914,1,1,6,0,0,5
167829,1276914,1,2,1,1,0,6
167830,1276914,1,2,2,1,0,7
167831,1276914,1,2,3,0,0,7
167832,1276914,1,2,4,3,0,10
167833,1276914,1,2,5,5,0,15
167834,1276914,1,2,6,4,0,19
167835,1276914,1,3,1,6,0,25
167836,1276914,1,3,2,4,0,29
167837,1276914,1,3,3,1,0,30
167838,1276914,1,3,4,1,0,31
167839,1276914,1,3,5,0,0,31
167840,1276914,1,3,6,1,0,32
167841,1276914,1,4,1,4,0,36
167842,1276914,1,4,2,1,0,37
167843,1276914,1,4,3,1,0,38
167844,1276914,1,4,4,1,0,39
167845,1276914,1,4,5,0,1,39
167846,1276914,1,4,6,1,0,40
167847,1276914,1,5,1,4,0,44
167848,1276914,1,5,2,0,0,44
167849,1276914,1,5,3,0,0,44
167850,1276914,1,5,4,0,0,44
167851,1276914,1,5,5,0,0,44
167852,1276914,1,5,6,1,0,45
167853,1276914,1,6,1,1,0,46
167854,1276914,1,6,2,1,0,47
167855,1276914,1,6,3,0,0,47
167856,1276914,1,6,4,0,0,47
167857,1276914,1,6,5,7,0,54
167858,1276914,1,6,6,4,0,58
167859,1276914,1,7,1,1,0,59
167860,1276914,1,7,2,0,0,59
167861,1276914,1,7,3,1,0,60
167862,1276914,1,7,4,1,0,61
167863,1276914,1,7,5,1,0,62
167864,1276914,1,7,6,3,0,65
167865,1276914,1,8,1,1,0,66
167866,1276914,1,8,2,0,0,66
167867,1276914,1,8,3,1,0,67
167868,1276914,1,8,4,6,0,73
167869,1276914,1,8,5,0,0,73
167870,1276914,1,8,6,1,0,74
167871,1276914,1,9,1,4,0,78
167872,1276914,1,9,2,1,0,79
167873,1276914,1,9,3,1,0,80
167874,1276914,1,9,4,1,0,81
167875,1276914,1,9,5,6,0,87
167876,1276914,1,9,6,0,0,87
167877,1276914,1,10,1,1,0,88
167878,1276914,1,10,2,1,0,89
167879,1276914,1,10,3,1,0,90
167880,1276914,1,10,4,4,0,94
167881,1276914,1,10,5,6,0,100
167882,1276914,1,10,6,0,0,100
167883,1276914,1,11,1,2,0,102
167884,1276914,1,11,2,2,0,104
167885,1276914,1,11,3,1,0,105
167886,1276914,1,11,4,1,0,106
167887,1276914,1,11,5,2,0,108
167888,1276914,1,11,6,1,0,109
167889,1276914,1,12,1,1,0,110
167890,1276914,1,12,2,2,0,112
167891,1276914,1,12,3,0,1,112
167892,1276914,1,12,4,1,0,113
167893,1276914,1,12,5,5,0,118
167894,1276914,1,12,6,0,0,118
167895,1276914,1,13,1,4,0,122
167896,1276914,1,13,2,4,0,126
167897,1276914,1,13,3,1,0,127
167898,1276914,1,13,4,6,0,133
167899,1276914,1,13,5,2,0,135
167900,1276914,1,13,6,1,0,136
167901,1276914,1,14,1,1,0,137
167902,1276914,1,14,2,0,0,137
167903,1276914,1,14,3,1,0,138
167904,1276914,1,14,4,2,0,140
167905,1276914,1,14,5,2,0,142
167906,1276914,1,14,6,1,0,143
167907,1276914,1,15,1,0,1,143
167908,1276914,1,15,2,2,0,145
167909,1276914,1,15,3,4,0,149
167910,1276914,1,15,4,4,0,153
167911,1276914,1,15,5,0,0,153
167912,1276914,1,15,6,1,0,154
167913,1276914,1,16,1,1,0,155
167914,1276914,1,16,2,1,0,156
167915,1276914,1,16,3,6,0,162
167916,1276914,1,16,4,4,0,166
167917,1276914,1,16,5,0,0,166
167918,1276914,1,16,6,4,0,170
167919,1276914,1,17,1,1,0,171
167920,1276914,1,17,2,1,0,172
167921,1276914,1,17,3,0,0,172
167922,1276914,1,17,4,2,0,174
167923,1276914,1,17,5,1,0,175
167924,1276914,1,17,6,1,0,176
167925,1276914,1,18,1,2,0,178
167926,1276914,1,18,2,6,0,184
167927,1276914,1,18,3,4,0,188
167928,1276914,1,18,4,0,0,188
167929,1276914,1,18,5,1,0,189
167930,1276914,1,18,6,2,0,191
167931,1276914,1,19,1,1,0,192
167932,1276914,1,19,2,6,0,198
167933,1276914,1,19,3,1,0,199
167934,1276914,1,19,4,1,0,200
167935,1276914,1,19,5,1,0,201
167936,1276914,1,19,6,2,0,203
167937,1276914,1,20,1,1,0,204
167938,1276914,1,20,2,0,0,204
167939,1276914,1,20,3,0,0,204
167940,1276914,1,20,4,1,0,205
167941,1276914,1,20,5,2,0,207
167942,1276914,1,20,6,0,0,207
168043,1276915,1,1,1,0,0,0
168044,1276915,1,1,2,0,0,0
168045,1276915,1,1,3,0,1,0
168046,1276915,1,1,4,0,0,0
168047,1276915,1,1,5,0,0,0
168048,1276915,1,1,6,0,0,0
168049,1276915,1,2,1,0,0,0
168050,1276915,1,2,2,4,0,4
168051,1276915,1,2,3,0,0,4
168052,1276915,1,2,4,0,0,4
168053,1276915,1,2,5,1,0,5
168054,1276915,1,2,6,4,0,9
168055,1276915,1,3,1,0,0,9
168056,1276915,1,3,2,0,0,9
168057,1276915,1,3,3,1,0,10
168058,1276915,1,3,4,3,0,13
168059,1276915,1,3,5,4,0,17
168060,1276915,1,3,6,0,0,17
168061,1276915,1,4,1,0,0,17
168062,1276915,1,4,2,1,0,18
168063,1276915,1,4,3,1,0,19
168064,1276915,1,4,4,4,0,23
168065,1276915,1,4,5,1,0,24
168066,1276915,1,4,6,4,0,28
168067,1276915,1,5,1,0,0,28
168068,1276915,1,5,2,1,0,29
168069,1276915,1,5,3,1,0,30
168070,1276915,1,5,4,1,0,31
168071,1276915,1,5,5,4,0,35
168072,1276915,1,5,6,1,0,36
168073,1276915,1,6,1,1,0,37
168074,1276915,1,6,2,4,0,41
168075,1276915,1,6,3,4,0,45
168076,1276915,1,6,4,0,0,45
168077,1276915,1,6,5,4,0,49
168078,1276915,1,6,6,4,0,53
168079,1276915,1,7,1,1,0,54
168080,1276915,1,7,2,1,1,55
168081,1276915,1,7,3,1,0,56
168082,1276915,1,7,4,0,0,56
168083,1276915,1,7,5,1,0,57
168084,1276915,1,7,6,0,0,57
168085,1276915,1,8,1,2,0,59
168086,1276915,1,8,2,2,0,61
168087,1276915,1,8,3,1,0,62
168088,1276915,1,8,4,1,0,63
168089,1276915,1,8,5,0,0,63
168090,1276915,1,8,6,1,0,64
168091,1276915,1,9,1,2,0,66
168092,1276915,1,9,2,1,0,67
168093,1276915,1,9,3,1,0,68
168094,1276915,1,9,4,0,0,68
168095,1276915,1,9,5,2,0,70
168096,1276915,1,9,6,2,0,72
168097,1276915,1,10,1,1,0,73
168098,1276915,1,10,2,1,0,74
168099,1276915,1,10,3,1,0,75
168100,1276915,1,10,4,2,0,77
168101,1276915,1,10,5,2,0,79
168102,1276915,1,10,6,1,0,80
168103,1276915,1,11,1,1,0,81
168104,1276915,1,11,2,1,0,82
168105,1276915,1,11,3,1,0,83
168106,1276915,1,11,4,1,0,84
168107,1276915,1,11,5,1,0,85
168108,1276915,1,11,6,2,0,87
168109,1276915,1,12,1,1,0,88
168110,1276915,1,12,2,1,0,89
168111,1276915,1,12,3,1,0,90
168112,1276915,1,12,4,1,0,91
168113,1276915,1,12,5,1,0,92
168114,1276915,1,12,6,1,0,93
168115,1276915,1,13,1,2,0,95
168116,1276915,1,13,2,4,0,99
168117,1276915,1,13,3,1,0,100
168118,1276915,1,13,4,1,0,101
168119,1276915,1,13,5,2,0,103
168120,1276915,1,13,6,1,0,104
168121,1276915,1,14,1,4,0,108
168122,1276915,1,14,2,1,0,109
168123,1276915,1,14,3,1,0,110
168124,1276915,1,14,4,1,0,111
168125,1276915,1,14,5,4,0,115
168126,1276915,1,14,6,1,0,116
168127,1276915,1,15,1,1,0,117
168128,1276915,1,15,2,2,0,119
168129,1276915,1,15,3,2,0,121
168130,1276915,1,15,4,4,0,125
168131,1276915,1,15,5,1,0,126
168132,1276915,1,15,6,1,0,127
168133,1276915,1,16,1,0,0,127
168134,1276915,1,16,2,1,0,128
168135,1276915,1,16,3,4,0,132
168136,1276915,1,16,4,5,0,137
168137,1276915,1,16,5,0,0,137
168138,1276915,1,16,6,4,0,141
168139,1276915,1,17,1,0,0,141
168140,1276915,1,17,2,1,0,142
168141,1276915,1,17,3,0,1,142
168142,1276915,1,17,4,1,0,143
168143,1276915,1,17,5,4,0,147
168144,1276915,1,17,6,4,0,151
168145,1276915,1,18,1,4,0,155
168146,1276915,1,18,2,4,0,159
168147,1276915,1,18,3,1,0,160
168148,1276915,1,18,4,4,0,164
168149,1276915,1,18,5,1,0,165
168150,1276915,1,18,6,1,0,166
168151,1276915,1,19,1,1,0,167
168152,1276915,1,19,2,0,0,167
168153,1276915,1,19,3,6,0,173
168154,1276915,1,19,4,2,0,175
168155,1276915,1,19,5,4,0,179
168156,1276915,1,19,6,2,0,181
168157,1276915,1,20,1,2,0,183
168158,1276915,1,20,2,0,1,183
168159,1276915,1,20,3,4,0,187
168160,1276915,1,20,4,4,0,191
168161,1276915,1,20,5,0,0,191
168162,1276915,1,20,6,0,1,191
168263,1277974,1,1,1,0,0,0
168264,1277974,1,1,2,1,0,1
168265,1277974,1,1,3,0,0,1
168266,1277974,1,1,4,0,0,1
168267,1277974,1,1,5,0,0,1
168268,1277974,1,1,6,1,0,2
168269,1277974,1,2,1,1,1,3
168270,1277974,1,2,2,0,0,3
168271,1277974,1,2,3,1,0,4
168272,1277974,1,2,4,0,0,4
168273,1277974,1,2,5,2,0,6
168274,1277974,1,2,6,1,0,7
168275,1277974,1,3,1,0,0,7
168276,1277974,1,3,2,0,0,7
168277,1277974,1,3,3,2,0,9
168278,1277974,1,3,4,1,0,10
168279,1277974,1,3,5,0,0,10
168280,1277974,1,3,6,0,1,10
168281,1277974,1,4,1,1,0,11
168282,1277974,1,4,2,1,0,12
168283,1277974,1,4,3,0,0,12
168284,1277974,1,4,4,0,0,12
168285,1277974,1,4,5,0,0,12
168286,1277974,1,4,6,0,0,12
168287,1277974,1,5,1,1,0,13
168288,1277974,1,5,2,1,0,14
168289,1277974,1,5,3,1,0,15
168290,1277974,1,5,4,0,1,15
168291,1277974,1,5,5,0,0,15
168292,1277974,1,5,6,1,0,16
168293,1277974,1,6,1,5,0,21
168294,1277974,1,6,2,0,0,21
168295,1277974,1,6,3,2,0,23
168296,1277974,1,6,4,0,0,23
168297,1277974,1,6,5,1,0,24
168298,1277974,1,6,6,1,0,25
168299,1277974,1,7,1,0,0,25
168300,1277974,1,7,2,4,0,29
168301,1277974,1,7,3,0,0,29
168302,1277974,1,7,4,1,0,30
168303,1277974,1,7,5,2,0,32
168304,1277974,1,7,6,1,0,33
168305,1277974,1,8,1,0,0,33
168306,1277974,1,8,2,0,0,33
168307,1277974,1,8,3,1,0,34
168308,1277974,1,8,4,1,0,35
168309,1277974,1,8,5,1,0,36
168310,1277974,1,8,6,1,0,37
168311,1277974,1,9,1,0,0,37
168312,1277974,1,9,2,1,0,38
168313,1277974,1,9,3,1,0,39
168314,1277974,1,9,4,1,0,40
168315,1277974,1,9,5,0,0,40
168316,1277974,1,9,6,0,1,40
168317,1277974,1,10,1,0,0,40
168318,1277974,1,10,2,0,0,40
168319,1277974,1,10,3,0,0,40
168320,1277974,1,10,4,0,0,40
168321,1277974,1,10,5,0,0,40
168322,1277974,1,10,6,0,0,40
168323,1277974,1,11,1,1,0,41
168324,1277974,1,11,2,6,0,47
168325,1277974,1,11,3,6,0,53
168326,1277974,1,11,4,0,0,53
168327,1277974,1,11,5,2,0,55
168328,1277974,1,11,6,0,0,55
168329,1277974,1,12,1,1,0,56
168330,1277974,1,12,2,1,0,57
168331,1277974,1,12,3,1,0,58
168332,1277974,1,12,4,1,0,59
168333,1277974,1,12,5,0,0,59
168334,1277974,1,12,6,0,0,59
168335,1277974,1,13,1,1,0,60
168336,1277974,1,13,2,0,0,60
168337,1277974,1,13,3,1,0,61
168338,1277974,1,13,4,0,0,61
168339,1277974,1,13,5,0,1,61
168340,1277974,1,13,6,1,0,62
168341,1277974,1,14,1,1,0,63
168342,1277974,1,14,2,0,0,63
168343,1277974,1,14,3,2,0,65
168344,1277974,1,14,4,1,0,66
168345,1277974,1,14,5,1,0,67
168346,1277974,1,14,6,0,0,67
168347,1277974,1,15,1,1,0,68
168348,1277974,1,15,2,1,0,69
168349,1277974,1,15,3,6,0,75
168350,1277974,1,15,4,1,0,76
168351,1277974,1,15,5,0,0,76
168352,1277974,1,15,6,4,0,80
168353,1277974,1,16,1,1,0,81
168354,1277974,1,16,2,1,0,82
168355,1277974,1,16,3,1,0,83
168356,1277974,1,16,4,2,0,85
168357,1277974,1,16,5,6,0,91
168358,1277974,1,16,6,1,0,92
168359,1277974,1,17,1,1,0,93
168360,1277974,1,17,2,1,0,94
168361,1277974,1,17,3,0,0,94
168362,1277974,1,17,4,2,0,96
168363,1277974,1,17,5,0,1,96
168364,1277974,1,17,6,0,0,96
168365,1277974,1,18,1,1,0,97
168366,1277974,1,18,2,0,0,97
168367,1277974,1,18,3,1,0,98
168368,1277974,1,18,4,1,0,99
168369,1277974,1,18,5,1,0,100
168370,1277974,1,18,6,1,0,101
168371,1277974,1,19,1,6,0,107
168372,1277974,1,19,2,2,0,109
168373,1277974,1,19,3,1,0,110
168374,1277974,1,19,4,0,1,110
168375,1277974,1,19,5,2,0,112
168376,1277974,1,19,6,0,0,112
168377,1277974,1,20,1,6,0,118
168378,1277974,1,20,2,0,0,118
168379,1277974,1,20,3,0,0,118
168380,1277974,1,20,4,2,0,120
168381,1277974,1,20,5,1,0,121
168382,1277974,1,20,6,6,0,127
168499,1277975,1,1,1,0,0,0
168500,1277975,1,1,2,0,0,0
168501,1277975,1,1,3,0,0,0
168502,1277975,1,1,4,1,0,1
168503,1277975,1,1,5,0,1,1
168504,1277975,1,1,6,1,0,2
168505,1277975,1,2,1,1,0,3
168506,1277975,1,2,2,1,0,4
168507,1277975,1,2,3,1,0,5
168508,1277975,1,2,4,0,0,5
168509,1277975,1,2,5,0,0,5
168510,1277975,1,2,6,0,1,5
168511,1277975,1,3,1,1,0,6
168512,1277975,1,3,2,6,0,12
168513,1277975,1,3,3,0,0,12
168514,1277975,1,3,4,4,0,16
168515,1277975,1,3,5,0,0,16
168516,1277975,1,3,6,1,0,17
168517,1277975,1,4,1,0,0,17
168518,1277975,1,4,2,1,0,18
168519,1277975,1,4,3,1,0,19
168520,1277975,1,4,4,0,0,19
168521,1277975,1,4,5,4,0,23
168522,1277975,1,4,6,0,0,23
168523,1277975,1,5,1,0,0,23
168524,1277975,1,5,2,0,0,23
168525,1277975,1,5,3,4,0,27
168526,1277975,1,5,4,2,0,29
168527,1277975,1,5,5,1,0,30
168528,1277975,1,5,6,0,0,30
168529,1277975,1,6,1,0,0,30
168530,1277975,1,6,2,0,0,30
168531,1277975,1,6,3,1,0,31
168532,1277975,1,6,4,0,0,31
168533,1277975,1,6,5,1,0,32
168534,1277975,1,6,6,4,0,36
168535,1277975,1,7,1,1,0,37
168536,1277975,1,7,2,1,0,38
168537,1277975,1,7,3,1,0,39
168538,1277975,1,7,4,2,0,41
168539,1277975,1,7,5,0,0,41
168540,1277975,1,7,6,1,0,42
168541,1277975,1,8,1,2,0,44
168542,1277975,1,8,2,1,0,45
168543,1277975,1,8,3,0,0,45
168544,1277975,1,8,4,1,0,46
168545,1277975,1,8,5,1,0,47
168546,1277975,1,8,6,4,0,51
168547,1277975,1,9,1,0,1,51
168548,1277975,1,9,2,0,0,51
168549,1277975,1,9,3,0,0,51
168550,1277975,1,9,4,1,0,52
168551,1277975,1,9,5,4,0,56
168552,1277975,1,9,6,1,0,57
168553,1277975,1,10,1,0,0,57
168554,1277975,1,10,2,4,0,61
168555,1277975,1,10,3,1,0,62
168556,1277975,1,10,4,1,0,63
168557,1277975,1,10,5,1,0,64
168558,1277975,1,10,6,0,0,64
168559,1277975,1,11,1,1,0,65
168560,1277975,1,11,2,2,0,67
168561,1277975,1,11,3,2,0,69
168562,1277975,1,11,4,1,0,70
168563,1277975,1,11,5,0,0,70
168564,1277975,1,11,6,2,0,72
168565,1277975,1,12,1,0,0,72
168566,1277975,1,12,2,0,0,72
168567,1277975,1,12,3,4,0,76
168568,1277975,1,12,4,1,0,77
168569,1277975,1,12,5,0,0,77
168570,1277975,1,12,6,1,0,78
168571,1277975,1,13,1,1,0,79
168572,1277975,1,13,2,0,0,79
168573,1277975,1,13,3,0,0,79
168574,1277975,1,13,4,0,1,79
168575,1277975,1,13,5,1,0,80
168576,1277975,1,13,6,1,0,81
168577,1277975,1,14,1,0,0,81
168578,1277975,1,14,2,1,1,82
168579,1277975,1,14,3,1,0,83
168580,1277975,1,14,4,0,0,83
168581,1277975,1,14,5,0,0,83
168582,1277975,1,14,6,0,0,83
168583,1277975,1,15,1,0,0,83
168584,1277975,1,15,2,0,0,83
168585,1277975,1,15,3,1,0,84
168586,1277975,1,15,4,1,0,85
168587,1277975,1,15,5,0,0,85
168588,1277975,1,15,6,0,0,85
168589,1277975,1,16,1,1,0,86
168590,1277975,1,16,2,2,0,88
168591,1277975,1,16,3,0,1,88
168592,1277975,1,16,4,0,0,88
168593,1277975,1,16,5,0,0,88
168594,1277975,1,16,6,1,0,89
168595,1277975,1,17,1,0,0,89
168596,1277975,1,17,2,0,0,89
168597,1277975,1,17,3,0,0,89
168598,1277975,1,17,4,0,0,89
168599,1277975,1,17,5,1,0,90
168600,1277975,1,17,6,1,0,91
168601,1277975,1,18,1,1,0,92
168602,1277975,1,18,2,1,0,93
168603,1277975,1,18,3,1,0,94
168604,1277975,1,18,4,1,0,95
168605,1277975,1,18,5,4,0,99
168606,1277975,1,18,6,1,0,100
168607,1277975,1,19,1,1,0,101
168608,1277975,1,19,2,1,0,102
168609,1277975,1,19,3,0,1,102
168610,1277975,1,19,4,1,0,103
168611,1277975,1,19,5,1,0,104
168612,1277975,1,19,6,0,0,104
168613,1277975,1,20,1,0,0,104
168614,1277975,1,20,2,1,0,105
168615,1277975,1,20,3,1,0,106
168616,1277975,1,20,4,0,0,106
168617,1277975,1,20,5,1,0,107
168618,1277975,1,20,6,1,0,108
168728,1277976,1,1,1,1,0,1
168729,1277976,1,1,2,0,0,1
168730,1277976,1,1,3,1,0,2
168731,1277976,1,1,4,0,0,2
168732,1277976,1,1,5,0,0,2
168733,1277976,1,1,6,0,0,2
168734,1277976,1,2,1,4,0,6
168735,1277976,1,2,2,1,0,7
168736,1277976,1,2,3,0,1,7
168737,1277976,1,2,4,4,0,11
168738,1277976,1,2,5,0,0,11
168739,1277976,1,2,6,0,0,11
168740,1277976,1,3,1,1,0,12
168741,1277976,1,3,2,0,0,12
168742,1277976,1,3,3,0,0,12
168743,1277976,1,3,4,1,0,13
168744,1277976,1,3,5,1,0,14
168745,1277976,1,3,6,0,0,14
168746,1277976,1,4,1,1,0,15
168747,1277976,1,4,2,0,0,15
168748,1277976,1,4,3,0,0,15
168749,1277976,1,4,4,0,0,15
168750,1277976,1,4,5,4,0,19
168751,1277976,1,4,6,4,0,23
168752,1277976,1,5,1,0,0,23
168753,1277976,1,5,2,1,0,24
168754,1277976,1,5,3,0,0,24
168755,1277976,1,5,4,1,0,25
168756,1277976,1,5,5,0,0,25
168757,1277976,1,5,6,0,0,25
168758,1277976,1,6,1,4,0,29
168759,1277976,1,6,2,0,0,29
168760,1277976,1,6,3,1,0,30
168761,1277976,1,6,4,1,0,31
168762,1277976,1,6,5,1,0,32
168763,1277976,1,6,6,1,0,33
168764,1277976,1,7,1,1,0,34
168765,1277976,1,7,2,1,0,35
168766,1277976,1,7,3,0,0,35
168767,1277976,1,7,4,1,0,36
168768,1277976,1,7,5,0,0,36
168769,1277976,1,7,6,1,0,37
168770,1277976,1,8,1,0,0,37
168771,1277976,1,8,2,0,1,37
168772,1277976,1,8,3,0,0,37
168773,1277976,1,8,4,0,0,37
168774,1277976,1,8,5,0,0,37
168775,1277976,1,8,6,2,0,39
168776,1277976,1,9,1,1,0,40
168777,1277976,1,9,2,0,0,40
168778,1277976,1,9,3,1,0,41
168779,1277976,1,9,4,0,0,41
168780,1277976,1,9,5,1,0,42
168781,1277976,1,9,6,0,0,42
168782,1277976,1,10,1,0,0,42
168783,1277976,1,10,2,0,0,42
168784,1277976,1,10,3,6,0,48
168785,1277976,1,10,4,0,0,48
168786,1277976,1,10,5,4,0,52
168787,1277976,1,10,6,0,0,52
168788,1277976,1,11,1,0,0,52
168789,1277976,1,11,2,0,0,52
168790,1277976,1,11,3,1,0,53
168791,1277976,1,11,4,1,0,54
168792,1277976,1,11,5,1,0,55
168793,1277976,1,11,6,0,0,55
168794,1277976,1,12,1,6,0,61
168795,1277976,1,12,2,1,0,62
168796,1277976,1,12,3,1,0,63
168797,1277976,1,12,4,0,0,63
168798,1277976,1,12,5,0,0,63
168799,1277976,1,12,6,6,0,69
168800,1277976,1,13,1,2,0,71
168801,1277976,1,13,2,0,0,71
168802,1277976,1,13,3,1,0,72
168803,1277976,1,13,4,1,0,73
168804,1277976,1,13,5,1,0,74
168805,1277976,1,13,6,0,0,74
168806,1277976,1,14,1,4,0,78
168807,1277976,1,14,2,0,0,78
168808,1277976,1,14,3,0,0,78
168809,1277976,1,14,4,0,0,78
168810,1277976,1,14,5,1,0,79
168811,1277976,1,14,6,1,0,80
168812,1277976,1,15,1,0,0,80
168813,1277976,1,15,2,0,1,80
168814,1277976,1,15,3,2,0,82
168815,1277976,1,15,4,6,0,88
168816,1277976,1,15,5,1,0,89
168817,1277976,1,15,6,0,0,89
168818,1277976,1,16,1,1,0,90
168819,1277976,1,16,2,1,0,91
168820,1277976,1,16,3,1,0,92
168821,1277976,1,16,4,1,0,93
168822,1277976,1,16,5,1,0,94
168823,1277976,1,16,6,1,0,95
168824,1277976,1,17,1,1,0,96
168825,1277976,1,17,2,2,0,98
168826,1277976,1,17,3,1,0,99
168827,1277976,1,17,4,1,0,100
168828,1277976,1,17,5,0,0,100
168829,1277976,1,17,6,0,0,100
168830,1277976,1,18,1,2,0,102
168831,1277976,1,18,2,0,0,102
168832,1277976,1,18,3,1,0,103
168833,1277976,1,18,4,2,0,105
168834,1277976,1,18,5,4,0,109
168835,1277976,1,18,6,1,0,110
168836,1277976,1,19,1,0,0,110
168837,1277976,1,19,2,1,0,111
168838,1277976,1,19,3,0,1,111
168839,1277976,1,19,4,1,0,112
168840,1277976,1,19,5,4,0,116
168841,1277976,1,19,6,0,1,116
168842,1277976,1,20,1,0,1,116
168843,1277976,1,20,2,2,0,118
168844,1277976,1,20,3,1,0,119
168845,1277976,1,20,4,0,0,119
168846,1277976,1,20,5,4,0,123
168847,1277976,1,20,6,1,1,124
168968,1278671,1,1,1,0,0,0
168969,1278671,1,1,2,1,0,1
168970,1278671,1,1,3,0,1,1
168971,1278671,1,1,4,0,0,1
168972,1278671,1,1,5,0,0,1
168973,1278671,1,1,6,1,0,2
168974,1278671,1,2,1,0,0,2
168975,1278671,1,2,2,2,0,4
168976,1278671,1,2,3,0,0,4
168977,1278671,1,2,4,4,0,8
168978,1278671,1,2,5,2,0,10
168979,1278671,1,2,6,1,0,11
168980,1278671,1,3,1,0,0,11
168981,1278671,1,3,2,0,0,11
168982,1278671,1,3,3,4,0,15
168983,1278671,1,3,4,0,0,15
168984,1278671,1,3,5,0,0,15
168985,1278671,1,3,6,0,0,15
168986,1278671,1,4,1,1,0,16
168987,1278671,1,4,2,0,0,16
168988,1278671,1,4,3,0,0,16
168989,1278671,1,4,4,2,0,18
168990,1278671,1,4,5,1,0,19
168991,1278671,1,4,6,1,0,20
168992,1278671,1,5,1,2,0,22
168993,1278671,1,5,2,0,0,22
168994,1278671,1,5,3,2,0,24
168995,1278671,1,5,4,1,0,25
168996,1278671,1,5,5,0,0,25
168997,1278671,1,5,6,1,0,26
168998,1278671,1,6,1,4,0,30
168999,1278671,1,6,2,1,0,31
169000,1278671,1,6,3,0,0,31
169001,1278671,1,6,4,4,0,35
169002,1278671,1,6,5,0,0,35
169003,1278671,1,6,6,6,0,41
169004,1278671,1,7,1,1,0,42
169005,1278671,1,7,2,1,0,43
169006,1278671,1,7,3,1,0,44
169007,1278671,1,7,4,0,0,44
169008,1278671,1,7,5,0,0,44
169009,1278671,1,7,6,4,0,48
169010,1278671,1,8,1,1,0,49
169011,1278671,1,8,2,1,0,50
169012,1278671,1,8,3,1,0,51
169013,1278671,1,8,4,2,0,53
169014,1278671,1,8,5,1,0,54
169015,1278671,1,8,6,1,0,55
169016,1278671,1,9,1,1,0,56
169017,1278671,1,9,2,1,0,57
169018,1278671,1,9,3,2,0,59
169019,1278671,1,9,4,1,0,60
169020,1278671,1,9,5,1,0,61
169021,1278671,1,9,6,1,0,62
169022,1278671,1,10,1,1,0,63
169023,1278671,1,10,2,0,0,63
169024,1278671,1,10,3,1,0,64
169025,1278671,1,10,4,1,0,65
169026,1278671,1,10,5,0,0,65
169027,1278671,1,10,6,0,0,65
169028,1278671,1,11,1,2,0,67
169029,1278671,1,11,2,1,0,68
169030,1278671,1,11,3,1,0,69
169031,1278671,1,11,4,2,0,71
169032,1278671,1,11,5,6,0,77
169033,1278671,1,11,6,4,0,81
169034,1278671,1,12,1,1,0,82
169035,1278671,1,12,2,1,0,83
169036,1278671,1,12,3,1,0,84
169037,1278671,1,12,4,2,0,86
169038,1278671,1,12,5,6,0,92
169039,1278671,1,12,6,4,0,96
169040,1278671,1,13,1,0,0,96
169041,1278671,1,13,2,1,0,97
169042,1278671,1,13,3,2,0,99
169043,1278671,1,13,4,1,0,100
169044,1278671,1,13,5,2,0,102
169045,1278671,1,13,6,4,0,106
169046,1278671,1,14,1,4,0,110
169047,1278671,1,14,2,0,1,110
169048,1278671,1,14,3,0,0,110
169049,1278671,1,14,4,0,0,110
169050,1278671,1,14,5,0,1,110
169051,1278671,1,14,6,0,0,110
169052,1278671,1,15,1,2,0,112
169053,1278671,1,15,2,6,0,118
169054,1278671,1,15,3,2,0,120
169055,1278671,1,15,4,1,0,121
169056,1278671,1,15,5,1,0,122
169057,1278671,1,15,6,1,0,123
169058,1278671,1,16,1,0,0,123
169059,1278671,1,16,2,1,0,124
169060,1278671,1,16,3,1,0,125
169061,1278671,1,16,4,1,0,126
169062,1278671,1,16,5,0,0,126
169063,1278671,1,16,6,4,0,130
169064,1278671,1,17,1,2,0,132
169065,1278671,1,17,2,1,0,133
169066,1278671,1,17,3,6,0,139
169067,1278671,1,17,4,1,0,140
169068,1278671,1,17,5,0,0,140
169069,1278671,1,17,6,4,0,144
169070,1278671,1,18,1,6,0,150
169071,1278671,1,18,2,0,1,150
169072,1278671,1,18,3,1,0,151
169073,1278671,1,18,4,0,0,151
169074,1278671,1,18,5,1,0,152
169075,1278671,1,18,6,0,0,152
169076,1278671,1,19,1,1,0,153
169077,1278671,1,19,2,0,1,153
169078,1278671,1,19,3,1,0,154
169079,1278671,1,19,4,0,0,154
169080,1278671,1,19,5,2,0,156
169081,1278671,1,19,6,1,0,157
169082,1278671,1,20,1,1,0,158
169083,1278671,1,20,2,4,0,162
169084,1278671,1,20,3,0,0,162
169085,1278671,1,20,4,0,0,162
169086,1278671,1,20,5,0,1,162
169087,1278671,1,20,6,2,0,164
169206,1278672,1,1,1,4,0,4
169207,1278672,1,1,2,4,0,8
169208,1278672,1,1,3,0,0,8
169209,1278672,1,1,4,2,0,10
169210,1278672,1,1,5,0,0,10
169211,1278672,1,1,6,4,0,14
169212,1278672,1,2,1,1,0,15
169213,1278672,1,2,2,1,0,16
169214,1278672,1,2,3,4,0,20
169215,1278672,1,2,4,4,0,24
169216,1278672,1,2,5,0,0,24
169217,1278672,1,2,6,0,0,24
169218,1278672,1,3,1,1,0,25
169219,1278672,1,3,2,1,0,26
169220,1278672,1,3,3,0,0,26
169221,1278672,1,3,4,2,0,28
169222,1278672,1,3,5,1,0,29
169223,1278672,1,3,6,0,0,29
169224,1278672,1,4,1,6,0,35
169225,1278672,1,4,2,1,0,36
169226,1278672,1,4,3,0,0,36
169227,1278672,1,4,4,4,0,40
169228,1278672,1,4,5,0,0,40
169229,1278672,1,4,6,2,0,42
169230,1278672,1,5,1,6,0,48
169231,1278672,1,5,2,0,1,48
169232,1278672,1,5,3,2,0,50
169233,1278672,1,5,4,1,0,51
169234,1278672,1,5,5,4,0,55
169235,1278672,1,5,6,1,0,56
169236,1278672,1,6,1,0,0,56
169237,1278672,1,6,2,1,0,57
169238,1278672,1,6,3,1,0,58
169239,1278672,1,6,4,1,0,59
169240,1278672,1,6,5,1,0,60
169241,1278672,1,6,6,4,0,64
169242,1278672,1,7,1,1,0,65
169243,1278672,1,7,2,1,0,66
169244,1278672,1,7,3,0,0,66
169245,1278672,1,7,4,1,0,67
169246,1278672,1,7,5,0,0,67
169247,1278672,1,7,6,2,0,69
169248,1278672,1,8,1,1,0,70
169249,1278672,1,8,2,0,0,70
169250,1278672,1,8,3,1,0,71
169251,1278672,1,8,4,1,0,72
169252,1278672,1,8,5,0,0,72
169253,1278672,1,8,6,1,0,73
169254,1278672,1,9,1,1,0,74
169255,1278672,1,9,2,1,0,75
169256,1278672,1,9,3,0,0,75
169257,1278672,1,9,4,4,0,79
169258,1278672,1,9,5,0,1,79
169259,1278672,1,9,6,1,0,80
169260,1278672,1,10,1,1,0,81
169261,1278672,1,10,2,0,0,81
169262,1278672,1,10,3,1,0,82
169263,1278672,1,10,4,1,0,83
169264,1278672,1,10,5,1,0,84
169265,1278672,1,10,6,0,0,84
169266,1278672,1,11,1,2,0,86
169267,1278672,1,11,2,2,0,88
169268,1278672,1,11,3,0,0,88
169269,1278672,1,11,4,0,0,88
169270,1278672,1,11,5,1,0,89
169271,1278672,1,11,6,1,0,90
169272,1278672,1,12,1,0,0,90
169273,1278672,1,12,2,0,1,90
169274,1278672,1,12,3,0,0,90
169275,1278672,1,12,4,4,0,94
169276,1278672,1,12,5,0,0,94
169277,1278672,1,12,6,0,0,94
169278,1278672,1,13,1,1,0,95
169279,1278672,1,13,2,0,0,95
169280,1278672,1,13,3,1,0,96
169281,1278672,1,13,4,1,0,97
169282,1278672,1,13,5,1,0,98
169283,1278672,1,13,6,4,0,102
169284,1278672,1,14,1,1,0,103
169285,1278672,1,14,2,6,0,109
169286,1278672,1,14,3,1,0,110
169287,1278672,1,14,4,2,0,112
169288,1278672,1,14,5,2,0,114
169289,1278672,1,14,6,0,0,114
169290,1278672,1,15,1,1,0,115
169291,1278672,1,15,2,1,0,116
169292,1278672,1,15,3,7,0,123
169293,1278672,1,15,4,1,0,124
169294,1278672,1,15,5,0,0,124
169295,1278672,1,15,6,1,0,125
169296,1278672,1,16,1,0,1,125
169297,1278672,1,16,2,0,0,125
169298,1278672,1,16,3,0,0,125
169299,1278672,1,16,4,1,0,126
169300,1278672,1,16,5,1,0,127
169301,1278672,1,16,6,1,0,128
169302,1278672,1,17,1,6,0,134
169303,1278672,1,17,2,3,0,137
169304,1278672,1,17,3,0,1,137
169305,1278672,1,17,4,0,0,137
169306,1278672,1,17,5,0,0,137
169307,1278672,1,17,6,1,0,138
169308,1278672,1,18,1,0,0,138
169309,1278672,1,18,2,1,0,139
169310,1278672,1,18,3,1,0,140
169311,1278672,1,18,4,0,0,140
169312,1278672,1,18,5,0,0,140
169313,1278672,1,18,6,0,1,140
169314,1278672,1,19,1,2,0,142
169315,1278672,1,19,2,0,0,142
169316,1278672,1,19,3,1,0,143
169317,1278672,1,19,4,1,0,144
169318,1278672,1,19,5,2,0,146
169319,1278672,1,19,6,0,0,146
169320,1278672,1,20,1,2,0,148
169321,1278672,1,20,2,2,0,150
169322,1278672,1,20,3,1,0,151
169323,1278672,1,20,4,0,0,151
169324,1278672,1,20,5,0,0,151
169325,1278672,1,20,6,2,0,153
169430,1278673,1,1,1,0,0,0
169431,1278673,1,1,2,4,0,4
169432,1278673,1,1,3,4,0,8
169433,1278673,1,1,4,0,0,8
169434,1278673,1,1,5,0,0,8
169435,1278673,1,1,6,0,0,8
169436,1278673,1,2,1,4,0,12
169437,1278673,1,2,2,0,0,12
169438,1278673,1,2,3,0,0,12
169439,1278673,1,2,4,0,0,12
169440,1278673,1,2,5,2,0,14
169441,1278673,1,2,6,4,0,18
169442,1278673,1,3,1,0,0,18
169443,1278673,1,3,2,6,0,24
169444,1278673,1,3,3,1,0,25
169445,1278673,1,3,4,4,0,29
169446,1278673,1,3,5,0,0,29
169447,1278673,1,3,6,0,0,29
169448,1278673,1,4,1,0,0,29
169449,1278673,1,4,2,6,0,35
169450,1278673,1,4,3,3,0,38
169451,1278673,1,4,4,0,0,38
169452,1278673,1,4,5,0,0,38
169453,1278673,1,4,6,1,0,39
169454,1278673,1,5,1,0,0,39
169455,1278673,1,5,2,0,0,39
169456,1278673,1,5,3,4,0,43
169457,1278673,1,5,4,4,0,47
169458,1278673,1,5,5,1,0,48
169459,1278673,1,5,6,1,0,49
169460,1278673,1,6,1,4,0,53
169461,1278673,1,6,2,1,0,54
169462,1278673,1,6,3,4,0,58
169463,1278673,1,6,4,1,0,59
169464,1278673,1,6,5,6,0,65
169465,1278673,1,6,6,4,0,69
169466,1278673,1,7,1,0,0,69
169467,1278673,1,7,2,0,1,69
169468,1278673,1,7,3,1,0,70
169469,1278673,1,7,4,1,0,71
169470,1278673,1,7,5,0,0,71
169471,1278673,1,7,6,0,1,71
169472,1278673,1,8,1,1,0,72
169473,1278673,1,8,2,1,0,73
169474,1278673,1,8,3,1,0,74
169475,1278673,1,8,4,1,0,75
169476,1278673,1,8,5,1,0,76
169477,1278673,1,8,6,1,0,77
169478,1278673,1,9,1,1,0,78
169479,1278673,1,9,2,1,0,79
169480,1278673,1,9,3,1,0,80
169481,1278673,1,9,4,2,0,82
169482,1278673,1,9,5,1,0,83
169483,1278673,1,9,6,0,1,83
169484,1278673,1,10,1,1,0,84
169485,1278673,1,10,2,1,0,85
169486,1278673,1,10,3,1,0,86
169487,1278673,1,10,4,0,0,86
169488,1278673,1,10,5,2,0,88
169489,1278673,1,10,6,2,0,90
169490,1278673,1,11,1,1,0,91
169491,1278673,1,11,2,1,0,92
169492,1278673,1,11,3,4,0,96
169493,1278673,1,11,4,2,0,98
169494,1278673,1,11,5,1,0,99
169495,1278673,1,11,6,4,0,103
169496,1278673,1,12,1,0,0,103
169497,1278673,1,12,2,0,1,103
169498,1278673,1,12,3,1,0,104
169499,1278673,1,12,4,1,0,105
169500,1278673,1,12,5,1,0,106
169501,1278673,1,12,6,2,0,108
169502,1278673,1,13,1,1,0,109
169503,1278673,1,13,2,1,0,110
169504,1278673,1,13,3,1,0,111
169505,1278673,1,13,4,0,0,111
169506,1278673,1,13,5,2,0,113
169507,1278673,1,13,6,1,0,114
169508,1278673,1,14,1,1,0,115
169509,1278673,1,14,2,4,0,119
169510,1278673,1,14,3,1,0,120
169511,1278673,1,14,4,6,0,126
169512,1278673,1,14,5,0,0,126
169513,1278673,1,14,6,1,0,127
169514,1278673,1,15,1,1,0,128
169515,1278673,1,15,2,1,0,129
169516,1278673,1,15,3,4,0,133
169517,1278673,1,15,4,0,0,133
169518,1278673,1,15,5,1,0,134
169519,1278673,1,15,6,0,0,134
169520,1278673,1,16,1,1,0,135
169521,1278673,1,16,2,2,0,137
169522,1278673,1,16,3,1,0,138
169523,1278673,1,16,4,1,0,139
169524,1278673,1,16,5,0,1,139
169525,1278673,1,16,6,1,0,140
169526,1278673,1,17,1,0,1,140
169527,1278673,1,17,2,0,0,140
169528,1278673,1,17,3,5,0,145
169529,1278673,1,17,4,1,0,146
169530,1278673,1,17,5,1,0,147
169531,1278673,1,17,6,1,0,148
169532,1278673,1,18,1,0,0,148
169533,1278673,1,18,2,1,0,149
169534,1278673,1,18,3,1,0,150
169535,1278673,1,18,4,4,0,154
169536,1278673,1,18,5,2,0,156
169537,1278673,1,18,6,0,0,156
169538,1278673,1,19,1,6,0,162
169539,1278673,1,19,2,0,0,162
169540,1278673,1,19,3,0,1,162
169541,1278673,1,19,4,1,0,163
169542,1278673,1,19,5,1,0,164
169543,1278673,1,19,6,1,0,165
169544,1278673,1,20,1,4,0,169
169545,1278673,1,20,2,4,0,173
169546,1278673,1,20,3,2,0,175
169547,1278673,1,20,4,6,0,181
169548,1278673,1,20,5,2,0,183
169549,1278673,1,20,6,1,0,184
169654,1278679,1,1,1,0,0,0
169655,1278679,1,1,2,4,0,4
169656,1278679,1,1,3,0,0,4
169657,1278679,1,1,4,0,0,4
169658,1278679,1,1,5,0,1,4
169659,1278679,1,1,6,0,0,4
169660,1278679,1,2,1,4,0,8
169661,1278679,1,2,2,0,0,8
169662,1278679,1,2,3,0,0,8
169663,1278679,1,2,4,0,0,8
169664,1278679,1,2,5,0,0,8
169665,1278679,1,2,6,4,0,12
169666,1278679,1,3,1,0,0,12
169667,1278679,1,3,2,1,0,13
169668,1278679,1,3,3,0,0,13
169669,1278679,1,3,4,4,0,17
169670,1278679,1,3,5,1,0,18
169671,1278679,1,3,6,0,0,18
169672,1278679,1,4,1,0,0,18
169673,1278679,1,4,2,0,0,18
169674,1278679,1,4,3,1,0,19
169675,1278679,1,4,4,0,0,19
169676,1278679,1,4,5,6,0,25
169677,1278679,1,4,6,0,0,25
169678,1278679,1,5,1,0,0,25
169679,1278679,1,5,2,4,0,29
169680,1278679,1,5,3,2,0,31
169681,1278679,1,5,4,4,0,35
169682,1278679,1,5,5,0,0,35
169683,1278679,1,5,6,0,0,35
169684,1278679,1,6,1,0,0,35
169685,1278679,1,6,2,1,0,36
169686,1278679,1,6,3,4,0,40
169687,1278679,1,6,4,0,0,40
169688,1278679,1,6,5,4,0,44
169689,1278679,1,6,6,0,0,44
169690,1278679,1,7,1,6,0,50
169691,1278679,1,7,2,0,0,50
169692,1278679,1,7,3,1,0,51
169693,1278679,1,7,4,0,0,51
169694,1278679,1,7,5,0,1,51
169695,1278679,1,7,6,0,0,51
169696,1278679,1,8,1,0,0,51
169697,1278679,1,8,2,1,0,52
169698,1278679,1,8,3,1,0,53
169699,1278679,1,8,4,1,0,54
169700,1278679,1,8,5,1,0,55
169701,1278679,1,8,6,0,0,55
169702,1278679,1,9,1,0,0,55
169703,1278679,1,9,2,0,0,55
169704,1278679,1,9,3,1,0,56
169705,1278679,1,9,4,0,0,56
169706,1278679,1,9,5,1,0,57
169707,1278679,1,9,6,6,0,63
169708,1278679,1,10,1,0,0,63
169709,1278679,1,10,2,2,0,65
169710,1278679,1,10,3,1,0,66
169711,1278679,1,10,4,4,0,70
169712,1278679,1,10,5,0,0,70
169713,1278679,1,10,6,1,0,71
169714,1278679,1,11,1,0,0,71
169715,1278679,1,11,2,1,1,72
169716,1278679,1,11,3,2,0,74
169717,1278679,1,11,4,0,0,74
169718,1278679,1,11,5,0,1,74
169719,1278679,1,11,6,0,0,74
169720,1278679,1,12,1,1,0,75
169721,1278679,1,12,2,0,0,75
169722,1278679,1,12,3,1,0,76
169723,1278679,1,12,4,0,0,76
169724,1278679,1,12,5,1,0,77
169725,1278679,1,12,6,1,0,78
169726,1278679,1,13,1,1,0,79
169727,1278679,1,13,2,1,0,80
169728,1278679,1,13,3,0,0,80
169729,1278679,1,13,4,1,0,81
169730,1278679,1,13,5,0,0,81
169731,1278679,1,13,6,0,0,81
169732,1278679,1,14,1,1,0,82
169733,1278679,1,14,2,6,0,88
169734,1278679,1,14,3,1,0,89
169735,1278679,1,14,4,1,0,90
169736,1278679,1,14,5,0,1,90
169737,1278679,1,14,6,4,0,94
169738,1278679,1,15,1,0,0,94
169739,1278679,1,15,2,1,0,95
169740,1278679,1,15,3,0,0,95
169741,1278679,1,15,4,1,0,96
169742,1278679,1,15,5,0,0,96
169743,1278679,1,15,6,0,0,96
169744,1278679,1,16,1,1,0,97
169745,1278679,1,16,2,0,0,97
169746,1278679,1,16,3,6,0,103
169747,1278679,1,16,4,4,0,107
169748,1278679,1,16,5,0,0,107
169749,1278679,1,16,6,1,0,108
169750,1278679,1,17,1,6,0,114
169751,1278679,1,17,2,4,0,118
169752,1278679,1,17,3,2,0,120
169753,1278679,1,17,4,0,0,120
169754,1278679,1,17,5,4,0,124
169755,1278679,1,17,6,1,0,125
169756,1278679,1,18,1,1,0,126
169757,1278679,1,18,2,6,0,132
169758,1278679,1,18,3,2,0,134
169759,1278679,1,18,4,1,0,135
169760,1278679,1,18,5,0,0,135
169761,1278679,1,18,6,0,1,135
169762,1278679,1,19,1,6,0,141
169763,1278679,1,19,2,2,0,143
169764,1278679,1,19,3,1,0,144
169765,1278679,1,19,4,1,0,145
169766,1278679,1,19,5,1,0,146
169767,1278679,1,19,6,1,0,147
169768,1278679,1,20,1,4,0,151
169769,1278679,1,20,2,1,0,152
169770,1278679,1,20,3,1,0,153
169771,1278679,1,20,4,1,0,154
169772,1278679,1,20,5,3,0,157
169773,1278679,1,20,6,0,1,157
169887,1278680,1,1,1,1,0,1
169888,1278680,1,1,2,0,0,1
169889,1278680,1,1,3,0,0,1
169890,1278680,1,1,4,8,0,9
169891,1278680,1,1,5,1,0,10
169892,1278680,1,1,6,0,0,10
169893,1278680,1,2,1,0,0,10
169894,1278680,1,2,2,0,0,10
169895,1278680,1,2,3,0,0,10
169896,1278680,1,2,4,0,0,10
169897,1278680,1,2,5,0,1,10
169898,1278680,1,2,6,0,0,10
169899,1278680,1,3,1,0,0,10
169900,1278680,1,3,2,4,0,14
169901,1278680,1,3,3,0,0,14
169902,1278680,1,3,4,0,0,14
169903,1278680,1,3,5,0,0,14
169904,1278680,1,3,6,4,0,18
169905,1278680,1,4,1,0,0,18
169906,1278680,1,4,2,0,0,18
169907,1278680,1,4,3,0,0,18
169908,1278680,1,4,4,1,0,19
169909,1278680,1,4,5,4,0,23
169910,1278680,1,4,6,0,0,23
169911,1278680,1,5,1,4,0,27
169912,1278680,1,5,2,1,0,28
169913,1278680,1,5,3,1,0,29
169914,1278680,1,5,4,1,0,30
169915,1278680,1,5,5,4,0,34
169916,1278680,1,5,6,0,0,34
169917,1278680,1,6,1,0,0,34
169918,1278680,1,6,2,4,0,38
169919,1278680,1,6,3,4,0,42
169920,1278680,1,6,4,0,0,42
169921,1278680,1,6,5,1,0,43
169922,1278680,1,6,6,6,0,49
169923,1278680,1,7,1,4,0,53
169924,1278680,1,7,2,0,0,53
169925,1278680,1,7,3,1,0,54
169926,1278680,1,7,4,1,0,55
169927,1278680,1,7,5,1,0,56
169928,1278680,1,7,6,0,0,56
169929,1278680,1,8,1,1,0,57
169930,1278680,1,8,2,1,0,58
169931,1278680,1,8,3,0,0,58
169932,1278680,1,8,4,1,0,59
169933,1278680,1,8,5,0,1,59
169934,1278680,1,8,6,1,0,60
169935,1278680,1,9,1,1,0,61
169936,1278680,1,9,2,4,0,65
169937,1278680,1,9,3,0,0,65
169938,1278680,1,9,4,1,0,66
169939,1278680,1,9,5,1,0,67
169940,1278680,1,9,6,2,0,69
169941,1278680,1,10,1,1,0,70
169942,1278680,1,10,2,1,0,71
169943,1278680,1,10,3,0,0,71
169944,1278680,1,10,4,1,0,72
169945,1278680,1,10,5,0,1,72
169946,1278680,1,10,6,4,0,76
169947,1278680,1,11,1,1,0,77
169948,1278680,1,11,2,0,0,77
169949,1278680,1,11,3,1,0,78
169950,1278680,1,11,4,1,0,79
169951,1278680,1,11,5,4,0,83
169952,1278680,1,11,6,2,0,85
169953,1278680,1,12,1,0,0,85
169954,1278680,1,12,2,1,0,86
169955,1278680,1,12,3,1,0,87
169956,1278680,1,12,4,0,0,87
169957,1278680,1,12,5,1,0,88
169958,1278680,1,12,6,0,0,88
169959,1278680,1,13,1,2,0,90
169960,1278680,1,13,2,4,0,94
169961,1278680,1,13,3,2,0,96
169962,1278680,1,13,4,1,0,97
169963,1278680,1,13,5,1,0,98
169964,1278680,1,13,6,0,0,98
169965,1278680,1,14,1,1,0,99
169966,1278680,1,14,2,6,0,105
169967,1278680,1,14,3,1,0,106
169968,1278680,1,14,4,0,1,106
169969,1278680,1,14,5,4,0,110
169970,1278680,1,14,6,0,0,110
169971,1278680,1,15,1,4,0,114
169972,1278680,1,15,2,1,0,115
169973,1278680,1,15,3,1,0,116
169974,1278680,1,15,4,0,0,116
169975,1278680,1,15,5,4,0,120
169976,1278680,1,15,6,4,0,124
169977,1278680,1,16,1,1,0,125
169978,1278680,1,16,2,1,0,126
169979,1278680,1,16,3,4,0,130
169980,1278680,1,16,4,4,0,134
169981,1278680,1,16,5,1,0,135
169982,1278680,1,16,6,4,0,139
169983,1278680,1,17,1,2,0,141
169984,1278680,1,17,2,0,0,141
169985,1278680,1,17,3,1,0,142
169986,1278680,1,17,4,1,0,143
169987,1278680,1,17,5,6,0,149
169988,1278680,1,17,6,3,0,152
169989,1278680,1,18,1,1,0,153
169990,1278680,1,18,2,3,0,156
169991,1278680,1,18,3,2,0,158
169992,1278680,1,18,4,2,0,160
169993,1278680,1,18,5,4,0,164
169994,1278680,1,18,6,0,0,164
169995,1278680,1,19,1,6,0,170
169996,1278680,1,19,2,1,0,171
169997,1278680,1,19,3,1,0,172
169998,1278680,1,19,4,4,0,176
169999,1278680,1,19,5,1,0,177
170000,1278680,1,19,6,2,0,179
170001,1278680,1,20,1,1,0,180
170002,1278680,1,20,2,1,0,181
170003,1278680,1,20,3,1,1,182
170004,1278680,1,20,4,1,0,183
170005,1278680,1,20,5,2,0,185
170006,1278680,1,20,6,1,0,186
170127,1278681,1,1,1,1,0,1
170128,1278681,1,1,2,0,0,1
170129,1278681,1,1,3,0,0,1
170130,1278681,1,1,4,4,0,5
170131,1278681,1,1,5,0,0,5
170132,1278681,1,1,6,0,0,5
170133,1278681,1,2,1,0,0,5
170134,1278681,1,2,2,4,0,9
170135,1278681,1,2,3,0,0,9
170136,1278681,1,2,4,0,0,9
170137,1278681,1,2,5,0,0,9
170138,1278681,1,2,6,0,0,9
170139,1278681,1,3,1,0,0,9
170140,1278681,1,3,2,1,0,10
170141,1278681,1,3,3,0,1,10
170142,1278681,1,3,4,1,0,11
170143,1278681,1,3,5,0,0,11
170144,1278681,1,3,6,4,0,15
170145,1278681,1,4,1,0,0,15
170146,1278681,1,4,2,4,0,19
170147,1278681,1,4,3,4,0,23
170148,1278681,1,4,4,0,0,23
170149,1278681,1,4,5,4,0,27
170150,1278681,1,4,6,0,0,27
170151,1278681,1,5,1,4,0,31
170152,1278681,1,5,2,4,0,35
170153,1278681,1,5,3,0,0,35
170154,1278681,1,5,4,1,0,36
170155,1278681,1,5,5,0,0,36
170156,1278681,1,5,6,1,0,37
170157,1278681,1,6,1,2,0,39
170158,1278681,1,6,2,0,0,39
170159,1278681,1,6,3,1,0,40
170160,1278681,1,6,4,1,0,41
170161,1278681,1,6,5,1,0,42
170162,1278681,1,6,6,1,0,43
170163,1278681,1,7,1,1,0,44
170164,1278681,1,7,2,0,0,44
170165,1278681,1,7,3,1,0,45
170166,1278681,1,7,4,1,0,46
170167,1278681,1,7,5,4,0,50
170168,1278681,1,7,6,1,0,51
170169,1278681,1,8,1,2,0,53
170170,1278681,1,8,2,1,0,54
170171,1278681,1,8,3,4,0,58
170172,1278681,1,8,4,1,0,59
170173,1278681,1,8,5,1,0,60
170174,1278681,1,8,6,1,0,61
170175,1278681,1,9,1,2,0,63
170176,1278681,1,9,2,0,0,63
170177,1278681,1,9,3,0,1,63
170178,1278681,1,9,4,1,0,64
170179,1278681,1,9,5,0,0,64
170180,1278681,1,9,6,0,0,64
170181,1278681,1,10,1,0,0,64
170182,1278681,1,10,2,1,0,65
170183,1278681,1,10,3,1,0,66
170184,1278681,1,10,4,0,1,66
170185,1278681,1,10,5,1,0,67
170186,1278681,1,10,6,1,0,68
170187,1278681,1,11,1,1,0,69
170188,1278681,1,11,2,1,0,70
170189,1278681,1,11,3,1,0,71
170190,1278681,1,11,4,6,0,77
170191,1278681,1,11,5,1,0,78
170192,1278681,1,11,6,0,0,78
170193,1278681,1,12,1,1,0,79
170194,1278681,1,12,2,0,0,79
170195,1278681,1,12,3,1,0,80
170196,1278681,1,12,4,0,0,80
170197,1278681,1,12,5,1,0,81
170198,1278681,1,12,6,0,0,81
170199,1278681,1,13,1,6,0,87
170200,1278681,1,13,2,1,0,88
170201,1278681,1,13,3,1,0,89
170202,1278681,1,13,4,0,0,89
170203,1278681,1,13,5,1,0,90
170204,1278681,1,13,6,0,0,90
170205,1278681,1,14,1,1,0,91
170206,1278681,1,14,2,1,0,92
170207,1278681,1,14,3,1,0,93
170208,1278681,1,14,4,0,0,93
170209,1278681,1,14,5,0,1,93
170210,1278681,1,14,6,0,0,93
170211,1278681,1,15,1,1,0,94
170212,1278681,1,15,2,1,0,95
170213,1278681,1,15,3,1,0,96
170214,1278681,1,15,4,1,0,97
170215,1278681,1,15,5,0,0,97
170216,1278681,1,15,6,1,0,98
170217,1278681,1,16,1,6,0,104
170218,1278681,1,16,2,1,0,105
170219,1278681,1,16,3,4,0,109
170220,1278681,1,16,4,1,0,110
170221,1278681,1,16,5,4,0,114
170222,1278681,1,16,6,1,0,115
170223,1278681,1,17,1,1,0,116
170224,1278681,1,17,2,1,0,117
170225,1278681,1,17,3,4,0,121
170226,1278681,1,17,4,6,0,127
170227,1278681,1,17,5,1,0,128
170228,1278681,1,17,6,4,0,132
170229,1278681,1,18,1,1,0,133
170230,1278681,1,18,2,2,0,135
170231,1278681,1,18,3,1,0,136
170232,1278681,1,18,4,0,0,136
170233,1278681,1,18,5,6,0,142
170234,1278681,1,18,6,0,0,142
170235,1278681,1,19,1,2,0,144
170236,1278681,1,19,2,6,0,150
170237,1278681,1,19,3,1,0,151
170238,1278681,1,19,4,4,0,155
170239,1278681,1,19,5,4,0,159
170240,1278681,1,19,6,4,0,163
170241,1278681,1,20,1,7,0,170
170242,1278681,1,20,2,1,0,171
170243,1278681,1,20,3,1,0,172
170244,1278681,1,20,4,6,0,178
170245,1278681,1,20,5,6,0,184
170246,1278681,1,20,6,0,1,184
170367,1278684,1,1,1,0,0,0
170368,1278684,1,1,2,0,0,0
170369,1278684,1,1,3,1,0,1
170370,1278684,1,1,4,1,0,2
170371,1278684,1,1,5,3,0,5
170372,1278684,1,1,6,0,0,5
170373,1278684,1,2,1,4,0,9
170374,1278684,1,2,2,1,0,10
170375,1278684,1,2,3,0,0,10
170376,1278684,1,2,4,0,0,10
170377,1278684,1,2,5,1,0,11
170378,1278684,1,2,6,0,0,11
170379,1278684,1,3,1,1,0,12
170380,1278684,1,3,2,4,0,16
170381,1278684,1,3,3,4,0,20
170382,1278684,1,3,4,4,0,24
170383,1278684,1,3,5,1,0,25
170384,1278684,1,3,6,1,0,26
170385,1278684,1,4,1,1,0,27
170386,1278684,1,4,2,0,0,27
170387,1278684,1,4,3,1,0,28
170388,1278684,1,4,4,2,0,30
170389,1278684,1,4,5,6,0,36
170390,1278684,1,4,6,4,0,40
170391,1278684,1,5,1,1,0,41
170392,1278684,1,5,2,1,0,42
170393,1278684,1,5,3,1,0,43
170394,1278684,1,5,4,0,0,43
170395,1278684,1,5,5,4,0,47
170396,1278684,1,5,6,0,0,47
170397,1278684,1,6,1,2,0,49
170398,1278684,1,6,2,1,0,50
170399,1278684,1,6,3,0,0,50
170400,1278684,1,6,4,6,0,56
170401,1278684,1,6,5,0,0,56
170402,1278684,1,6,6,2,0,58
170403,1278684,1,7,1,0,0,58
170404,1278684,1,7,2,1,0,59
170405,1278684,1,7,3,4,0,63
170406,1278684,1,7,4,2,0,65
170407,1278684,1,7,5,1,0,66
170408,1278684,1,7,6,1,0,67
170409,1278684,1,8,1,2,0,69
170410,1278684,1,8,2,1,0,70
170411,1278684,1,8,3,0,0,70
170412,1278684,1,8,4,1,0,71
170413,1278684,1,8,5,4,0,75
170414,1278684,1,8,6,1,0,76
170415,1278684,1,9,1,3,0,79
170416,1278684,1,9,2,0,0,79
170417,1278684,1,9,3,1,0,80
170418,1278684,1,9,4,6,0,86
170419,1278684,1,9,5,0,0,86
170420,1278684,1,9,6,1,0,87
170421,1278684,1,10,1,1,0,88
170422,1278684,1,10,2,2,0,90
170423,1278684,1,10,3,1,0,91
170424,1278684,1,10,4,2,0,93
170425,1278684,1,10,5,1,0,94
170426,1278684,1,10,6,4,0,98
170427,1278684,1,11,1,1,0,99
170428,1278684,1,11,2,2,0,101
170429,1278684,1,11,3,2,0,103
170430,1278684,1,11,4,1,0,104
170431,1278684,1,11,5,1,0,105
170432,1278684,1,11,6,1,0,106
170433,1278684,1,12,1,2,0,108
170434,1278684,1,12,2,1,0,109
170435,1278684,1,12,3,1,0,110
170436,1278684,1,12,4,1,0,111
170437,1278684,1,12,5,0,1,111
170438,1278684,1,12,6,1,0,112
170439,1278684,1,13,1,2,0,114
170440,1278684,1,13,2,0,0,114
170441,1278684,1,13,3,1,0,115
170442,1278684,1,13,4,2,0,117
170443,1278684,1,13,5,4,0,121
170444,1278684,1,13,6,0,0,121
170445,1278684,1,14,1,2,0,123
170446,1278684,1,14,2,1,0,124
170447,1278684,1,14,3,0,0,124
170448,1278684,1,14,4,0,0,124
170449,1278684,1,14,5,0,0,124
170450,1278684,1,14,6,1,0,125
170451,1278684,1,15,1,0,0,125
170452,1278684,1,15,2,1,0,126
170453,1278684,1,15,3,1,0,127
170454,1278684,1,15,4,0,0,127
170455,1278684,1,15,5,3,0,130
170456,1278684,1,15,6,0,0,130
170457,1278684,1,16,1,1,0,131
170458,1278684,1,16,2,6,0,137
170459,1278684,1,16,3,4,0,141
170460,1278684,1,16,4,4,0,145
170461,1278684,1,16,5,1,0,146
170462,1278684,1,16,6,1,0,147
170463,1278684,1,17,1,1,0,148
170464,1278684,1,17,2,2,0,150
170465,1278684,1,17,3,0,0,150
170466,1278684,1,17,4,4,0,154
170467,1278684,1,17,5,1,0,155
170468,1278684,1,17,6,0,1,155
170469,1278684,1,18,1,1,0,156
170470,1278684,1,18,2,2,0,158
170471,1278684,1,18,3,4,0,162
170472,1278684,1,18,4,2,0,164
170473,1278684,1,18,5,1,0,165
170474,1278684,1,18,6,0,0,165
170475,1278684,1,19,1,6,0,171
170476,1278684,1,19,2,4,0,175
170477,1278684,1,19,3,2,0,177
170478,1278684,1,19,4,1,0,178
170479,1278684,1,19,5,4,0,182
170480,1278684,1,19,6,1,0,183
170481,1278684,1,20,1,6,0,189
170482,1278684,1,20,2,2,0,191
170483,1278684,1,20,3,4,0,195
170484,1278684,1,20,4,2,0,197
170485,1278684,1,20,5,1,0,198
170486,1278684,1,20,6,1,0,199
170607,1278685,1,1,1,0,0,0
170608,1278685,1,1,2,1,0,1
170609,1278685,1,1,3,0,0,1
170610,1278685,1,1,4,1,0,2
170611,1278685,1,1,5,0,0,2
170612,1278685,1,1,6,0,0,2
170613,1278685,1,2,1,2,0,4
170614,1278685,1,2,2,0,0,4
170615,1278685,1,2,3,2,0,6
170616,1278685,1,2,4,0,0,6
170617,1278685,1,2,5,0,0,6
170618,1278685,1,2,6,1,0,7
170619,1278685,1,3,1,0,0,7
170620,1278685,1,3,2,4,0,11
170621,1278685,1,3,3,0,0,11
170622,1278685,1,3,4,0,0,11
170623,1278685,1,3,5,1,0,12
170624,1278685,1,3,6,1,0,13
170625,1278685,1,4,1,1,0,14
170626,1278685,1,4,2,1,0,15
170627,1278685,1,4,3,0,0,15
170628,1278685,1,4,4,0,0,15
170629,1278685,1,4,5,0,0,15
170630,1278685,1,4,6,0,0,15
170631,1278685,1,5,1,0,0,15
170632,1278685,1,5,2,4,0,19
170633,1278685,1,5,3,0,0,19
170634,1278685,1,5,4,1,0,20
170635,1278685,1,5,5,4,0,24
170636,1278685,1,5,6,1,0,25
170637,1278685,1,6,1,4,0,29
170638,1278685,1,6,2,1,0,30
170639,1278685,1,6,3,1,0,31
170640,1278685,1,6,4,1,0,32
170641,1278685,1,6,5,0,0,32
170642,1278685,1,6,6,0,0,32
170643,1278685,1,7,1,0,0,32
170644,1278685,1,7,2,2,0,34
170645,1278685,1,7,3,0,0,34
170646,1278685,1,7,4,4,0,38
170647,1278685,1,7,5,1,0,39
170648,1278685,1,7,6,2,0,41
170649,1278685,1,8,1,1,0,42
170650,1278685,1,8,2,4,0,46
170651,1278685,1,8,3,1,0,47
170652,1278685,1,8,4,1,0,48
170653,1278685,1,8,5,1,0,49
170654,1278685,1,8,6,2,0,51
170655,1278685,1,9,1,6,0,57
170656,1278685,1,9,2,4,0,61
170657,1278685,1,9,3,6,0,67
170658,1278685,1,9,4,0,1,67
170659,1278685,1,9,5,1,0,68
170660,1278685,1,9,6,1,0,69
170661,1278685,1,10,1,0,0,69
170662,1278685,1,10,2,1,0,70
170663,1278685,1,10,3,1,0,71
170664,1278685,1,10,4,0,0,71
170665,1278685,1,10,5,0,1,71
170666,1278685,1,10,6,0,0,71
170667,1278685,1,11,1,1,0,72
170668,1278685,1,11,2,0,0,72
170669,1278685,1,11,3,1,0,73
170670,1278685,1,11,4,2,0,75
170671,1278685,1,11,5,1,0,76
170672,1278685,1,11,6,0,1,76
170673,1278685,1,12,1,0,0,76
170674,1278685,1,12,2,1,0,77
170675,1278685,1,12,3,0,0,77
170676,1278685,1,12,4,1,0,78
170677,1278685,1,12,5,1,0,79
170678,1278685,1,12,6,1,0,80
170679,1278685,1,13,1,1,0,81
170680,1278685,1,13,2,4,0,85
170681,1278685,1,13,3,1,0,86
170682,1278685,1,13,4,1,0,87
170683,1278685,1,13,5,4,0,91
170684,1278685,1,13,6,1,0,92
170685,1278685,1,14,1,4,0,96
170686,1278685,1,14,2,0,0,96
170687,1278685,1,14,3,1,0,97
170688,1278685,1,14,4,1,0,98
170689,1278685,1,14,5,0,0,98
170690,1278685,1,14,6,0,0,98
170691,1278685,1,15,1,0,0,98
170692,1278685,1,15,2,0,0,98
170693,1278685,1,15,3,4,0,102
170694,1278685,1,15,4,0,1,102
170695,1278685,1,15,5,1,0,103
170696,1278685,1,15,6,0,0,103
170697,1278685,1,16,1,1,0,104
170698,1278685,1,16,2,1,0,105
170699,1278685,1,16,3,1,0,106
170700,1278685,1,16,4,4,0,110
170701,1278685,1,16,5,1,0,111
170702,1278685,1,16,6,0,0,111
170703,1278685,1,17,1,1,0,112
170704,1278685,1,17,2,6,0,118
170705,1278685,1,17,3,1,0,119
170706,1278685,1,17,4,4,0,123
170707,1278685,1,17,5,1,0,124
170708,1278685,1,17,6,6,0,130
170709,1278685,1,18,1,4,0,134
170710,1278685,1,18,2,4,0,138
170711,1278685,1,18,3,1,0,139
170712,1278685,1,18,4,0,0,139
170713,1278685,1,18,5,1,0,140
170714,1278685,1,18,6,4,0,144
170715,1278685,1,19,1,2,0,146
170716,1278685,1,19,2,6,0,152
170717,1278685,1,19,3,4,0,156
170718,1278685,1,19,4,2,0,158
170719,1278685,1,19,5,2,0,160
170720,1278685,1,19,6,0,1,160
170721,1278685,1,20,1,5,0,165
170722,1278685,1,20,2,2,0,167
170723,1278685,1,20,3,4,0,171
170724,1278685,1,20,4,0,0,171
170725,1278685,1,20,5,6,0,177
170726,1278685,1,20,6,6,0,183
170830,1278686,1,1,1,0,0,0
170831,1278686,1,1,2,0,0,0
170832,1278686,1,1,3,0,0,0
170833,1278686,1,1,4,0,0,0
170834,1278686,1,1,5,1,0,1
170835,1278686,1,1,6,0,1,1
170836,1278686,1,2,1,0,0,1
170837,1278686,1,2,2,0,0,1
170838,1278686,1,2,3,4,0,5
170839,1278686,1,2,4,0,0,5
170840,1278686,1,2,5,0,1,5
170841,1278686,1,2,6,0,0,5
170842,1278686,1,3,1,0,0,5
170843,1278686,1,3,2,1,0,6
170844,1278686,1,3,3,4,0,10
170845,1278686,1,3,4,0,0,10
170846,1278686,1,3,5,0,0,10
170847,1278686,1,3,6,0,0,10
170848,1278686,1,4,1,0,0,10
170849,1278686,1,4,2,0,0,10
170850,1278686,1,4,3,0,0,10
170851,1278686,1,4,4,0,0,10
170852,1278686,1,4,5,1,0,11
170853,1278686,1,4,6,0,1,11
170854,1278686,1,5,1,0,0,11
170855,1278686,1,5,2,0,0,11
170856,1278686,1,5,3,1,0,12
170857,1278686,1,5,4,1,0,13
170858,1278686,1,5,5,1,0,14
170859,1278686,1,5,6,0,0,14
170860,1278686,1,6,1,1,0,15
170861,1278686,1,6,2,0,0,15
170862,1278686,1,6,3,1,0,16
170863,1278686,1,6,4,0,0,16
170864,1278686,1,6,5,1,0,17
170865,1278686,1,6,6,1,0,18
170866,1278686,1,7,1,1,0,19
170867,1278686,1,7,2,1,0,20
170868,1278686,1,7,3,1,0,21
170869,1278686,1,7,4,1,0,22
170870,1278686,1,7,5,1,0,23
170871,1278686,1,7,6,1,0,24
170872,1278686,1,8,1,0,0,24
170873,1278686,1,8,2,1,0,25
170874,1278686,1,8,3,0,0,25
170875,1278686,1,8,4,0,0,25
170876,1278686,1,8,5,0,0,25
170877,1278686,1,8,6,1,0,26
170878,1278686,1,9,1,1,0,27
170879,1278686,1,9,2,2,0,29
170880,1278686,1,9,3,0,1,29
170881,1278686,1,9,4,0,0,29
170882,1278686,1,9,5,2,0,31
170883,1278686,1,9,6,3,0,34
170884,1278686,1,10,1,3,0,37
170885,1278686,1,10,2,0,0,37
170886,1278686,1,10,3,0,0,37
170887,1278686,1,10,4,1,0,38
170888,1278686,1,10,5,1,0,39
170889,1278686,1,10,6,4,0,43
170890,1278686,1,11,1,4,0,47
170891,1278686,1,11,2,0,0,47
170892,1278686,1,11,3,1,0,48
170893,1278686,1,11,4,2,0,50
170894,1278686,1,11,5,1,0,51
170895,1278686,1,11,6,1,0,52
170896,1278686,1,12,1,1,0,53
170897,1278686,1,12,2,1,0,54
170898,1278686,1,12,3,1,0,55
170899,1278686,1,12,4,4,0,59
170900,1278686,1,12,5,0,0,59
170901,1278686,1,12,6,1,0,60
170902,1278686,1,13,1,0,1,60
170903,1278686,1,13,2,2,0,62
170904,1278686,1,13,3,0,0,62
170905,1278686,1,13,4,1,0,63
170906,1278686,1,13,5,1,0,64
170907,1278686,1,13,6,0,0,64
170908,1278686,1,14,1,2,0,66
170909,1278686,1,14,2,1,0,67
170910,1278686,1,14,3,4,0,71
170911,1278686,1,14,4,0,0,71
170912,1278686,1,14,5,1,0,72
170913,1278686,1,14,6,2,0,74
170914,1278686,1,15,1,1,0,75
170915,1278686,1,15,2,1,0,76
170916,1278686,1,15,3,0,0,76
170917,1278686,1,15,4,1,0,77
170918,1278686,1,15,5,1,0,78
170919,1278686,1,15,6,0,0,78
170920,1278686,1,16,1,1,0,79
170921,1278686,1,16,2,1,0,80
170922,1278686,1,16,3,4,0,84
170923,1278686,1,16,4,1,0,85
170924,1278686,1,16,5,4,0,89
170925,1278686,1,16,6,1,0,90
170926,1278686,1,17,1,1,0,91
170927,1278686,1,17,2,4,0,95
170928,1278686,1,17,3,0,0,95
170929,1278686,1,17,4,4,0,99
170930,1278686,1,17,5,2,0,101
170931,1278686,1,17,6,2,0,103
170932,1278686,1,18,1,1,0,104
170933,1278686,1,18,2,1,0,105
170934,1278686,1,18,3,1,0,106
170935,1278686,1,18,4,4,0,110
170936,1278686,1,18,5,4,0,114
170937,1278686,1,18,6,1,0,115
170938,1278686,1,19,1,4,0,119
170939,1278686,1,19,2,4,0,123
170940,1278686,1,19,3,7,0,130
170941,1278686,1,19,4,1,0,131
170942,1278686,1,19,5,3,0,134
170943,1278686,1,19,6,0,0,134
170944,1278686,1,20,1,0,0,134
170945,1278686,1,20,2,6,0,140
170946,1278686,1,20,3,2,0,142
170947,1278686,1,20,4,0,0,142
170948,1278686,1,20,5,4,0,146
170949,1278686,1,20,6,0,0,146
171051,1278687,1,1,1,0,0,0
171052,1278687,1,1,2,5,0,5
171053,1278687,1,1,3,0,0,5
171054,1278687,1,1,4,4,0,9
171055,1278687,1,1,5,4,0,13
171056,1278687,1,1,6,0,0,13
171057,1278687,1,2,1,0,0,13
171058,1278687,1,2,2,1,0,14
171059,1278687,1,2,3,1,0,15
171060,1278687,1,2,4,0,0,15
171061,1278687,1,2,5,0,0,15
171062,1278687,1,2,6,0,0,15
171063,1278687,1,3,1,0,0,15
171064,1278687,1,3,2,1,0,16
171065,1278687,1,3,3,0,0,16
171066,1278687,1,3,4,0,0,16
171067,1278687,1,3,5,6,0,22
171068,1278687,1,3,6,2,0,24
171069,1278687,1,4,1,1,0,25
171070,1278687,1,4,2,1,0,26
171071,1278687,1,4,3,0,0,26
171072,1278687,1,4,4,4,0,30
171073,1278687,1,4,5,0,0,30
171074,1278687,1,4,6,5,0,35
171075,1278687,1,5,1,1,0,36
171076,1278687,1,5,2,0,0,36
171077,1278687,1,5,3,0,0,36
171078,1278687,1,5,4,0,0,36
171079,1278687,1,5,5,0,0,36
171080,1278687,1,5,6,0,0,36
171081,1278687,1,6,1,6,0,42
171082,1278687,1,6,2,1,0,43
171083,1278687,1,6,3,4,0,47
171084,1278687,1,6,4,0,0,47
171085,1278687,1,6,5,4,0,51
171086,1278687,1,6,6,0,0,51
171087,1278687,1,7,1,6,0,57
171088,1278687,1,7,2,0,1,57
171089,1278687,1,7,3,1,0,58
171090,1278687,1,7,4,4,0,62
171091,1278687,1,7,5,0,0,62
171092,1278687,1,7,6,1,0,63
171093,1278687,1,8,1,1,0,64
171094,1278687,1,8,2,2,0,66
171095,1278687,1,8,3,1,0,67
171096,1278687,1,8,4,6,0,73
171097,1278687,1,8,5,1,0,74
171098,1278687,1,8,6,1,0,75
171099,1278687,1,9,1,4,0,79
171100,1278687,1,9,2,1,0,80
171101,1278687,1,9,3,1,0,81
171102,1278687,1,9,4,1,0,82
171103,1278687,1,9,5,1,0,83
171104,1278687,1,9,6,4,0,87
171105,1278687,1,10,1,6,0,93
171106,1278687,1,10,2,0,0,93
171107,1278687,1,10,3,6,0,99
171108,1278687,1,10,4,1,0,100
171109,1278687,1,10,5,1,0,101
171110,1278687,1,10,6,1,0,102
171111,1278687,1,11,1,1,0,103
171112,1278687,1,11,2,1,0,104
171113,1278687,1,11,3,0,0,104
171114,1278687,1,11,4,1,0,105
171115,1278687,1,11,5,6,0,111
171116,1278687,1,11,6,1,0,112
171117,1278687,1,12,1,0,0,112
171118,1278687,1,12,2,1,0,113
171119,1278687,1,12,3,1,0,114
171120,1278687,1,12,4,1,0,115
171121,1278687,1,12,5,1,0,116
171122,1278687,1,12,6,1,0,117
171123,1278687,1,13,1,6,0,123
171124,1278687,1,13,2,6,0,129
171125,1278687,1,13,3,4,0,133
171126,1278687,1,13,4,4,0,137
171127,1278687,1,13,5,0,0,137
171128,1278687,1,13,6,0,1,137
171129,1278687,1,14,1,0,0,137
171130,1278687,1,14,2,2,0,139
171131,1278687,1,14,3,1,0,140
171132,1278687,1,14,4,0,0,140
171133,1278687,1,14,5,4,0,144
171134,1278687,1,14,6,1,0,145
171135,1278687,1,15,1,1,0,146
171136,1278687,1,15,2,1,0,147
171137,1278687,1,15,3,1,0,148
171138,1278687,1,15,4,0,0,148
171139,1278687,1,15,5,1,0,149
171140,1278687,1,15,6,1,0,150
171141,1278687,1,16,1,0,0,150
171142,1278687,1,16,2,4,0,154
171143,1278687,1,16,3,1,0,155
171144,1278687,1,16,4,0,0,155
171145,1278687,1,16,5,0,0,155
171146,1278687,1,16,6,1,0,156
171147,1278687,1,17,1,0,1,156
171148,1278687,1,17,2,1,0,157
171149,1278687,1,17,3,6,0,163
171150,1278687,1,17,4,1,0,164
171151,1278687,1,17,5,6,0,170
171152,1278687,1,17,6,4,0,174
171153,1278687,1,18,1,1,0,175
171154,1278687,1,18,2,1,0,176
171155,1278687,1,18,3,0,0,176
171156,1278687,1,18,4,4,0,180
171157,1278687,1,18,5,6,0,186
171158,1278687,1,18,6,1,0,187
171159,1278687,1,19,1,6,0,193
171160,1278687,1,19,2,1,0,194
171161,1278687,1,19,3,0,0,194
171162,1278687,1,19,4,2,0,196
171163,1278687,1,19,5,2,0,198
171164,1278687,1,19,6,4,0,202
171165,1278687,1,20,1,0,1,202
171166,1278687,1,20,2,0,0,202
171167,1278687,1,20,3,1,0,203
171168,1278687,1,20,4,6,0,209
171169,1278687,1,20,5,0,0,209
171170,1278687,1,20,6,2,0,211
171286,1278688,1,1,1,0,0,0
171287,1278688,1,1,2,0,0,0
171288,1278688,1,1,3,1,0,1
171289,1278688,1,1,4,1,0,2
171290,1278688,1,1,5,1,1,3
171291,1278688,1,1,6,0,0,3
171292,1278688,1,2,1,1,0,4
171293,1278688,1,2,2,0,0,4
171294,1278688,1,2,3,4,0,8
171295,1278688,1,2,4,3,0,11
171296,1278688,1,2,5,0,0,11
171297,1278688,1,2,6,0,0,11
171298,1278688,1,3,1,0,0,11
171299,1278688,1,3,2,0,0,11
171300,1278688,1,3,3,0,0,11
171301,1278688,1,3,4,0,0,11
171302,1278688,1,3,5,1,0,12
171303,1278688,1,3,6,0,0,12
171304,1278688,1,4,1,1,0,13
171305,1278688,1,4,2,6,0,19
171306,1278688,1,4,3,0,0,19
171307,1278688,1,4,4,6,0,25
171308,1278688,1,4,5,0,0,25
171309,1278688,1,4,6,0,0,25
171310,1278688,1,5,1,0,0,25
171311,1278688,1,5,2,1,0,26
171312,1278688,1,5,3,4,0,30
171313,1278688,1,5,4,0,0,30
171314,1278688,1,5,5,0,0,30
171315,1278688,1,5,6,1,0,31
171316,1278688,1,6,1,6,0,37
171317,1278688,1,6,2,1,0,38
171318,1278688,1,6,3,1,0,39
171319,1278688,1,6,4,2,0,41
171320,1278688,1,6,5,1,0,42
171321,1278688,1,6,6,0,0,42
171322,1278688,1,7,1,1,0,43
171323,1278688,1,7,2,1,0,44
171324,1278688,1,7,3,4,0,48
171325,1278688,1,7,4,0,1,48
171326,1278688,1,7,5,1,0,49
171327,1278688,1,7,6,1,0,50
171328,1278688,1,8,1,0,0,50
171329,1278688,1,8,2,1,0,51
171330,1278688,1,8,3,1,0,52
171331,1278688,1,8,4,1,0,53
171332,1278688,1,8,5,1,0,54
171333,1278688,1,8,6,0,0,54
171334,1278688,1,9,1,1,0,55
171335,1278688,1,9,2,1,0,56
171336,1278688,1,9,3,0,0,56
171337,1278688,1,9,4,1,0,57
171338,1278688,1,9,5,5,0,62
171339,1278688,1,9,6,6,0,68
171340,1278688,1,10,1,0,1,68
171341,1278688,1,10,2,0,0,68
171342,1278688,1,10,3,1,0,69
171343,1278688,1,10,4,0,0,69
171344,1278688,1,10,5,1,0,70
171345,1278688,1,10,6,1,0,71
171346,1278688,1,11,1,0,0,71
171347,1278688,1,11,2,1,0,72
171348,1278688,1,11,3,1,0,73
171349,1278688,1,11,4,1,0,74
171350,1278688,1,11,5,0,0,74
171351,1278688,1,11,6,4,0,78
171352,1278688,1,12,1,6,0,84
171353,1278688,1,12,2,1,0,85
171354,1278688,1,12,3,1,0,86
171355,1278688,1,12,4,1,0,87
171356,1278688,1,12,5,0,0,87
171357,1278688,1,12,6,0,0,87
171358,1278688,1,13,1,1,0,88
171359,1278688,1,13,2,1,0,89
171360,1278688,1,13,3,1,0,90
171361,1278688,1,13,4,0,1,90
171362,1278688,1,13,5,1,0,91
171363,1278688,1,13,6,1,0,92
171364,1278688,1,14,1,1,0,93
171365,1278688,1,14,2,4,0,97
171366,1278688,1,14,3,0,0,97
171367,1278688,1,14,4,1,0,98
171368,1278688,1,14,5,0,1,98
171369,1278688,1,14,6,1,0,99
171370,1278688,1,15,1,0,0,99
171371,1278688,1,15,2,1,0,100
171372,1278688,1,15,3,1,0,101
171373,1278688,1,15,4,1,0,102
171374,1278688,1,15,5,1,0,103
171375,1278688,1,15,6,1,0,104
171376,1278688,1,16,1,1,0,105
171377,1278688,1,16,2,1,0,106
171378,1278688,1,16,3,1,0,107
171379,1278688,1,16,4,1,0,108
171380,1278688,1,16,5,0,0,108
171381,1278688,1,16,6,1,0,109
171382,1278688,1,17,1,1,0,110
171383,1278688,1,17,2,0,0,110
171384,1278688,1,17,3,1,0,111
171385,1278688,1,17,4,0,0,111
171386,1278688,1,17,5,1,0,112
171387,1278688,1,17,6,0,1,112
171388,1278688,1,18,1,0,0,112
171389,1278688,1,18,2,1,0,113
171390,1278688,1,18,3,4,0,117
171391,1278688,1,18,4,0,0,117
171392,1278688,1,18,5,0,0,117
171393,1278688,1,18,6,1,0,118
171394,1278688,1,19,1,1,0,119
171395,1278688,1,19,2,0,0,119
171396,1278688,1,19,3,1,0,120
171397,1278688,1,19,4,1,0,121
171398,1278688,1,19,5,4,0,125
171399,1278688,1,19,6,5,0,130
171400,1278688,1,20,1,4,0,134
171401,1278688,1,20,2,0,0,134
171402,1278688,1,20,3,1,0,135
171403,1278688,1,20,4,6,0,141
171404,1278688,1,20,5,6,0,147
171405,1278688,1,20,6,1,0,148
171516,1278689,1,1,1,0,0,0
171517,1278689,1,1,2,2,0,2
171518,1278689,1,1,3,2,0,4
171519,1278689,1,1,4,0,0,4
171520,1278689,1,1,5,0,0,4
171521,1278689,1,1,6,0,0,4
171522,1278689,1,2,1,0,0,4
171523,1278689,1,2,2,4,0,8
171524,1278689,1,2,3,1,0,9
171525,1278689,1,2,4,1,0,10
171526,1278689,1,2,5,0,0,10
171527,1278689,1,2,6,0,0,10
171528,1278689,1,3,1,0,0,10
171529,1278689,1,3,2,4,0,14
171530,1278689,1,3,3,0,0,14
171531,1278689,1,3,4,6,0,20
171532,1278689,1,3,5,1,0,21
171533,1278689,1,3,6,1,0,22
171534,1278689,1,4,1,0,0,22
171535,1278689,1,4,2,2,0,24
171536,1278689,1,4,3,0,0,24
171537,1278689,1,4,4,2,0,26
171538,1278689,1,4,5,1,0,27
171539,1278689,1,4,6,1,0,28
171540,1278689,1,5,1,4,0,32
171541,1278689,1,5,2,4,0,36
171542,1278689,1,5,3,4,0,40
171543,1278689,1,5,4,4,0,44
171544,1278689,1,5,5,4,0,48
171545,1278689,1,5,6,0,0,48
171546,1278689,1,6,1,1,0,49
171547,1278689,1,6,2,0,0,49
171548,1278689,1,6,3,1,0,50
171549,1278689,1,6,4,1,0,51
171550,1278689,1,6,5,6,0,57
171551,1278689,1,6,6,0,0,57
171552,1278689,1,7,1,2,0,59
171553,1278689,1,7,2,1,0,60
171554,1278689,1,7,3,1,0,61
171555,1278689,1,7,4,1,0,62
171556,1278689,1,7,5,1,0,63
171557,1278689,1,7,6,4,0,67
171558,1278689,1,8,1,1,0,68
171559,1278689,1,8,2,0,0,68
171560,1278689,1,8,3,2,0,70
171561,1278689,1,8,4,1,0,71
171562,1278689,1,8,5,4,0,75
171563,1278689,1,8,6,1,0,76
171564,1278689,1,9,1,1,0,77
171565,1278689,1,9,2,1,0,78
171566,1278689,1,9,3,1,0,79
171567,1278689,1,9,4,6,0,85
171568,1278689,1,9,5,0,0,85
171569,1278689,1,9,6,4,0,89
171570,1278689,1,10,1,4,0,93
171571,1278689,1,10,2,1,0,94
171572,1278689,1,10,3,1,0,95
171573,1278689,1,10,4,0,0,95
171574,1278689,1,10,5,2,0,97
171575,1278689,1,10,6,0,1,97
171576,1278689,1,11,1,0,0,97
171577,1278689,1,11,2,1,0,98
171578,1278689,1,11,3,0,0,98
171579,1278689,1,11,4,0,0,98
171580,1278689,1,11,5,6,0,104
171581,1278689,1,11,6,0,0,104
171582,1278689,1,12,1,1,0,105
171583,1278689,1,12,2,0,0,105
171584,1278689,1,12,3,1,0,106
171585,1278689,1,12,4,4,0,110
171586,1278689,1,12,5,6,0,116
171587,1278689,1,12,6,4,0,120
171588,1278689,1,13,1,6,0,126
171589,1278689,1,13,2,1,0,127
171590,1278689,1,13,3,1,0,128
171591,1278689,1,13,4,0,0,128
171592,1278689,1,13,5,0,0,128
171593,1278689,1,13,6,0,1,128
171594,1278689,1,14,1,1,0,129
171595,1278689,1,14,2,1,0,130
171596,1278689,1,14,3,1,0,131
171597,1278689,1,14,4,0,1,131
171598,1278689,1,14,5,1,0,132
171599,1278689,1,14,6,1,0,133
171600,1278689,1,15,1,0,0,133
171601,1278689,1,15,2,1,0,134
171602,1278689,1,15,3,2,0,136
171603,1278689,1,15,4,0,0,136
171604,1278689,1,15,5,1,0,137
171605,1278689,1,15,6,1,0,138
171606,1278689,1,16,1,2,0,140
171607,1278689,1,16,2,1,0,141
171608,1278689,1,16,3,1,0,142
171609,1278689,1,16,4,1,0,143
171610,1278689,1,16,5,0,1,143
171611,1278689,1,16,6,1,0,144
171612,1278689,1,17,1,1,0,145
171613,1278689,1,17,2,0,0,145
171614,1278689,1,17,3,1,0,146
171615,1278689,1,17,4,1,0,147
171616,1278689,1,17,5,1,0,148
171617,1278689,1,17,6,0,0,148
171618,1278689,1,18,1,0,0,148
171619,1278689,1,18,2,1,0,149
171620,1278689,1,18,3,1,0,150
171621,1278689,1,18,4,4,0,154
171622,1278689,1,18,5,1,0,155
171623,1278689,1,18,6,1,0,156
171624,1278689,1,19,1,1,0,157
171625,1278689,1,19,2,1,0,158
171626,1278689,1,19,3,0,1,158
171627,1278689,1,19,4,4,0,162
171628,1278689,1,19,5,1,0,163
171629,1278689,1,19,6,4,0,167
171630,1278689,1,20,1,4,0,171
171631,1278689,1,20,2,1,0,172
171632,1278689,1,20,3,1,0,173
171633,1278689,1,20,4,4,0,177
171634,1278689,1,20,5,0,0,177
171635,1278689,1,20,6,2,0,179
171751,1278690,1,1,1,2,0,2
171752,1278690,1,1,2,0,0,2
171753,1278690,1,1,3,4,0,6
171754,1278690,1,1,4,2,0,8
171755,1278690,1,1,5,0,0,8
171756,1278690,1,1,6,0,0,8
171757,1278690,1,2,1,1,0,9
171758,1278690,1,2,2,0,0,9
171759,1278690,1,2,3,0,0,9
171760,1278690,1,2,4,0,0,9
171761,1278690,1,2,5,4,0,13
171762,1278690,1,2,6,0,1,13
171763,1278690,1,3,1,6,0,19
171764,1278690,1,3,2,0,0,19
171765,1278690,1,3,3,0,0,19
171766,1278690,1,3,4,1,0,20
171767,1278690,1,3,5,4,0,24
171768,1278690,1,3,6,0,1,24
171769,1278690,1,4,1,0,0,24
171770,1278690,1,4,2,0,0,24
171771,1278690,1,4,3,2,0,26
171772,1278690,1,4,4,0,0,26
171773,1278690,1,4,5,0,0,26
171774,1278690,1,4,6,1,0,27
171775,1278690,1,5,1,5,0,32
171776,1278690,1,5,2,4,0,36
171777,1278690,1,5,3,0,0,36
171778,1278690,1,5,4,1,0,37
171779,1278690,1,5,5,1,0,38
171780,1278690,1,5,6,1,0,39
171781,1278690,1,6,1,0,0,39
171782,1278690,1,6,2,0,0,39
171783,1278690,1,6,3,0,0,39
171784,1278690,1,6,4,1,0,40
171785,1278690,1,6,5,0,0,40
171786,1278690,1,6,6,0,0,40
171787,1278690,1,7,1,0,1,40
171788,1278690,1,7,2,0,0,40
171789,1278690,1,7,3,0,0,40
171790,1278690,1,7,4,0,0,40
171791,1278690,1,7,5,0,0,40
171792,1278690,1,7,6,4,0,44
171793,1278690,1,8,1,1,0,45
171794,1278690,1,8,2,0,0,45
171795,1278690,1,8,3,1,0,46
171796,1278690,1,8,4,4,0,50
171797,1278690,1,8,5,1,0,51
171798,1278690,1,8,6,1,0,52
171799,1278690,1,9,1,0,0,52
171800,1278690,1,9,2,0,0,52
171801,1278690,1,9,3,1,0,53
171802,1278690,1,9,4,0,0,53
171803,1278690,1,9,5,0,0,53
171804,1278690,1,9,6,1,0,54
171805,1278690,1,10,1,0,0,54
171806,1278690,1,10,2,1,0,55
171807,1278690,1,10,3,1,0,56
171808,1278690,1,10,4,0,0,56
171809,1278690,1,10,5,0,0,56
171810,1278690,1,10,6,0,0,56
171811,1278690,1,11,1,1,0,57
171812,1278690,1,11,2,4,0,61
171813,1278690,1,11,3,0,0,61
171814,1278690,1,11,4,0,0,61
171815,1278690,1,11,5,1,0,62
171816,1278690,1,11,6,0,0,62
171817,1278690,1,12,1,1,0,63
171818,1278690,1,12,2,1,0,64
171819,1278690,1,12,3,1,0,65
171820,1278690,1,12,4,6,0,71
171821,1278690,1,12,5,6,0,77
171822,1278690,1,12,6,1,0,78
171823,1278690,1,13,1,1,0,79
171824,1278690,1,13,2,0,0,79
171825,1278690,1,13,3,1,0,80
171826,1278690,1,13,4,1,0,81
171827,1278690,1,13,5,0,1,81
171828,1278690,1,13,6,0,0,81
171829,1278690,1,14,1,0,0,81
171830,1278690,1,14,2,2,0,83
171831,1278690,1,14,3,1,0,84
171832,1278690,1,14,4,0,0,84
171833,1278690,1,14,5,1,0,85
171834,1278690,1,14,6,4,0,89
171835,1278690,1,15,1,4,0,93
171836,1278690,1,15,2,0,0,93
171837,1278690,1,15,3,0,0,93
171838,1278690,1,15,4,1,0,94
171839,1278690,1,15,5,1,0,95
171840,1278690,1,15,6,1,0,96
171841,1278690,1,16,1,4,0,100
171842,1278690,1,16,2,0,0,100
171843,1278690,1,16,3,4,0,104
171844,1278690,1,16,4,1,0,105
171845,1278690,1,16,5,2,0,107
171846,1278690,1,16,6,4,0,111
171847,1278690,1,17,1,4,0,115
171848,1278690,1,17,2,0,0,115
171849,1278690,1,17,3,4,0,119
171850,1278690,1,17,4,4,0,123
171851,1278690,1,17,5,1,0,124
171852,1278690,1,17,6,0,0,124
171853,1278690,1,18,1,6,0,130
171854,1278690,1,18,2,4,0,134
171855,1278690,1,18,3,4,0,138
171856,1278690,1,18,4,0,0,138
171857,1278690,1,18,5,1,0,139
171858,1278690,1,18,6,1,0,140
171859,1278690,1,19,1,6,0,146
171860,1278690,1,19,2,0,1,146
171861,1278690,1,19,3,4,0,150
171862,1278690,1,19,4,1,0,151
171863,1278690,1,19,5,1,0,152
171864,1278690,1,19,6,1,0,153
171865,1278690,1,20,1,6,0,159
171866,1278690,1,20,2,0,1,159
171867,1278690,1,20,3,2,0,161
171868,1278690,1,20,4,2,0,163
171869,1278690,1,20,5,2,0,165
171870,1278690,1,20,6,4,0,169
171972,1287773,1,1,1,0,0,0
171973,1287773,1,1,2,1,0,1
171974,1287773,1,1,3,0,0,1
171975,1287773,1,1,4,0,1,1
171976,1287773,1,1,5,2,0,3
171977,1287773,1,1,6,0,0,3
171978,1287773,1,2,1,0,0,3
171979,1287773,1,2,2,1,0,4
171980,1287773,1,2,3,0,0,4
171981,1287773,1,2,4,0,0,4
171982,1287773,1,2,5,0,0,4
171983,1287773,1,2,6,4,0,8
171984,1287773,1,3,1,2,0,10
171985,1287773,1,3,2,4,0,14
171986,1287773,1,3,3,1,0,15
171987,1287773,1,3,4,2,0,17
171988,1287773,1,3,5,1,0,18
171989,1287773,1,3,6,1,0,19
171990,1287773,1,4,1,0,0,19
171991,1287773,1,4,2,4,0,23
171992,1287773,1,4,3,4,0,27
171993,1287773,1,4,4,0,0,27
171994,1287773,1,4,5,2,0,29
171995,1287773,1,4,6,1,0,30
171996,1287773,1,5,1,2,0,32
171997,1287773,1,5,2,1,0,33
171998,1287773,1,5,3,1,0,34
171999,1287773,1,5,4,1,0,35
172000,1287773,1,5,5,0,1,35
172001,1287773,1,5,6,1,0,36
172002,1287773,1,6,1,1,0,37
172003,1287773,1,6,2,1,0,38
172004,1287773,1,6,3,4,0,42
172005,1287773,1,6,4,1,0,43
172006,1287773,1,6,5,0,0,43
172007,1287773,1,6,6,1,0,44
172008,1287773,1,7,1,0,0,44
172009,1287773,1,7,2,0,0,44
172010,1287773,1,7,3,1,0,45
172011,1287773,1,7,4,0,0,45
172012,1287773,1,7,5,1,0,46
172013,1287773,1,7,6,1,0,47
172014,1287773,1,8,1,1,0,48
172015,1287773,1,8,2,4,0,52
172016,1287773,1,8,3,1,0,53
172017,1287773,1,8,4,0,0,53
172018,1287773,1,8,5,0,0,53
172019,1287773,1,8,6,4,0,57
172020,1287773,1,9,1,1,0,58
172021,1287773,1,9,2,1,0,59
172022,1287773,1,9,3,0,0,59
172023,1287773,1,9,4,0,0,59
172024,1287773,1,9,5,2,0,61
172025,1287773,1,9,6,1,0,62
172026,1287773,1,10,1,0,0,62
172027,1287773,1,10,2,4,0,66
172028,1287773,1,10,3,2,0,68
172029,1287773,1,10,4,2,0,70
172030,1287773,1,10,5,4,0,74
172031,1287773,1,10,6,1,0,75
172032,1287773,1,11,1,0,0,75
172033,1287773,1,11,2,1,0,76
172034,1287773,1,11,3,1,0,77
172035,1287773,1,11,4,4,0,81
172036,1287773,1,11,5,1,0,82
172037,1287773,1,11,6,1,0,83
172038,1287773,1,12,1,4,0,87
172039,1287773,1,12,2,1,0,88
172040,1287773,1,12,3,4,0,92
172041,1287773,1,12,4,1,0,93
172042,1287773,1,12,5,6,0,99
172043,1287773,1,12,6,4,0,103
172044,1287773,1,13,1,5,0,108
172045,1287773,1,13,2,2,0,110
172046,1287773,1,13,3,2,0,112
172047,1287773,1,13,4,1,0,113
172048,1287773,1,13,5,1,0,114
172049,1287773,1,13,6,0,0,114
172050,1287773,1,14,1,1,0,115
172051,1287773,1,14,2,6,0,121
172052,1287773,1,14,3,0,0,121
172053,1287773,1,14,4,1,0,122
172054,1287773,1,14,5,1,0,123
172055,1287773,1,14,6,4,0,127
172056,1287773,1,15,1,1,0,128
172057,1287773,1,15,2,1,0,129
172058,1287773,1,15,3,1,0,130
172059,1287773,1,15,4,4,0,134
172060,1287773,1,15,5,0,0,134
172061,1287773,1,15,6,6,0,140
172062,1287773,1,16,1,0,1,140
172063,1287773,1,16,2,1,0,141
172064,1287773,1,16,3,1,0,142
172065,1287773,1,16,4,2,0,144
172066,1287773,1,16,5,0,0,144
172067,1287773,1,16,6,0,0,144
172068,1287773,1,17,1,2,0,146
172069,1287773,1,17,2,1,0,147
172070,1287773,1,17,3,0,1,147
172071,1287773,1,17,4,1,0,148
172072,1287773,1,17,5,3,0,151
172073,1287773,1,17,6,4,0,155
172074,1287773,1,18,1,4,0,159
172075,1287773,1,18,2,1,0,160
172076,1287773,1,18,3,1,0,161
172077,1287773,1,18,4,0,1,161
172078,1287773,1,18,5,1,0,162
172079,1287773,1,18,6,6,0,168
172080,1287773,1,19,1,4,0,172
172081,1287773,1,19,2,1,0,173
172082,1287773,1,19,3,1,0,174
172083,1287773,1,19,4,4,0,178
172084,1287773,1,19,5,5,0,183
172085,1287773,1,19,6,6,0,189
172086,1287773,1,20,1,1,0,190
172087,1287773,1,20,2,1,0,191
172088,1287773,1,20,3,0,1,191
172089,1287773,1,20,4,2,0,193
172090,1287773,1,20,5,6,0,199
172091,1287773,1,20,6,1,0,200
172206,1287774,1,1,1,0,0,0
172207,1287774,1,1,2,0,0,0
172208,1287774,1,1,3,1,0,1
172209,1287774,1,1,4,1,0,2
172210,1287774,1,1,5,1,0,3
172211,1287774,1,1,6,0,0,3
172212,1287774,1,2,1,1,0,4
172213,1287774,1,2,2,0,0,4
172214,1287774,1,2,3,0,0,4
172215,1287774,1,2,4,1,0,5
172216,1287774,1,2,5,4,0,9
172217,1287774,1,2,6,0,0,9
172218,1287774,1,3,1,4,0,13
172219,1287774,1,3,2,1,0,14
172220,1287774,1,3,3,0,1,14
172221,1287774,1,3,4,4,0,18
172222,1287774,1,3,5,0,0,18
172223,1287774,1,3,6,1,0,19
172224,1287774,1,4,1,5,0,24
172225,1287774,1,4,2,4,0,28
172226,1287774,1,4,3,0,0,28
172227,1287774,1,4,4,0,0,28
172228,1287774,1,4,5,4,0,32
172229,1287774,1,4,6,6,0,38
172230,1287774,1,5,1,0,1,38
172231,1287774,1,5,2,0,0,38
172232,1287774,1,5,3,0,0,38
172233,1287774,1,5,4,0,0,38
172234,1287774,1,5,5,0,0,38
172235,1287774,1,5,6,1,0,39
172236,1287774,1,6,1,1,0,40
172237,1287774,1,6,2,4,0,44
172238,1287774,1,6,3,2,0,46
172239,1287774,1,6,4,2,0,48
172240,1287774,1,6,5,1,0,49
172241,1287774,1,6,6,1,0,50
172242,1287774,1,7,1,1,0,51
172243,1287774,1,7,2,0,0,51
172244,1287774,1,7,3,1,0,52
172245,1287774,1,7,4,0,0,52
172246,1287774,1,7,5,0,0,52
172247,1287774,1,7,6,0,0,52
172248,1287774,1,8,1,0,0,52
172249,1287774,1,8,2,1,0,53
172250,1287774,1,8,3,1,0,54
172251,1287774,1,8,4,1,0,55
172252,1287774,1,8,5,0,0,55
172253,1287774,1,8,6,4,0,59
172254,1287774,1,9,1,1,0,60
172255,1287774,1,9,2,0,0,60
172256,1287774,1,9,3,1,0,61
172257,1287774,1,9,4,0,0,61
172258,1287774,1,9,5,1,0,62
172259,1287774,1,9,6,1,0,63
172260,1287774,1,10,1,4,0,67
172261,1287774,1,10,2,0,0,67
172262,1287774,1,10,3,1,0,68
172263,1287774,1,10,4,4,0,72
172264,1287774,1,10,5,1,0,73
172265,1287774,1,10,6,0,0,73
172266,1287774,1,11,1,1,0,74
172267,1287774,1,11,2,1,0,75
172268,1287774,1,11,3,2,0,77
172269,1287774,1,11,4,4,0,81
172270,1287774,1,11,5,5,0,86
172271,1287774,1,11,6,0,0,86
172272,1287774,1,12,1,0,1,86
172273,1287774,1,12,2,1,0,87
172274,1287774,1,12,3,1,0,88
172275,1287774,1,12,4,1,0,89
172276,1287774,1,12,5,4,0,93
172277,1287774,1,12,6,1,0,94
172278,1287774,1,13,1,1,0,95
172279,1287774,1,13,2,1,0,96
172280,1287774,1,13,3,0,0,96
172281,1287774,1,13,4,1,0,97
172282,1287774,1,13,5,2,0,99
172283,1287774,1,13,6,4,0,103
172284,1287774,1,14,1,1,0,104
172285,1287774,1,14,2,1,0,105
172286,1287774,1,14,3,1,0,106
172287,1287774,1,14,4,2,0,108
172288,1287774,1,14,5,1,0,109
172289,1287774,1,14,6,0,1,109
172290,1287774,1,15,1,1,0,110
172291,1287774,1,15,2,1,0,111
172292,1287774,1,15,3,0,0,111
172293,1287774,1,15,4,0,1,111
172294,1287774,1,15,5,2,0,113
172295,1287774,1,15,6,0,0,113
172296,1287774,1,16,1,1,0,114
172297,1287774,1,16,2,0,0,114
172298,1287774,1,16,3,0,0,114
172299,1287774,1,16,4,6,0,120
172300,1287774,1,16,5,2,0,122
172301,1287774,1,16,6,1,0,123
172302,1287774,1,17,1,1,0,124
172303,1287774,1,17,2,0,1,124
172304,1287774,1,17,3,1,0,125
172305,1287774,1,17,4,0,0,125
172306,1287774,1,17,5,1,0,126
172307,1287774,1,17,6,1,0,127
172308,1287774,1,18,1,1,0,128
172309,1287774,1,18,2,1,0,129
172310,1287774,1,18,3,6,0,135
172311,1287774,1,18,4,0,0,135
172312,1287774,1,18,5,6,0,141
172313,1287774,1,18,6,0,1,141
172314,1287774,1,19,1,4,0,145
172315,1287774,1,19,2,6,0,151
172316,1287774,1,19,3,1,0,152
172317,1287774,1,19,4,1,0,153
172318,1287774,1,19,5,1,0,154
172319,1287774,1,19,6,4,0,158
172320,1287774,1,20,1,6,0,164
172321,1287774,1,20,2,0,0,164
172322,1287774,1,20,3,6,0,170
172323,1287774,1,20,4,1,0,171
172324,1287774,1,20,5,0,1,171
172325,1287774,1,20,6,1,0,172
172446,1287775,1,1,1,0,0,0
172447,1287775,1,1,2,0,0,0
172448,1287775,1,1,3,4,0,4
172449,1287775,1,1,4,4,0,8
172450,1287775,1,1,5,0,0,8
172451,1287775,1,1,6,1,0,9
172452,1287775,1,2,1,0,0,9
172453,1287775,1,2,2,1,0,10
172454,1287775,1,2,3,1,0,11
172455,1287775,1,2,4,0,0,11
172456,1287775,1,2,5,0,0,11
172457,1287775,1,2,6,4,0,15
172458,1287775,1,3,1,0,0,15
172459,1287775,1,3,2,4,0,19
172460,1287775,1,3,3,1,0,20
172461,1287775,1,3,4,6,0,26
172462,1287775,1,3,5,4,0,30
172463,1287775,1,3,6,4,0,34
172464,1287775,1,4,1,2,0,36
172465,1287775,1,4,2,1,0,37
172466,1287775,1,4,3,4,0,41
172467,1287775,1,4,4,4,0,45
172468,1287775,1,4,5,1,0,46
172469,1287775,1,4,6,1,0,47
172470,1287775,1,5,1,0,0,47
172471,1287775,1,5,2,3,0,50
172472,1287775,1,5,3,0,0,50
172473,1287775,1,5,4,0,0,50
172474,1287775,1,5,5,1,0,51
172475,1287775,1,5,6,0,0,51
172476,1287775,1,6,1,6,0,57
172477,1287775,1,6,2,2,0,59
172478,1287775,1,6,3,1,0,60
172479,1287775,1,6,4,0,0,60
172480,1287775,1,6,5,6,0,66
172481,1287775,1,6,6,0,1,66
172482,1287775,1,7,1,0,0,66
172483,1287775,1,7,2,0,0,66
172484,1287775,1,7,3,1,0,67
172485,1287775,1,7,4,0,0,67
172486,1287775,1,7,5,1,0,68
172487,1287775,1,7,6,1,0,69
172488,1287775,1,8,1,4,0,73
172489,1287775,1,8,2,1,0,74
172490,1287775,1,8,3,1,0,75
172491,1287775,1,8,4,1,0,76
172492,1287775,1,8,5,0,0,76
172493,1287775,1,8,6,2,0,78
172494,1287775,1,9,1,6,0,84
172495,1287775,1,9,2,6,0,90
172496,1287775,1,9,3,0,0,90
172497,1287775,1,9,4,6,0,96
172498,1287775,1,9,5,0,0,96
172499,1287775,1,9,6,1,0,97
172500,1287775,1,10,1,1,0,98
172501,1287775,1,10,2,0,0,98
172502,1287775,1,10,3,1,0,99
172503,1287775,1,10,4,0,1,99
172504,1287775,1,10,5,0,0,99
172505,1287775,1,10,6,0,0,99
172506,1287775,1,11,1,6,0,105
172507,1287775,1,11,2,0,0,105
172508,1287775,1,11,3,6,0,111
172509,1287775,1,11,4,1,0,112
172510,1287775,1,11,5,1,0,113
172511,1287775,1,11,6,1,0,114
172512,1287775,1,12,1,6,0,120
172513,1287775,1,12,2,0,0,120
172514,1287775,1,12,3,1,0,121
172515,1287775,1,12,4,2,0,123
172516,1287775,1,12,5,0,0,123
172517,1287775,1,12,6,1,0,124
172518,1287775,1,13,1,1,0,125
172519,1287775,1,13,2,0,0,125
172520,1287775,1,13,3,2,0,127
172521,1287775,1,13,4,1,0,128
172522,1287775,1,13,5,1,0,129
172523,1287775,1,13,6,1,0,130
172524,1287775,1,14,1,2,0,132
172525,1287775,1,14,2,0,0,132
172526,1287775,1,14,3,2,0,134
172527,1287775,1,14,4,6,0,140
172528,1287775,1,14,5,1,0,141
172529,1287775,1,14,6,2,0,143
172530,1287775,1,15,1,1,0,144
172531,1287775,1,15,2,0,0,144
172532,1287775,1,15,3,2,0,146
172533,1287775,1,15,4,1,0,147
172534,1287775,1,15,5,1,0,148
172535,1287775,1,15,6,5,0,153
172536,1287775,1,16,1,4,0,157
172537,1287775,1,16,2,1,0,158
172538,1287775,1,16,3,1,0,159
172539,1287775,1,16,4,6,0,165
172540,1287775,1,16,5,1,0,166
172541,1287775,1,16,6,4,0,170
172542,1287775,1,17,1,0,0,170
172543,1287775,1,17,2,1,0,171
172544,1287775,1,17,3,4,0,175
172545,1287775,1,17,4,1,0,176
172546,1287775,1,17,5,2,0,178
172547,1287775,1,17,6,1,0,179
172548,1287775,1,18,1,4,0,183
172549,1287775,1,18,2,7,0,190
172550,1287775,1,18,3,2,0,192
172551,1287775,1,18,4,0,1,192
172552,1287775,1,18,5,1,0,193
172553,1287775,1,18,6,1,0,194
172554,1287775,1,19,1,1,0,195
172555,1287775,1,19,2,1,0,196
172556,1287775,1,19,3,2,0,198
172557,1287775,1,19,4,1,0,199
172558,1287775,1,19,5,2,0,201
172559,1287775,1,19,6,1,0,202
172560,1287775,1,20,1,0,0,202
172561,1287775,1,20,2,1,0,203
172562,1287775,1,20,3,1,0,204
172563,1287775,1,20,4,1,0,205
172564,1287775,1,20,5,1,0,206
172565,1287775,1,20,6,1,0,207
172679,1288316,1,1,1,1,0,1
172680,1288316,1,1,2,0,0,1
172681,1288316,1,1,3,1,0,2
172682,1288316,1,1,4,1,0,3
172683,1288316,1,1,5,1,0,4
172684,1288316,1,1,6,6,0,10
172685,1288316,1,2,1,4,0,14
172686,1288316,1,2,2,0,0,14
172687,1288316,1,2,3,1,0,15
172688,1288316,1,2,4,1,0,16
172689,1288316,1,2,5,0,0,16
172690,1288316,1,2,6,2,0,18
172691,1288316,1,3,1,1,0,19
172692,1288316,1,3,2,0,0,19
172693,1288316,1,3,3,2,0,21
172694,1288316,1,3,4,0,0,21
172695,1288316,1,3,5,1,0,22
172696,1288316,1,3,6,0,0,22
172697,1288316,1,4,1,0,0,22
172698,1288316,1,4,2,4,0,26
172699,1288316,1,4,3,4,0,30
172700,1288316,1,4,4,4,0,34
172701,1288316,1,4,5,1,0,35
172702,1288316,1,4,6,1,0,36
172703,1288316,1,5,1,1,0,37
172704,1288316,1,5,2,0,0,37
172705,1288316,1,5,3,0,0,37
172706,1288316,1,5,4,1,0,38
172707,1288316,1,5,5,1,0,39
172708,1288316,1,5,6,1,0,40
172709,1288316,1,6,1,2,0,42
172710,1288316,1,6,2,1,0,43
172711,1288316,1,6,3,4,0,47
172712,1288316,1,6,4,1,0,48
172713,1288316,1,6,5,6,0,54
172714,1288316,1,6,6,2,0,56
172715,1288316,1,7,1,1,0,57
172716,1288316,1,7,2,4,0,61
172717,1288316,1,7,3,1,0,62
172718,1288316,1,7,4,0,0,62
172719,1288316,1,7,5,0,0,62
172720,1288316,1,7,6,1,0,63
172721,1288316,1,8,1,0,0,63
172722,1288316,1,8,2,2,0,65
172723,1288316,1,8,3,2,0,67
172724,1288316,1,8,4,0,1,67
172725,1288316,1,8,5,0,1,67
172726,1288316,1,8,6,1,0,68
172727,1288316,1,9,1,1,0,69
172728,1288316,1,9,2,1,0,70
172729,1288316,1,9,3,0,0,70
172730,1288316,1,9,4,1,0,71
172731,1288316,1,9,5,0,0,71
172732,1288316,1,9,6,1,0,72
172733,1288316,1,10,1,0,0,72
172734,1288316,1,10,2,1,0,73
172735,1288316,1,10,3,1,0,74
172736,1288316,1,10,4,4,0,78
172737,1288316,1,10,5,1,0,79
172738,1288316,1,10,6,1,0,80
172739,1288316,1,11,1,1,0,81
172740,1288316,1,11,2,1,0,82
172741,1288316,1,11,3,4,0,86
172742,1288316,1,11,4,1,0,87
172743,1288316,1,11,5,1,0,88
172744,1288316,1,11,6,1,0,89
172745,1288316,1,12,1,1,0,90
172746,1288316,1,12,2,1,0,91
172747,1288316,1,12,3,1,0,92
172748,1288316,1,12,4,1,0,93
172749,1288316,1,12,5,0,1,93
172750,1288316,1,12,6,1,0,94
172751,1288316,1,13,1,0,0,94
172752,1288316,1,13,2,0,0,94
172753,1288316,1,13,3,4,0,98
172754,1288316,1,13,4,1,0,99
172755,1288316,1,13,5,1,0,100
172756,1288316,1,13,6,1,0,101
172757,1288316,1,14,1,1,0,102
172758,1288316,1,14,2,1,0,103
172759,1288316,1,14,3,1,0,104
172760,1288316,1,14,4,0,0,104
172761,1288316,1,14,5,1,0,105
172762,1288316,1,14,6,0,0,105
172763,1288316,1,15,1,1,0,106
172764,1288316,1,15,2,0,0,106
172765,1288316,1,15,3,4,0,110
172766,1288316,1,15,4,1,0,111
172767,1288316,1,15,5,1,0,112
172768,1288316,1,15,6,0,0,112
172769,1288316,1,16,1,6,0,118
172770,1288316,1,16,2,0,1,118
172771,1288316,1,16,3,1,0,119
172772,1288316,1,16,4,1,0,120
172773,1288316,1,16,5,0,0,120
172774,1288316,1,16,6,1,0,121
172775,1288316,1,17,1,1,0,122
172776,1288316,1,17,2,4,0,126
172777,1288316,1,17,3,1,0,127
172778,1288316,1,17,4,0,1,127
172779,1288316,1,17,5,0,0,127
172780,1288316,1,17,6,1,0,128
172781,1288316,1,18,1,4,0,132
172782,1288316,1,18,2,0,0,132
172783,1288316,1,18,3,6,0,138
172784,1288316,1,18,4,4,0,142
172785,1288316,1,18,5,0,1,142
172786,1288316,1,18,6,0,0,142
172787,1288316,1,19,1,0,1,142
172788,1288316,1,19,2,0,1,142
172789,1288316,1,19,3,0,0,142
172790,1288316,1,19,4,0,0,142
172791,1288316,1,19,5,1,0,143
172792,1288316,1,19,6,1,0,144
172793,1288316,1,20,1,4,0,148
172794,1288316,1,20,2,6,0,154
172795,1288316,1,20,3,1,0,155
172796,1288316,1,20,4,1,0,156
172797,1288316,1,20,5,4,0,160
172798,1288316,1,20,6,2,0,162
172914,1298138,1,1,1,0,0,0
172915,1298138,1,1,2,0,1,0
172916,1298138,1,1,3,0,0,0
172917,1298138,1,1,4,4,0,4
172918,1298138,1,1,5,4,0,8
172919,1298138,1,1,6,0,0,8
172920,1298138,1,2,1,1,0,9
172921,1298138,1,2,2,1,0,10
172922,1298138,1,2,3,1,0,11
172923,1298138,1,2,4,0,0,11
172924,1298138,1,2,5,4,0,15
172925,1298138,1,2,6,2,0,17
172926,1298138,1,3,1,0,0,17
172927,1298138,1,3,2,1,0,18
172928,1298138,1,3,3,0,0,18
172929,1298138,1,3,4,0,0,18
172930,1298138,1,3,5,2,0,20
172931,1298138,1,3,6,0,0,20
172932,1298138,1,4,1,0,0,20
172933,1298138,1,4,2,4,0,24
172934,1298138,1,4,3,1,0,25
172935,1298138,1,4,4,1,0,26
172936,1298138,1,4,5,1,0,27
172937,1298138,1,4,6,4,0,31
172938,1298138,1,5,1,0,0,31
172939,1298138,1,5,2,1,0,32
172940,1298138,1,5,3,1,0,33
172941,1298138,1,5,4,4,0,37
172942,1298138,1,5,5,0,0,37
172943,1298138,1,5,6,0,1,37
172944,1298138,1,6,1,0,0,37
172945,1298138,1,6,2,0,0,37
172946,1298138,1,6,3,0,1,37
172947,1298138,1,6,4,1,0,38
172948,1298138,1,6,5,2,0,40
172949,1298138,1,6,6,1,0,41
172950,1298138,1,7,1,1,0,42
172951,1298138,1,7,2,0,0,42
172952,1298138,1,7,3,0,0,42
172953,1298138,1,7,4,0,0,42
172954,1298138,1,7,5,1,0,43
172955,1298138,1,7,6,0,0,43
172956,1298138,1,8,1,1,0,44
172957,1298138,1,8,2,4,0,48
172958,1298138,1,8,3,1,0,49
172959,1298138,1,8,4,1,0,50
172960,1298138,1,8,5,0,0,50
172961,1298138,1,8,6,1,0,51
172962,1298138,1,9,1,1,0,52
172963,1298138,1,9,2,1,0,53
172964,1298138,1,9,3,6,0,59
172965,1298138,1,9,4,0,0,59
172966,1298138,1,9,5,0,0,59
172967,1298138,1,9,6,6,0,65
172968,1298138,1,10,1,1,0,66
172969,1298138,1,10,2,2,0,68
172970,1298138,1,10,3,4,0,72
172971,1298138,1,10,4,1,0,73
172972,1298138,1,10,5,6,0,79
172973,1298138,1,10,6,0,1,79
172974,1298138,1,11,1,0,0,79
172975,1298138,1,11,2,1,0,80
172976,1298138,1,11,3,1,0,81
172977,1298138,1,11,4,1,0,82
172978,1298138,1,11,5,0,0,82
172979,1298138,1,11,6,2,0,84
172980,1298138,1,12,1,0,0,84
172981,1298138,1,12,2,2,0,86
172982,1298138,1,12,3,6,0,92
172983,1298138,1,12,4,4,0,96
172984,1298138,1,12,5,1,0,97
172985,1298138,1,12,6,2,0,99
172986,1298138,1,13,1,0,0,99
172987,1298138,1,13,2,7,0,106
172988,1298138,1,13,3,2,0,108
172989,1298138,1,13,4,4,0,112
172990,1298138,1,13,5,0,0,112
172991,1298138,1,13,6,0,0,112
172992,1298138,1,14,1,0,0,112
172993,1298138,1,14,2,4,0,116
172994,1298138,1,14,3,1,0,117
172995,1298138,1,14,4,1,0,118
172996,1298138,1,14,5,1,0,119
172997,1298138,1,14,6,6,0,125
172998,1298138,1,15,1,1,0,126
172999,1298138,1,15,2,1,0,127
173000,1298138,1,15,3,2,0,129
173001,1298138,1,15,4,1,0,130
173002,1298138,1,15,5,0,0,130
173003,1298138,1,15,6,0,0,130
173004,1298138,1,16,1,1,0,131
173005,1298138,1,16,2,1,0,132
173006,1298138,1,16,3,1,0,133
173007,1298138,1,16,4,3,0,136
173008,1298138,1,16,5,1,1,137
173009,1298138,1,16,6,0,0,137
173010,1298138,1,17,1,1,0,138
173011,1298138,1,17,2,0,0,138
173012,1298138,1,17,3,1,0,139
173013,1298138,1,17,4,0,0,139
173014,1298138,1,17,5,2,0,141
173015,1298138,1,17,6,0,0,141
173016,1298138,1,18,1,0,1,141
173017,1298138,1,18,2,1,0,142
173018,1298138,1,18,3,4,0,146
173019,1298138,1,18,4,2,0,148
173020,1298138,1,18,5,1,0,149
173021,1298138,1,18,6,1,0,150
173022,1298138,1,19,1,4,0,154
173023,1298138,1,19,2,2,0,156
173024,1298138,1,19,3,1,0,157
173025,1298138,1,19,4,2,0,159
173026,1298138,1,19,5,5,0,164
173027,1298138,1,19,6,1,0,165
173028,1298138,1,20,1,1,0,166
173029,1298138,1,20,2,2,0,168
173030,1298138,1,20,3,1,0,169
173031,1298138,1,20,4,4,0,173
173032,1298138,1,20,5,1,0,174
173033,1298138,1,20,6,0,1,174
173154,1298142,1,1,1,0,0,0
173155,1298142,1,1,2,0,0,0
173156,1298142,1,1,3,1,0,1
173157,1298142,1,1,4,4,0,5
173158,1298142,1,1,5,0,0,5
173159,1298142,1,1,6,0,0,5
173160,1298142,1,2,1,0,0,5
173161,1298142,1,2,2,4,0,9
173162,1298142,1,2,3,2,0,11
173163,1298142,1,2,4,1,0,12
173164,1298142,1,2,5,1,0,13
173165,1298142,1,2,6,1,0,14
173166,1298142,1,3,1,1,0,15
173167,1298142,1,3,2,0,0,15
173168,1298142,1,3,3,1,0,16
173169,1298142,1,3,4,6,0,22
173170,1298142,1,3,5,1,0,23
173171,1298142,1,3,6,1,0,24
173172,1298142,1,4,1,0,0,24
173173,1298142,1,4,2,4,0,28
173174,1298142,1,4,3,0,1,28
173175,1298142,1,4,4,1,0,29
173176,1298142,1,4,5,1,0,30
173177,1298142,1,4,6,0,0,30
173178,1298142,1,5,1,1,0,31
173179,1298142,1,5,2,0,0,31
173180,1298142,1,5,3,4,0,35
173181,1298142,1,5,4,1,0,36
173182,1298142,1,5,5,1,0,37
173183,1298142,1,5,6,1,0,38
173184,1298142,1,6,1,0,0,38
173185,1298142,1,6,2,2,0,40
173186,1298142,1,6,3,4,0,44
173187,1298142,1,6,4,2,0,46
173188,1298142,1,6,5,3,0,49
173189,1298142,1,6,6,0,0,49
173190,1298142,1,7,1,1,0,50
173191,1298142,1,7,2,1,0,51
173192,1298142,1,7,3,0,0,51
173193,1298142,1,7,4,1,0,52
173194,1298142,1,7,5,1,0,53
173195,1298142,1,7,6,0,0,53
173196,1298142,1,8,1,1,0,54
173197,1298142,1,8,2,1,0,55
173198,1298142,1,8,3,1,0,56
173199,1298142,1,8,4,0,0,56
173200,1298142,1,8,5,1,0,57
173201,1298142,1,8,6,1,0,58
173202,1298142,1,9,1,0,0,58
173203,1298142,1,9,2,1,0,59
173204,1298142,1,9,3,6,0,65
173205,1298142,1,9,4,4,0,69
173206,1298142,1,9,5,4,0,73
173207,1298142,1,9,6,1,0,74
173208,1298142,1,10,1,0,0,74
173209,1298142,1,10,2,1,0,75
173210,1298142,1,10,3,1,0,76
173211,1298142,1,10,4,1,0,77
173212,1298142,1,10,5,0,1,77
173213,1298142,1,10,6,1,0,78
173214,1298142,1,11,1,1,0,79
173215,1298142,1,11,2,1,0,80
173216,1298142,1,11,3,0,0,80
173217,1298142,1,11,4,1,0,81
173218,1298142,1,11,5,1,0,82
173219,1298142,1,11,6,1,0,83
173220,1298142,1,12,1,1,0,84
173221,1298142,1,12,2,1,0,85
173222,1298142,1,12,3,1,0,86
173223,1298142,1,12,4,1,0,87
173224,1298142,1,12,5,1,0,88
173225,1298142,1,12,6,1,0,89
173226,1298142,1,13,1,1,0,90
173227,1298142,1,13,2,0,1,90
173228,1298142,1,13,3,0,0,90
173229,1298142,1,13,4,4,0,94
173230,1298142,1,13,5,3,0,97
173231,1298142,1,13,6,0,1,97
173232,1298142,1,14,1,0,0,97
173233,1298142,1,14,2,0,0,97
173234,1298142,1,14,3,0,1,97
173235,1298142,1,14,4,2,0,99
173236,1298142,1,14,5,2,0,101
173237,1298142,1,14,6,0,1,101
173238,1298142,1,15,1,0,0,101
173239,1298142,1,15,2,0,0,101
173240,1298142,1,15,3,1,0,102
173241,1298142,1,15,4,1,0,103
173242,1298142,1,15,5,1,0,104
173243,1298142,1,15,6,2,0,106
173244,1298142,1,16,1,1,0,107
173245,1298142,1,16,2,1,0,108
173246,1298142,1,16,3,1,0,109
173247,1298142,1,16,4,4,0,113
173248,1298142,1,16,5,0,0,113
173249,1298142,1,16,6,0,0,113
173250,1298142,1,17,1,1,0,114
173251,1298142,1,17,2,1,0,115
173252,1298142,1,17,3,1,0,116
173253,1298142,1,17,4,1,0,117
173254,1298142,1,17,5,1,0,118
173255,1298142,1,17,6,2,0,120
173256,1298142,1,18,1,2,0,122
173257,1298142,1,18,2,1,0,123
173258,1298142,1,18,3,1,0,124
173259,1298142,1,18,4,2,0,126
173260,1298142,1,18,5,0,0,126
173261,1298142,1,18,6,1,0,127
173262,1298142,1,19,1,0,0,127
173263,1298142,1,19,2,4,0,131
173264,1298142,1,19,3,1,0,132
173265,1298142,1,19,4,2,0,134
173266,1298142,1,19,5,1,0,135
173267,1298142,1,19,6,2,0,137
173268,1298142,1,20,1,6,0,143
173269,1298142,1,20,2,0,0,143
173270,1298142,1,20,3,7,0,150
173271,1298142,1,20,4,0,1,150
173272,1298142,1,20,5,2,0,152
173273,1298142,1,20,6,1,0,153
173384,1298143,1,1,1,0,0,0
173385,1298143,1,1,2,2,0,2
173386,1298143,1,1,3,0,0,2
173387,1298143,1,1,4,0,0,2
173388,1298143,1,1,5,0,0,2
173389,1298143,1,1,6,1,0,3
173390,1298143,1,2,1,1,0,4
173391,1298143,1,2,2,0,0,4
173392,1298143,1,2,3,1,0,5
173393,1298143,1,2,4,0,0,5
173394,1298143,1,2,5,0,0,5
173395,1298143,1,2,6,0,0,5
173396,1298143,1,3,1,4,0,9
173397,1298143,1,3,2,0,0,9
173398,1298143,1,3,3,0,0,9
173399,1298143,1,3,4,1,0,10
173400,1298143,1,3,5,2,0,12
173401,1298143,1,3,6,0,0,12
173402,1298143,1,4,1,2,0,14
173403,1298143,1,4,2,0,0,14
173404,1298143,1,4,3,0,0,14
173405,1298143,1,4,4,0,0,14
173406,1298143,1,4,5,4,0,18
173407,1298143,1,4,6,0,0,18
173408,1298143,1,5,1,1,0,19
173409,1298143,1,5,2,1,0,20
173410,1298143,1,5,3,0,0,20
173411,1298143,1,5,4,0,0,20
173412,1298143,1,5,5,1,0,21
173413,1298143,1,5,6,1,0,22
173414,1298143,1,6,1,0,0,22
173415,1298143,1,6,2,2,0,24
173416,1298143,1,6,3,1,0,25
173417,1298143,1,6,4,6,0,31
173418,1298143,1,6,5,3,0,34
173419,1298143,1,6,6,2,0,36
173420,1298143,1,7,1,0,0,36
173421,1298143,1,7,2,0,0,36
173422,1298143,1,7,3,0,1,36
173423,1298143,1,7,4,0,1,36
173424,1298143,1,7,5,1,0,37
173425,1298143,1,7,6,4,0,41
173426,1298143,1,8,1,0,0,41
173427,1298143,1,8,2,0,0,41
173428,1298143,1,8,3,0,0,41
173429,1298143,1,8,4,1,0,42
173430,1298143,1,8,5,0,0,42
173431,1298143,1,8,6,0,0,42
173432,1298143,1,9,1,0,0,42
173433,1298143,1,9,2,1,0,43
173434,1298143,1,9,3,1,0,44
173435,1298143,1,9,4,0,0,44
173436,1298143,1,9,5,1,0,45
173437,1298143,1,9,6,6,0,51
173438,1298143,1,10,1,0,0,51
173439,1298143,1,10,2,1,0,52
173440,1298143,1,10,3,1,0,53
173441,1298143,1,10,4,4,0,57
173442,1298143,1,10,5,1,0,58
173443,1298143,1,10,6,2,0,60
173444,1298143,1,11,1,0,0,60
173445,1298143,1,11,2,0,0,60
173446,1298143,1,11,3,4,0,64
173447,1298143,1,11,4,0,0,64
173448,1298143,1,11,5,0,0,64
173449,1298143,1,11,6,2,0,66
173450,1298143,1,12,1,6,0,72
173451,1298143,1,12,2,2,0,74
173452,1298143,1,12,3,0,0,74
173453,1298143,1,12,4,1,0,75
173454,1298143,1,12,5,2,0,77
173455,1298143,1,12,6,1,0,78
173456,1298143,1,13,1,1,0,79
173457,1298143,1,13,2,1,0,80
173458,1298143,1,13,3,2,0,82
173459,1298143,1,13,4,2,0,84
173460,1298143,1,13,5,1,0,85
173461,1298143,1,13,6,2,0,87
173462,1298143,1,14,1,4,0,91
173463,1298143,1,14,2,0,0,91
173464,1298143,1,14,3,1,0,92
173465,1298143,1,14,4,1,0,93
173466,1298143,1,14,5,1,0,94
173467,1298143,1,14,6,2,0,96
173468,1298143,1,15,1,0,1,96
173469,1298143,1,15,2,1,0,97
173470,1298143,1,15,3,6,0,103
173471,1298143,1,15,4,1,0,104
173472,1298143,1,15,5,1,0,105
173473,1298143,1,15,6,4,0,109
173474,1298143,1,16,1,0,0,109
173475,1298143,1,16,2,2,0,111
173476,1298143,1,16,3,1,0,112
173477,1298143,1,16,4,2,0,114
173478,1298143,1,16,5,4,0,118
173479,1298143,1,16,6,1,0,119
173480,1298143,1,17,1,0,0,119
173481,1298143,1,17,2,2,0,121
173482,1298143,1,17,3,2,0,123
173483,1298143,1,17,4,4,0,127
173484,1298143,1,17,5,1,0,128
173485,1298143,1,17,6,1,0,129
173486,1298143,1,18,1,1,0,130
173487,1298143,1,18,2,0,1,130
173488,1298143,1,18,3,2,0,132
173489,1298143,1,18,4,0,0,132
173490,1298143,1,18,5,6,0,138
173491,1298143,1,18,6,0,0,138
173492,1298143,1,19,1,6,0,144
173493,1298143,1,19,2,6,0,150
173494,1298143,1,19,3,1,0,151
173495,1298143,1,19,4,0,1,151
173496,1298143,1,19,5,0,0,151
173497,1298143,1,19,6,2,0,153
173498,1298143,1,20,1,4,0,157
173499,1298143,1,20,2,0,1,157
173500,1298143,1,20,3,1,0,158
173501,1298143,1,20,4,1,0,159
173502,1298143,1,20,5,1,0,160
173503,1298143,1,20,6,2,0,162
173624,1298145,1,1,1,1,0,1
173625,1298145,1,1,2,0,0,1
173626,1298145,1,1,3,0,0,1
173627,1298145,1,1,4,4,0,5
173628,1298145,1,1,5,1,0,6
173629,1298145,1,1,6,0,0,6
173630,1298145,1,2,1,2,0,8
173631,1298145,1,2,2,0,0,8
173632,1298145,1,2,3,0,0,8
173633,1298145,1,2,4,1,0,9
173634,1298145,1,2,5,0,0,9
173635,1298145,1,2,6,0,0,9
173636,1298145,1,3,1,0,0,9
173637,1298145,1,3,2,0,0,9
173638,1298145,1,3,3,1,0,10
173639,1298145,1,3,4,0,1,10
173640,1298145,1,3,5,0,0,10
173641,1298145,1,3,6,1,0,11
173642,1298145,1,4,1,1,0,12
173643,1298145,1,4,2,0,0,12
173644,1298145,1,4,3,4,0,16
173645,1298145,1,4,4,4,0,20
173646,1298145,1,4,5,6,0,26
173647,1298145,1,4,6,1,0,27
173648,1298145,1,5,1,0,0,27
173649,1298145,1,5,2,0,1,27
173650,1298145,1,5,3,4,0,31
173651,1298145,1,5,4,0,0,31
173652,1298145,1,5,5,0,0,31
173653,1298145,1,5,6,1,0,32
173654,1298145,1,6,1,1,0,33
173655,1298145,1,6,2,1,0,34
173656,1298145,1,6,3,1,0,35
173657,1298145,1,6,4,1,0,36
173658,1298145,1,6,5,4,0,40
173659,1298145,1,6,6,1,0,41
173660,1298145,1,7,1,1,0,42
173661,1298145,1,7,2,1,0,43
173662,1298145,1,7,3,1,0,44
173663,1298145,1,7,4,1,0,45
173664,1298145,1,7,5,0,0,45
173665,1298145,1,7,6,1,0,46
173666,1298145,1,8,1,0,0,46
173667,1298145,1,8,2,4,0,50
173668,1298145,1,8,3,1,0,51
173669,1298145,1,8,4,1,0,52
173670,1298145,1,8,5,4,0,56
173671,1298145,1,8,6,2,0,58
173672,1298145,1,9,1,1,0,59
173673,1298145,1,9,2,1,0,60
173674,1298145,1,9,3,2,0,62
173675,1298145,1,9,4,1,0,63
173676,1298145,1,9,5,1,0,64
173677,1298145,1,9,6,0,0,64
173678,1298145,1,10,1,1,0,65
173679,1298145,1,10,2,0,0,65
173680,1298145,1,10,3,0,0,65
173681,1298145,1,10,4,1,0,66
173682,1298145,1,10,5,1,0,67
173683,1298145,1,10,6,0,0,67
173684,1298145,1,11,1,0,0,67
173685,1298145,1,11,2,1,0,68
173686,1298145,1,11,3,1,0,69
173687,1298145,1,11,4,1,0,70
173688,1298145,1,11,5,1,1,71
173689,1298145,1,11,6,0,0,71
173690,1298145,1,12,1,2,0,73
173691,1298145,1,12,2,4,0,77
173692,1298145,1,12,3,4,0,81
173693,1298145,1,12,4,1,0,82
173694,1298145,1,12,5,0,0,82
173695,1298145,1,12,6,2,0,84
173696,1298145,1,13,1,1,0,85
173697,1298145,1,13,2,1,0,86
173698,1298145,1,13,3,1,0,87
173699,1298145,1,13,4,1,0,88
173700,1298145,1,13,5,1,0,89
173701,1298145,1,13,6,1,0,90
173702,1298145,1,14,1,1,0,91
173703,1298145,1,14,2,1,0,92
173704,1298145,1,14,3,6,0,98
173705,1298145,1,14,4,0,0,98
173706,1298145,1,14,5,1,0,99
173707,1298145,1,14,6,0,0,99
173708,1298145,1,15,1,0,1,99
173709,1298145,1,15,2,1,0,100
173710,1298145,1,15,3,0,0,100
173711,1298145,1,15,4,1,0,101
173712,1298145,1,15,5,0,0,101
173713,1298145,1,15,6,4,0,105
173714,1298145,1,16,1,1,0,106
173715,1298145,1,16,2,2,0,108
173716,1298145,1,16,3,1,0,109
173717,1298145,1,16,4,1,0,110
173718,1298145,1,16,5,0,0,110
173719,1298145,1,16,6,1,0,111
173720,1298145,1,17,1,1,0,112
173721,1298145,1,17,2,0,0,112
173722,1298145,1,17,3,0,1,112
173723,1298145,1,17,4,0,0,112
173724,1298145,1,17,5,0,0,112
173725,1298145,1,17,6,0,0,112
173726,1298145,1,18,1,1,0,113
173727,1298145,1,18,2,0,0,113
173728,1298145,1,18,3,1,0,114
173729,1298145,1,18,4,1,0,115
173730,1298145,1,18,5,1,0,116
173731,1298145,1,18,6,6,0,122
173732,1298145,1,19,1,2,0,124
173733,1298145,1,19,2,0,0,124
173734,1298145,1,19,3,6,0,130
173735,1298145,1,19,4,0,0,130
173736,1298145,1,19,5,0,0,130
173737,1298145,1,19,6,2,0,132
173738,1298145,1,20,1,1,0,133
173739,1298145,1,20,2,6,0,139
173740,1298145,1,20,3,0,0,139
173741,1298145,1,20,4,3,0,142
173742,1298145,1,20,5,4,0,146
173743,1298145,1,20,6,0,0,146
173849,1298147,1,1,1,0,0,0
173850,1298147,1,1,2,4,0,4
173851,1298147,1,1,3,6,0,10
173852,1298147,1,1,4,0,0,10
173853,1298147,1,1,5,4,0,14
173854,1298147,1,1,6,0,0,14
173855,1298147,1,2,1,4,0,18
173856,1298147,1,2,2,1,0,19
173857,1298147,1,2,3,1,0,20
173858,1298147,1,2,4,4,0,24
173859,1298147,1,2,5,1,0,25
173860,1298147,1,2,6,4,0,29
173861,1298147,1,3,1,1,0,30
173862,1298147,1,3,2,4,0,34
173863,1298147,1,3,3,4,0,38
173864,1298147,1,3,4,0,0,38
173865,1298147,1,3,5,6,0,44
173866,1298147,1,3,6,2,0,46
173867,1298147,1,4,1,2,0,48
173868,1298147,1,4,2,0,0,48
173869,1298147,1,4,3,0,0,48
173870,1298147,1,4,4,1,0,49
173871,1298147,1,4,5,6,0,55
173872,1298147,1,4,6,1,0,56
173873,1298147,1,5,1,0,1,56
173874,1298147,1,5,2,0,0,56
173875,1298147,1,5,3,0,0,56
173876,1298147,1,5,4,0,0,56
173877,1298147,1,5,5,4,0,60
173878,1298147,1,5,6,0,0,60
173879,1298147,1,6,1,0,0,60
173880,1298147,1,6,2,4,0,64
173881,1298147,1,6,3,0,0,64
173882,1298147,1,6,4,1,0,65
173883,1298147,1,6,5,0,0,65
173884,1298147,1,6,6,0,0,65
173885,1298147,1,7,1,4,0,69
173886,1298147,1,7,2,1,0,70
173887,1298147,1,7,3,1,0,71
173888,1298147,1,7,4,1,0,72
173889,1298147,1,7,5,1,0,73
173890,1298147,1,7,6,1,0,74
173891,1298147,1,8,1,2,0,76
173892,1298147,1,8,2,1,0,77
173893,1298147,1,8,3,1,0,78
173894,1298147,1,8,4,1,0,79
173895,1298147,1,8,5,0,0,79
173896,1298147,1,8,6,2,0,81
173897,1298147,1,9,1,1,0,82
173898,1298147,1,9,2,1,0,83
173899,1298147,1,9,3,1,0,84
173900,1298147,1,9,4,0,0,84
173901,1298147,1,9,5,6,0,90
173902,1298147,1,9,6,0,0,90
173903,1298147,1,10,1,1,0,91
173904,1298147,1,10,2,2,0,93
173905,1298147,1,10,3,1,0,94
173906,1298147,1,10,4,1,0,95
173907,1298147,1,10,5,0,0,95
173908,1298147,1,10,6,2,0,97
173909,1298147,1,11,1,6,0,103
173910,1298147,1,11,2,1,0,104
173911,1298147,1,11,3,1,0,105
173912,1298147,1,11,4,1,0,106
173913,1298147,1,11,5,2,0,108
173914,1298147,1,11,6,1,0,109
173915,1298147,1,12,1,0,0,109
173916,1298147,1,12,2,1,0,110
173917,1298147,1,12,3,1,0,111
173918,1298147,1,12,4,1,0,112
173919,1298147,1,12,5,1,0,113
173920,1298147,1,12,6,1,0,114
173921,1298147,1,13,1,6,0,120
173922,1298147,1,13,2,2,0,122
173923,1298147,1,13,3,1,0,123
173924,1298147,1,13,4,1,0,124
173925,1298147,1,13,5,1,0,125
173926,1298147,1,13,6,0,1,125
173927,1298147,1,14,1,3,0,128
173928,1298147,1,14,2,0,0,128
173929,1298147,1,14,3,0,0,128
173930,1298147,1,14,4,4,0,132
173931,1298147,1,14,5,2,0,134
173932,1298147,1,14,6,0,0,134
173933,1298147,1,15,1,1,0,135
173934,1298147,1,15,2,1,0,136
173935,1298147,1,15,3,1,0,137
173936,1298147,1,15,4,4,0,141
173937,1298147,1,15,5,2,0,143
173938,1298147,1,15,6,1,0,144
173939,1298147,1,16,1,1,0,145
173940,1298147,1,16,2,0,0,145
173941,1298147,1,16,3,4,0,149
173942,1298147,1,16,4,1,0,150
173943,1298147,1,16,5,1,0,151
173944,1298147,1,16,6,1,1,152
173945,1298147,1,17,1,4,0,156
173946,1298147,1,17,2,1,0,157
173947,1298147,1,17,3,1,0,158
173948,1298147,1,17,4,1,0,159
173949,1298147,1,17,5,1,0,160
173950,1298147,1,17,6,1,0,161
173951,1298147,1,18,1,1,0,162
173952,1298147,1,18,2,6,0,168
173953,1298147,1,18,3,2,0,170
173954,1298147,1,18,4,2,0,172
173955,1298147,1,18,5,2,0,174
173956,1298147,1,18,6,2,0,176
173957,1298147,1,19,1,1,0,177
173958,1298147,1,19,2,1,0,178
173959,1298147,1,19,3,2,0,180
173960,1298147,1,19,4,1,0,181
173961,1298147,1,19,5,1,0,182
173962,1298147,1,19,6,4,0,186
173963,1298147,1,20,1,0,0,186
173964,1298147,1,20,2,2,0,188
173965,1298147,1,20,3,1,0,189
173966,1298147,1,20,4,3,0,192
173967,1298147,1,20,5,2,0,194
173968,1298147,1,20,6,6,0,200
174072,1298148,1,1,1,0,0,0
174073,1298148,1,1,2,1,0,1
174074,1298148,1,1,3,0,0,1
174075,1298148,1,1,4,0,0,1
174076,1298148,1,1,5,0,0,1
174077,1298148,1,1,6,1,0,2
174078,1298148,1,2,1,0,0,2
174079,1298148,1,2,2,2,0,4
174080,1298148,1,2,3,6,0,10
174081,1298148,1,2,4,1,0,11
174082,1298148,1,2,5,0,0,11
174083,1298148,1,2,6,0,0,11
174084,1298148,1,3,1,0,1,11
174085,1298148,1,3,2,0,0,11
174086,1298148,1,3,3,0,0,11
174087,1298148,1,3,4,4,0,15
174088,1298148,1,3,5,0,0,15
174089,1298148,1,3,6,0,0,15
174090,1298148,1,4,1,0,0,15
174091,1298148,1,4,2,0,0,15
174092,1298148,1,4,3,0,0,15
174093,1298148,1,4,4,0,0,15
174094,1298148,1,4,5,4,0,19
174095,1298148,1,4,6,1,0,20
174096,1298148,1,5,1,1,0,21
174097,1298148,1,5,2,0,0,21
174098,1298148,1,5,3,6,0,27
174099,1298148,1,5,4,0,0,27
174100,1298148,1,5,5,0,0,27
174101,1298148,1,5,6,0,0,27
174102,1298148,1,6,1,0,0,27
174103,1298148,1,6,2,0,0,27
174104,1298148,1,6,3,1,0,28
174105,1298148,1,6,4,4,0,32
174106,1298148,1,6,5,2,0,34
174107,1298148,1,6,6,1,0,35
174108,1298148,1,7,1,0,0,35
174109,1298148,1,7,2,0,0,35
174110,1298148,1,7,3,0,1,35
174111,1298148,1,7,4,1,0,36
174112,1298148,1,7,5,0,0,36
174113,1298148,1,7,6,1,0,37
174114,1298148,1,8,1,0,0,37
174115,1298148,1,8,2,0,0,37
174116,1298148,1,8,3,1,0,38
174117,1298148,1,8,4,0,0,38
174118,1298148,1,8,5,4,0,42
174119,1298148,1,8,6,0,0,42
174120,1298148,1,9,1,1,0,43
174121,1298148,1,9,2,1,0,44
174122,1298148,1,9,3,0,0,44
174123,1298148,1,9,4,2,0,46
174124,1298148,1,9,5,0,0,46
174125,1298148,1,9,6,1,0,47
174126,1298148,1,10,1,0,0,47
174127,1298148,1,10,2,0,0,47
174128,1298148,1,10,3,5,0,52
174129,1298148,1,10,4,2,0,54
174130,1298148,1,10,5,1,0,55
174131,1298148,1,10,6,0,0,55
174132,1298148,1,11,1,1,0,56
174133,1298148,1,11,2,1,0,57
174134,1298148,1,11,3,1,0,58
174135,1298148,1,11,4,2,0,60
174136,1298148,1,11,5,1,0,61
174137,1298148,1,11,6,1,0,62
174138,1298148,1,12,1,0,1,62
174139,1298148,1,12,2,1,0,63
174140,1298148,1,12,3,1,0,64
174141,1298148,1,12,4,0,0,64
174142,1298148,1,12,5,1,0,65
174143,1298148,1,12,6,0,0,65
174144,1298148,1,13,1,1,0,66
174145,1298148,1,13,2,1,0,67
174146,1298148,1,13,3,1,0,68
174147,1298148,1,13,4,6,0,74
174148,1298148,1,13,5,2,0,76
174149,1298148,1,13,6,2,0,78
174150,1298148,1,14,1,0,0,78
174151,1298148,1,14,2,2,0,80
174152,1298148,1,14,3,1,0,81
174153,1298148,1,14,4,0,0,81
174154,1298148,1,14,5,1,0,82
174155,1298148,1,14,6,0,0,82
174156,1298148,1,15,1,0,1,82
174157,1298148,1,15,2,0,0,82
174158,1298148,1,15,3,1,0,83
174159,1298148,1,15,4,0,0,83
174160,1298148,1,15,5,4,0,87
174161,1298148,1,15,6,2,0,89
174162,1298148,1,16,1,0,0,89
174163,1298148,1,16,2,2,0,91
174164,1298148,1,16,3,0,1,91
174165,1298148,1,16,4,4,0,95
174166,1298148,1,16,5,1,0,96
174167,1298148,1,16,6,1,0,97
174168,1298148,1,17,1,1,0,98
174169,1298148,1,17,2,1,0,99
174170,1298148,1,17,3,1,0,100
174171,1298148,1,17,4,1,0,101
174172,1298148,1,17,5,4,0,105
174173,1298148,1,17,6,1,0,106
174174,1298148,1,18,1,1,0,107
174175,1298148,1,18,2,1,0,108
174176,1298148,1,18,3,0,0,108
174177,1298148,1,18,4,1,0,109
174178,1298148,1,18,5,0,1,109
174179,1298148,1,18,6,0,1,109
174180,1298148,1,19,1,1,0,110
174181,1298148,1,19,2,0,1,110
174182,1298148,1,19,3,0,0,110
174183,1298148,1,19,4,0,0,110
174184,1298148,1,19,5,2,0,112
174185,1298148,1,19,6,0,0,112
174186,1298148,1,20,1,0,0,112
174187,1298148,1,20,2,0,1,112
174188,1298148,1,20,3,0,0,112
174189,1298148,1,20,4,0,1,112
174300,1298149,1,1,1,1,0,1
174301,1298149,1,1,2,0,0,1
174302,1298149,1,1,3,0,0,1
174303,1298149,1,1,4,0,0,1
174304,1298149,1,1,5,1,0,2
174305,1298149,1,1,6,0,0,2
174306,1298149,1,2,1,0,1,2
174307,1298149,1,2,2,0,0,2
174308,1298149,1,2,3,4,0,6
174309,1298149,1,2,4,0,0,6
174310,1298149,1,2,5,1,0,7
174311,1298149,1,2,6,1,0,8
174312,1298149,1,3,1,4,0,12
174313,1298149,1,3,2,1,0,13
174314,1298149,1,3,3,1,0,14
174315,1298149,1,3,4,3,0,17
174316,1298149,1,3,5,0,0,17
174317,1298149,1,3,6,1,0,18
174318,1298149,1,4,1,1,0,19
174319,1298149,1,4,2,0,0,19
174320,1298149,1,4,3,1,0,20
174321,1298149,1,4,4,0,0,20
174322,1298149,1,4,5,0,0,20
174323,1298149,1,4,6,4,0,24
174324,1298149,1,5,1,1,0,25
174325,1298149,1,5,2,1,0,26
174326,1298149,1,5,3,0,0,26
174327,1298149,1,5,4,0,1,26
174328,1298149,1,5,5,0,0,26
174329,1298149,1,5,6,0,0,26
174330,1298149,1,6,1,0,0,26
174331,1298149,1,6,2,4,0,30
174332,1298149,1,6,3,6,0,36
174333,1298149,1,6,4,1,0,37
174334,1298149,1,6,5,1,0,38
174335,1298149,1,6,6,2,0,40
174336,1298149,1,7,1,2,0,42
174337,1298149,1,7,2,1,0,43
174338,1298149,1,7,3,1,0,44
174339,1298149,1,7,4,1,0,45
174340,1298149,1,7,5,1,0,46
174341,1298149,1,7,6,0,0,46
174342,1298149,1,8,1,0,0,46
174343,1298149,1,8,2,0,0,46
174344,1298149,1,8,3,1,0,47
174345,1298149,1,8,4,1,0,48
174346,1298149,1,8,5,1,0,49
174347,1298149,1,8,6,1,0,50
174348,1298149,1,9,1,0,0,50
174349,1298149,1,9,2,1,0,51
174350,1298149,1,9,3,4,0,55
174351,1298149,1,9,4,0,1,55
174352,1298149,1,9,5,1,0,56
174353,1298149,1,9,6,1,0,57
174354,1298149,1,10,1,0,0,57
174355,1298149,1,10,2,1,0,58
174356,1298149,1,10,3,0,0,58
174357,1298149,1,10,4,1,0,59
174358,1298149,1,10,5,1,0,60
174359,1298149,1,10,6,0,1,60
174360,1298149,1,11,1,2,0,62
174361,1298149,1,11,2,1,0,63
174362,1298149,1,11,3,1,0,64
174363,1298149,1,11,4,0,0,64
174364,1298149,1,11,5,1,0,65
174365,1298149,1,11,6,1,0,66
174366,1298149,1,12,1,0,0,66
174367,1298149,1,12,2,1,0,67
174368,1298149,1,12,3,4,0,71
174369,1298149,1,12,4,1,0,72
174370,1298149,1,12,5,1,0,73
174371,1298149,1,12,6,1,0,74
174372,1298149,1,13,1,1,0,75
174373,1298149,1,13,2,1,0,76
174374,1298149,1,13,3,1,0,77
174375,1298149,1,13,4,1,0,78
174376,1298149,1,13,5,0,0,78
174377,1298149,1,13,6,1,0,79
174378,1298149,1,14,1,6,0,85
174379,1298149,1,14,2,2,0,87
174380,1298149,1,14,3,1,0,88
174381,1298149,1,14,4,1,0,89
174382,1298149,1,14,5,1,0,90
174383,1298149,1,14,6,1,0,91
174384,1298149,1,15,1,1,0,92
174385,1298149,1,15,2,4,0,96
174386,1298149,1,15,3,1,0,97
174387,1298149,1,15,4,1,0,98
174388,1298149,1,15,5,1,0,99
174389,1298149,1,15,6,1,0,100
174390,1298149,1,16,1,1,0,101
174391,1298149,1,16,2,0,0,101
174392,1298149,1,16,3,1,0,102
174393,1298149,1,16,4,1,0,103
174394,1298149,1,16,5,0,0,103
174395,1298149,1,16,6,1,0,104
174396,1298149,1,17,1,1,0,105
174397,1298149,1,17,2,1,0,106
174398,1298149,1,17,3,0,0,106
174399,1298149,1,17,4,1,0,107
174400,1298149,1,17,5,0,1,107
174401,1298149,1,17,6,1,0,108
174402,1298149,1,18,1,1,0,109
174403,1298149,1,18,2,1,0,110
174404,1298149,1,18,3,2,0,112
174405,1298149,1,18,4,4,0,116
174406,1298149,1,18,5,1,0,117
174407,1298149,1,18,6,0,1,117
174408,1298149,1,19,1,0,1,117
174409,1298149,1,19,2,0,0,117
174410,1298149,1,19,3,1,0,118
174411,1298149,1,19,4,0,1,118
174412,1298149,1,19,5,1,0,119
174413,1298149,1,19,6,1,0,120
174414,1298149,1,20,1,0,0,120
174415,1298149,1,20,2,0,0,120
174416,1298149,1,20,3,1,0,121
174417,1298149,1,20,4,1,0,122
174418,1298149,1,20,5,4,0,126
174419,1298149,1,20,6,2,0,128
174510,1298150,1,1,1,0,0,0
174511,1298150,1,1,2,0,0,0
174512,1298150,1,1,3,0,0,0
174513,1298150,1,1,4,0,0,0
174514,1298150,1,1,5,0,0,0
174515,1298150,1,1,6,1,0,1
174516,1298150,1,2,1,0,1,1
174517,1298150,1,2,2,0,0,1
174518,1298150,1,2,3,0,0,1
174519,1298150,1,2,4,0,0,1
174520,1298150,1,2,5,1,0,2
174521,1298150,1,2,6,4,0,6
174522,1298150,1,3,1,1,0,7
174523,1298150,1,3,2,0,0,7
174524,1298150,1,3,3,2,0,9
174525,1298150,1,3,4,0,0,9
174526,1298150,1,3,5,1,0,10
174527,1298150,1,3,6,0,0,10
174528,1298150,1,4,1,4,0,14
174529,1298150,1,4,2,1,0,15
174530,1298150,1,4,3,0,0,15
174531,1298150,1,4,4,0,0,15
174532,1298150,1,4,5,0,0,15
174533,1298150,1,4,6,0,1,15
174534,1298150,1,5,1,0,0,15
174535,1298150,1,5,2,3,0,18
174536,1298150,1,5,3,2,0,20
174537,1298150,1,5,4,0,0,20
174538,1298150,1,5,5,4,0,24
174539,1298150,1,5,6,0,0,24
174540,1298150,1,6,1,0,0,24
174541,1298150,1,6,2,0,0,24
174542,1298150,1,6,3,4,0,28
174543,1298150,1,6,4,3,0,31
174544,1298150,1,6,5,0,0,31
174545,1298150,1,6,6,1,0,32
174546,1298150,1,7,1,0,0,32
174547,1298150,1,7,2,3,0,35
174548,1298150,1,7,3,0,0,35
174549,1298150,1,7,4,1,0,36
174550,1298150,1,7,5,1,0,37
174551,1298150,1,7,6,4,0,41
174552,1298150,1,8,1,1,0,42
174553,1298150,1,8,2,1,0,43
174554,1298150,1,8,3,1,0,44
174555,1298150,1,8,4,0,0,44
174556,1298150,1,8,5,0,0,44
174557,1298150,1,8,6,0,0,44
174558,1298150,1,9,1,1,0,45
174559,1298150,1,9,2,0,0,45
174560,1298150,1,9,3,1,0,46
174561,1298150,1,9,4,2,0,48
174562,1298150,1,9,5,1,0,49
174563,1298150,1,9,6,1,0,50
174564,1298150,1,10,1,2,0,52
174565,1298150,1,10,2,1,0,53
174566,1298150,1,10,3,1,0,54
174567,1298150,1,10,4,4,0,58
174568,1298150,1,10,5,1,0,59
174569,1298150,1,10,6,1,0,60
174570,1298150,1,11,1,1,0,61
174571,1298150,1,11,2,0,0,61
174572,1298150,1,11,3,2,0,63
174573,1298150,1,11,4,0,0,63
174574,1298150,1,11,5,6,0,69
174575,1298150,1,11,6,1,0,70
174576,1298150,1,12,1,6,0,76
174577,1298150,1,12,2,0,0,76
174578,1298150,1,12,3,6,0,82
174579,1298150,1,12,4,6,0,88
174580,1298150,1,12,5,0,0,88
174581,1298150,1,12,6,3,0,91
174582,1298150,1,13,1,0,0,91
174583,1298150,1,13,2,0,1,91
174584,1298150,1,13,3,0,0,91
174585,1298150,1,13,4,4,0,95
174586,1298150,1,13,5,0,0,95
174587,1298150,1,13,6,1,0,96
174588,1298150,1,14,1,0,0,96
174589,1298150,1,14,2,0,1,96
174590,1298150,1,14,3,0,0,96
174591,1298150,1,14,4,2,0,98
174592,1298150,1,14,5,0,0,98
174593,1298150,1,14,6,0,1,98
174594,1298150,1,15,1,1,0,99
174595,1298150,1,15,2,1,0,100
174596,1298150,1,15,3,1,0,101
174597,1298150,1,15,4,2,0,103
174598,1298150,1,15,5,2,0,105
174599,1298150,1,15,6,1,0,106
174600,1298150,1,16,1,1,0,107
174601,1298150,1,16,2,4,0,111
174602,1298150,1,16,3,0,0,111
174603,1298150,1,16,4,4,0,115
174604,1298150,1,16,5,0,1,115
174605,1298150,1,16,6,1,0,116
174606,1298150,1,17,1,1,0,117
174607,1298150,1,17,2,2,0,119
174608,1298150,1,17,3,1,0,120
174609,1298150,1,17,4,0,1,120
174610,1298150,1,17,5,2,0,122
174611,1298150,1,17,6,3,0,125
174612,1298150,1,18,1,0,0,125
174613,1298150,1,18,2,4,0,129
174614,1298150,1,18,3,4,0,133
174615,1298150,1,18,4,0,0,133
174616,1298150,1,18,5,1,0,134
174617,1298150,1,18,6,1,0,135
174618,1298150,1,19,1,1,0,136
174619,1298150,1,19,2,1,0,137
174620,1298150,1,19,3,6,0,143
174621,1298150,1,19,4,4,0,147
174622,1298150,1,19,5,1,0,148
174623,1298150,1,19,6,1,0,149
174624,1298150,1,20,1,2,0,151
174625,1298150,1,20,2,0,1,151
174626,1298150,1,20,3,6,0,157
174627,1298150,1,20,4,0,0,157
174628,1298150,1,20,5,0,0,157
174629,1298150,1,20,6,2,0,159
174750,1298151,1,1,1,1,0,1
174751,1298151,1,1,2,0,0,1
174752,1298151,1,1,3,6,0,7
174753,1298151,1,1,4,0,0,7
174754,1298151,1,1,5,4,0,11
174755,1298151,1,1,6,1,0,12
174756,1298151,1,2,1,0,0,12
174757,1298151,1,2,2,1,0,13
174758,1298151,1,2,3,1,0,14
174759,1298151,1,2,4,1,0,15
174760,1298151,1,2,5,1,0,16
174761,1298151,1,2,6,0,0,16
174762,1298151,1,3,1,0,0,16
174763,1298151,1,3,2,0,0,16
174764,1298151,1,3,3,1,0,17
174765,1298151,1,3,4,2,0,19
174766,1298151,1,3,5,0,0,19
174767,1298151,1,3,6,0,0,19
174768,1298151,1,4,1,3,0,22
174769,1298151,1,4,2,4,0,26
174770,1298151,1,4,3,4,0,30
174771,1298151,1,4,4,0,0,30
174772,1298151,1,4,5,1,0,31
174773,1298151,1,4,6,2,0,33
174774,1298151,1,5,1,4,0,37
174775,1298151,1,5,2,4,0,41
174776,1298151,1,5,3,0,0,41
174777,1298151,1,5,4,0,0,41
174778,1298151,1,5,5,1,0,42
174779,1298151,1,5,6,1,0,43
174780,1298151,1,6,1,0,1,43
174781,1298151,1,6,2,1,0,44
174782,1298151,1,6,3,0,0,44
174783,1298151,1,6,4,1,0,45
174784,1298151,1,6,5,0,0,45
174785,1298151,1,6,6,2,0,47
174786,1298151,1,7,1,0,1,47
174787,1298151,1,7,2,0,0,47
174788,1298151,1,7,3,1,0,48
174789,1298151,1,7,4,1,0,49
174790,1298151,1,7,5,1,0,50
174791,1298151,1,7,6,1,0,51
174792,1298151,1,8,1,2,0,53
174793,1298151,1,8,2,0,0,53
174794,1298151,1,8,3,1,0,54
174795,1298151,1,8,4,1,0,55
174796,1298151,1,8,5,1,0,56
174797,1298151,1,8,6,1,0,57
174798,1298151,1,9,1,1,0,58
174799,1298151,1,9,2,1,0,59
174800,1298151,1,9,3,1,0,60
174801,1298151,1,9,4,0,1,60
174802,1298151,1,9,5,2,0,62
174803,1298151,1,9,6,1,0,63
174804,1298151,1,10,1,0,1,63
174805,1298151,1,10,2,1,0,64
174806,1298151,1,10,3,6,0,70
174807,1298151,1,10,4,0,0,70
174808,1298151,1,10,5,1,0,71
174809,1298151,1,10,6,1,0,72
174810,1298151,1,11,1,1,0,73
174811,1298151,1,11,2,2,0,75
174812,1298151,1,11,3,0,0,75
174813,1298151,1,11,4,1,0,76
174814,1298151,1,11,5,0,0,76
174815,1298151,1,11,6,0,1,76
174816,1298151,1,12,1,1,0,77
174817,1298151,1,12,2,0,0,77
174818,1298151,1,12,3,0,0,77
174819,1298151,1,12,4,1,0,78
174820,1298151,1,12,5,0,0,78
174821,1298151,1,12,6,1,0,79
174822,1298151,1,13,1,1,0,80
174823,1298151,1,13,2,0,0,80
174824,1298151,1,13,3,3,0,83
174825,1298151,1,13,4,1,0,84
174826,1298151,1,13,5,1,0,85
174827,1298151,1,13,6,1,0,86
174828,1298151,1,14,1,1,0,87
174829,1298151,1,14,2,3,0,90
174830,1298151,1,14,3,2,0,92
174831,1298151,1,14,4,0,0,92
174832,1298151,1,14,5,1,0,93
174833,1298151,1,14,6,1,0,94
174834,1298151,1,15,1,0,0,94
174835,1298151,1,15,2,4,0,98
174836,1298151,1,15,3,6,0,104
174837,1298151,1,15,4,1,0,105
174838,1298151,1,15,5,0,0,105
174839,1298151,1,15,6,1,0,106
174840,1298151,1,16,1,0,0,106
174841,1298151,1,16,2,1,0,107
174842,1298151,1,16,3,1,0,108
174843,1298151,1,16,4,1,0,109
174844,1298151,1,16,5,0,0,109
174845,1298151,1,16,6,1,0,110
174846,1298151,1,17,1,2,0,112
174847,1298151,1,17,2,1,0,113
174848,1298151,1,17,3,1,0,114
174849,1298151,1,17,4,1,0,115
174850,1298151,1,17,5,1,0,116
174851,1298151,1,17,6,4,0,120
174852,1298151,1,18,1,0,1,120
174853,1298151,1,18,2,4,0,124
174854,1298151,1,18,3,4,0,128
174855,1298151,1,18,4,0,0,128
174856,1298151,1,18,5,1,0,129
174857,1298151,1,18,6,0,1,129
174858,1298151,1,19,1,4,0,133
174859,1298151,1,19,2,1,0,134
174860,1298151,1,19,3,0,1,134
174861,1298151,1,19,4,0,0,134
174862,1298151,1,19,5,0,0,134
174863,1298151,1,19,6,0,0,134
174864,1298151,1,20,1,0,0,134
174865,1298151,1,20,2,0,0,134
174866,1298151,1,20,3,6,0,140
174867,1298151,1,20,4,2,0,142
174868,1298151,1,20,5,0,0,142
174869,1298151,1,20,6,2,0,144
174990,1298153,1,1,1,0,0,0
174991,1298153,1,1,2,1,0,1
174992,1298153,1,1,3,1,0,2
174993,1298153,1,1,4,0,0,2
174994,1298153,1,1,5,0,0,2
174995,1298153,1,1,6,0,0,2
174996,1298153,1,2,1,0,0,2
174997,1298153,1,2,2,4,0,6
174998,1298153,1,2,3,0,0,6
174999,1298153,1,2,4,0,0,6
175000,1298153,1,2,5,0,1,6
175001,1298153,1,2,6,0,0,6
175002,1298153,1,3,1,0,0,6
175003,1298153,1,3,2,4,0,10
175004,1298153,1,3,3,2,0,12
175005,1298153,1,3,4,1,0,13
175006,1298153,1,3,5,1,0,14
175007,1298153,1,3,6,2,0,16
175008,1298153,1,4,1,1,0,17
175009,1298153,1,4,2,0,0,17
175010,1298153,1,4,3,0,0,17
175011,1298153,1,4,4,1,0,18
175012,1298153,1,4,5,4,0,22
175013,1298153,1,4,6,0,0,22
175014,1298153,1,5,1,0,0,22
175015,1298153,1,5,2,0,0,22
175016,1298153,1,5,3,1,0,23
175017,1298153,1,5,4,1,0,24
175018,1298153,1,5,5,0,0,24
175019,1298153,1,5,6,1,0,25
175020,1298153,1,6,1,0,0,25
175021,1298153,1,6,2,2,0,27
175022,1298153,1,6,3,4,0,31
175023,1298153,1,6,4,0,0,31
175024,1298153,1,6,5,1,0,32
175025,1298153,1,6,6,4,0,36
175026,1298153,1,7,1,1,0,37
175027,1298153,1,7,2,1,0,38
175028,1298153,1,7,3,0,0,38
175029,1298153,1,7,4,0,0,38
175030,1298153,1,7,5,1,0,39
175031,1298153,1,7,6,4,0,43
175032,1298153,1,8,1,1,0,44
175033,1298153,1,8,2,2,0,46
175034,1298153,1,8,3,1,0,47
175035,1298153,1,8,4,1,0,48
175036,1298153,1,8,5,1,0,49
175037,1298153,1,8,6,1,0,50
175038,1298153,1,9,1,2,0,52
175039,1298153,1,9,2,0,0,52
175040,1298153,1,9,3,2,0,54
175041,1298153,1,9,4,2,0,56
175042,1298153,1,9,5,1,0,57
175043,1298153,1,9,6,1,0,58
175044,1298153,1,10,1,0,0,58
175045,1298153,1,10,2,1,0,59
175046,1298153,1,10,3,1,0,60
175047,1298153,1,10,4,1,0,61
175048,1298153,1,10,5,2,0,63
175049,1298153,1,10,6,0,0,63
175050,1298153,1,11,1,0,0,63
175051,1298153,1,11,2,1,0,64
175052,1298153,1,11,3,1,0,65
175053,1298153,1,11,4,3,0,68
175054,1298153,1,11,5,4,0,72
175055,1298153,1,11,6,1,0,73
175056,1298153,1,12,1,1,0,74
175057,1298153,1,12,2,1,0,75
175058,1298153,1,12,3,0,1,75
175059,1298153,1,12,4,1,0,76
175060,1298153,1,12,5,1,0,77
175061,1298153,1,12,6,1,0,78
175062,1298153,1,13,1,2,0,80
175063,1298153,1,13,2,1,0,81
175064,1298153,1,13,3,1,0,82
175065,1298153,1,13,4,6,0,88
175066,1298153,1,13,5,0,0,88
175067,1298153,1,13,6,4,0,92
175068,1298153,1,14,1,3,0,95
175069,1298153,1,14,2,2,0,97
175070,1298153,1,14,3,0,1,97
175071,1298153,1,14,4,1,0,98
175072,1298153,1,14,5,0,0,98
175073,1298153,1,14,6,1,0,99
175074,1298153,1,15,1,1,0,100
175075,1298153,1,15,2,2,0,102
175076,1298153,1,15,3,0,0,102
175077,1298153,1,15,4,4,0,106
175078,1298153,1,15,5,0,1,106
175079,1298153,1,15,6,0,0,106
175080,1298153,1,16,1,1,0,107
175081,1298153,1,16,2,2,0,109
175082,1298153,1,16,3,0,0,109
175083,1298153,1,16,4,1,0,110
175084,1298153,1,16,5,1,0,111
175085,1298153,1,16,6,0,1,111
175086,1298153,1,17,1,0,0,111
175087,1298153,1,17,2,0,0,111
175088,1298153,1,17,3,4,0,115
175089,1298153,1,17,4,2,0,117
175090,1298153,1,17,5,1,0,118
175091,1298153,1,17,6,1,0,119
175092,1298153,1,18,1,1,0,120
175093,1298153,1,18,2,0,0,120
175094,1298153,1,18,3,0,1,120
175095,1298153,1,18,4,2,0,122
175096,1298153,1,18,5,0,0,122
175097,1298153,1,18,6,4,0,126
175098,1298153,1,19,1,0,0,126
175099,1298153,1,19,2,1,0,127
175100,1298153,1,19,3,8,0,135
175101,1298153,1,19,4,1,0,136
175102,1298153,1,19,5,1,0,137
175103,1298153,1,19,6,0,0,137
175104,1298153,1,20,1,1,0,138
175105,1298153,1,20,2,2,0,140
175106,1298153,1,20,3,4,0,144
175107,1298153,1,20,4,7,0,151
175108,1298153,1,20,5,1,0,152
175109,1298153,1,20,6,5,0,157
175209,1298154,1,1,1,0,0,0
175210,1298154,1,1,2,1,0,1
175211,1298154,1,1,3,2,0,3
175212,1298154,1,1,4,0,0,3
175213,1298154,1,1,5,0,0,3
175214,1298154,1,1,6,0,0,3
175215,1298154,1,2,1,4,0,7
175216,1298154,1,2,2,1,0,8
175217,1298154,1,2,3,3,0,11
175218,1298154,1,2,4,0,0,11
175219,1298154,1,2,5,0,0,11
175220,1298154,1,2,6,4,0,15
175221,1298154,1,3,1,6,0,21
175222,1298154,1,3,2,0,0,21
175223,1298154,1,3,3,0,1,21
175224,1298154,1,3,4,1,0,22
175225,1298154,1,3,5,0,0,22
175226,1298154,1,3,6,4,0,26
175227,1298154,1,4,1,1,0,27
175228,1298154,1,4,2,4,0,31
175229,1298154,1,4,3,1,0,32
175230,1298154,1,4,4,1,0,33
175231,1298154,1,4,5,0,0,33
175232,1298154,1,4,6,4,0,37
175233,1298154,1,5,1,0,0,37
175234,1298154,1,5,2,4,0,41
175235,1298154,1,5,3,0,0,41
175236,1298154,1,5,4,1,0,42
175237,1298154,1,5,5,1,0,43
175238,1298154,1,5,6,2,0,45
175239,1298154,1,6,1,2,0,47
175240,1298154,1,6,2,4,0,51
175241,1298154,1,6,3,0,0,51
175242,1298154,1,6,4,2,0,53
175243,1298154,1,6,5,0,0,53
175244,1298154,1,6,6,6,0,59
175245,1298154,1,7,1,4,0,63
175246,1298154,1,7,2,1,0,64
175247,1298154,1,7,3,0,0,64
175248,1298154,1,7,4,0,0,64
175249,1298154,1,7,5,1,0,65
175250,1298154,1,7,6,0,0,65
175251,1298154,1,8,1,0,0,65
175252,1298154,1,8,2,0,0,65
175253,1298154,1,8,3,1,0,66
175254,1298154,1,8,4,1,0,67
175255,1298154,1,8,5,1,0,68
175256,1298154,1,8,6,1,0,69
175257,1298154,1,9,1,1,0,70
175258,1298154,1,9,2,0,0,70
175259,1298154,1,9,3,1,0,71
175260,1298154,1,9,4,0,0,71
175261,1298154,1,9,5,2,0,73
175262,1298154,1,9,6,1,0,74
175263,1298154,1,10,1,5,0,79
175264,1298154,1,10,2,1,0,80
175265,1298154,1,10,3,1,0,81
175266,1298154,1,10,4,4,0,85
175267,1298154,1,10,5,6,0,91
175268,1298154,1,10,6,1,0,92
175269,1298154,1,11,1,1,0,93
175270,1298154,1,11,2,1,0,94
175271,1298154,1,11,3,1,0,95
175272,1298154,1,11,4,1,0,96
175273,1298154,1,11,5,0,0,96
175274,1298154,1,11,6,1,0,97
175275,1298154,1,12,1,2,0,99
175276,1298154,1,12,2,1,0,100
175277,1298154,1,12,3,1,0,101
175278,1298154,1,12,4,1,0,102
175279,1298154,1,12,5,1,0,103
175280,1298154,1,12,6,0,1,103
175281,1298154,1,13,1,0,0,103
175282,1298154,1,13,2,0,1,103
175283,1298154,1,13,3,5,0,108
175284,1298154,1,13,4,0,0,108
175285,1298154,1,13,5,1,0,109
175286,1298154,1,13,6,0,0,109
175287,1298154,1,14,1,1,0,110
175288,1298154,1,14,2,1,0,111
175289,1298154,1,14,3,1,0,112
175290,1298154,1,14,4,1,0,113
175291,1298154,1,14,5,1,0,114
175292,1298154,1,14,6,2,0,116
175293,1298154,1,15,1,1,0,117
175294,1298154,1,15,2,2,0,119
175295,1298154,1,15,3,6,0,125
175296,1298154,1,15,4,0,0,125
175297,1298154,1,15,5,2,0,127
175298,1298154,1,15,6,0,0,127
175299,1298154,1,16,1,4,0,131
175300,1298154,1,16,2,1,0,132
175301,1298154,1,16,3,0,1,132
175302,1298154,1,16,4,0,1,132
175303,1298154,1,16,5,0,0,132
175304,1298154,1,16,6,1,0,133
175305,1298154,1,17,1,1,0,134
175306,1298154,1,17,2,4,0,138
175307,1298154,1,17,3,0,1,138
175308,1298154,1,17,4,1,0,139
175309,1298154,1,17,5,4,0,143
175310,1298154,1,17,6,1,0,144
175311,1298154,1,18,1,1,0,145
175312,1298154,1,18,2,1,0,146
175313,1298154,1,18,3,1,0,147
175314,1298154,1,18,4,2,0,149
175315,1298154,1,18,5,0,1,149
175316,1298154,1,18,6,1,0,150
175317,1298154,1,19,1,2,0,152
175318,1298154,1,19,2,0,1,152
175319,1298154,1,19,3,1,0,153
175320,1298154,1,19,4,0,0,153
175321,1298154,1,19,5,3,0,156
175322,1298154,1,19,6,0,1,156
175323,1298154,1,20,1,1,0,157
175324,1298154,1,20,2,0,1,157
175412,1298156,1,1,1,0,0,0
175413,1298156,1,1,2,2,0,2
175414,1298156,1,1,3,0,0,2
175415,1298156,1,1,4,0,0,2
175416,1298156,1,1,5,0,0,2
175417,1298156,1,1,6,0,1,2
175418,1298156,1,2,1,0,0,2
175419,1298156,1,2,2,1,0,3
175420,1298156,1,2,3,1,0,4
175421,1298156,1,2,4,4,0,8
175422,1298156,1,2,5,1,0,9
175423,1298156,1,2,6,1,0,10
175424,1298156,1,3,1,0,0,10
175425,1298156,1,3,2,0,0,10
175426,1298156,1,3,3,4,0,14
175427,1298156,1,3,4,1,0,15
175428,1298156,1,3,5,12,0,27
175429,1298156,1,3,6,4,0,31
175430,1298156,1,4,1,0,0,31
175431,1298156,1,4,2,6,0,37
175432,1298156,1,4,3,4,0,41
175433,1298156,1,4,4,1,0,42
175434,1298156,1,4,5,0,0,42
175435,1298156,1,4,6,0,0,42
175436,1298156,1,5,1,0,0,42
175437,1298156,1,5,2,6,0,48
175438,1298156,1,5,3,2,0,50
175439,1298156,1,5,4,0,0,50
175440,1298156,1,5,5,6,0,56
175441,1298156,1,5,6,2,0,58
175442,1298156,1,6,1,1,0,59
175443,1298156,1,6,2,1,0,60
175444,1298156,1,6,3,0,0,60
175445,1298156,1,6,4,1,0,61
175446,1298156,1,6,5,1,0,62
175447,1298156,1,6,6,1,0,63
175448,1298156,1,7,1,0,0,63
175449,1298156,1,7,2,1,0,64
175450,1298156,1,7,3,2,0,66
175451,1298156,1,7,4,0,0,66
175452,1298156,1,7,5,0,0,66
175453,1298156,1,7,6,0,0,66
175454,1298156,1,8,1,4,0,70
175455,1298156,1,8,2,1,0,71
175456,1298156,1,8,3,1,0,72
175457,1298156,1,8,4,1,0,73
175458,1298156,1,8,5,1,0,74
175459,1298156,1,8,6,0,0,74
175460,1298156,1,9,1,0,0,74
175461,1298156,1,9,2,1,0,75
175462,1298156,1,9,3,4,0,79
175463,1298156,1,9,4,1,0,80
175464,1298156,1,9,5,6,0,86
175465,1298156,1,9,6,1,0,87
175466,1298156,1,10,1,1,0,88
175467,1298156,1,10,2,0,0,88
175468,1298156,1,10,3,1,0,89
175469,1298156,1,10,4,1,0,90
175470,1298156,1,10,5,0,0,90
175471,1298156,1,10,6,1,0,91
175472,1298156,1,11,1,0,0,91
175473,1298156,1,11,2,2,0,93
175474,1298156,1,11,3,1,0,94
175475,1298156,1,11,4,4,0,98
175476,1298156,1,11,5,6,0,104
175477,1298156,1,11,6,13,0,117
175478,1298156,1,12,1,0,0,117
175479,1298156,1,12,2,1,0,118
175480,1298156,1,12,3,4,0,122
175481,1298156,1,12,4,1,0,123
175482,1298156,1,12,5,0,0,123
175483,1298156,1,12,6,6,0,129
175484,1298156,1,13,1,0,0,129
175485,1298156,1,13,2,6,0,135
175486,1298156,1,13,3,1,0,136
175487,1298156,1,13,4,0,0,136
175488,1298156,1,13,5,4,0,140
175489,1298156,1,13,6,2,0,142
175490,1298156,1,14,1,6,0,148
175491,1298156,1,14,2,6,0,154
175492,1298156,1,14,3,4,0,158
175493,1298156,1,14,4,2,0,160
175494,1298156,1,14,5,4,0,164
175495,1298156,1,14,6,1,0,165
175496,1298156,1,15,1,1,0,166
175497,1298156,1,15,2,4,0,170
175498,1298156,1,15,3,0,1,170
175499,1298156,1,15,4,4,0,174
175500,1298156,1,15,5,1,0,175
175501,1298156,1,15,6,1,0,176
175502,1298156,1,16,1,1,0,177
175503,1298156,1,16,2,0,0,177
175504,1298156,1,16,3,1,0,178
175505,1298156,1,16,4,1,0,179
175506,1298156,1,16,5,0,0,179
175507,1298156,1,16,6,1,0,180
175508,1298156,1,17,1,0,1,180
175509,1298156,1,17,2,1,0,181
175510,1298156,1,17,3,0,0,181
175511,1298156,1,17,4,1,0,182
175512,1298156,1,17,5,1,0,183
175513,1298156,1,17,6,6,0,189
175514,1298156,1,18,1,1,0,190
175515,1298156,1,18,2,1,0,191
175516,1298156,1,18,3,0,0,191
175517,1298156,1,18,4,2,0,193
175518,1298156,1,18,5,0,0,193
175519,1298156,1,18,6,1,0,194
175520,1298156,1,19,1,1,0,195
175521,1298156,1,19,2,2,0,197
175522,1298156,1,19,3,0,1,197
175523,1298156,1,19,4,0,0,197
175524,1298156,1,19,5,0,0,197
175525,1298156,1,19,6,1,0,198
175526,1298156,1,20,1,1,0,199
175527,1298156,1,20,2,0,0,199
175528,1298156,1,20,3,4,0,203
175529,1298156,1,20,4,1,1,204
175530,1298156,1,20,5,0,0,204
175531,1298156,1,20,6,1,0,205
175631,1298157,1,1,1,0,0,0
175632,1298157,1,1,2,1,0,1
175633,1298157,1,1,3,4,0,5
175634,1298157,1,1,4,2,0,7
175635,1298157,1,1,5,0,0,7
175636,1298157,1,1,6,0,0,7
175637,1298157,1,2,1,0,0,7
175638,1298157,1,2,2,1,0,8
175639,1298157,1,2,3,0,0,8
175640,1298157,1,2,4,1,0,9
175641,1298157,1,2,5,0,0,9
175642,1298157,1,2,6,0,0,9
175643,1298157,1,3,1,2,0,11
175644,1298157,1,3,2,0,0,11
175645,1298157,1,3,3,0,0,11
175646,1298157,1,3,4,0,1,11
175647,1298157,1,3,5,1,0,12
175648,1298157,1,3,6,6,0,18
175649,1298157,1,4,1,1,0,19
175650,1298157,1,4,2,0,0,19
175651,1298157,1,4,3,4,0,23
175652,1298157,1,4,4,0,0,23
175653,1298157,1,4,5,0,0,23
175654,1298157,1,4,6,0,0,23
175655,1298157,1,5,1,0,0,23
175656,1298157,1,5,2,1,0,24
175657,1298157,1,5,3,2,0,26
175658,1298157,1,5,4,0,0,26
175659,1298157,1,5,5,0,0,26
175660,1298157,1,5,6,2,0,28
175661,1298157,1,6,1,0,0,28
175662,1298157,1,6,2,2,0,30
175663,1298157,1,6,3,1,0,31
175664,1298157,1,6,4,0,0,31
175665,1298157,1,6,5,1,0,32
175666,1298157,1,6,6,0,0,32
175667,1298157,1,7,1,1,0,33
175668,1298157,1,7,2,1,0,34
175669,1298157,1,7,3,0,0,34
175670,1298157,1,7,4,2,0,36
175671,1298157,1,7,5,1,0,37
175672,1298157,1,7,6,1,0,38
175673,1298157,1,8,1,1,0,39
175674,1298157,1,8,2,1,0,40
175675,1298157,1,8,3,1,0,41
175676,1298157,1,8,4,6,0,47
175677,1298157,1,8,5,0,0,47
175678,1298157,1,8,6,1,0,48
175679,1298157,1,9,1,0,0,48
175680,1298157,1,9,2,1,0,49
175681,1298157,1,9,3,2,0,51
175682,1298157,1,9,4,0,0,51
175683,1298157,1,9,5,1,0,52
175684,1298157,1,9,6,1,0,53
175685,1298157,1,10,1,0,0,53
175686,1298157,1,10,2,4,0,57
175687,1298157,1,10,3,6,0,63
175688,1298157,1,10,4,1,0,64
175689,1298157,1,10,5,1,0,65
175690,1298157,1,10,6,2,0,67
175691,1298157,1,11,1,1,0,68
175692,1298157,1,11,2,0,0,68
175693,1298157,1,11,3,1,0,69
175694,1298157,1,11,4,4,0,73
175695,1298157,1,11,5,4,0,77
175696,1298157,1,11,6,1,0,78
175697,1298157,1,12,1,1,0,79
175698,1298157,1,12,2,1,0,80
175699,1298157,1,12,3,1,0,81
175700,1298157,1,12,4,2,0,83
175701,1298157,1,12,5,1,0,84
175702,1298157,1,12,6,0,1,84
175703,1298157,1,13,1,4,0,88
175704,1298157,1,13,2,1,0,89
175705,1298157,1,13,3,1,0,90
175706,1298157,1,13,4,2,0,92
175707,1298157,1,13,5,1,0,93
175708,1298157,1,13,6,2,0,95
175709,1298157,1,14,1,1,0,96
175710,1298157,1,14,2,4,0,100
175711,1298157,1,14,3,4,0,104
175712,1298157,1,14,4,0,0,104
175713,1298157,1,14,5,1,0,105
175714,1298157,1,14,6,1,0,106
175715,1298157,1,15,1,1,0,107
175716,1298157,1,15,2,0,0,107
175717,1298157,1,15,3,4,0,111
175718,1298157,1,15,4,1,0,112
175719,1298157,1,15,5,0,0,112
175720,1298157,1,15,6,2,0,114
175721,1298157,1,16,1,4,0,118
175722,1298157,1,16,2,4,0,122
175723,1298157,1,16,3,1,0,123
175724,1298157,1,16,4,4,0,127
175725,1298157,1,16,5,0,0,127
175726,1298157,1,16,6,1,0,128
175727,1298157,1,17,1,3,0,131
175728,1298157,1,17,2,4,0,135
175729,1298157,1,17,3,6,0,141
175730,1298157,1,17,4,1,0,142
175731,1298157,1,17,5,1,0,143
175732,1298157,1,17,6,1,0,144
175733,1298157,1,18,1,1,0,145
175734,1298157,1,18,2,2,0,147
175735,1298157,1,18,3,1,0,148
175736,1298157,1,18,4,1,0,149
175737,1298157,1,18,5,4,0,153
175738,1298157,1,18,6,1,0,154
175739,1298157,1,19,1,4,0,158
175740,1298157,1,19,2,0,0,158
175741,1298157,1,19,3,2,0,160
175742,1298157,1,19,4,1,0,161
175743,1298157,1,19,5,1,0,162
175744,1298157,1,19,6,0,0,162
175745,1298157,1,20,1,1,0,163
175746,1298157,1,20,2,2,0,165
175747,1298157,1,20,3,1,0,166
175748,1298157,1,20,4,6,0,172
175749,1298157,1,20,5,1,0,173
175750,1298157,1,20,6,6,0,179
175871,1298158,1,1,1,3,0,3
175872,1298158,1,1,2,2,0,5
175873,1298158,1,1,3,1,0,6
175874,1298158,1,1,4,4,0,10
175875,1298158,1,1,5,4,0,14
175876,1298158,1,1,6,0,0,14
175877,1298158,1,2,1,4,0,18
175878,1298158,1,2,2,4,0,22
175879,1298158,1,2,3,0,0,22
175880,1298158,1,2,4,0,0,22
175881,1298158,1,2,5,0,0,22
175882,1298158,1,2,6,1,0,23
175883,1298158,1,3,1,1,0,24
175884,1298158,1,3,2,1,0,25
175885,1298158,1,3,3,1,0,26
175886,1298158,1,3,4,1,0,27
175887,1298158,1,3,5,4,0,31
175888,1298158,1,3,6,0,0,31
175889,1298158,1,4,1,2,0,33
175890,1298158,1,4,2,1,0,34
175891,1298158,1,4,3,1,0,35
175892,1298158,1,4,4,1,0,36
175893,1298158,1,4,5,1,0,37
175894,1298158,1,4,6,1,0,38
175895,1298158,1,5,1,0,0,38
175896,1298158,1,5,2,1,0,39
175897,1298158,1,5,3,1,0,40
175898,1298158,1,5,4,2,0,42
175899,1298158,1,5,5,0,0,42
175900,1298158,1,5,6,0,1,42
175901,1298158,1,6,1,1,0,43
175902,1298158,1,6,2,0,1,43
175903,1298158,1,6,3,4,0,47
175904,1298158,1,6,4,0,0,47
175905,1298158,1,6,5,0,0,47
175906,1298158,1,6,6,0,0,47
175907,1298158,1,7,1,1,0,48
175908,1298158,1,7,2,0,0,48
175909,1298158,1,7,3,0,0,48
175910,1298158,1,7,4,0,0,48
175911,1298158,1,7,5,1,0,49
175912,1298158,1,7,6,0,0,49
175913,1298158,1,8,1,1,0,50
175914,1298158,1,8,2,1,0,51
175915,1298158,1,8,3,1,0,52
175916,1298158,1,8,4,0,0,52
175917,1298158,1,8,5,1,0,53
175918,1298158,1,8,6,0,0,53
175919,1298158,1,9,1,0,0,53
175920,1298158,1,9,2,4,0,57
175921,1298158,1,9,3,1,0,58
175922,1298158,1,9,4,2,0,60
175923,1298158,1,9,5,1,0,61
175924,1298158,1,9,6,0,0,61
175925,1298158,1,10,1,2,0,63
175926,1298158,1,10,2,0,0,63
175927,1298158,1,10,3,1,0,64
175928,1298158,1,10,4,0,1,64
175929,1298158,1,10,5,1,0,65
175930,1298158,1,10,6,2,0,67
175931,1298158,1,11,1,0,0,67
175932,1298158,1,11,2,0,0,67
175933,1298158,1,11,3,0,0,67
175934,1298158,1,11,4,0,0,67
175935,1298158,1,11,5,0,0,67
175936,1298158,1,11,6,4,0,71
175937,1298158,1,12,1,1,0,72
175938,1298158,1,12,2,1,0,73
175939,1298158,1,12,3,0,0,73
175940,1298158,1,12,4,1,0,74
175941,1298158,1,12,5,1,0,75
175942,1298158,1,12,6,1,0,76
175943,1298158,1,13,1,1,0,77
175944,1298158,1,13,2,4,0,81
175945,1298158,1,13,3,1,0,82
175946,1298158,1,13,4,4,0,86
175947,1298158,1,13,5,0,0,86
175948,1298158,1,13,6,1,0,87
175949,1298158,1,14,1,4,0,91
175950,1298158,1,14,2,3,0,94
175951,1298158,1,14,3,0,0,94
175952,1298158,1,14,4,1,0,95
175953,1298158,1,14,5,0,1,95
175954,1298158,1,14,6,0,1,95
175955,1298158,1,15,1,0,0,95
175956,1298158,1,15,2,0,0,95
175957,1298158,1,15,3,0,1,95
175958,1298158,1,15,4,0,1,95
175959,1298158,1,15,5,3,0,98
175960,1298158,1,15,6,0,0,98
175961,1298158,1,16,1,0,0,98
175962,1298158,1,16,2,1,0,99
175963,1298158,1,16,3,1,0,100
175964,1298158,1,16,4,2,0,102
175965,1298158,1,16,5,1,0,103
175966,1298158,1,16,6,1,0,104
175967,1298158,1,17,1,2,0,106
175968,1298158,1,17,2,0,0,106
175969,1298158,1,17,3,1,0,107
175970,1298158,1,17,4,1,0,108
175971,1298158,1,17,5,0,0,108
175972,1298158,1,17,6,0,0,108
175973,1298158,1,18,1,3,0,111
175974,1298158,1,18,2,1,0,112
175975,1298158,1,18,3,1,0,113
175976,1298158,1,18,4,0,0,113
175977,1298158,1,18,5,1,0,114
175978,1298158,1,18,6,1,0,115
175979,1298158,1,19,1,0,0,115
175980,1298158,1,19,2,1,0,116
175981,1298158,1,19,3,2,0,118
175982,1298158,1,19,4,0,0,118
175983,1298158,1,19,5,1,0,119
175984,1298158,1,19,6,1,0,120
175985,1298158,1,20,1,0,0,120
175986,1298158,1,20,2,6,0,126
175987,1298158,1,20,3,0,1,126
175988,1298158,1,20,4,1,0,127
175989,1298158,1,20,5,1,0,128
175990,1298158,1,20,6,2,0,130
176111,1298161,1,1,1,0,0,0
176112,1298161,1,1,2,1,0,1
176113,1298161,1,1,3,1,0,2
176114,1298161,1,1,4,0,1,2
176115,1298161,1,1,5,1,0,3
176116,1298161,1,1,6,0,0,3
176117,1298161,1,2,1,0,0,3
176118,1298161,1,2,2,0,0,3
176119,1298161,1,2,3,1,0,4
176120,1298161,1,2,4,1,0,5
176121,1298161,1,2,5,0,0,5
176122,1298161,1,2,6,1,0,6
176123,1298161,1,3,1,1,0,7
176124,1298161,1,3,2,0,1,7
176125,1298161,1,3,3,0,0,7
176126,1298161,1,3,4,4,0,11
176127,1298161,1,3,5,0,0,11
176128,1298161,1,3,6,0,0,11
176129,1298161,1,4,1,0,0,11
176130,1298161,1,4,2,0,0,11
176131,1298161,1,4,3,4,0,15
176132,1298161,1,4,4,0,0,15
176133,1298161,1,4,5,0,0,15
176134,1298161,1,4,6,0,1,15
176135,1298161,1,5,1,0,0,15
176136,1298161,1,5,2,1,0,16
176137,1298161,1,5,3,1,0,17
176138,1298161,1,5,4,1,0,18
176139,1298161,1,5,5,0,0,18
176140,1298161,1,5,6,1,0,19
176141,1298161,1,6,1,1,0,20
176142,1298161,1,6,2,4,0,24
176143,1298161,1,6,3,0,0,24
176144,1298161,1,6,4,0,0,24
176145,1298161,1,6,5,0,0,24
176146,1298161,1,6,6,1,0,25
176147,1298161,1,7,1,0,0,25
176148,1298161,1,7,2,1,0,26
176149,1298161,1,7,3,2,0,28
176150,1298161,1,7,4,1,0,29
176151,1298161,1,7,5,1,0,30
176152,1298161,1,7,6,0,0,30
176153,1298161,1,8,1,4,0,34
176154,1298161,1,8,2,1,0,35
176155,1298161,1,8,3,0,0,35
176156,1298161,1,8,4,4,0,39
176157,1298161,1,8,5,2,0,41
176158,1298161,1,8,6,1,0,42
176159,1298161,1,9,1,0,0,42
176160,1298161,1,9,2,1,0,43
176161,1298161,1,9,3,0,0,43
176162,1298161,1,9,4,1,0,44
176163,1298161,1,9,5,1,0,45
176164,1298161,1,9,6,0,0,45
176165,1298161,1,10,1,1,0,46
176166,1298161,1,10,2,0,0,46
176167,1298161,1,10,3,2,0,48
176168,1298161,1,10,4,6,0,54
176169,1298161,1,10,5,0,0,54
176170,1298161,1,10,6,0,0,54
176171,1298161,1,11,1,1,0,55
176172,1298161,1,11,2,2,0,57
176173,1298161,1,11,3,2,0,59
176174,1298161,1,11,4,1,0,60
176175,1298161,1,11,5,1,0,61
176176,1298161,1,11,6,2,0,63
176177,1298161,1,12,1,2,0,65
176178,1298161,1,12,2,1,0,66
176179,1298161,1,12,3,0,0,66
176180,1298161,1,12,4,3,0,69
176181,1298161,1,12,5,1,0,70
176182,1298161,1,12,6,0,0,70
176183,1298161,1,13,1,1,0,71
176184,1298161,1,13,2,0,0,71
176185,1298161,1,13,3,1,0,72
176186,1298161,1,13,4,2,0,74
176187,1298161,1,13,5,0,0,74
176188,1298161,1,13,6,2,0,76
176189,1298161,1,14,1,4,0,80
176190,1298161,1,14,2,2,0,82
176191,1298161,1,14,3,4,0,86
176192,1298161,1,14,4,2,0,88
176193,1298161,1,14,5,5,0,93
176194,1298161,1,14,6,1,0,94
176195,1298161,1,15,1,4,0,98
176196,1298161,1,15,2,1,0,99
176197,1298161,1,15,3,0,1,99
176198,1298161,1,15,4,1,0,100
176199,1298161,1,15,5,0,0,100
176200,1298161,1,15,6,2,0,102
176201,1298161,1,16,1,1,0,103
176202,1298161,1,16,2,1,0,104
176203,1298161,1,16,3,1,0,105
176204,1298161,1,16,4,6,0,111
176205,1298161,1,16,5,1,0,112
176206,1298161,1,16,6,1,0,113
176207,1298161,1,17,1,1,0,114
176208,1298161,1,17,2,1,0,115
176209,1298161,1,17,3,6,0,121
176210,1298161,1,17,4,6,0,127
176211,1298161,1,17,5,1,0,128
176212,1298161,1,17,6,1,0,129
176213,1298161,1,18,1,0,1,129
176214,1298161,1,18,2,2,0,131
176215,1298161,1,18,3,0,0,131
176216,1298161,1,18,4,8,0,139
176217,1298161,1,18,5,0,0,139
176218,1298161,1,18,6,1,0,140
176219,1298161,1,19,1,4,0,144
176220,1298161,1,19,2,1,0,145
176221,1298161,1,19,3,2,0,147
176222,1298161,1,19,4,1,0,148
176223,1298161,1,19,5,4,0,152
176224,1298161,1,19,6,1,0,153
176225,1298161,1,20,1,2,0,155
176226,1298161,1,20,2,6,0,161
176227,1298161,1,20,3,1,0,162
176228,1298161,1,20,4,0,1,162
176229,1298161,1,20,5,1,1,163
176230,1298161,1,20,6,4,0,167
176347,1298162,1,1,1,0,0,0
176348,1298162,1,1,2,0,0,0
176349,1298162,1,1,3,0,0,0
176350,1298162,1,1,4,4,0,4
176351,1298162,1,1,5,0,0,4
176352,1298162,1,1,6,1,0,5
176353,1298162,1,2,1,4,0,9
176354,1298162,1,2,2,1,0,10
176355,1298162,1,2,3,0,0,10
176356,1298162,1,2,4,0,1,10
176357,1298162,1,2,5,4,0,14
176358,1298162,1,2,6,0,0,14
176359,1298162,1,3,1,0,0,14
176360,1298162,1,3,2,0,0,14
176361,1298162,1,3,3,2,0,16
176362,1298162,1,3,4,1,0,17
176363,1298162,1,3,5,0,0,17
176364,1298162,1,3,6,0,0,17
176365,1298162,1,4,1,1,0,18
176366,1298162,1,4,2,0,0,18
176367,1298162,1,4,3,0,0,18
176368,1298162,1,4,4,1,0,19
176369,1298162,1,4,5,1,0,20
176370,1298162,1,4,6,4,0,24
176371,1298162,1,5,1,1,0,25
176372,1298162,1,5,2,1,0,26
176373,1298162,1,5,3,2,0,28
176374,1298162,1,5,4,0,0,28
176375,1298162,1,5,5,0,0,28
176376,1298162,1,5,6,0,0,28
176377,1298162,1,6,1,4,0,32
176378,1298162,1,6,2,0,0,32
176379,1298162,1,6,3,0,1,32
176380,1298162,1,6,4,0,0,32
176381,1298162,1,6,5,0,0,32
176382,1298162,1,6,6,0,0,32
176383,1298162,1,7,1,1,0,33
176384,1298162,1,7,2,1,0,34
176385,1298162,1,7,3,1,0,35
176386,1298162,1,7,4,1,0,36
176387,1298162,1,7,5,1,0,37
176388,1298162,1,7,6,4,0,41
176389,1298162,1,8,1,1,0,42
176390,1298162,1,8,2,2,0,44
176391,1298162,1,8,3,1,0,45
176392,1298162,1,8,4,1,0,46
176393,1298162,1,8,5,2,0,48
176394,1298162,1,8,6,4,0,52
176395,1298162,1,9,1,2,0,54
176396,1298162,1,9,2,1,0,55
176397,1298162,1,9,3,1,0,56
176398,1298162,1,9,4,1,0,57
176399,1298162,1,9,5,1,0,58
176400,1298162,1,9,6,1,0,59
176401,1298162,1,10,1,1,0,60
176402,1298162,1,10,2,0,0,60
176403,1298162,1,10,3,0,0,60
176404,1298162,1,10,4,1,0,61
176405,1298162,1,10,5,1,0,62
176406,1298162,1,10,6,1,0,63
176407,1298162,1,11,1,1,0,64
176408,1298162,1,11,2,2,0,66
176409,1298162,1,11,3,1,0,67
176410,1298162,1,11,4,4,0,71
176411,1298162,1,11,5,1,0,72
176412,1298162,1,11,6,2,0,74
176413,1298162,1,12,1,4,0,78
176414,1298162,1,12,2,2,0,80
176415,1298162,1,12,3,2,0,82
176416,1298162,1,12,4,1,0,83
176417,1298162,1,12,5,1,0,84
176418,1298162,1,12,6,1,0,85
176419,1298162,1,13,1,0,0,85
176420,1298162,1,13,2,0,0,85
176421,1298162,1,13,3,0,0,85
176422,1298162,1,13,4,1,0,86
176423,1298162,1,13,5,0,1,86
176424,1298162,1,13,6,1,0,87
176425,1298162,1,14,1,1,0,88
176426,1298162,1,14,2,1,0,89
176427,1298162,1,14,3,4,0,93
176428,1298162,1,14,4,1,0,94
176429,1298162,1,14,5,1,0,95
176430,1298162,1,14,6,0,0,95
176431,1298162,1,15,1,1,0,96
176432,1298162,1,15,2,1,0,97
176433,1298162,1,15,3,1,0,98
176434,1298162,1,15,4,2,0,100
176435,1298162,1,15,5,1,0,101
176436,1298162,1,15,6,2,0,103
176437,1298162,1,16,1,6,0,109
176438,1298162,1,16,2,4,0,113
176439,1298162,1,16,3,1,0,114
176440,1298162,1,16,4,1,0,115
176441,1298162,1,16,5,4,0,119
176442,1298162,1,16,6,1,0,120
176443,1298162,1,17,1,2,0,122
176444,1298162,1,17,2,0,1,122
176445,1298162,1,17,3,1,0,123
176446,1298162,1,17,4,1,0,124
176447,1298162,1,17,5,1,0,125
176448,1298162,1,17,6,1,0,126
176449,1298162,1,18,1,2,0,128
176450,1298162,1,18,2,0,0,128
176451,1298162,1,18,3,0,0,128
176452,1298162,1,18,4,0,0,128
176453,1298162,1,18,5,1,0,129
176454,1298162,1,18,6,2,0,131
176455,1298162,1,19,1,1,0,132
176456,1298162,1,19,2,1,0,133
176457,1298162,1,19,3,2,0,135
176458,1298162,1,19,4,1,0,136
176459,1298162,1,19,5,6,0,142
176460,1298162,1,19,6,1,0,143
176461,1298162,1,20,1,4,0,147
176462,1298162,1,20,2,0,1,147
176463,1298162,1,20,3,1,0,148
176464,1298162,1,20,4,1,1,149
176465,1298162,1,20,5,1,0,150
176466,1298162,1,20,6,0,1,150
176587,1298163,1,1,1,0,0,0
176588,1298163,1,1,2,0,0,0
176589,1298163,1,1,3,0,0,0
176590,1298163,1,1,4,0,0,0
176591,1298163,1,1,5,1,0,1
176592,1298163,1,1,6,1,0,2
176593,1298163,1,2,1,0,0,2
176594,1298163,1,2,2,0,0,2
176595,1298163,1,2,3,0,0,2
176596,1298163,1,2,4,1,0,3
176597,1298163,1,2,5,0,0,3
176598,1298163,1,2,6,0,0,3
176599,1298163,1,3,1,4,0,7
176600,1298163,1,3,2,0,1,7
176601,1298163,1,3,3,0,0,7
176602,1298163,1,3,4,1,0,8
176603,1298163,1,3,5,1,0,9
176604,1298163,1,3,6,0,0,9
176605,1298163,1,4,1,2,0,11
176606,1298163,1,4,2,0,0,11
176607,1298163,1,4,3,1,0,12
176608,1298163,1,4,4,0,0,12
176609,1298163,1,4,5,0,0,12
176610,1298163,1,4,6,0,0,12
176611,1298163,1,5,1,1,0,13
176612,1298163,1,5,2,4,0,17
176613,1298163,1,5,3,0,0,17
176614,1298163,1,5,4,0,0,17
176615,1298163,1,5,5,0,0,17
176616,1298163,1,5,6,1,0,18
176617,1298163,1,6,1,0,0,18
176618,1298163,1,6,2,0,0,18
176619,1298163,1,6,3,0,0,18
176620,1298163,1,6,4,0,0,18
176621,1298163,1,6,5,0,1,18
176622,1298163,1,6,6,1,0,19
176623,1298163,1,7,1,0,1,19
176624,1298163,1,7,2,1,0,20
176625,1298163,1,7,3,0,0,20
176626,1298163,1,7,4,1,0,21
176627,1298163,1,7,5,0,0,21
176628,1298163,1,7,6,0,0,21
176629,1298163,1,8,1,1,0,22
176630,1298163,1,8,2,0,0,22
176631,1298163,1,8,3,2,0,24
176632,1298163,1,8,4,1,0,25
176633,1298163,1,8,5,1,0,26
176634,1298163,1,8,6,0,0,26
176635,1298163,1,9,1,0,1,26
176636,1298163,1,9,2,0,0,26
176637,1298163,1,9,3,0,0,26
176638,1298163,1,9,4,1,0,27
176639,1298163,1,9,5,1,0,28
176640,1298163,1,9,6,0,0,28
176641,1298163,1,10,1,1,0,29
176642,1298163,1,10,2,1,0,30
176643,1298163,1,10,3,1,0,31
176644,1298163,1,10,4,2,0,33
176645,1298163,1,10,5,0,0,33
176646,1298163,1,10,6,1,0,34
176647,1298163,1,11,1,1,0,35
176648,1298163,1,11,2,1,0,36
176649,1298163,1,11,3,1,0,37
176650,1298163,1,11,4,4,0,41
176651,1298163,1,11,5,1,0,42
176652,1298163,1,11,6,1,0,43
176653,1298163,1,12,1,1,0,44
176654,1298163,1,12,2,0,0,44
176655,1298163,1,12,3,0,0,44
176656,1298163,1,12,4,0,0,44
176657,1298163,1,12,5,4,0,48
176658,1298163,1,12,6,1,0,49
176659,1298163,1,13,1,1,0,50
176660,1298163,1,13,2,0,0,50
176661,1298163,1,13,3,1,0,51
176662,1298163,1,13,4,1,0,52
176663,1298163,1,13,5,0,0,52
176664,1298163,1,13,6,1,0,53
176665,1298163,1,14,1,1,0,54
176666,1298163,1,14,2,0,0,54
176667,1298163,1,14,3,2,0,56
176668,1298163,1,14,4,2,0,58
176669,1298163,1,14,5,0,0,58
176670,1298163,1,14,6,1,0,59
176671,1298163,1,15,1,2,0,61
176672,1298163,1,15,2,0,1,61
176673,1298163,1,15,3,0,0,61
176674,1298163,1,15,4,3,0,64
176675,1298163,1,15,5,4,0,68
176676,1298163,1,15,6,0,0,68
176677,1298163,1,16,1,0,0,68
176678,1298163,1,16,2,1,0,69
176679,1298163,1,16,3,0,1,69
176680,1298163,1,16,4,0,0,69
176681,1298163,1,16,5,0,0,69
176682,1298163,1,16,6,2,0,71
176683,1298163,1,17,1,1,0,72
176684,1298163,1,17,2,1,0,73
176685,1298163,1,17,3,0,1,73
176686,1298163,1,17,4,0,0,73
176687,1298163,1,17,5,0,0,73
176688,1298163,1,17,6,1,0,74
176689,1298163,1,18,1,0,0,74
176690,1298163,1,18,2,2,0,76
176691,1298163,1,18,3,1,0,77
176692,1298163,1,18,4,0,0,77
176693,1298163,1,18,5,2,0,79
176694,1298163,1,18,6,0,0,79
176695,1298163,1,19,1,1,0,80
176696,1298163,1,19,2,1,1,81
176697,1298163,1,19,3,0,1,81
176698,1298163,1,19,4,0,0,81
176699,1298163,1,19,5,2,0,83
176700,1298163,1,19,6,3,0,86
176701,1298163,1,20,1,1,0,87
176702,1298163,1,20,2,1,0,88
176703,1298163,1,20,3,0,0,88
176704,1298163,1,20,4,1,0,89
176705,1298163,1,20,5,1,0,90
176706,1298163,1,20,6,1,1,91
176790,1298164,1,1,1,0,0,0
176791,1298164,1,1,2,0,0,0
176792,1298164,1,1,3,0,0,0
176793,1298164,1,1,4,0,0,0
176794,1298164,1,1,5,0,0,0
176795,1298164,1,1,6,0,0,0
176796,1298164,1,2,1,0,0,0
176797,1298164,1,2,2,0,0,0
176798,1298164,1,2,3,0,0,0
176799,1298164,1,2,4,6,0,6
176800,1298164,1,2,5,0,0,6
176801,1298164,1,2,6,0,0,6
176802,1298164,1,3,1,0,0,6
176803,1298164,1,3,2,6,0,12
176804,1298164,1,3,3,1,0,13
176805,1298164,1,3,4,1,0,14
176806,1298164,1,3,5,0,0,14
176807,1298164,1,3,6,0,0,14
176808,1298164,1,4,1,0,0,14
176809,1298164,1,4,2,1,0,15
176810,1298164,1,4,3,1,0,16
176811,1298164,1,4,4,4,0,20
176812,1298164,1,4,5,0,0,20
176813,1298164,1,4,6,1,0,21
176814,1298164,1,5,1,2,0,23
176815,1298164,1,5,2,0,1,23
176816,1298164,1,5,3,1,0,24
176817,1298164,1,5,4,1,0,25
176818,1298164,1,5,5,1,0,26
176819,1298164,1,5,6,0,1,26
176820,1298164,1,6,1,4,0,30
176821,1298164,1,6,2,1,0,31
176822,1298164,1,6,3,1,0,32
176823,1298164,1,6,4,0,0,32
176824,1298164,1,6,5,1,0,33
176825,1298164,1,6,6,0,0,33
176826,1298164,1,7,1,4,0,37
176827,1298164,1,7,2,4,0,41
176828,1298164,1,7,3,0,0,41
176829,1298164,1,7,4,0,0,41
176830,1298164,1,7,5,0,1,41
176831,1298164,1,7,6,0,0,41
176832,1298164,1,8,1,1,0,42
176833,1298164,1,8,2,0,0,42
176834,1298164,1,8,3,0,1,42
176835,1298164,1,8,4,1,0,43
176836,1298164,1,8,5,4,0,47
176837,1298164,1,8,6,0,0,47
176838,1298164,1,9,1,1,0,48
176839,1298164,1,9,2,1,0,49
176840,1298164,1,9,3,0,1,49
176841,1298164,1,9,4,0,0,49
176842,1298164,1,9,5,1,0,50
176843,1298164,1,9,6,1,0,51
176844,1298164,1,10,1,2,0,53
176845,1298164,1,10,2,6,0,59
176846,1298164,1,10,3,0,0,59
176847,1298164,1,10,4,0,0,59
176848,1298164,1,10,5,0,0,59
176849,1298164,1,10,6,1,0,60
176850,1298164,1,11,1,4,0,64
176851,1298164,1,11,2,1,0,65
176852,1298164,1,11,3,0,0,65
176853,1298164,1,11,4,1,0,66
176854,1298164,1,11,5,1,0,67
176855,1298164,1,11,6,0,0,67
176856,1298164,1,12,1,1,0,68
176857,1298164,1,12,2,0,0,68
176858,1298164,1,12,3,2,0,70
176859,1298164,1,12,4,3,0,73
176860,1298164,1,12,5,0,0,73
176861,1298164,1,12,6,0,0,73
176862,1298164,1,13,1,0,0,73
176863,1298164,1,13,2,1,0,74
176864,1298164,1,13,3,1,0,75
176865,1298164,1,13,4,6,0,81
176866,1298164,1,13,5,2,0,83
176867,1298164,1,13,6,1,0,84
176868,1298164,1,14,1,1,0,85
176869,1298164,1,14,2,0,0,85
176870,1298164,1,14,3,1,0,86
176871,1298164,1,14,4,1,0,87
176872,1298164,1,14,5,1,0,88
176873,1298164,1,14,6,1,0,89
176874,1298164,1,15,1,6,0,95
176875,1298164,1,15,2,0,0,95
176876,1298164,1,15,3,0,0,95
176877,1298164,1,15,4,4,0,99
176878,1298164,1,15,5,1,0,100
176879,1298164,1,15,6,1,0,101
176880,1298164,1,16,1,0,1,101
176881,1298164,1,16,2,0,0,101
176882,1298164,1,16,3,2,0,103
176883,1298164,1,16,4,0,0,103
176884,1298164,1,16,5,1,0,104
176885,1298164,1,16,6,1,0,105
176886,1298164,1,17,1,1,0,106
176887,1298164,1,17,2,0,0,106
176888,1298164,1,17,3,1,0,107
176889,1298164,1,17,4,0,0,107
176890,1298164,1,17,5,4,0,111
176891,1298164,1,17,6,4,0,115
176892,1298164,1,18,1,0,0,115
176893,1298164,1,18,2,2,0,117
176894,1298164,1,18,3,1,0,118
176895,1298164,1,18,4,4,0,122
176896,1298164,1,18,5,1,0,123
176897,1298164,1,18,6,1,0,124
176898,1298164,1,19,1,0,1,124
176899,1298164,1,19,2,0,0,124
176900,1298164,1,19,3,1,0,125
176901,1298164,1,19,4,2,0,127
176902,1298164,1,19,5,0,1,127
176903,1298164,1,19,6,0,0,127
176904,1298164,1,20,1,2,0,129
176905,1298164,1,20,2,0,0,129
176906,1298164,1,20,3,1,0,130
176907,1298164,1,20,4,0,1,130
176908,1298164,1,20,5,1,0,131
176909,1298164,1,20,6,2,0,133
177028,1298165,1,1,1,0,0,0
177029,1298165,1,1,2,1,0,1
177030,1298165,1,1,3,2,0,3
177031,1298165,1,1,4,0,0,3
177032,1298165,1,1,5,2,0,5
177033,1298165,1,1,6,0,0,5
177034,1298165,1,2,1,1,0,6
177035,1298165,1,2,2,0,0,6
177036,1298165,1,2,3,1,0,7
177037,1298165,1,2,4,0,0,7
177038,1298165,1,2,5,0,0,7
177039,1298165,1,2,6,1,0,8
177040,1298165,1,3,1,0,1,8
177041,1298165,1,3,2,4,0,12
177042,1298165,1,3,3,1,0,13
177043,1298165,1,3,4,0,0,13
177044,1298165,1,3,5,1,0,14
177045,1298165,1,3,6,0,0,14
177046,1298165,1,4,1,1,0,15
177047,1298165,1,4,2,0,0,15
177048,1298165,1,4,3,1,0,16
177049,1298165,1,4,4,0,0,16
177050,1298165,1,4,5,4,0,20
177051,1298165,1,4,6,0,0,20
177052,1298165,1,5,1,0,0,20
177053,1298165,1,5,2,1,0,21
177054,1298165,1,5,3,2,0,23
177055,1298165,1,5,4,6,0,29
177056,1298165,1,5,5,0,0,29
177057,1298165,1,5,6,5,0,34
177058,1298165,1,6,1,4,0,38
177059,1298165,1,6,2,0,0,38
177060,1298165,1,6,3,0,0,38
177061,1298165,1,6,4,0,0,38
177062,1298165,1,6,5,0,0,38
177063,1298165,1,6,6,0,0,38
177064,1298165,1,7,1,1,0,39
177065,1298165,1,7,2,0,0,39
177066,1298165,1,7,3,6,0,45
177067,1298165,1,7,4,0,0,45
177068,1298165,1,7,5,7,0,52
177069,1298165,1,7,6,1,0,53
177070,1298165,1,8,1,1,0,54
177071,1298165,1,8,2,2,0,56
177072,1298165,1,8,3,0,0,56
177073,1298165,1,8,4,1,0,57
177074,1298165,1,8,5,2,0,59
177075,1298165,1,8,6,1,0,60
177076,1298165,1,9,1,0,1,60
177077,1298165,1,9,2,2,0,62
177078,1298165,1,9,3,2,0,64
177079,1298165,1,9,4,2,0,66
177080,1298165,1,9,5,1,0,67
177081,1298165,1,9,6,1,0,68
177082,1298165,1,10,1,1,0,69
177083,1298165,1,10,2,0,0,69
177084,1298165,1,10,3,0,0,69
177085,1298165,1,10,4,0,0,69
177086,1298165,1,10,5,3,0,72
177087,1298165,1,10,6,6,0,78
177088,1298165,1,11,1,0,0,78
177089,1298165,1,11,2,0,0,78
177090,1298165,1,11,3,4,0,82
177091,1298165,1,11,4,1,0,83
177092,1298165,1,11,5,1,1,84
177093,1298165,1,11,6,0,0,84
177094,1298165,1,12,1,0,0,84
177095,1298165,1,12,2,1,0,85
177096,1298165,1,12,3,0,0,85
177097,1298165,1,12,4,1,0,86
177098,1298165,1,12,5,0,0,86
177099,1298165,1,12,6,1,0,87
177100,1298165,1,13,1,0,0,87
177101,1298165,1,13,2,1,0,88
177102,1298165,1,13,3,1,0,89
177103,1298165,1,13,4,1,0,90
177104,1298165,1,13,5,1,0,91
177105,1298165,1,13,6,1,0,92
177106,1298165,1,14,1,0,0,92
177107,1298165,1,14,2,4,0,96
177108,1298165,1,14,3,2,0,98
177109,1298165,1,14,4,6,0,104
177110,1298165,1,14,5,1,0,105
177111,1298165,1,14,6,3,0,108
177112,1298165,1,15,1,4,0,112
177113,1298165,1,15,2,3,0,115
177114,1298165,1,15,3,4,0,119
177115,1298165,1,15,4,1,0,120
177116,1298165,1,15,5,7,0,127
177117,1298165,1,15,6,7,0,134
177118,1298165,1,16,1,2,0,136
177119,1298165,1,16,2,1,0,137
177120,1298165,1,16,3,1,0,138
177121,1298165,1,16,4,1,0,139
177122,1298165,1,16,5,0,0,139
177123,1298165,1,16,6,6,0,145
177124,1298165,1,17,1,2,0,147
177125,1298165,1,17,2,1,0,148
177126,1298165,1,17,3,2,0,150
177127,1298165,1,17,4,4,0,154
177128,1298165,1,17,5,0,1,154
177129,1298165,1,17,6,1,0,155
177130,1298165,1,18,1,1,0,156
177131,1298165,1,18,2,0,0,156
177132,1298165,1,18,3,1,0,157
177133,1298165,1,18,4,1,0,158
177134,1298165,1,18,5,0,0,158
177135,1298165,1,18,6,0,0,158
177136,1298165,1,19,1,1,0,159
177137,1298165,1,19,2,1,0,160
177138,1298165,1,19,3,0,0,160
177139,1298165,1,19,4,0,1,160
177140,1298165,1,19,5,1,0,161
177141,1298165,1,19,6,1,0,162
177142,1298165,1,20,1,4,0,166
177143,1298165,1,20,2,2,0,168
177144,1298165,1,20,3,4,0,172
177145,1298165,1,20,4,1,0,173
177146,1298165,1,20,5,4,0,177
177147,1298165,1,20,6,2,0,179
177257,1298166,1,1,1,0,0,0
177258,1298166,1,1,2,0,0,0
177259,1298166,1,1,3,0,0,0
177260,1298166,1,1,4,0,0,0
177261,1298166,1,1,5,0,0,0
177262,1298166,1,1,6,1,0,1
177263,1298166,1,2,1,0,0,1
177264,1298166,1,2,2,0,0,1
177265,1298166,1,2,3,4,0,5
177266,1298166,1,2,4,0,0,5
177267,1298166,1,2,5,2,0,7
177268,1298166,1,2,6,0,0,7
177269,1298166,1,3,1,0,0,7
177270,1298166,1,3,2,1,0,8
177271,1298166,1,3,3,0,0,8
177272,1298166,1,3,4,6,0,14
177273,1298166,1,3,5,2,0,16
177274,1298166,1,3,6,0,0,16
177275,1298166,1,4,1,0,0,16
177276,1298166,1,4,2,4,0,20
177277,1298166,1,4,3,0,0,20
177278,1298166,1,4,4,1,0,21
177279,1298166,1,4,5,0,0,21
177280,1298166,1,4,6,4,0,25
177281,1298166,1,5,1,4,0,29
177282,1298166,1,5,2,1,0,30
177283,1298166,1,5,3,6,0,36
177284,1298166,1,5,4,1,0,37
177285,1298166,1,5,5,1,0,38
177286,1298166,1,5,6,0,0,38
177287,1298166,1,6,1,0,0,38
177288,1298166,1,6,2,1,0,39
177289,1298166,1,6,3,1,0,40
177290,1298166,1,6,4,1,0,41
177291,1298166,1,6,5,1,0,42
177292,1298166,1,6,6,0,0,42
177293,1298166,1,7,1,0,1,42
177294,1298166,1,7,2,2,0,44
177295,1298166,1,7,3,3,0,47
177296,1298166,1,7,4,0,0,47
177297,1298166,1,7,5,0,0,47
177298,1298166,1,7,6,0,0,47
177299,1298166,1,8,1,0,0,47
177300,1298166,1,8,2,2,0,49
177301,1298166,1,8,3,1,0,50
177302,1298166,1,8,4,0,0,50
177303,1298166,1,8,5,1,0,51
177304,1298166,1,8,6,1,0,52
177305,1298166,1,9,1,1,0,53
177306,1298166,1,9,2,7,0,60
177307,1298166,1,9,3,1,0,61
177308,1298166,1,9,4,1,0,62
177309,1298166,1,9,5,1,0,63
177310,1298166,1,9,6,0,0,63
177311,1298166,1,10,1,1,0,64
177312,1298166,1,10,2,0,0,64
177313,1298166,1,10,3,1,0,65
177314,1298166,1,10,4,0,0,65
177315,1298166,1,10,5,1,0,66
177316,1298166,1,10,6,2,0,68
177317,1298166,1,11,1,0,0,68
177318,1298166,1,11,2,0,1,68
177319,1298166,1,11,3,0,0,68
177320,1298166,1,11,4,2,0,70
177321,1298166,1,11,5,1,0,71
177322,1298166,1,11,6,1,0,72
177323,1298166,1,12,1,4,0,76
177324,1298166,1,12,2,2,0,78
177325,1298166,1,12,3,6,0,84
177326,1298166,1,12,4,2,0,86
177327,1298166,1,12,5,1,0,87
177328,1298166,1,12,6,2,0,89
177329,1298166,1,13,1,1,0,90
177330,1298166,1,13,2,0,1,90
177331,1298166,1,13,3,0,0,90
177332,1298166,1,13,4,1,0,91
177333,1298166,1,13,5,1,0,92
177334,1298166,1,13,6,3,0,95
177335,1298166,1,14,1,0,0,95
177336,1298166,1,14,2,0,0,95
177337,1298166,1,14,3,1,0,96
177338,1298166,1,14,4,1,0,97
177339,1298166,1,14,5,1,0,98
177340,1298166,1,14,6,1,0,99
177341,1298166,1,15,1,1,0,100
177342,1298166,1,15,2,0,0,100
177343,1298166,1,15,3,1,0,101
177344,1298166,1,15,4,0,0,101
177345,1298166,1,15,5,1,0,102
177346,1298166,1,15,6,2,0,104
177347,1298166,1,16,1,1,0,105
177348,1298166,1,16,2,4,0,109
177349,1298166,1,16,3,1,0,110
177350,1298166,1,16,4,2,0,112
177351,1298166,1,16,5,1,0,113
177352,1298166,1,16,6,0,1,113
177353,1298166,1,17,1,1,0,114
177354,1298166,1,17,2,2,0,116
177355,1298166,1,17,3,1,0,117
177356,1298166,1,17,4,2,0,119
177357,1298166,1,17,5,2,0,121
177358,1298166,1,17,6,4,0,125
177359,1298166,1,18,1,1,0,126
177360,1298166,1,18,2,1,1,127
177361,1298166,1,18,3,1,0,128
177362,1298166,1,18,4,3,0,131
177363,1298166,1,18,5,0,0,131
177364,1298166,1,18,6,1,0,132
177365,1298166,1,19,1,4,0,136
177366,1298166,1,19,2,2,0,138
177367,1298166,1,19,3,0,0,138
177368,1298166,1,19,4,1,0,139
177369,1298166,1,19,5,1,1,140
177370,1298166,1,19,6,1,0,141
177371,1298166,1,20,1,0,0,141
177372,1298166,1,20,2,1,0,142
177373,1298166,1,20,3,0,1,142
177374,1298166,1,20,4,1,0,143
177375,1298166,1,20,5,1,0,144
177376,1298166,1,20,6,0,1,144
177488,1298167,1,1,1,0,0,0
177489,1298167,1,1,2,3,0,3
177490,1298167,1,1,3,0,0,3
177491,1298167,1,1,4,0,0,3
177492,1298167,1,1,5,4,0,7
177493,1298167,1,1,6,2,0,9
177494,1298167,1,2,1,1,0,10
177495,1298167,1,2,2,0,0,10
177496,1298167,1,2,3,0,0,10
177497,1298167,1,2,4,4,0,14
177498,1298167,1,2,5,2,0,16
177499,1298167,1,2,6,0,0,16
177500,1298167,1,3,1,0,0,16
177501,1298167,1,3,2,0,0,16
177502,1298167,1,3,3,1,0,17
177503,1298167,1,3,4,0,0,17
177504,1298167,1,3,5,0,0,17
177505,1298167,1,3,6,4,0,21
177506,1298167,1,4,1,1,0,22
177507,1298167,1,4,2,0,0,22
177508,1298167,1,4,3,0,0,22
177509,1298167,1,4,4,0,0,22
177510,1298167,1,4,5,1,0,23
177511,1298167,1,4,6,2,0,25
177512,1298167,1,5,1,6,0,31
177513,1298167,1,5,2,0,0,31
177514,1298167,1,5,3,4,0,35
177515,1298167,1,5,4,4,0,39
177516,1298167,1,5,5,0,0,39
177517,1298167,1,5,6,1,0,40
177518,1298167,1,6,1,4,0,44
177519,1298167,1,6,2,1,0,45
177520,1298167,1,6,3,0,0,45
177521,1298167,1,6,4,1,0,46
177522,1298167,1,6,5,1,0,47
177523,1298167,1,6,6,1,0,48
177524,1298167,1,7,1,1,0,49
177525,1298167,1,7,2,1,0,50
177526,1298167,1,7,3,6,0,56
177527,1298167,1,7,4,1,0,57
177528,1298167,1,7,5,0,0,57
177529,1298167,1,7,6,1,0,58
177530,1298167,1,8,1,0,0,58
177531,1298167,1,8,2,1,0,59
177532,1298167,1,8,3,1,0,60
177533,1298167,1,8,4,1,0,61
177534,1298167,1,8,5,0,0,61
177535,1298167,1,8,6,0,0,61
177536,1298167,1,9,1,2,0,63
177537,1298167,1,9,2,0,0,63
177538,1298167,1,9,3,0,0,63
177539,1298167,1,9,4,1,0,64
177540,1298167,1,9,5,1,0,65
177541,1298167,1,9,6,2,0,67
177542,1298167,1,10,1,2,0,69
177543,1298167,1,10,2,4,0,73
177544,1298167,1,10,3,1,0,74
177545,1298167,1,10,4,1,0,75
177546,1298167,1,10,5,1,0,76
177547,1298167,1,10,6,1,0,77
177548,1298167,1,11,1,4,0,81
177549,1298167,1,11,2,0,1,81
177550,1298167,1,11,3,1,0,82
177551,1298167,1,11,4,1,0,83
177552,1298167,1,11,5,1,0,84
177553,1298167,1,11,6,1,0,85
177554,1298167,1,12,1,0,0,85
177555,1298167,1,12,2,2,0,87
177556,1298167,1,12,3,4,0,91
177557,1298167,1,12,4,1,0,92
177558,1298167,1,12,5,2,0,94
177559,1298167,1,12,6,0,0,94
177560,1298167,1,13,1,0,0,94
177561,1298167,1,13,2,4,0,98
177562,1298167,1,13,3,1,0,99
177563,1298167,1,13,4,1,0,100
177564,1298167,1,13,5,4,0,104
177565,1298167,1,13,6,4,0,108
177566,1298167,1,14,1,0,1,108
177567,1298167,1,14,2,0,0,108
177568,1298167,1,14,3,0,0,108
177569,1298167,1,14,4,1,0,109
177570,1298167,1,14,5,0,0,109
177571,1298167,1,14,6,1,0,110
177572,1298167,1,15,1,2,0,112
177573,1298167,1,15,2,4,0,116
177574,1298167,1,15,3,4,0,120
177575,1298167,1,15,4,2,0,122
177576,1298167,1,15,5,2,0,124
177577,1298167,1,15,6,1,0,125
177578,1298167,1,16,1,1,0,126
177579,1298167,1,16,2,2,0,128
177580,1298167,1,16,3,1,0,129
177581,1298167,1,16,4,0,0,129
177582,1298167,1,16,5,6,0,135
177583,1298167,1,16,6,2,0,137
177584,1298167,1,17,1,1,0,138
177585,1298167,1,17,2,1,0,139
177586,1298167,1,17,3,6,0,145
177587,1298167,1,17,4,0,0,145
177588,1298167,1,17,5,1,0,146
177589,1298167,1,17,6,2,0,148
177590,1298167,1,18,1,1,0,149
177591,1298167,1,18,2,0,0,149
177592,1298167,1,18,3,4,0,153
177593,1298167,1,18,4,0,1,153
177594,1298167,1,18,5,1,0,154
177595,1298167,1,18,6,0,0,154
177596,1298167,1,19,1,6,0,160
177597,1298167,1,19,2,0,1,160
177598,1298167,1,19,3,2,0,162
177599,1298167,1,19,4,0,1,162
177600,1298167,1,19,5,1,0,163
177601,1298167,1,19,6,0,0,163
177602,1298167,1,20,1,2,0,165
177603,1298167,1,20,2,1,0,166
177604,1298167,1,20,3,6,0,172
177605,1298167,1,20,4,4,0,176
177606,1298167,1,20,5,0,1,176
177607,1298167,1,20,6,3,0,179
177728,1298168,1,1,1,0,0,0
177729,1298168,1,1,2,0,0,0
177730,1298168,1,1,3,2,0,2
177731,1298168,1,1,4,0,0,2
177732,1298168,1,1,5,1,0,3
177733,1298168,1,1,6,0,0,3
177734,1298168,1,2,1,5,0,8
177735,1298168,1,2,2,1,0,9
177736,1298168,1,2,3,0,1,9
177737,1298168,1,2,4,0,0,9
177738,1298168,1,2,5,0,0,9
177739,1298168,1,2,6,4,0,13
177740,1298168,1,3,1,0,0,13
177741,1298168,1,3,2,1,0,14
177742,1298168,1,3,3,0,0,14
177743,1298168,1,3,4,0,0,14
177744,1298168,1,3,5,0,0,14
177745,1298168,1,3,6,0,0,14
177746,1298168,1,4,1,0,0,14
177747,1298168,1,4,2,0,0,14
177748,1298168,1,4,3,0,0,14
177749,1298168,1,4,4,0,0,14
177750,1298168,1,4,5,0,0,14
177751,1298168,1,4,6,0,1,14
177752,1298168,1,5,1,1,0,15
177753,1298168,1,5,2,0,0,15
177754,1298168,1,5,3,3,0,18
177755,1298168,1,5,4,0,0,18
177756,1298168,1,5,5,0,0,18
177757,1298168,1,5,6,0,0,18
177758,1298168,1,6,1,1,0,19
177759,1298168,1,6,2,1,0,20
177760,1298168,1,6,3,0,0,20
177761,1298168,1,6,4,0,0,20
177762,1298168,1,6,5,0,0,20
177763,1298168,1,6,6,0,1,20
177764,1298168,1,7,1,4,0,24
177765,1298168,1,7,2,2,0,26
177766,1298168,1,7,3,0,0,26
177767,1298168,1,7,4,2,0,28
177768,1298168,1,7,5,1,0,29
177769,1298168,1,7,6,1,0,30
177770,1298168,1,8,1,0,0,30
177771,1298168,1,8,2,0,0,30
177772,1298168,1,8,3,0,0,30
177773,1298168,1,8,4,2,0,32
177774,1298168,1,8,5,0,0,32
177775,1298168,1,8,6,4,0,36
177776,1298168,1,9,1,0,0,36
177777,1298168,1,9,2,2,0,38
177778,1298168,1,9,3,4,0,42
177779,1298168,1,9,4,6,0,48
177780,1298168,1,9,5,2,0,50
177781,1298168,1,9,6,0,0,50
177782,1298168,1,10,1,0,0,50
177783,1298168,1,10,2,1,0,51
177784,1298168,1,10,3,0,0,51
177785,1298168,1,10,4,0,0,51
177786,1298168,1,10,5,1,0,52
177787,1298168,1,10,6,1,0,53
177788,1298168,1,11,1,0,0,53
177789,1298168,1,11,2,4,0,57
177790,1298168,1,11,3,2,0,59
177791,1298168,1,11,4,1,0,60
177792,1298168,1,11,5,0,0,60
177793,1298168,1,11,6,1,0,61
177794,1298168,1,12,1,1,0,62
177795,1298168,1,12,2,1,0,63
177796,1298168,1,12,3,4,0,67
177797,1298168,1,12,4,1,0,68
177798,1298168,1,12,5,0,1,68
177799,1298168,1,12,6,0,0,68
177800,1298168,1,13,1,6,0,74
177801,1298168,1,13,2,1,0,75
177802,1298168,1,13,3,2,0,77
177803,1298168,1,13,4,0,1,77
177804,1298168,1,13,5,1,0,78
177805,1298168,1,13,6,0,0,78
177806,1298168,1,14,1,7,0,85
177807,1298168,1,14,2,1,0,86
177808,1298168,1,14,3,1,0,87
177809,1298168,1,14,4,0,0,87
177810,1298168,1,14,5,4,0,91
177811,1298168,1,14,6,1,0,92
177812,1298168,1,15,1,0,0,92
177813,1298168,1,15,2,0,1,92
177814,1298168,1,15,3,0,0,92
177815,1298168,1,15,4,1,0,93
177816,1298168,1,15,5,1,0,94
177817,1298168,1,15,6,1,0,95
177818,1298168,1,16,1,0,0,95
177819,1298168,1,16,2,2,0,97
177820,1298168,1,16,3,1,0,98
177821,1298168,1,16,4,0,0,98
177822,1298168,1,16,5,0,0,98
177823,1298168,1,16,6,0,1,98
177824,1298168,1,17,1,1,0,99
177825,1298168,1,17,2,1,0,100
177826,1298168,1,17,3,0,1,100
177827,1298168,1,17,4,0,0,100
177828,1298168,1,17,5,1,0,101
177829,1298168,1,17,6,1,0,102
177830,1298168,1,18,1,2,0,104
177831,1298168,1,18,2,6,0,110
177832,1298168,1,18,3,0,0,110
177833,1298168,1,18,4,0,0,110
177834,1298168,1,18,5,1,1,111
177835,1298168,1,18,6,0,0,111
177836,1298168,1,19,1,1,0,112
177837,1298168,1,19,2,1,0,113
177838,1298168,1,19,3,0,0,113
177839,1298168,1,19,4,2,0,115
177840,1298168,1,19,5,1,0,116
177841,1298168,1,19,6,0,0,116
177842,1298168,1,20,1,1,0,117
177843,1298168,1,20,2,0,1,117
177952,1298169,1,1,1,0,0,0
177953,1298169,1,1,2,0,0,0
177954,1298169,1,1,3,0,0,0
177955,1298169,1,1,4,0,0,0
177956,1298169,1,1,5,1,0,1
177957,1298169,1,1,6,0,0,1
177958,1298169,1,2,1,0,0,1
177959,1298169,1,2,2,1,0,2
177960,1298169,1,2,3,1,0,3
177961,1298169,1,2,4,1,0,4
177962,1298169,1,2,5,6,0,10
177963,1298169,1,2,6,0,0,10
177964,1298169,1,3,1,0,0,10
177965,1298169,1,3,2,0,0,10
177966,1298169,1,3,3,0,0,10
177967,1298169,1,3,4,1,0,11
177968,1298169,1,3,5,0,0,11
177969,1298169,1,3,6,0,0,11
177970,1298169,1,4,1,0,0,11
177971,1298169,1,4,2,0,1,11
177972,1298169,1,4,3,1,0,12
177973,1298169,1,4,4,4,0,16
177974,1298169,1,4,5,6,0,22
177975,1298169,1,4,6,0,0,22
177976,1298169,1,5,1,4,0,26
177977,1298169,1,5,2,4,0,30
177978,1298169,1,5,3,0,0,30
177979,1298169,1,5,4,0,0,30
177980,1298169,1,5,5,0,0,30
177981,1298169,1,5,6,0,0,30
177982,1298169,1,6,1,0,0,30
177983,1298169,1,6,2,2,0,32
177984,1298169,1,6,3,0,0,32
177985,1298169,1,6,4,1,0,33
177986,1298169,1,6,5,4,0,37
177987,1298169,1,6,6,0,0,37
177988,1298169,1,7,1,1,0,38
177989,1298169,1,7,2,2,0,40
177990,1298169,1,7,3,0,0,40
177991,1298169,1,7,4,0,0,40
177992,1298169,1,7,5,1,0,41
177993,1298169,1,7,6,1,0,42
177994,1298169,1,8,1,2,0,44
177995,1298169,1,8,2,1,0,45
177996,1298169,1,8,3,1,0,46
177997,1298169,1,8,4,4,0,50
177998,1298169,1,8,5,1,0,51
177999,1298169,1,8,6,1,0,52
178000,1298169,1,9,1,4,0,56
178001,1298169,1,9,2,0,0,56
178002,1298169,1,9,3,1,0,57
178003,1298169,1,9,4,14,0,71
178004,1298169,1,9,5,4,0,75
178005,1298169,1,9,6,1,0,76
178006,1298169,1,10,1,2,0,78
178007,1298169,1,10,2,0,1,78
178008,1298169,1,10,3,1,0,79
178009,1298169,1,10,4,1,0,80
178010,1298169,1,10,5,2,0,82
178011,1298169,1,10,6,4,0,86
178012,1298169,1,11,1,1,0,87
178013,1298169,1,11,2,1,0,88
178014,1298169,1,11,3,0,0,88
178015,1298169,1,11,4,1,0,89
178016,1298169,1,11,5,2,0,91
178017,1298169,1,11,6,1,0,92
178018,1298169,1,12,1,2,0,94
178019,1298169,1,12,2,1,0,95
178020,1298169,1,12,3,2,0,97
178021,1298169,1,12,4,1,0,98
178022,1298169,1,12,5,2,0,100
178023,1298169,1,12,6,1,0,101
178024,1298169,1,13,1,0,0,101
178025,1298169,1,13,2,4,0,105
178026,1298169,1,13,3,4,0,109
178027,1298169,1,13,4,1,0,110
178028,1298169,1,13,5,1,0,111
178029,1298169,1,13,6,4,0,115
178030,1298169,1,14,1,0,0,115
178031,1298169,1,14,2,1,0,116
178032,1298169,1,14,3,0,1,116
178033,1298169,1,14,4,1,0,117
178034,1298169,1,14,5,1,0,118
178035,1298169,1,14,6,1,0,119
178036,1298169,1,15,1,0,0,119
178037,1298169,1,15,2,2,0,121
178038,1298169,1,15,3,1,0,122
178039,1298169,1,15,4,0,0,122
178040,1298169,1,15,5,4,0,126
178041,1298169,1,15,6,4,0,130
178042,1298169,1,16,1,0,1,130
178043,1298169,1,16,2,1,0,131
178044,1298169,1,16,3,4,0,135
178045,1298169,1,16,4,1,0,136
178046,1298169,1,16,5,1,0,137
178047,1298169,1,16,6,3,0,140
178048,1298169,1,17,1,4,0,144
178049,1298169,1,17,2,1,0,145
178050,1298169,1,17,3,3,0,148
178051,1298169,1,17,4,0,0,148
178052,1298169,1,17,5,2,0,150
178053,1298169,1,17,6,0,1,150
178054,1298169,1,18,1,4,0,154
178055,1298169,1,18,2,2,0,156
178056,1298169,1,18,3,0,0,156
178057,1298169,1,18,4,0,0,156
178058,1298169,1,18,5,1,0,157
178059,1298169,1,18,6,0,0,157
178060,1298169,1,19,1,0,1,157
178061,1298169,1,19,2,1,0,158
178062,1298169,1,19,3,1,0,159
178063,1298169,1,19,4,1,0,160
178064,1298169,1,19,5,4,0,164
178065,1298169,1,19,6,6,0,170
178066,1298169,1,20,1,0,0,170
178067,1298169,1,20,2,6,0,176
178068,1298169,1,20,3,4,0,180
178069,1298169,1,20,4,1,0,181
178070,1298169,1,20,5,2,0,183
178071,1298169,1,20,6,1,0,184
178168,1298170,1,1,1,0,0,0
178169,1298170,1,1,2,4,0,4
178170,1298170,1,1,3,0,0,4
178171,1298170,1,1,4,0,1,4
178172,1298170,1,1,5,0,0,4
178173,1298170,1,1,6,0,0,4
178174,1298170,1,2,1,0,0,4
178175,1298170,1,2,2,0,0,4
178176,1298170,1,2,3,1,0,5
178177,1298170,1,2,4,6,0,11
178178,1298170,1,2,5,6,0,17
178179,1298170,1,2,6,4,0,21
178180,1298170,1,3,1,0,0,21
178181,1298170,1,3,2,0,0,21
178182,1298170,1,3,3,0,0,21
178183,1298170,1,3,4,1,0,22
178184,1298170,1,3,5,4,0,26
178185,1298170,1,3,6,1,0,27
178186,1298170,1,4,1,1,0,28
178187,1298170,1,4,2,0,0,28
178188,1298170,1,4,3,0,0,28
178189,1298170,1,4,4,2,0,30
178190,1298170,1,4,5,0,0,30
178191,1298170,1,4,6,1,0,31
178192,1298170,1,5,1,1,0,32
178193,1298170,1,5,2,0,0,32
178194,1298170,1,5,3,6,0,38
178195,1298170,1,5,4,0,1,38
178196,1298170,1,5,5,0,0,38
178197,1298170,1,5,6,2,0,40
178198,1298170,1,6,1,0,0,40
178199,1298170,1,6,2,0,1,40
178200,1298170,1,6,3,0,0,40
178201,1298170,1,6,4,1,0,41
178202,1298170,1,6,5,1,0,42
178203,1298170,1,6,6,0,0,42
178204,1298170,1,7,1,1,0,43
178205,1298170,1,7,2,0,0,43
178206,1298170,1,7,3,0,1,43
178207,1298170,1,7,4,0,0,43
178208,1298170,1,7,5,0,0,43
178209,1298170,1,7,6,0,0,43
178210,1298170,1,8,1,1,0,44
178211,1298170,1,8,2,0,0,44
178212,1298170,1,8,3,4,0,48
178213,1298170,1,8,4,1,0,49
178214,1298170,1,8,5,1,0,50
178215,1298170,1,8,6,0,0,50
178216,1298170,1,9,1,0,0,50
178217,1298170,1,9,2,1,0,51
178218,1298170,1,9,3,1,0,52
178219,1298170,1,9,4,1,0,53
178220,1298170,1,9,5,1,0,54
178221,1298170,1,9,6,1,0,55
178222,1298170,1,10,1,4,0,59
178223,1298170,1,10,2,2,0,61
178224,1298170,1,10,3,4,0,65
178225,1298170,1,10,4,1,0,66
178226,1298170,1,10,5,1,0,67
178227,1298170,1,10,6,1,0,68
178228,1298170,1,11,1,1,0,69
178229,1298170,1,11,2,0,0,69
178230,1298170,1,11,3,1,0,70
178231,1298170,1,11,4,0,0,70
178232,1298170,1,11,5,0,0,70
178233,1298170,1,11,6,1,0,71
178234,1298170,1,12,1,1,0,72
178235,1298170,1,12,2,0,0,72
178236,1298170,1,12,3,0,0,72
178237,1298170,1,12,4,2,0,74
178238,1298170,1,12,5,4,0,78
178239,1298170,1,12,6,4,0,82
178240,1298170,1,13,1,2,0,84
178241,1298170,1,13,2,0,0,84
178242,1298170,1,13,3,4,0,88
178243,1298170,1,13,4,1,0,89
178244,1298170,1,13,5,6,0,95
178245,1298170,1,13,6,0,1,95
178246,1298170,1,14,1,6,0,101
178247,1298170,1,14,2,1,0,102
178248,1298170,1,14,3,1,0,103
178249,1298170,1,14,4,1,0,104
178250,1298170,1,14,5,0,0,104
178251,1298170,1,14,6,1,0,105
178252,1298170,1,15,1,4,0,109
178253,1298170,1,15,2,0,0,109
178254,1298170,1,15,3,2,0,111
178255,1298170,1,15,4,6,0,117
178256,1298170,1,15,5,1,0,118
178257,1298170,1,15,6,2,0,120
178258,1298170,1,16,1,2,0,122
178259,1298170,1,16,2,1,0,123
178260,1298170,1,16,3,0,0,123
178261,1298170,1,16,4,6,0,129
178262,1298170,1,16,5,2,0,131
178263,1298170,1,16,6,4,0,135
178264,1298170,1,17,1,1,0,136
178265,1298170,1,17,2,0,0,136
178266,1298170,1,17,3,4,0,140
178267,1298170,1,17,4,6,0,146
178268,1298170,1,17,5,1,0,147
178269,1298170,1,17,6,1,0,148
178270,1298170,1,18,1,4,0,152
178271,1298170,1,18,2,1,0,153
178272,1298170,1,18,3,2,0,155
178273,1298170,1,18,4,0,0,155
178274,1298170,1,18,5,3,0,158
178275,1298170,1,18,6,1,0,159
178276,1298170,1,19,1,2,0,161
178277,1298170,1,19,2,1,0,162
178278,1298170,1,19,3,13,0,175
178279,1298170,1,19,4,2,0,177
178280,1298170,1,19,5,0,1,177
178281,1298170,1,19,6,0,1,177
178282,1298170,1,20,1,0,1,177
178283,1298170,1,20,2,1,0,178
178284,1298170,1,20,3,2,0,180
178285,1298170,1,20,4,0,0,180
178286,1298170,1,20,5,3,0,183
178287,1298170,1,20,6,2,1,185
178372,1298171,1,1,1,1,0,1
178373,1298171,1,1,2,1,0,2
178374,1298171,1,1,3,0,0,2
178375,1298171,1,1,4,0,0,2
178376,1298171,1,1,5,0,0,2
178377,1298171,1,1,6,2,0,4
178378,1298171,1,2,1,4,0,8
178379,1298171,1,2,2,0,0,8
178380,1298171,1,2,3,0,0,8
178381,1298171,1,2,4,0,0,8
178382,1298171,1,2,5,3,0,11
178383,1298171,1,2,6,0,0,11
178384,1298171,1,3,1,1,0,12
178385,1298171,1,3,2,1,0,13
178386,1298171,1,3,3,0,0,13
178387,1298171,1,3,4,0,0,13
178388,1298171,1,3,5,1,0,14
178389,1298171,1,3,6,2,0,16
178390,1298171,1,4,1,1,0,17
178391,1298171,1,4,2,4,0,21
178392,1298171,1,4,3,0,0,21
178393,1298171,1,4,4,4,0,25
178394,1298171,1,4,5,4,0,29
178395,1298171,1,4,6,0,0,29
178396,1298171,1,5,1,0,0,29
178397,1298171,1,5,2,0,0,29
178398,1298171,1,5,3,1,0,30
178399,1298171,1,5,4,1,0,31
178400,1298171,1,5,5,1,0,32
178401,1298171,1,5,6,4,0,36
178402,1298171,1,6,1,4,0,40
178403,1298171,1,6,2,1,0,41
178404,1298171,1,6,3,7,0,48
178405,1298171,1,6,4,4,0,52
178406,1298171,1,6,5,0,1,52
178407,1298171,1,6,6,0,0,52
178408,1298171,1,7,1,1,0,53
178409,1298171,1,7,2,0,0,53
178410,1298171,1,7,3,1,0,54
178411,1298171,1,7,4,0,0,54
178412,1298171,1,7,5,1,0,55
178413,1298171,1,7,6,1,0,56
178414,1298171,1,8,1,0,0,56
178415,1298171,1,8,2,0,0,56
178416,1298171,1,8,3,1,0,57
178417,1298171,1,8,4,1,0,58
178418,1298171,1,8,5,1,0,59
178419,1298171,1,8,6,0,0,59
178420,1298171,1,9,1,4,0,63
178421,1298171,1,9,2,1,0,64
178422,1298171,1,9,3,1,0,65
178423,1298171,1,9,4,1,0,66
178424,1298171,1,9,5,1,0,67
178425,1298171,1,9,6,2,0,69
178426,1298171,1,10,1,0,0,69
178427,1298171,1,10,2,2,0,71
178428,1298171,1,10,3,1,0,72
178429,1298171,1,10,4,0,0,72
178430,1298171,1,10,5,2,0,74
178431,1298171,1,10,6,1,0,75
178432,1298171,1,11,1,1,0,76
178433,1298171,1,11,2,2,0,78
178434,1298171,1,11,3,4,0,82
178435,1298171,1,11,4,1,0,83
178436,1298171,1,11,5,4,0,87
178437,1298171,1,11,6,6,0,93
178438,1298171,1,12,1,3,0,96
178439,1298171,1,12,2,0,1,96
178440,1298171,1,12,3,0,0,96
178441,1298171,1,12,4,6,0,102
178442,1298171,1,12,5,1,0,103
178443,1298171,1,12,6,0,0,103
178444,1298171,1,13,1,1,0,104
178445,1298171,1,13,2,1,0,105
178446,1298171,1,13,3,0,0,105
178447,1298171,1,13,4,4,0,109
178448,1298171,1,13,5,4,0,113
178449,1298171,1,13,6,1,0,114
178450,1298171,1,14,1,0,1,114
178451,1298171,1,14,2,0,0,114
178452,1298171,1,14,3,2,0,116
178453,1298171,1,14,4,0,0,116
178454,1298171,1,14,5,1,0,117
178455,1298171,1,14,6,1,0,118
178456,1298171,1,15,1,1,0,119
178457,1298171,1,15,2,1,0,120
178458,1298171,1,15,3,1,0,121
178459,1298171,1,15,4,1,0,122
178460,1298171,1,15,5,1,0,123
178461,1298171,1,15,6,5,0,128
178462,1298171,1,16,1,0,0,128
178463,1298171,1,16,2,4,0,132
178464,1298171,1,16,3,0,0,132
178465,1298171,1,16,4,2,0,134
178466,1298171,1,16,5,4,0,138
178467,1298171,1,16,6,2,0,140
178468,1298171,1,17,1,2,0,142
178469,1298171,1,17,2,1,0,143
178470,1298171,1,17,3,4,0,147
178471,1298171,1,17,4,2,0,149
178472,1298171,1,17,5,1,0,150
178473,1298171,1,17,6,2,0,152
178474,1298171,1,18,1,2,0,154
178475,1298171,1,18,2,2,0,156
178476,1298171,1,18,3,1,0,157
178477,1298171,1,18,4,6,0,163
178478,1298171,1,18,5,4,0,167
178479,1298171,1,18,6,6,0,173
178480,1298171,1,19,1,1,0,174
178481,1298171,1,19,2,0,1,174
178482,1298171,1,19,3,0,1,174
178483,1298171,1,19,4,0,1,174
178484,1298171,1,19,5,1,0,175
178485,1298171,1,19,6,1,0,176
178486,1298171,1,20,1,1,0,177
178487,1298171,1,20,2,2,0,179
178488,1298171,1,20,3,0,0,179
178489,1298171,1,20,4,2,0,181
178490,1298171,1,20,5,2,0,183
178491,1298171,1,20,6,2,0,185
178612,1298172,1,1,1,0,0,0
178613,1298172,1,1,2,0,0,0
178614,1298172,1,1,3,4,0,4
178615,1298172,1,1,4,2,0,6
178616,1298172,1,1,5,0,0,6
178617,1298172,1,1,6,0,0,6
178618,1298172,1,2,1,3,0,9
178619,1298172,1,2,2,4,0,13
178620,1298172,1,2,3,4,0,17
178621,1298172,1,2,4,5,0,22
178622,1298172,1,2,5,0,0,22
178623,1298172,1,2,6,0,0,22
178624,1298172,1,3,1,0,1,22
178625,1298172,1,3,2,0,0,22
178626,1298172,1,3,3,0,0,22
178627,1298172,1,3,4,1,0,23
178628,1298172,1,3,5,4,0,27
178629,1298172,1,3,6,0,0,27
178630,1298172,1,4,1,1,0,28
178631,1298172,1,4,2,1,0,29
178632,1298172,1,4,3,4,0,33
178633,1298172,1,4,4,3,0,36
178634,1298172,1,4,5,0,0,36
178635,1298172,1,5,0,6,0,42
178636,1298172,1,5,1,1,0,43
178637,1298172,1,5,2,1,0,44
178638,1298172,1,5,3,1,0,45
178639,1298172,1,5,4,1,0,46
178640,1298172,1,5,5,1,0,47
178641,1298172,1,6,0,1,0,48
178642,1298172,1,6,1,0,1,48
178643,1298172,1,6,2,0,0,48
178644,1298172,1,6,3,0,0,48
178645,1298172,1,6,4,4,0,52
178646,1298172,1,6,5,0,1,52
178647,1298172,1,7,0,1,0,53
178648,1298172,1,7,1,1,0,54
178649,1298172,1,7,2,0,0,54
178650,1298172,1,7,3,0,0,54
178651,1298172,1,7,4,0,0,54
178652,1298172,1,7,5,1,0,55
178653,1298172,1,8,0,2,0,57
178654,1298172,1,8,1,1,0,58
178655,1298172,1,8,2,1,0,59
178656,1298172,1,8,3,1,0,60
178657,1298172,1,8,4,1,0,61
178658,1298172,1,8,5,1,0,62
178659,1298172,1,9,0,1,0,63
178660,1298172,1,9,1,1,0,64
178661,1298172,1,9,2,6,0,70
178662,1298172,1,9,3,4,0,74
178663,1298172,1,9,4,4,0,78
178664,1298172,1,9,5,0,0,78
178665,1298172,1,10,0,0,0,78
178666,1298172,1,10,1,1,0,79
178667,1298172,1,10,2,1,0,80
178668,1298172,1,10,3,1,0,81
178669,1298172,1,10,4,0,0,81
178670,1298172,1,10,5,2,0,83
178671,1298172,1,11,0,1,0,84
178672,1298172,1,11,1,1,0,85
178673,1298172,1,11,2,1,0,86
178674,1298172,1,11,3,0,1,86
178675,1298172,1,11,4,0,0,86
178676,1298172,1,11,5,2,0,88
178677,1298172,1,12,0,0,0,88
178678,1298172,1,12,1,6,0,94
178679,1298172,1,12,2,2,0,96
178680,1298172,1,12,3,1,0,97
178681,1298172,1,12,4,4,0,101
178682,1298172,1,12,5,1,0,102
178683,1298172,1,13,0,4,0,106
178684,1298172,1,13,1,2,0,108
178685,1298172,1,13,2,0,0,108
178686,1298172,1,13,3,1,0,109
178687,1298172,1,13,4,1,0,110
178688,1298172,1,13,5,2,0,112
178689,1298172,1,14,0,1,0,113
178690,1298172,1,14,1,5,0,118
178691,1298172,1,14,2,1,0,119
178692,1298172,1,14,3,1,0,120
178693,1298172,1,14,4,0,0,120
178694,1298172,1,14,5,1,0,121
178695,1298172,1,15,0,6,0,127
178696,1298172,1,15,1,1,0,128
178697,1298172,1,15,2,0,0,128
178698,1298172,1,15,3,1,0,129
178699,1298172,1,15,4,4,0,133
178700,1298172,1,15,5,0,0,133
178701,1298172,1,16,0,6,0,139
178702,1298172,1,16,1,0,0,139
178703,1298172,1,16,2,0,1,139
178704,1298172,1,16,3,0,0,139
178705,1298172,1,16,4,4,0,143
178706,1298172,1,16,5,0,0,143
178707,1298172,1,17,0,0,0,143
178708,1298172,1,17,1,1,0,144
178709,1298172,1,17,2,0,0,144
178710,1298172,1,17,3,0,0,144
178711,1298172,1,17,4,1,0,145
178712,1298172,1,17,5,1,0,146
178713,1298172,1,18,0,6,0,152
178714,1298172,1,18,1,1,0,153
178715,1298172,1,18,2,1,0,154
178716,1298172,1,18,3,1,0,155
178717,1298172,1,18,4,0,1,155
178718,1298172,1,18,5,0,0,155
178719,1298172,1,19,0,1,0,156
178720,1298172,1,19,1,0,1,156
178721,1298172,1,19,2,1,0,157
178722,1298172,1,19,3,0,0,157
178723,1298172,1,19,4,2,0,159
178724,1298172,1,19,5,0,1,159
178725,1298172,1,20,0,1,0,160
178726,1298172,1,20,1,0,0,160
178727,1298172,1,20,2,4,0,164
178728,1298172,1,20,3,0,0,164
178729,1298172,1,20,4,0,0,164
178730,1298172,1,20,5,4,0,168
178851,1298173,1,1,1,0,0,0
178852,1298173,1,1,2,6,0,6
178853,1298173,1,1,3,1,0,7
178854,1298173,1,1,4,0,0,7
178855,1298173,1,1,5,1,0,8
178856,1298173,1,1,6,1,0,9
178857,1298173,1,2,1,2,0,11
178858,1298173,1,2,2,1,0,12
178859,1298173,1,2,3,1,0,13
178860,1298173,1,2,4,1,0,14
178861,1298173,1,2,5,0,0,14
178862,1298173,1,2,6,1,0,15
178863,1298173,1,3,1,6,0,21
178864,1298173,1,3,2,0,0,21
178865,1298173,1,3,3,3,0,24
178866,1298173,1,3,4,1,0,25
178867,1298173,1,3,5,1,0,26
178868,1298173,1,3,6,6,0,32
178869,1298173,1,4,1,1,0,33
178870,1298173,1,4,2,1,0,34
178871,1298173,1,4,3,0,0,34
178872,1298173,1,4,4,4,0,38
178873,1298173,1,4,5,0,0,38
178874,1298173,1,4,6,1,1,39
178875,1298173,1,5,1,0,0,39
178876,1298173,1,5,2,1,0,40
178877,1298173,1,5,3,1,0,41
178878,1298173,1,5,4,4,0,45
178879,1298173,1,5,5,6,0,51
178880,1298173,1,5,6,1,0,52
178881,1298173,1,6,1,0,0,52
178882,1298173,1,6,2,0,0,52
178883,1298173,1,6,3,0,0,52
178884,1298173,1,6,4,0,0,52
178885,1298173,1,6,5,1,0,53
178886,1298173,1,6,6,1,0,54
178887,1298173,1,7,1,1,0,55
178888,1298173,1,7,2,1,0,56
178889,1298173,1,7,3,0,0,56
178890,1298173,1,7,4,1,0,57
178891,1298173,1,7,5,2,0,59
178892,1298173,1,7,6,6,0,65
178893,1298173,1,8,1,0,0,65
178894,1298173,1,8,2,2,0,67
178895,1298173,1,8,3,1,0,68
178896,1298173,1,8,4,1,0,69
178897,1298173,1,8,5,2,0,71
178898,1298173,1,8,6,0,0,71
178899,1298173,1,9,1,1,0,72
178900,1298173,1,9,2,0,1,72
178901,1298173,1,9,3,1,0,73
178902,1298173,1,9,4,1,0,74
178903,1298173,1,9,5,0,0,74
178904,1298173,1,9,6,1,0,75
178905,1298173,1,10,1,1,0,76
178906,1298173,1,10,2,1,0,77
178907,1298173,1,10,3,1,0,78
178908,1298173,1,10,4,1,0,79
178909,1298173,1,10,5,1,0,80
178910,1298173,1,10,6,0,0,80
178911,1298173,1,11,1,2,0,82
178912,1298173,1,11,2,1,0,83
178913,1298173,1,11,3,1,0,84
178914,1298173,1,11,4,0,1,84
178915,1298173,1,11,5,0,0,84
178916,1298173,1,11,6,0,0,84
178917,1298173,1,12,1,1,0,85
178918,1298173,1,12,2,1,0,86
178919,1298173,1,12,3,1,0,87
178920,1298173,1,12,4,0,0,87
178921,1298173,1,12,5,1,0,88
178922,1298173,1,12,6,1,0,89
178923,1298173,1,13,1,0,0,89
178924,1298173,1,13,2,6,0,95
178925,1298173,1,13,3,0,0,95
178926,1298173,1,13,4,1,0,96
178927,1298173,1,13,5,4,0,100
178928,1298173,1,13,6,0,0,100
178929,1298173,1,14,1,1,0,101
178930,1298173,1,14,2,0,0,101
178931,1298173,1,14,3,0,0,101
178932,1298173,1,14,4,1,0,102
178933,1298173,1,14,5,0,0,102
178934,1298173,1,14,6,2,0,104
178935,1298173,1,15,1,1,0,105
178936,1298173,1,15,2,1,0,106
178937,1298173,1,15,3,1,0,107
178938,1298173,1,15,4,4,0,111
178939,1298173,1,15,5,1,0,112
178940,1298173,1,15,6,4,0,116
178941,1298173,1,16,1,1,0,117
178942,1298173,1,16,2,1,0,118
178943,1298173,1,16,3,0,1,118
178944,1298173,1,16,4,0,0,118
178945,1298173,1,16,5,1,0,119
178946,1298173,1,16,6,1,0,120
178947,1298173,1,17,1,1,0,121
178948,1298173,1,17,2,1,0,122
178949,1298173,1,17,3,1,0,123
178950,1298173,1,17,4,0,0,123
178951,1298173,1,17,5,0,0,123
178952,1298173,1,17,6,0,0,123
178953,1298173,1,18,1,0,0,123
178954,1298173,1,18,2,1,0,124
178955,1298173,1,18,3,1,0,125
178956,1298173,1,18,4,2,0,127
178957,1298173,1,18,5,0,1,127
178958,1298173,1,18,6,1,0,128
178959,1298173,1,19,1,0,0,128
178960,1298173,1,19,2,2,0,130
178961,1298173,1,19,3,0,0,130
178962,1298173,1,19,4,0,0,130
178963,1298173,1,19,5,4,0,134
178964,1298173,1,19,6,2,0,136
178965,1298173,1,20,1,4,0,140
178966,1298173,1,20,2,0,1,140
178967,1298173,1,20,3,1,0,141
178968,1298173,1,20,4,0,0,141
178969,1298173,1,20,5,0,1,141
178970,1298173,1,20,6,0,1,141
179089,1298174,1,1,1,0,0,0
179090,1298174,1,1,2,4,0,4
179091,1298174,1,1,3,0,0,4
179092,1298174,1,1,4,0,0,4
179093,1298174,1,1,5,0,0,4
179094,1298174,1,1,6,1,0,5
179095,1298174,1,2,1,4,0,9
179096,1298174,1,2,2,0,0,9
179097,1298174,1,2,3,4,0,13
179098,1298174,1,2,4,0,0,13
179099,1298174,1,2,5,0,0,13
179100,1298174,1,2,6,4,0,17
179101,1298174,1,3,1,0,0,17
179102,1298174,1,3,2,1,0,18
179103,1298174,1,3,3,1,0,19
179104,1298174,1,3,4,1,0,20
179105,1298174,1,3,5,1,0,21
179106,1298174,1,3,6,1,0,22
179107,1298174,1,4,1,0,0,22
179108,1298174,1,4,2,0,0,22
179109,1298174,1,4,3,4,0,26
179110,1298174,1,4,4,4,0,30
179111,1298174,1,4,5,1,0,31
179112,1298174,1,4,6,2,0,33
179113,1298174,1,5,1,0,0,33
179114,1298174,1,5,2,0,0,33
179115,1298174,1,5,3,1,0,34
179116,1298174,1,5,4,0,0,34
179117,1298174,1,5,5,0,0,34
179118,1298174,1,5,6,0,0,34
179119,1298174,1,6,1,4,0,38
179120,1298174,1,6,2,1,0,39
179121,1298174,1,6,3,2,0,41
179122,1298174,1,6,4,2,0,43
179123,1298174,1,6,5,4,0,47
179124,1298174,1,6,6,1,0,48
179125,1298174,1,7,1,0,0,48
179126,1298174,1,7,2,1,0,49
179127,1298174,1,7,3,1,0,50
179128,1298174,1,7,4,1,0,51
179129,1298174,1,7,5,0,0,51
179130,1298174,1,7,6,1,0,52
179131,1298174,1,8,1,1,0,53
179132,1298174,1,8,2,2,0,55
179133,1298174,1,8,3,0,0,55
179134,1298174,1,8,4,0,0,55
179135,1298174,1,8,5,1,0,56
179136,1298174,1,8,6,0,0,56
179137,1298174,1,9,1,0,0,56
179138,1298174,1,9,2,2,0,58
179139,1298174,1,9,3,0,1,58
179140,1298174,1,9,4,1,0,59
179141,1298174,1,9,5,1,0,60
179142,1298174,1,9,6,1,0,61
179143,1298174,1,10,1,2,0,63
179144,1298174,1,10,2,1,0,64
179145,1298174,1,10,3,0,0,64
179146,1298174,1,10,4,0,0,64
179147,1298174,1,10,5,6,0,70
179148,1298174,1,10,6,0,0,70
179149,1298174,1,11,1,6,0,76
179150,1298174,1,11,2,1,0,77
179151,1298174,1,11,3,0,0,77
179152,1298174,1,11,4,1,0,78
179153,1298174,1,11,5,1,0,79
179154,1298174,1,11,6,2,0,81
179155,1298174,1,12,1,0,0,81
179156,1298174,1,12,2,4,0,85
179157,1298174,1,12,3,0,0,85
179158,1298174,1,12,4,2,0,87
179159,1298174,1,12,5,3,0,90
179160,1298174,1,12,6,0,0,90
179161,1298174,1,13,1,0,0,90
179162,1298174,1,13,2,6,0,96
179163,1298174,1,13,3,1,0,97
179164,1298174,1,13,4,0,1,97
179165,1298174,1,13,5,0,0,97
179166,1298174,1,13,6,1,0,98
179167,1298174,1,14,1,4,0,102
179168,1298174,1,14,2,0,0,102
179169,1298174,1,14,3,1,0,103
179170,1298174,1,14,4,1,0,104
179171,1298174,1,14,5,0,0,104
179172,1298174,1,14,6,1,0,105
179173,1298174,1,15,1,0,0,105
179174,1298174,1,15,2,1,0,106
179175,1298174,1,15,3,1,0,107
179176,1298174,1,15,4,1,0,108
179177,1298174,1,15,5,4,0,112
179178,1298174,1,15,6,0,1,112
179179,1298174,1,16,1,1,0,113
179180,1298174,1,16,2,0,0,113
179181,1298174,1,16,3,0,0,113
179182,1298174,1,16,4,0,0,113
179183,1298174,1,16,5,0,0,113
179184,1298174,1,16,6,0,0,113
179185,1298174,1,17,1,1,0,114
179186,1298174,1,17,2,1,0,115
179187,1298174,1,17,3,2,0,117
179188,1298174,1,17,4,0,0,117
179189,1298174,1,17,5,2,0,119
179190,1298174,1,17,6,4,0,123
179191,1298174,1,18,1,0,1,123
179192,1298174,1,18,2,1,0,124
179193,1298174,1,18,3,1,0,125
179194,1298174,1,18,4,1,0,126
179195,1298174,1,18,5,0,0,126
179196,1298174,1,18,6,1,0,127
179197,1298174,1,19,1,4,0,131
179198,1298174,1,19,2,1,0,132
179199,1298174,1,19,3,4,0,136
179200,1298174,1,19,4,4,0,140
179201,1298174,1,19,5,1,0,141
179202,1298174,1,19,6,2,0,143
179203,1298174,1,20,1,0,0,143
179204,1298174,1,20,2,1,0,144
179205,1298174,1,20,3,6,0,150
179206,1298174,1,20,4,2,0,152
179207,1298174,1,20,5,0,0,152
179208,1298174,1,20,6,6,0,158
179329,1298175,1,1,1,0,0,0
179330,1298175,1,1,2,1,0,1
179331,1298175,1,1,3,1,0,2
179332,1298175,1,1,4,4,0,6
179333,1298175,1,1,5,0,0,6
179334,1298175,1,1,6,0,0,6
179335,1298175,1,2,1,1,0,7
179336,1298175,1,2,2,1,0,8
179337,1298175,1,2,3,0,0,8
179338,1298175,1,2,4,1,0,9
179339,1298175,1,2,5,4,0,13
179340,1298175,1,2,6,0,0,13
179341,1298175,1,3,1,0,0,13
179342,1298175,1,3,2,6,0,19
179343,1298175,1,3,3,1,0,20
179344,1298175,1,3,4,1,0,21
179345,1298175,1,3,5,0,1,21
179346,1298175,1,3,6,0,0,21
179347,1298175,1,4,1,0,0,21
179348,1298175,1,4,2,0,0,21
179349,1298175,1,4,3,4,0,25
179350,1298175,1,4,4,2,0,27
179351,1298175,1,4,5,1,0,28
179352,1298175,1,4,6,6,0,34
179353,1298175,1,5,1,2,0,36
179354,1298175,1,5,2,0,0,36
179355,1298175,1,5,3,0,0,36
179356,1298175,1,5,4,0,0,36
179357,1298175,1,5,5,1,0,37
179358,1298175,1,5,6,1,0,38
179359,1298175,1,6,1,0,0,38
179360,1298175,1,6,2,0,0,38
179361,1298175,1,6,3,0,0,38
179362,1298175,1,6,4,0,0,38
179363,1298175,1,6,5,1,0,39
179364,1298175,1,6,6,1,0,40
179365,1298175,1,7,1,2,0,42
179366,1298175,1,7,2,2,0,44
179367,1298175,1,7,3,0,0,44
179368,1298175,1,7,4,0,0,44
179369,1298175,1,7,5,4,0,48
179370,1298175,1,7,6,1,0,49
179371,1298175,1,8,1,0,0,49
179372,1298175,1,8,2,0,0,49
179373,1298175,1,8,3,1,0,50
179374,1298175,1,8,4,1,0,51
179375,1298175,1,8,5,4,0,55
179376,1298175,1,8,6,1,0,56
179377,1298175,1,9,1,1,0,57
179378,1298175,1,9,2,4,0,61
179379,1298175,1,9,3,1,0,62
179380,1298175,1,9,4,0,0,62
179381,1298175,1,9,5,2,0,64
179382,1298175,1,9,6,0,0,64
179383,1298175,1,10,1,0,0,64
179384,1298175,1,10,2,1,0,65
179385,1298175,1,10,3,1,0,66
179386,1298175,1,10,4,2,0,68
179387,1298175,1,10,5,1,0,69
179388,1298175,1,10,6,1,0,70
179389,1298175,1,11,1,0,0,70
179390,1298175,1,11,2,1,0,71
179391,1298175,1,11,3,2,0,73
179392,1298175,1,11,4,0,1,73
179393,1298175,1,11,5,0,1,73
179394,1298175,1,11,6,1,0,74
179395,1298175,1,12,1,1,0,75
179396,1298175,1,12,2,1,0,76
179397,1298175,1,12,3,1,0,77
179398,1298175,1,12,4,0,0,77
179399,1298175,1,12,5,0,0,77
179400,1298175,1,12,6,1,0,78
179401,1298175,1,13,1,4,0,82
179402,1298175,1,13,2,1,0,83
179403,1298175,1,13,3,1,0,84
179404,1298175,1,13,4,1,0,85
179405,1298175,1,13,5,2,0,87
179406,1298175,1,13,6,0,0,87
179407,1298175,1,14,1,4,0,91
179408,1298175,1,14,2,0,1,91
179409,1298175,1,14,3,0,0,91
179410,1298175,1,14,4,0,0,91
179411,1298175,1,14,5,0,0,91
179412,1298175,1,14,6,1,0,92
179413,1298175,1,15,1,1,0,93
179414,1298175,1,15,2,1,0,94
179415,1298175,1,15,3,2,0,96
179416,1298175,1,15,4,1,0,97
179417,1298175,1,15,5,0,0,97
179418,1298175,1,15,6,2,0,99
179419,1298175,1,16,1,4,0,103
179420,1298175,1,16,2,1,0,104
179421,1298175,1,16,3,0,0,104
179422,1298175,1,16,4,0,0,104
179423,1298175,1,16,5,1,0,105
179424,1298175,1,16,6,1,0,106
179425,1298175,1,17,1,1,0,107
179426,1298175,1,17,2,0,1,107
179427,1298175,1,17,3,0,0,107
179428,1298175,1,17,4,0,0,107
179429,1298175,1,17,5,0,1,107
179430,1298175,1,17,6,0,0,107
179431,1298175,1,18,1,0,0,107
179432,1298175,1,18,2,0,0,107
179433,1298175,1,18,3,1,0,108
179434,1298175,1,18,4,0,0,108
179435,1298175,1,18,5,0,0,108
179436,1298175,1,18,6,1,0,109
179437,1298175,1,19,1,0,1,109
179438,1298175,1,19,2,0,0,109
179439,1298175,1,19,3,1,0,110
179440,1298175,1,19,4,1,0,111
179441,1298175,1,19,5,1,0,112
179442,1298175,1,19,6,4,0,116
179443,1298175,1,20,1,1,0,117
179444,1298175,1,20,2,4,0,121
179445,1298175,1,20,3,1,0,122
179446,1298175,1,20,4,4,0,126
179447,1298175,1,20,5,0,1,126
179448,1298175,1,20,6,1,0,127
179558,1298176,1,1,1,0,0,0
179559,1298176,1,1,2,0,0,0
179560,1298176,1,1,3,0,0,0
179561,1298176,1,1,4,0,0,0
179562,1298176,1,1,5,0,0,0
179563,1298176,1,1,6,0,0,0
179564,1298176,1,2,1,0,0,0
179565,1298176,1,2,2,0,0,0
179566,1298176,1,2,3,0,0,0
179567,1298176,1,2,4,1,0,1
179568,1298176,1,2,5,1,0,2
179569,1298176,1,2,6,4,0,6
179570,1298176,1,3,1,3,0,9
179571,1298176,1,3,2,0,0,9
179572,1298176,1,3,3,1,0,10
179573,1298176,1,3,4,6,0,16
179574,1298176,1,3,5,1,0,17
179575,1298176,1,3,6,1,0,18
179576,1298176,1,4,1,2,0,20
179577,1298176,1,4,2,2,0,22
179578,1298176,1,4,3,1,0,23
179579,1298176,1,4,4,4,0,27
179580,1298176,1,4,5,0,1,27
179581,1298176,1,4,6,4,0,31
179582,1298176,1,5,1,1,0,32
179583,1298176,1,5,2,0,0,32
179584,1298176,1,5,3,1,0,33
179585,1298176,1,5,4,1,0,34
179586,1298176,1,5,5,1,0,35
179587,1298176,1,5,6,1,0,36
179588,1298176,1,6,1,0,0,36
179589,1298176,1,6,2,4,0,40
179590,1298176,1,6,3,1,0,41
179591,1298176,1,6,4,3,0,44
179592,1298176,1,6,5,1,0,45
179593,1298176,1,6,6,1,0,46
179594,1298176,1,7,1,0,0,46
179595,1298176,1,7,2,4,0,50
179596,1298176,1,7,3,2,0,52
179597,1298176,1,7,4,1,0,53
179598,1298176,1,7,5,0,0,53
179599,1298176,1,7,6,1,0,54
179600,1298176,1,8,1,1,0,55
179601,1298176,1,8,2,1,0,56
179602,1298176,1,8,3,2,0,58
179603,1298176,1,8,4,6,0,64
179604,1298176,1,8,5,4,0,68
179605,1298176,1,8,6,0,0,68
179606,1298176,1,9,1,0,0,68
179607,1298176,1,9,2,0,0,68
179608,1298176,1,9,3,1,0,69
179609,1298176,1,9,4,0,0,69
179610,1298176,1,9,5,1,0,70
179611,1298176,1,9,6,1,0,71
179612,1298176,1,10,1,1,0,72
179613,1298176,1,10,2,1,0,73
179614,1298176,1,10,3,1,0,74
179615,1298176,1,10,4,4,0,78
179616,1298176,1,10,5,1,0,79
179617,1298176,1,10,6,0,0,79
179618,1298176,1,11,1,1,0,80
179619,1298176,1,11,2,1,0,81
179620,1298176,1,11,3,1,0,82
179621,1298176,1,11,4,1,0,83
179622,1298176,1,11,5,1,0,84
179623,1298176,1,11,6,1,0,85
179624,1298176,1,12,1,0,0,85
179625,1298176,1,12,2,0,0,85
179626,1298176,1,12,3,1,0,86
179627,1298176,1,12,4,1,0,87
179628,1298176,1,12,5,0,1,87
179629,1298176,1,12,6,2,0,89
179630,1298176,1,13,1,6,0,95
179631,1298176,1,13,2,0,1,95
179632,1298176,1,13,3,1,0,96
179633,1298176,1,13,4,1,0,97
179634,1298176,1,13,5,0,0,97
179635,1298176,1,13,6,1,0,98
179636,1298176,1,14,1,1,0,99
179637,1298176,1,14,2,1,0,100
179638,1298176,1,14,3,1,1,101
179639,1298176,1,14,4,0,0,101
179640,1298176,1,14,5,1,0,102
179641,1298176,1,14,6,1,0,103
179642,1298176,1,15,1,1,0,104
179643,1298176,1,15,2,1,0,105
179644,1298176,1,15,3,0,0,105
179645,1298176,1,15,4,1,0,106
179646,1298176,1,15,5,1,0,107
179647,1298176,1,15,6,0,0,107
179648,1298176,1,16,1,1,0,108
179649,1298176,1,16,2,4,0,112
179650,1298176,1,16,3,4,0,116
179651,1298176,1,16,4,1,0,117
179652,1298176,1,16,5,4,0,121
179653,1298176,1,16,6,4,0,125
179654,1298176,1,17,1,4,0,129
179655,1298176,1,17,2,0,0,129
179656,1298176,1,17,3,6,0,135
179657,1298176,1,17,4,1,0,136
179658,1298176,1,17,5,1,0,137
179659,1298176,1,17,6,0,0,137
179660,1298176,1,18,1,1,0,138
179661,1298176,1,18,2,4,0,142
179662,1298176,1,18,3,2,0,144
179663,1298176,1,18,4,1,0,145
179664,1298176,1,18,5,1,0,146
179665,1298176,1,18,6,6,0,152
179666,1298176,1,19,1,4,0,156
179667,1298176,1,19,2,2,0,158
179668,1298176,1,19,3,1,0,159
179669,1298176,1,19,4,4,0,163
179670,1298176,1,19,5,2,0,165
179671,1298176,1,19,6,0,0,165
179672,1298176,1,20,1,1,0,166
179673,1298176,1,20,2,0,1,166
179674,1298176,1,20,3,8,0,174
179675,1298176,1,20,4,2,0,176
179676,1298176,1,20,5,4,0,180
179677,1298176,1,20,6,6,0,186
179782,1298177,1,1,1,4,0,4
179783,1298177,1,1,2,0,0,4
179784,1298177,1,1,3,0,1,4
179785,1298177,1,1,4,1,0,5
179786,1298177,1,1,5,1,0,6
179787,1298177,1,1,6,0,0,6
179788,1298177,1,2,1,0,0,6
179789,1298177,1,2,2,0,0,6
179790,1298177,1,2,3,0,0,6
179791,1298177,1,2,4,4,0,10
179792,1298177,1,2,5,0,0,10
179793,1298177,1,2,6,4,0,14
179794,1298177,1,3,1,3,0,17
179795,1298177,1,3,2,0,0,17
179796,1298177,1,3,3,0,0,17
179797,1298177,1,3,4,1,0,18
179798,1298177,1,3,5,1,0,19
179799,1298177,1,3,6,0,0,19
179800,1298177,1,4,1,2,0,21
179801,1298177,1,4,2,0,0,21
179802,1298177,1,4,3,1,0,22
179803,1298177,1,4,4,1,0,23
179804,1298177,1,4,5,0,0,23
179805,1298177,1,4,6,0,0,23
179806,1298177,1,5,1,1,0,24
179807,1298177,1,5,2,1,0,25
179808,1298177,1,5,3,1,0,26
179809,1298177,1,5,4,2,0,28
179810,1298177,1,5,5,1,0,29
179811,1298177,1,5,6,1,0,30
179812,1298177,1,6,1,4,0,34
179813,1298177,1,6,2,1,0,35
179814,1298177,1,6,3,1,0,36
179815,1298177,1,6,4,2,0,38
179816,1298177,1,6,5,0,0,38
179817,1298177,1,6,6,0,1,38
179818,1298177,1,7,1,1,0,39
179819,1298177,1,7,2,1,0,40
179820,1298177,1,7,3,4,0,44
179821,1298177,1,7,4,0,0,44
179822,1298177,1,7,5,0,0,44
179823,1298177,1,7,6,0,0,44
179824,1298177,1,8,1,1,0,45
179825,1298177,1,8,2,0,0,45
179826,1298177,1,8,3,1,0,46
179827,1298177,1,8,4,2,0,48
179828,1298177,1,8,5,1,0,49
179829,1298177,1,8,6,0,1,49
179830,1298177,1,9,1,0,0,49
179831,1298177,1,9,2,1,0,50
179832,1298177,1,9,3,0,0,50
179833,1298177,1,9,4,1,0,51
179834,1298177,1,9,5,0,0,51
179835,1298177,1,9,6,1,0,52
179836,1298177,1,10,1,1,0,53
179837,1298177,1,10,2,1,0,54
179838,1298177,1,10,3,1,0,55
179839,1298177,1,10,4,1,0,56
179840,1298177,1,10,5,1,0,57
179841,1298177,1,10,6,2,0,59
179842,1298177,1,11,1,1,0,60
179843,1298177,1,11,2,4,0,64
179844,1298177,1,11,3,2,0,66
179845,1298177,1,11,4,2,0,68
179846,1298177,1,11,5,4,0,72
179847,1298177,1,11,6,1,0,73
179848,1298177,1,12,1,1,0,74
179849,1298177,1,12,2,1,0,75
179850,1298177,1,12,3,1,0,76
179851,1298177,1,12,4,2,0,78
179852,1298177,1,12,5,1,0,79
179853,1298177,1,12,6,2,0,81
179854,1298177,1,13,1,6,0,87
179855,1298177,1,13,2,0,0,87
179856,1298177,1,13,3,0,0,87
179857,1298177,1,13,4,1,0,88
179858,1298177,1,13,5,0,0,88
179859,1298177,1,13,6,1,0,89
179860,1298177,1,14,1,1,0,90
179861,1298177,1,14,2,1,0,91
179862,1298177,1,14,3,1,0,92
179863,1298177,1,14,4,1,0,93
179864,1298177,1,14,5,6,0,99
179865,1298177,1,14,6,0,0,99
179866,1298177,1,15,1,0,0,99
179867,1298177,1,15,2,0,0,99
179868,1298177,1,15,3,4,0,103
179869,1298177,1,15,4,1,0,104
179870,1298177,1,15,5,1,0,105
179871,1298177,1,15,6,1,0,106
179872,1298177,1,16,1,2,0,108
179873,1298177,1,16,2,1,0,109
179874,1298177,1,16,3,2,0,111
179875,1298177,1,16,4,2,0,113
179876,1298177,1,16,5,2,0,115
179877,1298177,1,16,6,1,0,116
179878,1298177,1,17,1,1,0,117
179879,1298177,1,17,2,0,1,117
179880,1298177,1,17,3,0,0,117
179881,1298177,1,17,4,2,0,119
179882,1298177,1,17,5,2,0,121
179883,1298177,1,17,6,2,0,123
179884,1298177,1,18,1,4,0,127
179885,1298177,1,18,2,1,0,128
179886,1298177,1,18,3,1,0,129
179887,1298177,1,18,4,2,0,131
179888,1298177,1,18,5,1,0,132
179889,1298177,1,18,6,1,0,133
179890,1298177,1,19,1,1,0,134
179891,1298177,1,19,2,2,0,136
179892,1298177,1,19,3,1,0,137
179893,1298177,1,19,4,4,0,141
179894,1298177,1,19,5,1,0,142
179895,1298177,1,19,6,2,0,144
179896,1298177,1,20,1,2,0,146
179897,1298177,1,20,2,1,0,147
179898,1298177,1,20,3,1,0,148
179899,1298177,1,20,4,1,0,149
179900,1298177,1,20,5,2,0,151
179901,1298177,1,20,6,1,0,152
180017,1298178,1,1,1,4,0,4
180018,1298178,1,1,2,1,0,5
180019,1298178,1,1,3,0,0,5
180020,1298178,1,1,4,1,0,6
180021,1298178,1,1,5,0,0,6
180022,1298178,1,1,6,0,0,6
180023,1298178,1,2,1,0,0,6
180024,1298178,1,2,2,2,0,8
180025,1298178,1,2,3,1,0,9
180026,1298178,1,2,4,0,1,9
180027,1298178,1,2,5,0,0,9
180028,1298178,1,2,6,1,0,10
180029,1298178,1,3,1,0,0,10
180030,1298178,1,3,2,0,0,10
180031,1298178,1,3,3,1,0,11
180032,1298178,1,3,4,0,0,11
180033,1298178,1,3,5,0,0,11
180034,1298178,1,3,6,0,0,11
180035,1298178,1,4,1,6,0,17
180036,1298178,1,4,2,1,0,18
180037,1298178,1,4,3,1,0,19
180038,1298178,1,4,4,0,0,19
180039,1298178,1,4,5,2,0,21
180040,1298178,1,4,6,0,0,21
180041,1298178,1,5,1,1,0,22
180042,1298178,1,5,2,4,0,26
180043,1298178,1,5,3,4,0,30
180044,1298178,1,5,4,1,0,31
180045,1298178,1,5,5,0,0,31
180046,1298178,1,5,6,0,0,31
180047,1298178,1,6,1,4,0,35
180048,1298178,1,6,2,0,0,35
180049,1298178,1,6,3,0,0,35
180050,1298178,1,6,4,1,0,36
180051,1298178,1,6,5,1,0,37
180052,1298178,1,6,6,1,0,38
180053,1298178,1,7,1,0,0,38
180054,1298178,1,7,2,1,0,39
180055,1298178,1,7,3,4,0,43
180056,1298178,1,7,4,2,0,45
180057,1298178,1,7,5,1,0,46
180058,1298178,1,7,6,0,0,46
180059,1298178,1,8,1,1,0,47
180060,1298178,1,8,2,0,0,47
180061,1298178,1,8,3,1,0,48
180062,1298178,1,8,4,1,0,49
180063,1298178,1,8,5,1,0,50
180064,1298178,1,8,6,1,0,51
180065,1298178,1,9,1,1,0,52
180066,1298178,1,9,2,4,0,56
180067,1298178,1,9,3,0,0,56
180068,1298178,1,9,4,0,0,56
180069,1298178,1,9,5,0,1,56
180070,1298178,1,9,6,1,0,57
180071,1298178,1,10,1,0,0,57
180072,1298178,1,10,2,1,0,58
180073,1298178,1,10,3,2,0,60
180074,1298178,1,10,4,0,0,60
180075,1298178,1,10,5,1,0,61
180076,1298178,1,10,6,1,0,62
180077,1298178,1,11,1,0,0,62
180078,1298178,1,11,2,1,0,63
180079,1298178,1,11,3,1,0,64
180080,1298178,1,11,4,0,0,64
180081,1298178,1,11,5,6,0,70
180082,1298178,1,11,6,4,0,74
180083,1298178,1,12,1,1,0,75
180084,1298178,1,12,2,0,1,75
180085,1298178,1,12,3,0,0,75
180086,1298178,1,12,4,0,0,75
180087,1298178,1,12,5,1,0,76
180088,1298178,1,12,6,1,0,77
180089,1298178,1,13,1,1,0,78
180090,1298178,1,13,2,0,0,78
180091,1298178,1,13,3,0,0,78
180092,1298178,1,13,4,1,0,79
180093,1298178,1,13,5,1,0,80
180094,1298178,1,13,6,0,0,80
180095,1298178,1,14,1,1,0,81
180096,1298178,1,14,2,1,0,82
180097,1298178,1,14,3,4,0,86
180098,1298178,1,14,4,1,0,87
180099,1298178,1,14,5,2,0,89
180100,1298178,1,14,6,1,0,90
180101,1298178,1,15,1,1,0,91
180102,1298178,1,15,2,4,0,95
180103,1298178,1,15,3,0,0,95
180104,1298178,1,15,4,1,0,96
180105,1298178,1,15,5,0,0,96
180106,1298178,1,15,6,4,0,100
180107,1298178,1,16,1,2,0,102
180108,1298178,1,16,2,0,0,102
180109,1298178,1,16,3,4,0,106
180110,1298178,1,16,4,1,0,107
180111,1298178,1,16,5,2,0,109
180112,1298178,1,16,6,1,0,110
180113,1298178,1,17,1,6,0,116
180114,1298178,1,17,2,2,0,118
180115,1298178,1,17,3,0,0,118
180116,1298178,1,17,4,2,0,120
180117,1298178,1,17,5,0,0,120
180118,1298178,1,17,6,1,0,121
180119,1298178,1,18,1,6,0,127
180120,1298178,1,18,2,6,0,133
180121,1298178,1,18,3,0,0,133
180122,1298178,1,18,4,1,0,134
180123,1298178,1,18,5,2,0,136
180124,1298178,1,18,6,0,1,136
180125,1298178,1,19,1,1,0,137
180126,1298178,1,19,2,4,0,141
180127,1298178,1,19,3,1,0,142
180128,1298178,1,19,4,4,0,146
180129,1298178,1,19,5,6,0,152
180130,1298178,1,19,6,4,0,156
180131,1298178,1,20,1,1,0,157
180132,1298178,1,20,2,1,0,158
180133,1298178,1,20,3,0,1,158
180134,1298178,1,20,4,6,0,164
180135,1298178,1,20,5,4,0,168
180136,1298178,1,20,6,0,1,168
180233,1298179,1,1,1,2,0,2
180234,1298179,1,1,2,2,0,4
180235,1298179,1,1,3,0,0,4
180236,1298179,1,1,4,1,0,5
180237,1298179,1,1,5,0,0,5
180238,1298179,1,1,6,3,0,8
180239,1298179,1,2,1,1,0,9
180240,1298179,1,2,2,0,0,9
180241,1298179,1,2,3,1,0,10
180242,1298179,1,2,4,1,0,11
180243,1298179,1,2,5,1,0,12
180244,1298179,1,2,6,0,0,12
180245,1298179,1,3,1,0,0,12
180246,1298179,1,3,2,1,0,13
180247,1298179,1,3,3,2,0,15
180248,1298179,1,3,4,1,0,16
180249,1298179,1,3,5,0,0,16
180250,1298179,1,3,6,0,0,16
180251,1298179,1,4,1,6,0,22
180252,1298179,1,4,2,1,0,23
180253,1298179,1,4,3,1,0,24
180254,1298179,1,4,4,0,0,24
180255,1298179,1,4,5,1,0,25
180256,1298179,1,4,6,3,0,28
180257,1298179,1,5,1,1,0,29
180258,1298179,1,5,2,0,1,29
180259,1298179,1,5,3,0,0,29
180260,1298179,1,5,4,0,0,29
180261,1298179,1,5,5,0,0,29
180262,1298179,1,5,6,0,0,29
180263,1298179,1,6,1,0,0,29
180264,1298179,1,6,2,4,0,33
180265,1298179,1,6,3,1,0,34
180266,1298179,1,6,4,0,0,34
180267,1298179,1,6,5,0,0,34
180268,1298179,1,6,6,5,0,39
180269,1298179,1,7,1,1,0,40
180270,1298179,1,7,2,1,0,41
180271,1298179,1,7,3,1,0,42
180272,1298179,1,7,4,0,0,42
180273,1298179,1,7,5,2,0,44
180274,1298179,1,7,6,1,0,45
180275,1298179,1,8,1,0,1,45
180276,1298179,1,8,2,0,0,45
180277,1298179,1,8,3,0,0,45
180278,1298179,1,8,4,1,0,46
180279,1298179,1,8,5,2,0,48
180280,1298179,1,8,6,2,0,50
180281,1298179,1,9,1,1,0,51
180282,1298179,1,9,2,4,0,55
180283,1298179,1,9,3,1,0,56
180284,1298179,1,9,4,2,0,58
180285,1298179,1,9,5,1,0,59
180286,1298179,1,9,6,0,0,59
180287,1298179,1,10,1,2,0,61
180288,1298179,1,10,2,1,0,62
180289,1298179,1,10,3,1,0,63
180290,1298179,1,10,4,1,0,64
180291,1298179,1,10,5,1,0,65
180292,1298179,1,10,6,3,0,68
180293,1298179,1,11,1,2,0,70
180294,1298179,1,11,2,1,0,71
180295,1298179,1,11,3,0,0,71
180296,1298179,1,11,4,4,0,75
180297,1298179,1,11,5,7,0,82
180298,1298179,1,11,6,2,0,84
180299,1298179,1,12,1,0,1,84
180300,1298179,1,12,2,0,0,84
180301,1298179,1,12,3,0,0,84
180302,1298179,1,12,4,0,0,84
180303,1298179,1,12,5,0,0,84
180304,1298179,1,12,6,0,0,84
180305,1298179,1,13,1,1,0,85
180306,1298179,1,13,2,0,1,85
180307,1298179,1,13,3,1,0,86
180308,1298179,1,13,4,2,0,88
180309,1298179,1,13,5,1,0,89
180310,1298179,1,13,6,1,0,90
180311,1298179,1,14,1,1,0,91
180312,1298179,1,14,2,1,0,92
180313,1298179,1,14,3,4,0,96
180314,1298179,1,14,4,1,0,97
180315,1298179,1,14,5,1,0,98
180316,1298179,1,14,6,0,0,98
180317,1298179,1,15,1,0,0,98
180318,1298179,1,15,2,1,0,99
180319,1298179,1,15,3,1,0,100
180320,1298179,1,15,4,4,0,104
180321,1298179,1,15,5,1,0,105
180322,1298179,1,15,6,1,0,106
180323,1298179,1,16,1,2,0,108
180324,1298179,1,16,2,5,0,113
180325,1298179,1,16,3,1,0,114
180326,1298179,1,16,4,1,0,115
180327,1298179,1,16,5,3,0,118
180328,1298179,1,16,6,1,0,119
180329,1298179,1,17,1,2,0,121
180330,1298179,1,17,2,0,0,121
180331,1298179,1,17,3,0,1,121
180332,1298179,1,17,4,0,0,121
180333,1298179,1,17,5,1,0,122
180334,1298179,1,17,6,0,0,122
180335,1298179,1,18,1,1,0,123
180336,1298179,1,18,2,0,1,123
180337,1298179,1,18,3,0,0,123
180338,1298179,1,18,4,3,0,126
180339,1298179,1,18,5,1,0,127
180340,1298179,1,18,6,0,0,127
180341,1298179,1,19,1,0,0,127
180342,1298179,1,19,2,2,0,129
180343,1298179,1,19,3,0,1,129
180344,1298179,1,19,4,1,0,130
180345,1298179,1,19,5,0,0,130
180346,1298179,1,19,6,1,0,131
180347,1298179,1,20,1,0,0,131
180348,1298179,1,20,2,0,0,131
180349,1298179,1,20,3,0,1,131
180350,1298179,1,20,4,1,0,132
180351,1298179,1,20,5,4,0,136
180352,1298179,1,20,6,1,0,137
180467,1299596,1,1,1,0,0,0
180468,1299596,1,1,2,2,0,2
180469,1299596,1,1,3,0,0,2
180470,1299596,1,1,4,0,1,2
180471,1299596,1,1,5,1,0,3
180472,1299596,1,1,6,0,0,3
180473,1299596,1,2,1,1,0,4
180474,1299596,1,2,2,1,0,5
180475,1299596,1,2,3,0,0,5
180476,1299596,1,2,4,1,0,6
180477,1299596,1,2,5,1,0,7
180478,1299596,1,2,6,0,0,7
180479,1299596,1,3,1,4,0,11
180480,1299596,1,3,2,4,0,15
180481,1299596,1,3,3,1,0,16
180482,1299596,1,3,4,1,0,17
180483,1299596,1,3,5,0,0,17
180484,1299596,1,3,6,0,0,17
180485,1299596,1,4,1,0,0,17
180486,1299596,1,4,2,4,0,21
180487,1299596,1,4,3,1,0,22
180488,1299596,1,4,4,4,0,26
180489,1299596,1,4,5,1,0,27
180490,1299596,1,4,6,0,1,27
180491,1299596,1,5,1,1,0,28
180492,1299596,1,5,2,0,0,28
180493,1299596,1,5,3,1,0,29
180494,1299596,1,5,4,2,0,31
180495,1299596,1,5,5,0,1,31
180496,1299596,1,5,6,0,0,31
180497,1299596,1,6,1,1,0,32
180498,1299596,1,6,2,0,0,32
180499,1299596,1,6,3,2,0,34
180500,1299596,1,6,4,1,0,35
180501,1299596,1,6,5,0,0,35
180502,1299596,1,6,6,0,0,35
180503,1299596,1,7,1,0,0,35
180504,1299596,1,7,2,1,0,36
180505,1299596,1,7,3,1,0,37
180506,1299596,1,7,4,1,0,38
180507,1299596,1,7,5,1,0,39
180508,1299596,1,7,6,0,0,39
180509,1299596,1,8,1,1,0,40
180510,1299596,1,8,2,0,0,40
180511,1299596,1,8,3,4,0,44
180512,1299596,1,8,4,0,0,44
180513,1299596,1,8,5,2,0,46
180514,1299596,1,8,6,1,0,47
180515,1299596,1,9,1,1,0,48
180516,1299596,1,9,2,1,0,49
180517,1299596,1,9,3,1,0,50
180518,1299596,1,9,4,6,0,56
180519,1299596,1,9,5,2,0,58
180520,1299596,1,9,6,1,0,59
180521,1299596,1,10,1,1,0,60
180522,1299596,1,10,2,0,1,60
180523,1299596,1,10,3,1,0,61
180524,1299596,1,10,4,1,0,62
180525,1299596,1,10,5,1,0,63
180526,1299596,1,10,6,0,0,63
180527,1299596,1,11,1,0,0,63
180528,1299596,1,11,2,0,0,63
180529,1299596,1,11,3,1,0,64
180530,1299596,1,11,4,0,0,64
180531,1299596,1,11,5,1,0,65
180532,1299596,1,11,6,1,0,66
180533,1299596,1,12,1,0,1,66
180534,1299596,1,12,2,1,0,67
180535,1299596,1,12,3,1,0,68
180536,1299596,1,12,4,0,1,68
180537,1299596,1,12,5,1,0,69
180538,1299596,1,12,6,0,0,69
180539,1299596,1,13,1,0,0,69
180540,1299596,1,13,2,1,0,70
180541,1299596,1,13,3,1,0,71
180542,1299596,1,13,4,4,0,75
180543,1299596,1,13,5,0,0,75
180544,1299596,1,13,6,1,0,76
180545,1299596,1,14,1,0,0,76
180546,1299596,1,14,2,0,0,76
180547,1299596,1,14,3,1,0,77
180548,1299596,1,14,4,3,0,80
180549,1299596,1,14,5,0,0,80
180550,1299596,1,14,6,1,0,81
180551,1299596,1,15,1,1,0,82
180552,1299596,1,15,2,0,0,82
180553,1299596,1,15,3,3,0,85
180554,1299596,1,15,4,1,0,86
180555,1299596,1,15,5,4,0,90
180556,1299596,1,15,6,0,0,90
180557,1299596,1,16,1,2,0,92
180558,1299596,1,16,2,1,0,93
180559,1299596,1,16,3,1,0,94
180560,1299596,1,16,4,4,0,98
180561,1299596,1,16,5,1,0,99
180562,1299596,1,16,6,0,1,99
180563,1299596,1,17,1,6,0,105
180564,1299596,1,17,2,1,0,106
180565,1299596,1,17,3,1,0,107
180566,1299596,1,17,4,1,0,108
180567,1299596,1,17,5,1,0,109
180568,1299596,1,17,6,1,0,110
180569,1299596,1,18,1,0,1,110
180570,1299596,1,18,2,1,0,111
180571,1299596,1,18,3,0,0,111
180572,1299596,1,18,4,1,0,112
180573,1299596,1,18,5,1,0,113
180574,1299596,1,18,6,0,0,113
180575,1299596,1,19,1,1,0,114
180576,1299596,1,19,2,0,0,114
180577,1299596,1,19,3,1,0,115
180578,1299596,1,19,4,6,0,121
180579,1299596,1,19,5,1,0,122
180580,1299596,1,19,6,0,0,122
180581,1299596,1,20,1,1,0,123
180582,1299596,1,20,2,1,0,124
180583,1299596,1,20,3,0,1,124
180584,1299596,1,20,4,1,0,125
180585,1299596,1,20,5,1,0,126
180586,1299596,1,20,6,1,1,127
180707,1299832,1,1,1,1,0,1
180708,1299832,1,1,2,4,0,5
180709,1299832,1,1,3,0,0,5
180710,1299832,1,1,4,1,0,6
180711,1299832,1,1,5,0,0,6
180712,1299832,1,1,6,0,0,6
180713,1299832,1,2,1,0,0,6
180714,1299832,1,2,2,1,0,7
180715,1299832,1,2,3,1,0,8
180716,1299832,1,2,4,1,0,9
180717,1299832,1,2,5,1,0,10
180718,1299832,1,2,6,0,0,10
180719,1299832,1,3,1,0,1,10
180720,1299832,1,3,2,1,0,11
180721,1299832,1,3,3,1,0,12
180722,1299832,1,3,4,0,0,12
180723,1299832,1,3,5,1,0,13
180724,1299832,1,3,6,1,0,14
180725,1299832,1,4,1,4,0,18
180726,1299832,1,4,2,4,0,22
180727,1299832,1,4,3,0,0,22
180728,1299832,1,4,4,0,0,22
180729,1299832,1,4,5,0,0,22
180730,1299832,1,4,6,0,0,22
180731,1299832,1,5,1,0,0,22
180732,1299832,1,5,2,0,0,22
180733,1299832,1,5,3,1,0,23
180734,1299832,1,5,4,1,0,24
180735,1299832,1,5,5,1,0,25
180736,1299832,1,5,6,0,1,25
180737,1299832,1,6,1,4,0,29
180738,1299832,1,6,2,0,0,29
180739,1299832,1,6,3,2,0,31
180740,1299832,1,6,4,5,0,36
180741,1299832,1,6,5,1,0,37
180742,1299832,1,6,6,0,0,37
180743,1299832,1,7,1,1,0,38
180744,1299832,1,7,2,0,0,38
180745,1299832,1,7,3,1,0,39
180746,1299832,1,7,4,1,0,40
180747,1299832,1,7,5,3,0,43
180748,1299832,1,7,6,2,0,45
180749,1299832,1,8,1,1,0,46
180750,1299832,1,8,2,0,0,46
180751,1299832,1,8,3,1,0,47
180752,1299832,1,8,4,0,1,47
180753,1299832,1,8,5,1,0,48
180754,1299832,1,8,6,1,0,49
180755,1299832,1,9,1,1,0,50
180756,1299832,1,9,2,1,0,51
180757,1299832,1,9,3,1,0,52
180758,1299832,1,9,4,0,0,52
180759,1299832,1,9,5,1,0,53
180760,1299832,1,9,6,1,0,54
180761,1299832,1,10,1,0,0,54
180762,1299832,1,10,2,6,0,60
180763,1299832,1,10,3,2,0,62
180764,1299832,1,10,4,2,0,64
180765,1299832,1,10,5,1,0,65
180766,1299832,1,10,6,6,0,71
180767,1299832,1,11,1,1,0,72
180768,1299832,1,11,2,1,0,73
180769,1299832,1,11,3,6,0,79
180770,1299832,1,11,4,1,0,80
180771,1299832,1,11,5,0,1,80
180772,1299832,1,11,6,1,0,81
180773,1299832,1,12,1,1,0,82
180774,1299832,1,12,2,1,0,83
180775,1299832,1,12,3,0,0,83
180776,1299832,1,12,4,1,0,84
180777,1299832,1,12,5,1,0,85
180778,1299832,1,12,6,1,0,86
180779,1299832,1,13,1,4,0,90
180780,1299832,1,13,2,2,0,92
180781,1299832,1,13,3,0,0,92
180782,1299832,1,13,4,0,0,92
180783,1299832,1,13,5,1,0,93
180784,1299832,1,13,6,4,0,97
180785,1299832,1,14,1,1,0,98
180786,1299832,1,14,2,1,0,99
180787,1299832,1,14,3,1,0,100
180788,1299832,1,14,4,1,0,101
180789,1299832,1,14,5,0,0,101
180790,1299832,1,14,6,1,0,102
180791,1299832,1,15,1,2,0,104
180792,1299832,1,15,2,4,0,108
180793,1299832,1,15,3,1,0,109
180794,1299832,1,15,4,0,0,109
180795,1299832,1,15,5,1,0,110
180796,1299832,1,15,6,0,0,110
180797,1299832,1,16,1,1,0,111
180798,1299832,1,16,2,0,0,111
180799,1299832,1,16,3,2,0,113
180800,1299832,1,16,4,1,0,114
180801,1299832,1,16,5,0,0,114
180802,1299832,1,16,6,0,0,114
180803,1299832,1,17,1,2,0,116
180804,1299832,1,17,2,1,0,117
180805,1299832,1,17,3,5,0,122
180806,1299832,1,17,4,2,0,124
180807,1299832,1,17,5,2,0,126
180808,1299832,1,17,6,0,1,126
180809,1299832,1,18,1,1,0,127
180810,1299832,1,18,2,0,1,127
180811,1299832,1,18,3,1,0,128
180812,1299832,1,18,4,1,0,129
180813,1299832,1,18,5,1,0,130
180814,1299832,1,18,6,1,0,131
180815,1299832,1,19,1,1,0,132
180816,1299832,1,19,2,1,0,133
180817,1299832,1,19,3,1,0,134
180818,1299832,1,19,4,0,0,134
180819,1299832,1,19,5,4,0,138
180820,1299832,1,19,6,4,0,142
180821,1299832,1,20,1,4,0,146
180822,1299832,1,20,2,1,1,147
180823,1299832,1,20,3,2,0,149
180824,1299832,1,20,4,1,0,150
180825,1299832,1,20,5,1,1,151
180826,1299832,1,20,6,4,0,155
180933,1299833,1,1,1,2,0,2
180934,1299833,1,1,2,0,0,2
180935,1299833,1,1,3,0,0,2
180936,1299833,1,1,4,0,0,2
180937,1299833,1,1,5,0,0,2
180938,1299833,1,1,6,1,0,3
180939,1299833,1,2,1,0,0,3
180940,1299833,1,2,2,4,0,7
180941,1299833,1,2,3,0,0,7
180942,1299833,1,2,4,0,1,7
180943,1299833,1,2,5,0,0,7
180944,1299833,1,2,6,1,0,8
180945,1299833,1,3,1,0,0,8
180946,1299833,1,3,2,0,0,8
180947,1299833,1,3,3,2,0,10
180948,1299833,1,3,4,6,0,16
180949,1299833,1,3,5,1,0,17
180950,1299833,1,3,6,1,0,18
180951,1299833,1,4,1,0,0,18
180952,1299833,1,4,2,0,0,18
180953,1299833,1,4,3,1,0,19
180954,1299833,1,4,4,2,0,21
180955,1299833,1,4,5,1,0,22
180956,1299833,1,4,6,0,0,22
180957,1299833,1,5,1,0,1,22
180958,1299833,1,5,2,4,0,26
180959,1299833,1,5,3,0,0,26
180960,1299833,1,5,4,0,0,26
180961,1299833,1,5,5,0,0,26
180962,1299833,1,5,6,4,0,30
180963,1299833,1,6,1,0,0,30
180964,1299833,1,6,2,1,0,31
180965,1299833,1,6,3,0,0,31
180966,1299833,1,6,4,1,0,32
180967,1299833,1,6,5,0,0,32
180968,1299833,1,6,6,1,0,33
180969,1299833,1,7,1,1,0,34
180970,1299833,1,7,2,0,0,34
180971,1299833,1,7,3,1,0,35
180972,1299833,1,7,4,1,0,36
180973,1299833,1,7,5,0,0,36
180974,1299833,1,7,6,0,0,36
180975,1299833,1,8,1,1,0,37
180976,1299833,1,8,2,0,0,37
180977,1299833,1,8,3,1,0,38
180978,1299833,1,8,4,0,0,38
180979,1299833,1,8,5,0,0,38
180980,1299833,1,8,6,0,0,38
180981,1299833,1,9,1,0,1,38
180982,1299833,1,9,2,1,0,39
180983,1299833,1,9,3,1,0,40
180984,1299833,1,9,4,0,0,40
180985,1299833,1,9,5,1,0,41
180986,1299833,1,9,6,1,0,42
180987,1299833,1,10,1,1,0,43
180988,1299833,1,10,2,2,0,45
180989,1299833,1,10,3,0,1,45
180990,1299833,1,10,4,0,0,45
180991,1299833,1,10,5,1,0,46
180992,1299833,1,10,6,1,0,47
180993,1299833,1,11,1,0,0,47
180994,1299833,1,11,2,1,0,48
180995,1299833,1,11,3,0,0,48
180996,1299833,1,11,4,0,0,48
180997,1299833,1,11,5,0,0,48
180998,1299833,1,11,6,1,0,49
180999,1299833,1,12,1,0,0,49
181000,1299833,1,12,2,1,0,50
181001,1299833,1,12,3,4,0,54
181002,1299833,1,12,4,2,0,56
181003,1299833,1,12,5,4,0,60
181004,1299833,1,12,6,2,0,62
181005,1299833,1,13,1,4,0,66
181006,1299833,1,13,2,1,0,67
181007,1299833,1,13,3,1,0,68
181008,1299833,1,13,4,1,0,69
181009,1299833,1,13,5,0,0,69
181010,1299833,1,13,6,1,0,70
181011,1299833,1,14,1,0,0,70
181012,1299833,1,14,2,2,0,72
181013,1299833,1,14,3,4,0,76
181014,1299833,1,14,4,4,0,80
181015,1299833,1,14,5,1,0,81
181016,1299833,1,14,6,1,0,82
181017,1299833,1,15,1,4,0,86
181018,1299833,1,15,2,1,0,87
181019,1299833,1,15,3,1,0,88
181020,1299833,1,15,4,0,1,88
181021,1299833,1,15,5,0,0,88
181022,1299833,1,15,6,4,0,92
181023,1299833,1,16,1,0,0,92
181024,1299833,1,16,2,1,0,93
181025,1299833,1,16,3,1,0,94
181026,1299833,1,16,4,4,0,98
181027,1299833,1,16,5,1,0,99
181028,1299833,1,16,6,0,0,99
181029,1299833,1,17,1,0,1,99
181030,1299833,1,17,2,1,0,100
181031,1299833,1,17,3,0,1,100
181032,1299833,1,17,4,0,0,100
181033,1299833,1,17,5,1,0,101
181034,1299833,1,17,6,1,0,102
181035,1299833,1,18,1,0,0,102
181036,1299833,1,18,2,1,0,103
181037,1299833,1,18,3,1,0,104
181038,1299833,1,18,4,0,1,104
181039,1299833,1,18,5,0,0,104
181040,1299833,1,18,6,1,0,105
181041,1299833,1,19,1,0,1,105
181042,1299833,1,19,2,1,0,106
181043,1299833,1,19,3,1,0,107
181044,1299833,1,19,4,1,0,108
181045,1299833,1,19,5,1,0,109
181046,1299833,1,19,6,0,0,109
181047,1299833,1,20,1,1,0,110
181048,1299833,1,20,2,1,0,111
181049,1299833,1,20,3,0,0,111
181050,1299833,1,20,4,0,0,111
181051,1299833,1,20,5,1,0,112
181052,1299833,1,20,6,3,0,115
181159,1303307,1,1,1,0,0,0
181160,1303307,1,1,2,0,0,0
181161,1303307,1,1,3,1,0,1
181162,1303307,1,1,4,0,0,1
181163,1303307,1,1,5,0,1,1
181164,1303307,1,1,6,0,0,1
181165,1303307,1,2,1,5,0,6
181166,1303307,1,2,2,0,1,6
181167,1303307,1,2,3,2,0,8
181168,1303307,1,2,4,0,0,8
181169,1303307,1,2,5,2,0,10
181170,1303307,1,2,6,4,0,14
181171,1303307,1,3,1,1,0,15
181172,1303307,1,3,2,0,0,15
181173,1303307,1,3,3,1,0,16
181174,1303307,1,3,4,0,0,16
181175,1303307,1,3,5,0,0,16
181176,1303307,1,3,6,1,0,17
181177,1303307,1,4,1,0,0,17
181178,1303307,1,4,2,4,0,21
181179,1303307,1,4,3,1,0,22
181180,1303307,1,4,4,0,0,22
181181,1303307,1,4,5,0,1,22
181182,1303307,1,4,6,0,0,22
181183,1303307,1,5,1,1,0,23
181184,1303307,1,5,2,1,0,24
181185,1303307,1,5,3,4,0,28
181186,1303307,1,5,4,4,0,32
181187,1303307,1,5,5,1,0,33
181188,1303307,1,5,6,1,0,34
181189,1303307,1,6,1,1,0,35
181190,1303307,1,6,2,1,0,36
181191,1303307,1,6,3,4,0,40
181192,1303307,1,6,4,1,0,41
181193,1303307,1,6,5,4,0,45
181194,1303307,1,6,6,7,0,52
181195,1303307,1,7,1,0,0,52
181196,1303307,1,7,2,0,0,52
181197,1303307,1,7,3,1,0,53
181198,1303307,1,7,4,1,0,54
181199,1303307,1,7,5,1,0,55
181200,1303307,1,7,6,1,0,56
181201,1303307,1,8,1,0,0,56
181202,1303307,1,8,2,1,0,57
181203,1303307,1,8,3,0,0,57
181204,1303307,1,8,4,6,0,63
181205,1303307,1,8,5,6,0,69
181206,1303307,1,8,6,0,0,69
181207,1303307,1,9,1,1,0,70
181208,1303307,1,9,2,1,0,71
181209,1303307,1,9,3,1,0,72
181210,1303307,1,9,4,0,1,72
181211,1303307,1,9,5,1,0,73
181212,1303307,1,9,6,0,0,73
181213,1303307,1,10,1,4,0,77
181214,1303307,1,10,2,2,0,79
181215,1303307,1,10,3,6,0,85
181216,1303307,1,10,4,0,0,85
181217,1303307,1,10,5,1,0,86
181218,1303307,1,10,6,1,0,87
181219,1303307,1,11,1,0,0,87
181220,1303307,1,11,2,1,0,88
181221,1303307,1,11,3,1,0,89
181222,1303307,1,11,4,1,0,90
181223,1303307,1,11,5,1,0,91
181224,1303307,1,11,6,0,0,91
181225,1303307,1,12,1,1,0,92
181226,1303307,1,12,2,1,0,93
181227,1303307,1,12,3,4,0,97
181228,1303307,1,12,4,3,0,100
181229,1303307,1,12,5,6,0,106
181230,1303307,1,12,6,2,0,108
181287,1303308,1,1,1,4,0,4
181288,1303308,1,1,2,1,0,5
181289,1303308,1,1,3,1,0,6
181290,1303308,1,1,4,1,0,7
181291,1303308,1,1,5,0,0,7
181292,1303308,1,1,6,1,0,8
181293,1303308,1,2,1,1,0,9
181294,1303308,1,2,2,0,0,9
181295,1303308,1,2,3,0,0,9
181296,1303308,1,2,4,4,0,13
181297,1303308,1,2,5,0,0,13
181298,1303308,1,2,6,0,0,13
181299,1303308,1,3,1,0,1,13
181300,1303308,1,3,2,0,0,13
181301,1303308,1,3,3,0,0,13
181302,1303308,1,3,4,0,0,13
181303,1303308,1,3,5,2,0,15
181304,1303308,1,3,6,6,0,21
181305,1303308,1,4,1,3,0,24
181306,1303308,1,4,2,4,0,28
181307,1303308,1,4,3,0,0,28
181308,1303308,1,4,4,1,0,29
181309,1303308,1,4,5,0,0,29
181310,1303308,1,4,6,1,0,30
181311,1303308,1,5,1,0,0,30
181312,1303308,1,5,2,4,0,34
181313,1303308,1,5,3,0,0,34
181314,1303308,1,5,4,4,0,38
181315,1303308,1,5,5,1,0,39
181316,1303308,1,5,6,0,0,39
181317,1303308,1,6,1,6,0,45
181318,1303308,1,6,2,1,0,46
181319,1303308,1,6,3,4,0,50
181320,1303308,1,6,4,0,0,50
181321,1303308,1,6,5,0,0,50
181322,1303308,1,6,6,4,0,54
181323,1303308,1,7,1,1,0,55
181324,1303308,1,7,2,1,0,56
181325,1303308,1,7,3,1,0,57
181326,1303308,1,7,4,0,0,57
181327,1303308,1,7,5,0,0,57
181328,1303308,1,7,6,1,0,58
181329,1303308,1,8,1,1,0,59
181330,1303308,1,8,2,0,0,59
181331,1303308,1,8,3,1,0,60
181332,1303308,1,8,4,1,0,61
181333,1303308,1,8,5,4,0,65
181334,1303308,1,8,6,1,0,66
181335,1303308,1,9,1,1,0,67
181336,1303308,1,9,2,1,0,68
181337,1303308,1,9,3,2,0,70
181338,1303308,1,9,4,4,0,74
181339,1303308,1,9,5,6,0,80
181340,1303308,1,9,6,1,0,81
181341,1303308,1,10,1,1,0,82
181342,1303308,1,10,2,6,0,88
181343,1303308,1,10,3,1,0,89
181344,1303308,1,10,4,1,0,90
181345,1303308,1,10,5,6,0,96
181346,1303308,1,10,6,1,0,97
181347,1303308,1,11,1,4,0,101
181348,1303308,1,11,2,4,0,105
181349,1303308,1,11,3,0,0,105
181350,1303308,1,11,4,0,0,105
181351,1303308,1,11,5,1,0,106
181352,1303308,1,11,6,4,0,110
181353,1303308,1,12,1,5,0,115
181354,1303308,1,12,2,6,0,121
181355,1303308,1,12,3,0,0,121
181356,1303308,1,12,4,2,0,123
181357,1303308,1,12,5,5,0,128
181358,1303308,1,12,6,1,0,129
181359,1303308,1,13,1,2,0,131
181360,1303308,1,13,2,0,0,131
181361,1303308,1,13,3,1,0,132
181362,1303308,1,13,4,4,0,136
181363,1303308,1,13,5,1,0,137
181364,1303308,1,13,6,1,0,138
181365,1303308,1,14,1,7,0,145
181366,1303308,1,14,2,3,0,148
181367,1303308,1,14,3,4,0,152
181368,1303308,1,14,4,0,0,152
181369,1303308,1,14,5,1,0,153
181370,1303308,1,14,6,5,0,158
181371,1303308,1,15,1,1,0,159
181372,1303308,1,15,2,4,0,163
181373,1303308,1,15,3,1,0,164
181374,1303308,1,15,4,1,0,165
181375,1303308,1,15,5,6,0,171
181376,1303308,1,15,6,6,0,177
181377,1303308,1,16,1,2,0,179
181378,1303308,1,16,2,1,0,180
181379,1303308,1,16,3,1,0,181
181380,1303308,1,16,4,1,0,182
181381,1303308,1,16,5,1,0,183
181382,1303308,1,16,6,0,0,183
181383,1303308,1,17,1,6,0,189
181384,1303308,1,17,2,0,1,189
181385,1303308,1,17,3,1,0,190
181386,1303308,1,17,4,1,0,191
181387,1303308,1,17,5,6,0,197
181388,1303308,1,17,6,4,0,201
181389,1303308,1,18,1,1,0,202
181390,1303308,1,18,2,4,0,206
181391,1303308,1,18,3,0,1,206
181392,1303308,1,18,4,2,0,208
181393,1303308,1,18,5,4,0,212
181394,1303308,1,18,6,0,1,212
181395,1303308,1,19,1,0,0,212
181396,1303308,1,19,2,4,0,216
181397,1303308,1,19,3,0,0,216
181398,1303308,1,19,4,1,0,217
181399,1303308,1,19,5,0,1,217
181400,1303308,1,19,6,0,1,217
181401,1303308,1,20,1,0,0,217
181402,1303308,1,20,2,2,0,219
181403,1303308,1,20,3,4,0,223
181404,1303308,1,20,4,1,0,224
181405,1303308,1,20,5,0,1,224
181406,1303308,1,20,6,1,0,225
181527,1303312,1,1,1,4,0,4
181528,1303312,1,1,2,0,0,4
181529,1303312,1,1,3,1,0,5
181530,1303312,1,1,4,0,0,5
181531,1303312,1,1,5,0,0,5
181532,1303312,1,1,6,0,0,5
181533,1303312,1,2,1,4,0,9
181534,1303312,1,2,2,1,0,10
181535,1303312,1,2,3,4,0,14
181536,1303312,1,2,4,1,0,15
181537,1303312,1,2,5,1,0,16
181538,1303312,1,2,6,0,0,16
181539,1303312,1,3,1,4,0,20
181540,1303312,1,3,2,4,0,24
181541,1303312,1,3,3,1,0,25
181542,1303312,1,3,4,0,1,25
181543,1303312,1,3,5,0,0,25
181544,1303312,1,3,6,0,0,25
181545,1303312,1,4,1,4,0,29
181546,1303312,1,4,2,0,0,29
181547,1303312,1,4,3,0,1,29
181548,1303312,1,4,4,2,0,31
181549,1303312,1,4,5,0,0,31
181550,1303312,1,4,6,1,0,32
181551,1303312,1,5,1,0,0,32
181552,1303312,1,5,2,1,0,33
181553,1303312,1,5,3,0,0,33
181554,1303312,1,5,4,1,0,34
181555,1303312,1,5,5,4,0,38
181556,1303312,1,5,6,0,1,38
181557,1303312,1,6,1,1,0,39
181558,1303312,1,6,2,1,0,40
181559,1303312,1,6,3,0,0,40
181560,1303312,1,6,4,1,0,41
181561,1303312,1,6,5,1,0,42
181562,1303312,1,6,6,0,0,42
181563,1303312,1,7,1,1,0,43
181564,1303312,1,7,2,0,0,43
181565,1303312,1,7,3,4,0,47
181566,1303312,1,7,4,1,0,48
181567,1303312,1,7,5,0,0,48
181568,1303312,1,7,6,1,0,49
181569,1303312,1,8,1,0,0,49
181570,1303312,1,8,2,1,0,50
181571,1303312,1,8,3,0,0,50
181572,1303312,1,8,4,1,0,51
181573,1303312,1,8,5,2,0,53
181574,1303312,1,8,6,0,0,53
181575,1303312,1,9,1,0,0,53
181576,1303312,1,9,2,1,0,54
181577,1303312,1,9,3,0,1,54
181578,1303312,1,9,4,1,0,55
181579,1303312,1,9,5,1,0,56
181580,1303312,1,9,6,1,0,57
181581,1303312,1,10,1,1,0,58
181582,1303312,1,10,2,1,0,59
181583,1303312,1,10,3,1,0,60
181584,1303312,1,10,4,2,0,62
181585,1303312,1,10,5,1,0,63
181586,1303312,1,10,6,2,0,65
181587,1303312,1,11,1,4,0,69
181588,1303312,1,11,2,1,0,70
181589,1303312,1,11,3,1,0,71
181590,1303312,1,11,4,1,0,72
181591,1303312,1,11,5,0,0,72
181592,1303312,1,11,6,2,0,74
181593,1303312,1,12,1,0,0,74
181594,1303312,1,12,2,2,0,76
181595,1303312,1,12,3,1,0,77
181596,1303312,1,12,4,0,0,77
181597,1303312,1,12,5,4,0,81
181598,1303312,1,12,6,1,0,82
181599,1303312,1,13,1,1,0,83
181600,1303312,1,13,2,6,0,89
181601,1303312,1,13,3,1,0,90
181602,1303312,1,13,4,0,0,90
181603,1303312,1,13,5,0,0,90
181604,1303312,1,13,6,1,0,91
181605,1303312,1,14,1,1,0,92
181606,1303312,1,14,2,4,0,96
181607,1303312,1,14,3,4,0,100
181608,1303312,1,14,4,0,0,100
181609,1303312,1,14,5,0,1,100
181610,1303312,1,14,6,1,0,101
181611,1303312,1,15,1,1,0,102
181612,1303312,1,15,2,4,0,106
181613,1303312,1,15,3,1,0,107
181614,1303312,1,15,4,0,0,107
181615,1303312,1,15,5,1,0,108
181616,1303312,1,15,6,4,0,112
181617,1303312,1,16,1,1,0,113
181618,1303312,1,16,2,0,0,113
181619,1303312,1,16,3,1,0,114
181620,1303312,1,16,4,2,0,116
181621,1303312,1,16,5,6,0,122
181622,1303312,1,16,6,1,0,123
181623,1303312,1,17,1,0,0,123
181624,1303312,1,17,2,0,0,123
181625,1303312,1,17,3,2,0,125
181626,1303312,1,17,4,2,0,127
181627,1303312,1,17,5,0,0,127
181628,1303312,1,17,6,2,0,129
181629,1303312,1,18,1,4,0,133
181630,1303312,1,18,2,3,0,136
181631,1303312,1,18,3,1,0,137
181632,1303312,1,18,4,1,0,138
181633,1303312,1,18,5,6,0,144
181634,1303312,1,18,6,1,0,145
181635,1303312,1,19,1,0,1,145
181636,1303312,1,19,2,2,0,147
181637,1303312,1,19,3,0,1,147
181638,1303312,1,19,4,1,0,148
181639,1303312,1,19,5,4,0,152
181640,1303312,1,19,6,2,0,154
181641,1303312,1,20,1,0,1,154
181642,1303312,1,20,2,0,0,154
181643,1303312,1,20,3,4,0,158
181644,1303312,1,20,4,7,0,165
181645,1303312,1,20,5,6,0,171
181646,1303312,1,20,6,2,0,173
181757,1303313,1,1,1,1,0,1
181758,1303313,1,1,2,2,0,3
181759,1303313,1,1,3,0,0,3
181760,1303313,1,1,4,6,0,9
181761,1303313,1,1,5,0,0,9
181762,1303313,1,1,6,4,0,13
181763,1303313,1,2,1,1,0,14
181764,1303313,1,2,2,1,0,15
181765,1303313,1,2,3,2,0,17
181766,1303313,1,2,4,1,0,18
181767,1303313,1,2,5,1,0,19
181768,1303313,1,2,6,1,0,20
181769,1303313,1,3,1,0,0,20
181770,1303313,1,3,2,0,0,20
181771,1303313,1,3,3,4,0,24
181772,1303313,1,3,4,1,0,25
181773,1303313,1,3,5,0,0,25
181774,1303313,1,3,6,0,0,25
181775,1303313,1,4,1,6,0,31
181776,1303313,1,4,2,4,0,35
181777,1303313,1,4,3,4,0,39
181778,1303313,1,4,4,0,0,39
181779,1303313,1,4,5,0,0,39
181780,1303313,1,4,6,1,0,40
181781,1303313,1,5,1,4,0,44
181782,1303313,1,5,2,0,1,44
181783,1303313,1,5,3,1,0,45
181784,1303313,1,5,4,0,0,45
181785,1303313,1,5,5,1,0,46
181786,1303313,1,5,6,1,0,47
181787,1303313,1,6,1,1,0,48
181788,1303313,1,6,2,1,0,49
181789,1303313,1,6,3,0,0,49
181790,1303313,1,6,4,0,0,49
181791,1303313,1,6,5,1,0,50
181792,1303313,1,6,6,1,0,51
181793,1303313,1,7,1,0,0,51
181794,1303313,1,7,2,0,0,51
181795,1303313,1,7,3,0,0,51
181796,1303313,1,7,4,1,0,52
181797,1303313,1,7,5,1,0,53
181798,1303313,1,7,6,1,0,54
181799,1303313,1,8,1,4,0,58
181800,1303313,1,8,2,1,0,59
181801,1303313,1,8,3,0,0,59
181802,1303313,1,8,4,1,0,60
181803,1303313,1,8,5,0,0,60
181804,1303313,1,8,6,0,0,60
181805,1303313,1,9,1,1,0,61
181806,1303313,1,9,2,6,0,67
181807,1303313,1,9,3,2,0,69
181808,1303313,1,9,4,0,0,69
181809,1303313,1,9,5,1,0,70
181810,1303313,1,9,6,0,1,70
181811,1303313,1,10,1,1,0,71
181812,1303313,1,10,2,0,0,71
181813,1303313,1,10,3,1,0,72
181814,1303313,1,10,4,1,0,73
181815,1303313,1,10,5,0,0,73
181816,1303313,1,10,6,1,0,74
181817,1303313,1,11,1,1,0,75
181818,1303313,1,11,2,1,0,76
181819,1303313,1,11,3,1,0,77
181820,1303313,1,11,4,1,0,78
181821,1303313,1,11,5,0,0,78
181822,1303313,1,11,6,4,0,82
181823,1303313,1,12,1,0,0,82
181824,1303313,1,12,2,6,0,88
181825,1303313,1,12,3,1,0,89
181826,1303313,1,12,4,4,0,93
181827,1303313,1,12,5,2,0,95
181828,1303313,1,12,6,6,0,101
181829,1303313,1,13,1,1,0,102
181830,1303313,1,13,2,1,0,103
181831,1303313,1,13,3,6,0,109
181832,1303313,1,13,4,0,0,109
181833,1303313,1,13,5,1,0,110
181834,1303313,1,13,6,1,0,111
181835,1303313,1,14,1,2,0,113
181836,1303313,1,14,2,4,0,117
181837,1303313,1,14,3,2,0,119
181838,1303313,1,14,4,0,0,119
181839,1303313,1,14,5,2,0,121
181840,1303313,1,14,6,1,0,122
181841,1303313,1,15,1,1,0,123
181842,1303313,1,15,2,0,1,123
181843,1303313,1,15,3,0,0,123
181844,1303313,1,15,4,1,0,124
181845,1303313,1,15,5,1,0,125
181846,1303313,1,15,6,4,0,129
181847,1303313,1,16,1,0,0,129
181848,1303313,1,16,2,4,0,133
181849,1303313,1,16,3,0,0,133
181850,1303313,1,16,4,1,0,134
181851,1303313,1,16,5,4,0,138
181852,1303313,1,16,6,0,0,138
181853,1303313,1,17,1,6,0,144
181854,1303313,1,17,2,1,0,145
181855,1303313,1,17,3,1,0,146
181856,1303313,1,17,4,2,0,148
181857,1303313,1,17,5,0,0,148
181858,1303313,1,17,6,1,0,149
181859,1303313,1,18,1,6,0,155
181860,1303313,1,18,2,0,0,155
181861,1303313,1,18,3,0,0,155
181862,1303313,1,18,4,0,0,155
181863,1303313,1,18,5,2,0,157
181864,1303313,1,18,6,1,0,158
181865,1303313,1,19,1,4,0,162
181866,1303313,1,19,2,1,0,163
181867,1303313,1,19,3,4,0,167
181868,1303313,1,19,4,4,0,171
181869,1303313,1,19,5,0,0,171
181870,1303313,1,19,6,0,1,171
181871,1303313,1,20,1,1,0,172
181872,1303313,1,20,2,0,0,172
181873,1303313,1,20,3,2,0,174
181874,1303313,1,20,4,0,0,174
181875,1303313,1,20,5,4,0,178
181876,1303313,1,20,6,1,0,179
181960,1303314,1,1,1,0,0,0
181961,1303314,1,1,2,6,0,6
181962,1303314,1,1,3,0,0,6
181963,1303314,1,1,4,4,0,10
181964,1303314,1,1,5,0,0,10
181965,1303314,1,1,6,1,0,11
181966,1303314,1,2,1,0,0,11
181967,1303314,1,2,2,0,0,11
181968,1303314,1,2,3,4,0,15
181969,1303314,1,2,4,4,0,19
181970,1303314,1,2,5,0,0,19
181971,1303314,1,2,6,0,0,19
181972,1303314,1,3,1,0,0,19
181973,1303314,1,3,2,1,0,20
181974,1303314,1,3,3,0,0,20
181975,1303314,1,3,4,5,0,25
181976,1303314,1,3,5,0,0,25
181977,1303314,1,3,6,1,0,26
181978,1303314,1,4,1,0,0,26
181979,1303314,1,4,2,0,0,26
181980,1303314,1,4,3,1,0,27
181981,1303314,1,4,4,1,0,28
181982,1303314,1,4,5,0,0,28
181983,1303314,1,4,6,0,0,28
181984,1303314,1,5,1,1,0,29
181985,1303314,1,5,2,0,0,29
181986,1303314,1,5,3,0,0,29
181987,1303314,1,5,4,4,0,33
181988,1303314,1,5,5,0,1,33
181989,1303314,1,5,6,0,0,33
181990,1303314,1,6,1,1,0,34
181991,1303314,1,6,2,0,0,34
181992,1303314,1,6,3,3,0,37
181993,1303314,1,6,4,1,0,38
181994,1303314,1,6,5,0,0,38
181995,1303314,1,6,6,4,0,42
181996,1303314,1,7,1,6,0,48
181997,1303314,1,7,2,0,0,48
181998,1303314,1,7,3,0,0,48
181999,1303314,1,7,4,1,0,49
182000,1303314,1,7,5,1,0,50
182001,1303314,1,7,6,0,0,50
182002,1303314,1,8,1,1,0,51
182003,1303314,1,8,2,1,0,52
182004,1303314,1,8,3,0,0,52
182005,1303314,1,8,4,1,0,53
182006,1303314,1,8,5,1,0,54
182007,1303314,1,8,6,4,0,58
182008,1303314,1,9,1,0,0,58
182009,1303314,1,9,2,1,0,59
182010,1303314,1,9,3,4,0,63
182011,1303314,1,9,4,4,0,67
182012,1303314,1,9,5,4,0,71
182013,1303314,1,9,6,0,0,71
182014,1303314,1,10,1,0,0,71
182015,1303314,1,10,2,6,0,77
182016,1303314,1,10,3,1,0,78
182017,1303314,1,10,4,0,0,78
182018,1303314,1,10,5,1,0,79
182019,1303314,1,10,6,0,1,79
182020,1303314,1,11,1,1,0,80
182021,1303314,1,11,2,1,0,81
182022,1303314,1,11,3,0,0,81
182023,1303314,1,11,4,0,1,81
182024,1303314,1,11,5,0,0,81
182025,1303314,1,11,6,1,0,82
182026,1303314,1,12,1,4,0,86
182027,1303314,1,12,2,0,0,86
182028,1303314,1,12,3,1,0,87
182029,1303314,1,12,4,0,0,87
182030,1303314,1,12,5,1,0,88
182031,1303314,1,12,6,1,0,89
182032,1303314,1,13,1,1,0,90
182033,1303314,1,13,2,1,0,91
182034,1303314,1,13,3,1,0,92
182035,1303314,1,13,4,0,1,92
182036,1303314,1,13,5,2,0,94
182037,1303314,1,13,6,1,0,95
182038,1303314,1,14,1,0,0,95
182039,1303314,1,14,2,0,0,95
182040,1303314,1,14,3,2,0,97
182041,1303314,1,14,4,1,0,98
182042,1303314,1,14,5,0,0,98
182043,1303314,1,14,6,4,0,102
182044,1303314,1,15,1,0,0,102
182045,1303314,1,15,2,1,0,103
182046,1303314,1,15,3,0,0,103
182047,1303314,1,15,4,0,0,103
182048,1303314,1,15,5,1,0,104
182049,1303314,1,15,6,0,0,104
182050,1303314,1,16,1,0,0,104
182051,1303314,1,16,2,2,0,106
182052,1303314,1,16,3,1,0,107
182053,1303314,1,16,4,1,0,108
182054,1303314,1,16,5,0,0,108
182055,1303314,1,16,6,0,1,108
182056,1303314,1,17,1,4,0,112
182057,1303314,1,17,2,4,0,116
182058,1303314,1,17,3,0,1,116
182059,1303314,1,17,4,0,0,116
182060,1303314,1,17,5,2,0,118
182061,1303314,1,17,6,6,0,124
182062,1303314,1,18,1,0,0,124
182063,1303314,1,18,2,6,0,130
182064,1303314,1,18,3,2,0,132
182065,1303314,1,18,4,4,0,136
182066,1303314,1,18,5,4,0,140
182067,1303314,1,18,6,3,0,143
182068,1303314,1,19,1,6,0,149
182069,1303314,1,19,2,4,0,153
182070,1303314,1,19,3,6,0,159
182071,1303314,1,19,4,0,0,159
182072,1303314,1,19,5,0,0,159
182073,1303314,1,19,6,2,0,161
182074,1303314,1,20,1,1,0,162
182075,1303314,1,20,2,4,0,166
182076,1303314,1,20,3,0,0,166
182077,1303314,1,20,4,6,0,172
182078,1303314,1,20,5,1,0,173
182079,1303314,1,20,6,1,0,174
182194,1303315,1,1,1,1,0,1
182195,1303315,1,1,2,2,0,3
182196,1303315,1,1,3,1,0,4
182197,1303315,1,1,4,0,0,4
182198,1303315,1,1,5,1,0,5
182199,1303315,1,1,6,2,0,7
182200,1303315,1,2,1,1,0,8
182201,1303315,1,2,2,0,0,8
182202,1303315,1,2,3,1,0,9
182203,1303315,1,2,4,0,0,9
182204,1303315,1,2,5,0,0,9
182205,1303315,1,2,6,1,0,10
182206,1303315,1,3,1,7,0,17
182207,1303315,1,3,2,4,0,21
182208,1303315,1,3,3,0,0,21
182209,1303315,1,3,4,1,0,22
182210,1303315,1,3,5,1,0,23
182211,1303315,1,3,6,0,0,23
182212,1303315,1,4,1,0,1,23
182213,1303315,1,4,2,1,0,24
182214,1303315,1,4,3,0,0,24
182215,1303315,1,4,4,4,0,28
182216,1303315,1,4,5,0,0,28
182217,1303315,1,4,6,1,0,29
182218,1303315,1,5,1,1,0,30
182219,1303315,1,5,2,0,0,30
182220,1303315,1,5,3,2,0,32
182221,1303315,1,5,4,4,0,36
182222,1303315,1,5,5,0,0,36
182223,1303315,1,5,6,2,0,38
182224,1303315,1,6,1,2,0,40
182225,1303315,1,6,2,1,0,41
182226,1303315,1,6,3,4,0,45
182227,1303315,1,6,4,0,1,45
182228,1303315,1,6,5,1,0,46
182229,1303315,1,6,6,1,0,47
182230,1303315,1,7,1,4,0,51
182231,1303315,1,7,2,0,0,51
182232,1303315,1,7,3,4,0,55
182233,1303315,1,7,4,1,0,56
182234,1303315,1,7,5,1,0,57
182235,1303315,1,7,6,0,0,57
182236,1303315,1,8,1,1,0,58
182237,1303315,1,8,2,0,0,58
182238,1303315,1,8,3,4,0,62
182239,1303315,1,8,4,4,0,66
182240,1303315,1,8,5,1,0,67
182241,1303315,1,8,6,1,0,68
182242,1303315,1,9,1,1,0,69
182243,1303315,1,9,2,1,0,70
182244,1303315,1,9,3,0,0,70
182245,1303315,1,9,4,1,0,71
182246,1303315,1,9,5,4,0,75
182247,1303315,1,9,6,1,0,76
182248,1303315,1,10,1,0,0,76
182249,1303315,1,10,2,1,0,77
182250,1303315,1,10,3,1,0,78
182251,1303315,1,10,4,4,0,82
182252,1303315,1,10,5,0,0,82
182253,1303315,1,10,6,0,0,82
182254,1303315,1,11,1,2,0,84
182255,1303315,1,11,2,6,0,90
182256,1303315,1,11,3,2,0,92
182257,1303315,1,11,4,1,0,93
182258,1303315,1,11,5,1,0,94
182259,1303315,1,11,6,0,0,94
182260,1303315,1,12,1,0,0,94
182261,1303315,1,12,2,4,0,98
182262,1303315,1,12,3,1,0,99
182263,1303315,1,12,4,6,0,105
182264,1303315,1,12,5,1,0,106
182265,1303315,1,12,6,1,0,107
182266,1303315,1,13,1,2,0,109
182267,1303315,1,13,2,1,0,110
182268,1303315,1,13,3,6,0,116
182269,1303315,1,13,4,1,0,117
182270,1303315,1,13,5,1,0,118
182271,1303315,1,13,6,2,0,120
182272,1303315,1,14,1,1,0,121
182273,1303315,1,14,2,6,0,127
182274,1303315,1,14,3,4,0,131
182275,1303315,1,14,4,6,0,137
182276,1303315,1,14,5,4,0,141
182277,1303315,1,14,6,1,0,142
182278,1303315,1,15,1,1,0,143
182279,1303315,1,15,2,0,0,143
182280,1303315,1,15,3,1,0,144
182281,1303315,1,15,4,1,0,145
182282,1303315,1,15,5,0,0,145
182283,1303315,1,15,6,1,0,146
182284,1303315,1,16,1,4,0,150
182285,1303315,1,16,2,1,0,151
182286,1303315,1,16,3,6,0,157
182287,1303315,1,16,4,0,1,157
182288,1303315,1,16,5,0,1,157
182289,1303315,1,16,6,1,0,158
182290,1303315,1,17,1,1,0,159
182291,1303315,1,17,2,1,0,160
182292,1303315,1,17,3,4,0,164
182293,1303315,1,17,4,6,0,170
182294,1303315,1,17,5,4,0,174
182295,1303315,1,17,6,1,0,175
182296,1303315,1,18,1,0,0,175
182297,1303315,1,18,2,4,0,179
182298,1303315,1,18,3,2,0,181
182299,1303315,1,18,4,1,0,182
182300,1303315,1,18,5,0,0,182
182301,1303315,1,18,6,1,0,183
182302,1303315,1,19,1,1,0,184
182303,1303315,1,19,2,1,1,185
182304,1303315,1,19,3,2,0,187
182305,1303315,1,19,4,4,0,191
182306,1303315,1,19,5,1,0,192
182307,1303315,1,19,6,1,0,193
182308,1303315,1,20,1,1,0,194
182309,1303315,1,20,2,0,0,194
182310,1303315,1,20,3,4,0,198
182311,1303315,1,20,4,6,0,204
182312,1303315,1,20,5,2,0,206
182313,1303315,1,20,6,5,0,211
182434,1303316,1,1,1,1,0,1
182435,1303316,1,1,2,0,0,1
182436,1303316,1,1,3,0,0,1
182437,1303316,1,1,4,1,0,2
182438,1303316,1,1,5,1,0,3
182439,1303316,1,1,6,4,0,7
182440,1303316,1,2,1,1,0,8
182441,1303316,1,2,2,0,0,8
182442,1303316,1,2,3,4,0,12
182443,1303316,1,2,4,0,0,12
182444,1303316,1,2,5,1,0,13
182445,1303316,1,2,6,0,0,13
182446,1303316,1,3,1,0,0,13
182447,1303316,1,3,2,4,0,17
182448,1303316,1,3,3,4,0,21
182449,1303316,1,3,4,2,0,23
182450,1303316,1,3,5,0,0,23
182451,1303316,1,3,6,1,0,24
182452,1303316,1,4,1,0,0,24
182453,1303316,1,4,2,4,0,28
182454,1303316,1,4,3,0,0,28
182455,1303316,1,4,4,1,0,29
182456,1303316,1,4,5,1,0,30
182457,1303316,1,4,6,0,0,30
182458,1303316,1,5,1,0,0,30
182459,1303316,1,5,2,0,0,30
182460,1303316,1,5,3,4,0,34
182461,1303316,1,5,4,1,0,35
182462,1303316,1,5,5,0,0,35
182463,1303316,1,5,6,2,0,37
182464,1303316,1,6,1,4,0,41
182465,1303316,1,6,2,1,0,42
182466,1303316,1,6,3,0,1,42
182467,1303316,1,6,4,0,0,42
182468,1303316,1,6,5,0,0,42
182469,1303316,1,6,6,0,0,42
182470,1303316,1,7,1,0,0,42
182471,1303316,1,7,2,0,0,42
182472,1303316,1,7,3,0,0,42
182473,1303316,1,7,4,0,0,42
182474,1303316,1,7,5,1,0,43
182475,1303316,1,7,6,0,0,43
182476,1303316,1,8,1,1,0,44
182477,1303316,1,8,2,1,0,45
182478,1303316,1,8,3,1,0,46
182479,1303316,1,8,4,0,0,46
182480,1303316,1,8,5,1,0,47
182481,1303316,1,8,6,0,0,47
182482,1303316,1,9,1,0,0,47
182483,1303316,1,9,2,0,0,47
182484,1303316,1,9,3,0,0,47
182485,1303316,1,9,4,0,0,47
182486,1303316,1,9,5,1,0,48
182487,1303316,1,9,6,1,0,49
182488,1303316,1,10,1,1,0,50
182489,1303316,1,10,2,1,0,51
182490,1303316,1,10,3,1,0,52
182491,1303316,1,10,4,0,1,52
182492,1303316,1,10,5,1,0,53
182493,1303316,1,10,6,1,0,54
182494,1303316,1,11,1,0,0,54
182495,1303316,1,11,2,1,0,55
182496,1303316,1,11,3,0,0,55
182497,1303316,1,11,4,1,0,56
182498,1303316,1,11,5,1,0,57
182499,1303316,1,11,6,1,0,58
182500,1303316,1,12,1,1,0,59
182501,1303316,1,12,2,4,0,63
182502,1303316,1,12,3,6,0,69
182503,1303316,1,12,4,6,0,75
182504,1303316,1,12,5,2,0,77
182505,1303316,1,12,6,7,0,84
182506,1303316,1,13,1,0,1,84
182507,1303316,1,13,2,1,0,85
182508,1303316,1,13,3,0,1,85
182509,1303316,1,13,4,0,0,85
182510,1303316,1,13,5,1,0,86
182511,1303316,1,13,6,1,0,87
182512,1303316,1,14,1,1,0,88
182513,1303316,1,14,2,1,0,89
182514,1303316,1,14,3,1,0,90
182515,1303316,1,14,4,1,0,91
182516,1303316,1,14,5,1,0,92
182517,1303316,1,14,6,1,0,93
182518,1303316,1,15,1,4,0,97
182519,1303316,1,15,2,4,0,101
182520,1303316,1,15,3,1,0,102
182521,1303316,1,15,4,0,0,102
182522,1303316,1,15,5,6,0,108
182523,1303316,1,15,6,0,0,108
182524,1303316,1,16,1,1,0,109
182525,1303316,1,16,2,7,0,116
182526,1303316,1,16,3,6,0,122
182527,1303316,1,16,4,0,0,122
182528,1303316,1,16,5,5,0,127
182529,1303316,1,16,6,1,0,128
182530,1303316,1,17,1,1,0,129
182531,1303316,1,17,2,5,0,134
182532,1303316,1,17,3,4,0,138
182533,1303316,1,17,4,13,0,151
182534,1303316,1,17,5,4,0,155
182535,1303316,1,17,6,1,0,156
182536,1303316,1,18,1,0,1,156
182537,1303316,1,18,2,0,0,156
182538,1303316,1,18,3,1,0,157
182539,1303316,1,18,4,0,0,157
182540,1303316,1,18,5,1,0,158
182541,1303316,1,18,6,4,0,162
182542,1303316,1,19,1,2,0,164
182543,1303316,1,19,2,1,0,165
182544,1303316,1,19,3,2,0,167
182545,1303316,1,19,4,7,0,174
182546,1303316,1,19,5,4,0,178
182547,1303316,1,19,6,0,1,178
182548,1303316,1,20,1,1,0,179
182549,1303316,1,20,2,1,0,180
182550,1303316,1,20,3,1,0,181
182551,1303316,1,20,4,0,0,181
182552,1303316,1,20,5,0,0,181
182553,1303316,1,20,6,1,0,182
182667,1307159,1,1,1,0,0,0
182668,1307159,1,1,2,0,0,0
182669,1307159,1,1,3,0,0,0
182670,1307159,1,1,4,1,0,1
182671,1307159,1,1,5,0,0,1
182672,1307159,1,1,6,4,0,5
182673,1307159,1,2,1,1,0,6
182674,1307159,1,2,2,0,0,6
182675,1307159,1,2,3,1,0,7
182676,1307159,1,2,4,0,0,7
182677,1307159,1,2,5,0,0,7
182678,1307159,1,2,6,1,0,8
182679,1307159,1,3,1,0,0,8
182680,1307159,1,3,2,0,0,8
182681,1307159,1,3,3,0,0,8
182682,1307159,1,3,4,1,0,9
182683,1307159,1,3,5,0,0,9
182684,1307159,1,3,6,2,0,11
182685,1307159,1,4,1,4,0,15
182686,1307159,1,4,2,4,0,19
182687,1307159,1,4,3,1,0,20
182688,1307159,1,4,4,1,0,21
182689,1307159,1,4,5,4,0,25
182690,1307159,1,4,6,1,0,26
182691,1307159,1,5,1,4,0,30
182692,1307159,1,5,2,4,0,34
182693,1307159,1,5,3,0,0,34
182694,1307159,1,5,4,0,0,34
182695,1307159,1,5,5,0,1,34
182696,1307159,1,5,6,4,0,38
182697,1307159,1,6,1,4,0,42
182698,1307159,1,6,2,4,0,46
182699,1307159,1,6,3,0,0,46
182700,1307159,1,6,4,0,0,46
182701,1307159,1,6,5,0,0,46
182702,1307159,1,6,6,1,0,47
182703,1307159,1,7,1,0,0,47
182704,1307159,1,7,2,6,0,53
182705,1307159,1,7,3,1,0,54
182706,1307159,1,7,4,1,0,55
182707,1307159,1,7,5,1,0,56
182708,1307159,1,7,6,0,0,56
182709,1307159,1,8,1,1,0,57
182710,1307159,1,8,2,0,0,57
182711,1307159,1,8,3,0,0,57
182712,1307159,1,8,4,4,0,61
182713,1307159,1,8,5,1,0,62
182714,1307159,1,8,6,1,0,63
182715,1307159,1,9,1,0,0,63
182716,1307159,1,9,2,4,0,67
182717,1307159,1,9,3,1,0,68
182718,1307159,1,9,4,1,0,69
182719,1307159,1,9,5,6,0,75
182720,1307159,1,9,6,0,0,75
182721,1307159,1,10,1,0,0,75
182722,1307159,1,10,2,0,0,75
182723,1307159,1,10,3,0,0,75
182724,1307159,1,10,4,1,1,76
182725,1307159,1,10,5,1,0,77
182726,1307159,1,10,6,1,0,78
182727,1307159,1,11,1,1,0,79
182728,1307159,1,11,2,1,0,80
182729,1307159,1,11,3,2,0,82
182730,1307159,1,11,4,1,0,83
182731,1307159,1,11,5,0,0,83
182732,1307159,1,11,6,1,0,84
182733,1307159,1,12,1,1,0,85
182734,1307159,1,12,2,1,0,86
182735,1307159,1,12,3,1,0,87
182736,1307159,1,12,4,2,0,89
182737,1307159,1,12,5,1,0,90
182738,1307159,1,12,6,1,0,91
182739,1307159,1,13,1,1,0,92
182740,1307159,1,13,2,1,0,93
182741,1307159,1,13,3,4,0,97
182742,1307159,1,13,4,2,0,99
182743,1307159,1,13,5,4,0,103
182744,1307159,1,13,6,1,0,104
182745,1307159,1,14,1,0,0,104
182746,1307159,1,14,2,1,0,105
182747,1307159,1,14,3,6,0,111
182748,1307159,1,14,4,1,0,112
182749,1307159,1,14,5,1,0,113
182750,1307159,1,14,6,0,1,113
182751,1307159,1,15,1,1,0,114
182752,1307159,1,15,2,1,0,115
182753,1307159,1,15,3,0,1,115
182754,1307159,1,15,4,1,0,116
182755,1307159,1,15,5,1,0,117
182756,1307159,1,15,6,1,0,118
182757,1307159,1,16,1,1,0,119
182758,1307159,1,16,2,1,0,120
182759,1307159,1,16,3,1,0,121
182760,1307159,1,16,4,1,0,122
182761,1307159,1,16,5,0,1,122
182762,1307159,1,16,6,0,0,122
182763,1307159,1,17,1,4,0,126
182764,1307159,1,17,2,0,0,126
182765,1307159,1,17,3,1,0,127
182766,1307159,1,17,4,1,0,128
182767,1307159,1,17,5,6,0,134
182768,1307159,1,17,6,0,1,134
182769,1307159,1,18,1,1,0,135
182770,1307159,1,18,2,0,0,135
182771,1307159,1,18,3,1,0,136
182772,1307159,1,18,4,0,0,136
182773,1307159,1,18,5,1,0,137
182774,1307159,1,18,6,1,0,138
182775,1307159,1,19,1,1,0,139
182776,1307159,1,19,2,4,0,143
182777,1307159,1,19,3,2,0,145
182778,1307159,1,19,4,1,0,146
182779,1307159,1,19,5,1,0,147
182780,1307159,1,19,6,0,1,147
182781,1307159,1,20,1,1,0,148
182782,1307159,1,20,2,6,0,154
182783,1307159,1,20,3,6,0,160
182784,1307159,1,20,4,4,0,164
182785,1307159,1,20,5,2,0,166
182786,1307159,1,20,6,2,0,168
182906,1307160,1,1,1,1,0,1
182907,1307160,1,1,2,0,0,1
182908,1307160,1,1,3,1,0,2
182909,1307160,1,1,4,0,0,2
182910,1307160,1,1,5,0,0,2
182911,1307160,1,1,6,4,0,6
182912,1307160,1,2,1,0,1,6
182913,1307160,1,2,2,2,0,8
182914,1307160,1,2,3,1,0,9
182915,1307160,1,2,4,1,0,10
182916,1307160,1,2,5,0,0,10
182917,1307160,1,2,6,4,0,14
182918,1307160,1,3,1,1,0,15
182919,1307160,1,3,2,0,0,15
182920,1307160,1,3,3,4,0,19
182921,1307160,1,3,4,1,0,20
182922,1307160,1,3,5,0,1,20
182923,1307160,1,3,6,0,0,20
182924,1307160,1,4,1,2,0,22
182925,1307160,1,4,2,0,0,22
182926,1307160,1,4,3,0,0,22
182927,1307160,1,4,4,1,0,23
182928,1307160,1,4,5,1,0,24
182929,1307160,1,4,6,0,0,24
182930,1307160,1,5,1,4,0,28
182931,1307160,1,5,2,4,0,32
182932,1307160,1,5,3,0,0,32
182933,1307160,1,5,4,0,0,32
182934,1307160,1,5,5,0,0,32
182935,1307160,1,5,6,4,0,36
182936,1307160,1,6,1,1,0,37
182937,1307160,1,6,2,4,0,41
182938,1307160,1,6,3,0,0,41
182939,1307160,1,6,4,0,0,41
182940,1307160,1,6,5,0,0,41
182941,1307160,1,6,6,0,1,41
182942,1307160,1,7,1,2,0,43
182943,1307160,1,7,2,1,0,44
182944,1307160,1,7,3,0,0,44
182945,1307160,1,7,4,1,0,45
182946,1307160,1,7,5,1,0,46
182947,1307160,1,7,6,0,0,46
182948,1307160,1,8,1,1,0,47
182949,1307160,1,8,2,1,0,48
182950,1307160,1,8,3,0,0,48
182951,1307160,1,8,4,4,0,52
182952,1307160,1,8,5,1,0,53
182953,1307160,1,8,6,1,0,54
182954,1307160,1,9,1,1,0,55
182955,1307160,1,9,2,0,1,55
182956,1307160,1,9,3,1,0,56
182957,1307160,1,9,4,1,0,57
182958,1307160,1,9,5,1,0,58
182959,1307160,1,9,6,1,0,59
182960,1307160,1,10,1,1,0,60
182961,1307160,1,10,2,0,0,60
182962,1307160,1,10,3,0,0,60
182963,1307160,1,10,4,1,0,61
182964,1307160,1,10,5,0,0,61
182965,1307160,1,10,6,1,0,62
182966,1307160,1,11,1,0,0,62
182967,1307160,1,11,2,4,0,66
182968,1307160,1,11,3,1,0,67
182969,1307160,1,11,4,0,0,67
182970,1307160,1,11,5,0,0,67
182971,1307160,1,11,6,1,0,68
182972,1307160,1,12,1,1,0,69
182973,1307160,1,12,2,0,1,69
182974,1307160,1,12,3,0,0,69
182975,1307160,1,12,4,1,0,70
182976,1307160,1,12,5,5,0,75
182977,1307160,1,12,6,1,0,76
182978,1307160,1,13,1,2,0,78
182979,1307160,1,13,2,4,0,82
182980,1307160,1,13,3,1,0,83
182981,1307160,1,13,4,1,0,84
182982,1307160,1,13,5,1,0,85
182983,1307160,1,13,6,1,0,86
182984,1307160,1,14,1,1,0,87
182985,1307160,1,14,2,0,0,87
182986,1307160,1,14,3,1,0,88
182987,1307160,1,14,4,1,0,89
182988,1307160,1,14,5,1,0,90
182989,1307160,1,14,6,2,0,92
182990,1307160,1,15,1,1,0,93
182991,1307160,1,15,2,0,0,93
182992,1307160,1,15,3,3,0,96
182993,1307160,1,15,4,0,0,96
182994,1307160,1,15,5,0,0,96
182995,1307160,1,15,6,0,0,96
182996,1307160,1,16,1,0,0,96
182997,1307160,1,16,2,1,0,97
182998,1307160,1,16,3,1,0,98
182999,1307160,1,16,4,1,0,99
183000,1307160,1,16,5,0,1,99
183001,1307160,1,16,6,1,0,100
183002,1307160,1,17,1,2,0,102
183003,1307160,1,17,2,1,0,103
183004,1307160,1,17,3,0,1,103
183005,1307160,1,17,4,0,0,103
183006,1307160,1,17,5,0,0,103
183007,1307160,1,17,6,1,0,104
183008,1307160,1,18,1,1,0,105
183009,1307160,1,18,2,1,0,106
183010,1307160,1,18,3,0,0,106
183011,1307160,1,18,4,1,0,107
183012,1307160,1,18,5,1,0,108
183013,1307160,1,18,6,0,0,108
183014,1307160,1,19,1,2,0,110
183015,1307160,1,19,2,2,0,112
183016,1307160,1,19,3,1,0,113
183017,1307160,1,19,4,4,0,117
183018,1307160,1,19,5,0,0,117
183019,1307160,1,19,6,0,0,117
183020,1307160,1,20,1,0,1,117
183021,1307160,1,20,2,1,0,118
183022,1307160,1,20,3,1,0,119
183023,1307160,1,20,4,1,0,120
183024,1307160,1,20,5,0,0,120
183025,1307160,1,20,6,2,0,122
183140,1307161,1,1,1,7,0,7
183141,1307161,1,1,2,0,0,7
183142,1307161,1,1,3,0,0,7
183143,1307161,1,1,4,0,0,7
183144,1307161,1,1,5,0,0,7
183145,1307161,1,1,6,4,0,11
183146,1307161,1,2,1,0,0,11
183147,1307161,1,2,2,0,0,11
183148,1307161,1,2,3,1,0,12
183149,1307161,1,2,4,1,0,13
183150,1307161,1,2,5,0,0,13
183151,1307161,1,2,6,1,0,14
183152,1307161,1,3,1,0,0,14
183153,1307161,1,3,2,1,0,15
183154,1307161,1,3,3,0,0,15
183155,1307161,1,3,4,0,0,15
183156,1307161,1,3,5,0,0,15
183157,1307161,1,3,6,0,0,15
183158,1307161,1,4,1,2,0,17
183159,1307161,1,4,2,4,0,21
183160,1307161,1,4,3,0,0,21
183161,1307161,1,4,4,1,0,22
183162,1307161,1,4,5,1,0,23
183163,1307161,1,4,6,0,0,23
183164,1307161,1,5,1,0,0,23
183165,1307161,1,5,2,2,0,25
183166,1307161,1,5,3,0,0,25
183167,1307161,1,5,4,0,0,25
183168,1307161,1,5,5,4,0,29
183169,1307161,1,5,6,0,0,29
183170,1307161,1,6,1,1,0,30
183171,1307161,1,6,2,4,0,34
183172,1307161,1,6,3,0,0,34
183173,1307161,1,6,4,1,0,35
183174,1307161,1,6,5,2,0,37
183175,1307161,1,6,6,4,0,41
183176,1307161,1,7,1,0,0,41
183177,1307161,1,7,2,1,0,42
183178,1307161,1,7,3,0,0,42
183179,1307161,1,7,4,1,0,43
183180,1307161,1,7,5,4,0,47
183181,1307161,1,7,6,0,0,47
183182,1307161,1,8,1,0,0,47
183183,1307161,1,8,2,1,0,48
183184,1307161,1,8,3,0,0,48
183185,1307161,1,8,4,1,0,49
183186,1307161,1,8,5,1,0,50
183187,1307161,1,8,6,2,0,52
183188,1307161,1,9,1,0,0,52
183189,1307161,1,9,2,1,0,53
183190,1307161,1,9,3,4,0,57
183191,1307161,1,9,4,4,0,61
183192,1307161,1,9,5,4,0,65
183193,1307161,1,9,6,1,0,66
183194,1307161,1,10,1,1,0,67
183195,1307161,1,10,2,4,0,71
183196,1307161,1,10,3,5,0,76
183197,1307161,1,10,4,0,0,76
183198,1307161,1,10,5,6,0,82
183199,1307161,1,10,6,1,0,83
183200,1307161,1,11,1,1,0,84
183201,1307161,1,11,2,1,0,85
183202,1307161,1,11,3,1,0,86
183203,1307161,1,11,4,1,0,87
183204,1307161,1,11,5,1,0,88
183205,1307161,1,11,6,1,0,89
183206,1307161,1,12,1,1,0,90
183207,1307161,1,12,2,0,1,90
183208,1307161,1,12,3,1,0,91
183209,1307161,1,12,4,2,0,93
183210,1307161,1,12,5,1,0,94
183211,1307161,1,12,6,2,0,96
183212,1307161,1,13,1,6,0,102
183213,1307161,1,13,2,1,0,103
183214,1307161,1,13,3,0,0,103
183215,1307161,1,13,4,1,0,104
183216,1307161,1,13,5,1,0,105
183217,1307161,1,13,6,1,0,106
183218,1307161,1,14,1,1,0,107
183219,1307161,1,14,2,2,0,109
183220,1307161,1,14,3,0,1,109
183221,1307161,1,14,4,1,0,110
183222,1307161,1,14,5,0,0,110
183223,1307161,1,14,6,4,0,114
183224,1307161,1,15,1,1,0,115
183225,1307161,1,15,2,6,0,121
183226,1307161,1,15,3,2,0,123
183227,1307161,1,15,4,1,0,124
183228,1307161,1,15,5,1,0,125
183229,1307161,1,15,6,2,0,127
183230,1307161,1,16,1,4,0,131
183231,1307161,1,16,2,1,0,132
183232,1307161,1,16,3,1,0,133
183233,1307161,1,16,4,0,0,133
183234,1307161,1,16,5,2,0,135
183235,1307161,1,16,6,1,0,136
183236,1307161,1,17,1,1,0,137
183237,1307161,1,17,2,0,0,137
183238,1307161,1,17,3,2,0,139
183239,1307161,1,17,4,1,0,140
183240,1307161,1,17,5,1,0,141
183241,1307161,1,17,6,6,0,147
183242,1307161,1,18,1,1,0,148
183243,1307161,1,18,2,1,0,149
183244,1307161,1,18,3,4,0,153
183245,1307161,1,18,4,4,0,157
183246,1307161,1,18,5,0,1,157
183247,1307161,1,18,6,1,0,158
183248,1307161,1,19,1,0,0,158
183249,1307161,1,19,2,2,0,160
183250,1307161,1,19,3,1,0,161
183251,1307161,1,19,4,0,0,161
183252,1307161,1,19,5,6,0,167
183253,1307161,1,19,6,6,0,173
183254,1307161,1,20,1,2,1,175
183255,1307161,1,20,2,0,0,175
183256,1307161,1,20,3,6,0,181
183257,1307161,1,20,4,2,0,183
183258,1307161,1,20,5,6,0,189
183259,1307161,1,20,6,0,1,189
183380,1307162,1,1,1,7,0,7
183381,1307162,1,1,2,0,0,7
183382,1307162,1,1,3,4,0,11
183383,1307162,1,1,4,0,0,11
183384,1307162,1,1,5,0,0,11
183385,1307162,1,1,6,6,0,17
183386,1307162,1,2,1,1,0,18
183387,1307162,1,2,2,0,0,18
183388,1307162,1,2,3,6,0,24
183389,1307162,1,2,4,4,0,28
183390,1307162,1,2,5,0,0,28
183391,1307162,1,2,6,0,0,28
183392,1307162,1,3,1,4,0,32
183393,1307162,1,3,2,1,0,33
183394,1307162,1,3,3,4,0,37
183395,1307162,1,3,4,0,1,37
183396,1307162,1,3,5,0,0,37
183397,1307162,1,3,6,1,0,38
183398,1307162,1,4,1,0,1,38
183399,1307162,1,4,2,0,1,38
183400,1307162,1,4,3,0,0,38
183401,1307162,1,4,4,1,0,39
183402,1307162,1,4,5,4,0,43
183403,1307162,1,4,6,1,0,44
183404,1307162,1,5,1,4,0,48
183405,1307162,1,5,2,2,0,50
183406,1307162,1,5,3,1,0,51
183407,1307162,1,5,4,0,0,51
183408,1307162,1,5,5,4,0,55
183409,1307162,1,5,6,0,1,55
183410,1307162,1,6,1,1,0,56
183411,1307162,1,6,2,0,0,56
183412,1307162,1,6,3,1,0,57
183413,1307162,1,6,4,1,0,58
183414,1307162,1,6,5,1,0,59
183415,1307162,1,6,6,6,0,65
183416,1307162,1,7,1,1,0,66
183417,1307162,1,7,2,4,0,70
183418,1307162,1,7,3,1,0,71
183419,1307162,1,7,4,0,0,71
183420,1307162,1,7,5,1,0,72
183421,1307162,1,7,6,1,0,73
183422,1307162,1,8,1,0,0,73
183423,1307162,1,8,2,2,0,75
183424,1307162,1,8,3,1,0,76
183425,1307162,1,8,4,0,1,76
183426,1307162,1,8,5,3,0,79
183427,1307162,1,8,6,0,0,79
183428,1307162,1,9,1,1,0,80
183429,1307162,1,9,2,2,0,82
183430,1307162,1,9,3,2,0,84
183431,1307162,1,9,4,6,0,90
183432,1307162,1,9,5,3,0,93
183433,1307162,1,9,6,6,0,99
183434,1307162,1,10,1,6,0,105
183435,1307162,1,10,2,1,0,106
183436,1307162,1,10,3,6,0,112
183437,1307162,1,10,4,1,0,113
183438,1307162,1,10,5,1,0,114
183439,1307162,1,10,6,6,0,120
183440,1307162,1,11,1,4,0,124
183441,1307162,1,11,2,2,0,126
183442,1307162,1,11,3,0,0,126
183443,1307162,1,11,4,0,1,126
183444,1307162,1,11,5,2,0,128
183445,1307162,1,11,6,4,0,132
183512,1307163,1,1,1,0,0,0
183513,1307163,1,1,2,2,0,2
183514,1307163,1,1,3,3,0,5
183515,1307163,1,1,4,1,0,6
183516,1307163,1,1,5,0,0,6
183517,1307163,1,1,6,0,0,6
183518,1307163,1,2,1,4,0,10
183519,1307163,1,2,2,4,0,14
183520,1307163,1,2,3,0,1,14
183521,1307163,1,2,4,1,0,15
183522,1307163,1,2,5,1,0,16
183523,1307163,1,2,6,0,1,16
183524,1307163,1,3,1,1,0,17
183525,1307163,1,3,2,0,0,17
183526,1307163,1,3,3,1,0,18
183527,1307163,1,3,4,0,0,18
183528,1307163,1,3,5,1,0,19
183529,1307163,1,3,6,1,0,20
183530,1307163,1,4,1,4,0,24
183531,1307163,1,4,2,1,0,25
183532,1307163,1,4,3,0,0,25
183533,1307163,1,4,4,1,0,26
183534,1307163,1,4,5,0,1,26
183535,1307163,1,4,6,0,0,26
183536,1307163,1,5,1,1,0,27
183537,1307163,1,5,2,0,0,27
183538,1307163,1,5,3,0,0,27
183539,1307163,1,5,4,1,0,28
183540,1307163,1,5,5,0,0,28
183541,1307163,1,5,6,0,0,28
183542,1307163,1,6,1,4,0,32
183543,1307163,1,6,2,1,0,33
183544,1307163,1,6,3,0,0,33
183545,1307163,1,6,4,0,0,33
183546,1307163,1,6,5,0,0,33
183547,1307163,1,6,6,0,0,33
183548,1307163,1,7,1,0,0,33
183549,1307163,1,7,2,0,0,33
183550,1307163,1,7,3,1,0,34
183551,1307163,1,7,4,0,0,34
183552,1307163,1,7,5,0,0,34
183553,1307163,1,7,6,2,0,36
183554,1307163,1,8,1,1,0,37
183555,1307163,1,8,2,0,0,37
183556,1307163,1,8,3,0,0,37
183557,1307163,1,8,4,1,0,38
183558,1307163,1,8,5,1,0,39
183559,1307163,1,8,6,0,0,39
183560,1307163,1,9,1,0,0,39
183561,1307163,1,9,2,1,0,40
183562,1307163,1,9,3,1,0,41
183563,1307163,1,9,4,0,0,41
183564,1307163,1,9,5,0,0,41
183565,1307163,1,9,6,1,0,42
183566,1307163,1,10,1,6,0,48
183567,1307163,1,10,2,4,0,52
183568,1307163,1,10,3,0,0,52
183569,1307163,1,10,4,0,0,52
183570,1307163,1,10,5,6,0,58
183571,1307163,1,10,6,4,0,62
183572,1307163,1,11,1,1,0,63
183573,1307163,1,11,2,0,0,63
183574,1307163,1,11,3,2,0,65
183575,1307163,1,11,4,1,0,66
183576,1307163,1,11,5,0,1,66
183577,1307163,1,11,6,0,1,66
183578,1307163,1,12,1,1,0,67
183579,1307163,1,12,2,0,0,67
183580,1307163,1,12,3,0,0,67
183581,1307163,1,12,4,0,0,67
183582,1307163,1,12,5,3,0,70
183583,1307163,1,12,6,1,0,71
183584,1307163,1,13,1,1,0,72
183585,1307163,1,13,2,1,0,73
183586,1307163,1,13,3,1,0,74
183587,1307163,1,13,4,5,0,79
183588,1307163,1,13,5,1,0,80
183589,1307163,1,13,6,0,0,80
183590,1307163,1,14,1,1,0,81
183591,1307163,1,14,2,2,0,83
183592,1307163,1,14,3,1,0,84
183593,1307163,1,14,4,1,0,85
183594,1307163,1,14,5,1,0,86
183595,1307163,1,14,6,1,0,87
183596,1307163,1,15,1,0,0,87
183597,1307163,1,15,2,1,0,88
183598,1307163,1,15,3,4,0,92
183599,1307163,1,15,4,1,0,93
183600,1307163,1,15,5,0,0,93
183601,1307163,1,15,6,2,0,95
183642,1307293,1,1,1,1,0,1
183643,1307293,1,1,2,0,0,1
183644,1307293,1,1,3,0,0,1
183645,1307293,1,1,4,3,0,4
183646,1307293,1,1,5,2,0,6
183647,1307293,1,1,6,1,0,7
183648,1307293,1,2,1,0,0,7
183649,1307293,1,2,2,1,0,8
183650,1307293,1,2,3,0,0,8
183651,1307293,1,2,4,0,0,8
183652,1307293,1,2,5,1,0,9
183653,1307293,1,2,6,0,0,9
183654,1307293,1,3,1,0,0,9
183655,1307293,1,3,2,1,0,10
183656,1307293,1,3,3,1,0,11
183657,1307293,1,3,4,4,0,15
183658,1307293,1,3,5,6,0,21
183659,1307293,1,3,6,2,0,23
183660,1307293,1,4,1,4,0,27
183661,1307293,1,4,2,1,0,28
183662,1307293,1,4,3,4,0,32
183663,1307293,1,4,4,1,0,33
183664,1307293,1,4,5,1,0,34
183665,1307293,1,4,6,1,0,35
183666,1307293,1,5,1,4,0,39
183667,1307293,1,5,2,0,1,39
183668,1307293,1,5,3,0,0,39
183669,1307293,1,5,4,0,0,39
183670,1307293,1,5,5,0,0,39
183671,1307293,1,5,6,1,0,40
183672,1307293,1,6,1,0,0,40
183673,1307293,1,6,2,6,0,46
183674,1307293,1,6,3,0,0,46
183675,1307293,1,6,4,4,0,50
183676,1307293,1,6,5,0,0,50
183677,1307293,1,6,6,0,0,50
183678,1307293,1,7,1,2,0,52
183679,1307293,1,7,2,1,0,53
183680,1307293,1,7,3,0,0,53
183681,1307293,1,7,4,1,0,54
183682,1307293,1,7,5,1,0,55
183683,1307293,1,7,6,1,0,56
183684,1307293,1,8,1,0,0,56
183685,1307293,1,8,2,2,0,58
183686,1307293,1,8,3,1,0,59
183687,1307293,1,8,4,1,0,60
183688,1307293,1,8,5,1,0,61
183689,1307293,1,8,6,1,0,62
183690,1307293,1,9,1,2,0,64
183691,1307293,1,9,2,0,0,64
183692,1307293,1,9,3,2,0,66
183693,1307293,1,9,4,0,0,66
183694,1307293,1,9,5,1,0,67
183695,1307293,1,9,6,1,0,68
183696,1307293,1,10,1,4,0,72
183697,1307293,1,10,2,4,0,76
183698,1307293,1,10,3,1,0,77
183699,1307293,1,10,4,0,0,77
183700,1307293,1,10,5,1,0,78
183701,1307293,1,10,6,1,0,79
183702,1307293,1,11,1,0,0,79
183703,1307293,1,11,2,1,0,80
183704,1307293,1,11,3,1,0,81
183705,1307293,1,11,4,1,0,82
183706,1307293,1,11,5,6,0,88
183707,1307293,1,11,6,0,0,88
183708,1307293,1,12,1,1,0,89
183709,1307293,1,12,2,2,0,91
183710,1307293,1,12,3,0,0,91
183711,1307293,1,12,4,9,0,100
183712,1307293,1,12,5,0,0,100
183713,1307293,1,12,6,0,1,100
183714,1307293,1,13,1,1,0,101
183715,1307293,1,13,2,0,0,101
183716,1307293,1,13,3,0,0,101
183717,1307293,1,13,4,0,0,101
183718,1307293,1,13,5,1,0,102
183719,1307293,1,13,6,0,0,102
183720,1307293,1,14,1,0,1,102
183721,1307293,1,14,2,0,0,102
183722,1307293,1,14,3,1,0,103
183723,1307293,1,14,4,0,1,103
183724,1307293,1,14,5,0,0,103
183725,1307293,1,14,6,0,1,103
183726,1307293,1,15,1,1,0,104
183727,1307293,1,15,2,1,0,105
183728,1307293,1,15,3,1,0,106
183729,1307293,1,15,4,1,0,107
183730,1307293,1,15,5,3,0,110
183731,1307293,1,15,6,1,0,111
183732,1307293,1,16,1,0,0,111
183733,1307293,1,16,2,4,0,115
183734,1307293,1,16,3,1,0,116
183735,1307293,1,16,4,0,1,116
183736,1307293,1,16,5,1,0,117
183737,1307293,1,16,6,1,0,118
183738,1307293,1,17,1,0,1,118
183739,1307293,1,17,2,0,0,118
183740,1307293,1,17,3,1,0,119
183741,1307293,1,17,4,0,0,119
183742,1307293,1,17,5,0,0,119
183743,1307293,1,17,6,0,0,119
183744,1307293,1,18,1,2,0,121
183745,1307293,1,18,2,0,0,121
183746,1307293,1,18,3,4,0,125
183747,1307293,1,18,4,0,0,125
183748,1307293,1,18,5,1,0,126
183749,1307293,1,18,6,1,0,127
183750,1307293,1,19,1,0,1,127
183751,1307293,1,19,2,1,0,128
183752,1307293,1,19,3,0,1,128
183753,1307293,1,19,4,0,0,128
183754,1307293,1,19,5,0,0,128
183755,1307293,1,19,6,0,0,128
183756,1307293,1,20,1,0,0,128
183757,1307293,1,20,2,0,0,128
183758,1307293,1,20,3,0,1,128
183843,1307294,1,1,1,1,0,1
183844,1307294,1,1,2,0,0,1
183845,1307294,1,1,3,0,0,1
183846,1307294,1,1,4,4,0,5
183847,1307294,1,1,5,0,1,5
183848,1307294,1,1,6,0,0,5
183849,1307294,1,2,1,0,0,5
183850,1307294,1,2,2,0,0,5
183851,1307294,1,2,3,0,0,5
183852,1307294,1,2,4,0,0,5
183853,1307294,1,2,5,0,0,5
183854,1307294,1,2,6,0,0,5
183855,1307294,1,3,1,0,0,5
183856,1307294,1,3,2,0,0,5
183857,1307294,1,3,3,2,0,7
183858,1307294,1,3,4,0,1,7
183859,1307294,1,3,5,0,0,7
183860,1307294,1,3,6,0,0,7
183861,1307294,1,4,1,0,0,7
183862,1307294,1,4,2,1,0,8
183863,1307294,1,4,3,0,0,8
183864,1307294,1,4,4,1,0,9
183865,1307294,1,4,5,1,0,10
183866,1307294,1,4,6,2,0,12
183867,1307294,1,5,1,6,0,18
183868,1307294,1,5,2,0,0,18
183869,1307294,1,5,3,1,0,19
183870,1307294,1,5,4,1,0,20
183871,1307294,1,5,5,0,0,20
183872,1307294,1,5,6,0,0,20
183873,1307294,1,6,1,0,0,20
183874,1307294,1,6,2,6,0,26
183875,1307294,1,6,3,0,0,26
183876,1307294,1,6,4,0,0,26
183877,1307294,1,6,5,1,0,27
183878,1307294,1,6,6,1,0,28
183879,1307294,1,7,1,0,0,28
183880,1307294,1,7,2,6,0,34
183881,1307294,1,7,3,1,0,35
183882,1307294,1,7,4,0,0,35
183883,1307294,1,7,5,1,0,36
183884,1307294,1,7,6,1,0,37
183885,1307294,1,8,1,1,0,38
183886,1307294,1,8,2,1,0,39
183887,1307294,1,8,3,4,0,43
183888,1307294,1,8,4,1,0,44
183889,1307294,1,8,5,1,0,45
183890,1307294,1,8,6,1,0,46
183891,1307294,1,9,1,2,0,48
183892,1307294,1,9,2,2,0,50
183893,1307294,1,9,3,1,0,51
183894,1307294,1,9,4,1,0,52
183895,1307294,1,9,5,1,0,53
183896,1307294,1,9,6,0,0,53
183897,1307294,1,10,1,4,0,57
183898,1307294,1,10,2,1,0,58
183899,1307294,1,10,3,0,0,58
183900,1307294,1,10,4,0,0,58
183901,1307294,1,10,5,4,0,62
183902,1307294,1,10,6,1,0,63
183903,1307294,1,11,1,2,0,65
183904,1307294,1,11,2,1,0,66
183905,1307294,1,11,3,2,0,68
183906,1307294,1,11,4,1,0,69
183907,1307294,1,11,5,0,0,69
183908,1307294,1,11,6,1,0,70
183909,1307294,1,12,1,0,0,70
183910,1307294,1,12,2,2,0,72
183911,1307294,1,12,3,1,0,73
183912,1307294,1,12,4,0,0,73
183913,1307294,1,12,5,0,1,73
183914,1307294,1,12,6,1,0,74
183915,1307294,1,13,1,0,0,74
183916,1307294,1,13,2,2,0,76
183917,1307294,1,13,3,1,0,77
183918,1307294,1,13,4,1,0,78
183919,1307294,1,13,5,0,0,78
183920,1307294,1,13,6,4,0,82
183921,1307294,1,14,1,2,0,84
183922,1307294,1,14,2,0,0,84
183923,1307294,1,14,3,0,0,84
183924,1307294,1,14,4,4,0,88
183925,1307294,1,14,5,1,0,89
183926,1307294,1,14,6,1,0,90
183927,1307294,1,15,1,0,1,90
183928,1307294,1,15,2,1,0,91
183929,1307294,1,15,3,1,0,92
183930,1307294,1,15,4,0,0,92
183931,1307294,1,15,5,0,0,92
183932,1307294,1,15,6,4,0,96
183933,1307294,1,16,1,1,0,97
183934,1307294,1,16,2,0,0,97
183935,1307294,1,16,3,0,0,97
183936,1307294,1,16,4,0,0,97
183937,1307294,1,16,5,1,0,98
183938,1307294,1,16,6,1,0,99
183939,1307294,1,17,1,2,0,101
183940,1307294,1,17,2,0,1,101
183941,1307294,1,17,3,1,0,102
183942,1307294,1,17,4,2,0,104
183943,1307294,1,17,5,4,0,108
183944,1307294,1,17,6,0,0,108
183945,1307294,1,18,1,1,0,109
183946,1307294,1,18,2,0,0,109
183947,1307294,1,18,3,0,0,109
183948,1307294,1,18,4,0,0,109
183949,1307294,1,18,5,1,0,110
183950,1307294,1,18,6,1,0,111
183951,1307294,1,19,1,1,0,112
183952,1307294,1,19,2,1,0,113
183953,1307294,1,19,3,0,0,113
183954,1307294,1,19,4,4,0,117
183955,1307294,1,19,5,4,0,121
183956,1307294,1,19,6,0,1,121
183957,1307294,1,20,1,0,1,121
183958,1307294,1,20,2,0,1,121
183959,1307294,1,20,3,0,0,121
183960,1307294,1,20,4,0,1,121
183961,1307294,1,20,5,1,0,122
183962,1307294,1,20,6,2,0,124
184070,1307295,1,1,1,0,0,0
184071,1307295,1,1,2,0,0,0
184072,1307295,1,1,3,1,0,1
184073,1307295,1,1,4,1,0,2
184074,1307295,1,1,5,1,0,3
184075,1307295,1,1,6,1,0,4
184076,1307295,1,2,1,0,0,4
184077,1307295,1,2,2,4,0,8
184078,1307295,1,2,3,0,0,8
184079,1307295,1,2,4,0,0,8
184080,1307295,1,2,5,4,0,12
184081,1307295,1,2,6,3,0,15
184082,1307295,1,3,1,0,0,15
184083,1307295,1,3,2,4,0,19
184084,1307295,1,3,3,4,0,23
184085,1307295,1,3,4,0,0,23
184086,1307295,1,3,5,0,0,23
184087,1307295,1,3,6,0,0,23
184088,1307295,1,4,1,4,0,27
184089,1307295,1,4,2,0,0,27
184090,1307295,1,4,3,0,0,27
184091,1307295,1,4,4,0,0,27
184092,1307295,1,4,5,0,0,27
184093,1307295,1,4,6,0,0,27
184094,1307295,1,5,1,4,0,31
184095,1307295,1,5,2,1,0,32
184096,1307295,1,5,3,4,0,36
184097,1307295,1,5,4,1,0,37
184098,1307295,1,5,5,3,0,40
184099,1307295,1,5,6,0,0,40
184100,1307295,1,6,1,0,0,40
184101,1307295,1,6,2,1,0,41
184102,1307295,1,6,3,2,0,43
184103,1307295,1,6,4,0,1,43
184104,1307295,1,6,5,0,0,43
184105,1307295,1,6,6,6,0,49
184106,1307295,1,7,1,1,0,50
184107,1307295,1,7,2,1,0,51
184108,1307295,1,7,3,0,0,51
184109,1307295,1,7,4,4,0,55
184110,1307295,1,7,5,0,0,55
184111,1307295,1,7,6,4,0,59
184112,1307295,1,8,1,6,0,65
184113,1307295,1,8,2,0,0,65
184114,1307295,1,8,3,1,0,66
184115,1307295,1,8,4,0,0,66
184116,1307295,1,8,5,0,0,66
184117,1307295,1,8,6,2,0,68
184118,1307295,1,9,1,1,0,69
184119,1307295,1,9,2,4,0,73
184120,1307295,1,9,3,2,0,75
184121,1307295,1,9,4,4,0,79
184122,1307295,1,9,5,2,0,81
184123,1307295,1,9,6,1,0,82
184124,1307295,1,10,1,1,0,83
184125,1307295,1,10,2,1,0,84
184126,1307295,1,10,3,0,0,84
184127,1307295,1,10,4,0,0,84
184128,1307295,1,10,5,1,0,85
184129,1307295,1,10,6,0,1,85
184130,1307295,1,11,1,0,1,85
184131,1307295,1,11,2,0,1,85
184132,1307295,1,11,3,1,0,86
184133,1307295,1,11,4,1,0,87
184134,1307295,1,11,5,1,0,88
184135,1307295,1,11,6,0,0,88
184136,1307295,1,12,1,1,0,89
184137,1307295,1,12,2,1,0,90
184138,1307295,1,12,3,2,0,92
184139,1307295,1,12,4,1,0,93
184140,1307295,1,12,5,0,0,93
184141,1307295,1,12,6,0,0,93
184142,1307295,1,13,1,2,0,95
184143,1307295,1,13,2,2,0,97
184144,1307295,1,13,3,4,0,101
184145,1307295,1,13,4,1,0,102
184146,1307295,1,13,5,1,0,103
184147,1307295,1,13,6,0,0,103
184148,1307295,1,14,1,1,0,104
184149,1307295,1,14,2,1,0,105
184150,1307295,1,14,3,1,0,106
184151,1307295,1,14,4,2,0,108
184152,1307295,1,14,5,1,0,109
184153,1307295,1,14,6,2,0,111
184154,1307295,1,15,1,1,0,112
184155,1307295,1,15,2,1,0,113
184156,1307295,1,15,3,1,0,114
184157,1307295,1,15,4,1,0,115
184158,1307295,1,15,5,1,0,116
184159,1307295,1,15,6,1,0,117
184160,1307295,1,16,1,6,0,123
184161,1307295,1,16,2,4,0,127
184162,1307295,1,16,3,4,0,131
184163,1307295,1,16,4,2,0,133
184164,1307295,1,16,5,0,0,133
184165,1307295,1,16,6,0,1,133
184166,1307295,1,17,1,0,0,133
184167,1307295,1,17,2,1,0,134
184168,1307295,1,17,3,1,0,135
184169,1307295,1,17,4,1,0,136
184170,1307295,1,17,5,1,0,137
184171,1307295,1,17,6,1,0,138
184172,1307295,1,18,1,2,0,140
184173,1307295,1,18,2,1,0,141
184174,1307295,1,18,3,0,0,141
184175,1307295,1,18,4,1,0,142
184176,1307295,1,18,5,6,0,148
184177,1307295,1,18,6,1,0,149
184178,1307295,1,19,1,0,0,149
184179,1307295,1,19,2,0,0,149
184180,1307295,1,19,3,1,0,150
184181,1307295,1,19,4,5,0,155
184182,1307295,1,19,5,1,0,156
184183,1307295,1,19,6,4,0,160
184184,1307295,1,20,1,4,0,164
184185,1307295,1,20,2,1,0,165
184186,1307295,1,20,3,0,0,165
184187,1307295,1,20,4,5,0,170
184188,1307295,1,20,5,6,0,176
184189,1307295,1,20,6,0,0,176
184310,1310901,1,1,1,1,0,1
184311,1310901,1,1,2,0,0,1
184312,1310901,1,1,3,0,0,1
184313,1310901,1,1,4,0,0,1
184314,1310901,1,1,5,0,0,1
184315,1310901,1,1,6,0,0,1
184316,1310901,1,2,1,0,0,1
184317,1310901,1,2,2,0,0,1
184318,1310901,1,2,3,1,0,2
184319,1310901,1,2,4,2,0,4
184320,1310901,1,2,5,0,0,4
184321,1310901,1,2,6,1,0,5
184322,1310901,1,3,1,0,0,5
184323,1310901,1,3,2,6,0,11
184324,1310901,1,3,3,0,1,11
184325,1310901,1,3,4,0,0,11
184326,1310901,1,3,5,0,0,11
184327,1310901,1,3,6,0,0,11
184328,1310901,1,4,1,1,0,12
184329,1310901,1,4,2,0,0,12
184330,1310901,1,4,3,1,0,13
184331,1310901,1,4,4,0,0,13
184332,1310901,1,4,5,4,0,17
184333,1310901,1,4,6,1,0,18
184334,1310901,1,5,1,1,0,19
184335,1310901,1,5,2,0,0,19
184336,1310901,1,5,3,1,0,20
184337,1310901,1,5,4,4,0,24
184338,1310901,1,5,5,1,0,25
184339,1310901,1,5,6,0,0,25
184340,1310901,1,6,1,6,0,31
184341,1310901,1,6,2,0,0,31
184342,1310901,1,6,3,1,0,32
184343,1310901,1,6,4,0,1,32
184344,1310901,1,6,5,0,0,32
184345,1310901,1,6,6,1,0,33
184346,1310901,1,7,1,1,0,34
184347,1310901,1,7,2,0,0,34
184348,1310901,1,7,3,1,0,35
184349,1310901,1,7,4,1,0,36
184350,1310901,1,7,5,2,0,38
184351,1310901,1,7,6,1,0,39
184352,1310901,1,8,1,1,0,40
184353,1310901,1,8,2,0,0,40
184354,1310901,1,8,3,0,0,40
184355,1310901,1,8,4,0,0,40
184356,1310901,1,8,5,4,0,44
184357,1310901,1,8,6,1,0,45
184358,1310901,1,9,1,1,0,46
184359,1310901,1,9,2,0,0,46
184360,1310901,1,9,3,1,0,47
184361,1310901,1,9,4,2,0,49
184362,1310901,1,9,5,2,0,51
184363,1310901,1,9,6,1,0,52
184364,1310901,1,10,1,0,0,52
184365,1310901,1,10,2,4,0,56
184366,1310901,1,10,3,1,0,57
184367,1310901,1,10,4,1,0,58
184368,1310901,1,10,5,1,0,59
184369,1310901,1,10,6,1,0,60
184370,1310901,1,11,1,1,0,61
184371,1310901,1,11,2,0,1,61
184372,1310901,1,11,3,1,0,62
184373,1310901,1,11,4,2,0,64
184374,1310901,1,11,5,1,0,65
184375,1310901,1,11,6,1,0,66
184376,1310901,1,12,1,1,0,67
184377,1310901,1,12,2,0,0,67
184378,1310901,1,12,3,2,0,69
184379,1310901,1,12,4,1,0,70
184380,1310901,1,12,5,2,0,72
184381,1310901,1,12,6,1,0,73
184382,1310901,1,13,1,1,0,74
184383,1310901,1,13,2,1,0,75
184384,1310901,1,13,3,1,0,76
184385,1310901,1,13,4,1,0,77
184386,1310901,1,13,5,1,0,78
184387,1310901,1,13,6,4,0,82
184388,1310901,1,14,1,1,0,83
184389,1310901,1,14,2,2,0,85
184390,1310901,1,14,3,0,1,85
184391,1310901,1,14,4,4,0,89
184392,1310901,1,14,5,2,0,91
184393,1310901,1,14,6,1,0,92
184394,1310901,1,15,1,0,0,92
184395,1310901,1,15,2,0,0,92
184396,1310901,1,15,3,1,0,93
184397,1310901,1,15,4,0,0,93
184398,1310901,1,15,5,2,0,95
184399,1310901,1,15,6,0,1,95
184400,1310901,1,16,1,0,0,95
184401,1310901,1,16,2,0,0,95
184402,1310901,1,16,3,1,0,96
184403,1310901,1,16,4,1,0,97
184404,1310901,1,16,5,2,0,99
184405,1310901,1,16,6,1,0,100
184406,1310901,1,17,1,2,0,102
184407,1310901,1,17,2,4,0,106
184408,1310901,1,17,3,6,0,112
184409,1310901,1,17,4,3,0,115
184410,1310901,1,17,5,7,0,122
184411,1310901,1,17,6,0,1,122
184412,1310901,1,18,1,0,0,122
184413,1310901,1,18,2,1,0,123
184414,1310901,1,18,3,0,0,123
184415,1310901,1,18,4,0,0,123
184416,1310901,1,18,5,1,0,124
184417,1310901,1,18,6,0,0,124
184418,1310901,1,19,1,1,0,125
184419,1310901,1,19,2,2,0,127
184420,1310901,1,19,3,1,0,128
184421,1310901,1,19,4,6,0,134
184422,1310901,1,19,5,4,0,138
184423,1310901,1,19,6,6,0,144
184424,1310901,1,20,1,1,0,145
184425,1310901,1,20,2,0,0,145
184426,1310901,1,20,3,1,0,146
184427,1310901,1,20,4,1,0,147
184428,1310901,1,20,5,0,1,147
184429,1310901,1,20,6,1,0,148
184547,1310902,1,1,1,3,0,3
184548,1310902,1,1,2,0,0,3
184549,1310902,1,1,3,0,0,3
184550,1310902,1,1,4,0,0,3
184551,1310902,1,1,5,4,0,7
184552,1310902,1,1,6,0,1,7
184553,1310902,1,2,1,2,0,9
184554,1310902,1,2,2,4,0,13
184555,1310902,1,2,3,0,0,13
184556,1310902,1,2,4,0,0,13
184557,1310902,1,2,5,3,0,16
184558,1310902,1,2,6,0,0,16
184559,1310902,1,3,1,1,0,17
184560,1310902,1,3,2,0,0,17
184561,1310902,1,3,3,0,0,17
184562,1310902,1,3,4,1,0,18
184563,1310902,1,3,5,1,0,19
184564,1310902,1,3,6,0,0,19
184565,1310902,1,4,1,0,0,19
184566,1310902,1,4,2,1,0,20
184567,1310902,1,4,3,0,0,20
184568,1310902,1,4,4,4,0,24
184569,1310902,1,4,5,6,0,30
184570,1310902,1,4,6,1,0,31
184571,1310902,1,5,1,1,0,32
184572,1310902,1,5,2,0,0,32
184573,1310902,1,5,3,0,0,32
184574,1310902,1,5,4,0,0,32
184575,1310902,1,5,5,0,1,32
184576,1310902,1,5,6,0,0,32
184577,1310902,1,6,1,1,0,33
184578,1310902,1,6,2,0,0,33
184579,1310902,1,6,3,4,0,37
184580,1310902,1,6,4,0,0,37
184581,1310902,1,6,5,0,0,37
184582,1310902,1,6,6,0,0,37
184583,1310902,1,7,1,2,0,39
184584,1310902,1,7,2,1,0,40
184585,1310902,1,7,3,0,0,40
184586,1310902,1,7,4,1,0,41
184587,1310902,1,7,5,0,0,41
184588,1310902,1,7,6,2,0,43
184589,1310902,1,8,1,0,0,43
184590,1310902,1,8,2,0,0,43
184591,1310902,1,8,3,1,0,44
184592,1310902,1,8,4,0,1,44
184593,1310902,1,8,5,1,0,45
184594,1310902,1,8,6,0,0,45
184595,1310902,1,9,1,6,0,51
184596,1310902,1,9,2,1,0,52
184597,1310902,1,9,3,2,0,54
184598,1310902,1,9,4,0,0,54
184599,1310902,1,9,5,0,0,54
184600,1310902,1,9,6,1,0,55
184601,1310902,1,10,1,1,0,56
184602,1310902,1,10,2,0,0,56
184603,1310902,1,10,3,4,0,60
184604,1310902,1,10,4,1,0,61
184605,1310902,1,10,5,3,0,64
184606,1310902,1,10,6,1,0,65
184607,1310902,1,11,1,6,0,71
184608,1310902,1,11,2,1,0,72
184609,1310902,1,11,3,1,0,73
184610,1310902,1,11,4,1,0,74
184611,1310902,1,11,5,1,0,75
184612,1310902,1,11,6,2,0,77
184613,1310902,1,12,1,1,0,78
184614,1310902,1,12,2,0,0,78
184615,1310902,1,12,3,1,0,79
184616,1310902,1,12,4,4,0,83
184617,1310902,1,12,5,1,0,84
184618,1310902,1,12,6,1,0,85
184619,1310902,1,13,1,2,0,87
184620,1310902,1,13,2,1,0,88
184621,1310902,1,13,3,4,0,92
184622,1310902,1,13,4,4,0,96
184623,1310902,1,13,5,1,0,97
184624,1310902,1,13,6,1,0,98
184625,1310902,1,14,1,1,0,99
184626,1310902,1,14,2,2,0,101
184627,1310902,1,14,3,0,1,101
184628,1310902,1,14,4,1,0,102
184629,1310902,1,14,5,1,0,103
184630,1310902,1,14,6,1,0,104
184631,1310902,1,15,1,0,0,104
184632,1310902,1,15,2,0,0,104
184633,1310902,1,15,3,1,0,105
184634,1310902,1,15,4,0,0,105
184635,1310902,1,15,5,2,0,107
184636,1310902,1,15,6,4,0,111
184637,1310902,1,16,1,1,0,112
184638,1310902,1,16,2,1,0,113
184639,1310902,1,16,3,1,0,114
184640,1310902,1,16,4,1,0,115
184641,1310902,1,16,5,0,0,115
184642,1310902,1,16,6,2,0,117
184643,1310902,1,17,1,0,0,117
184644,1310902,1,17,2,1,0,118
184645,1310902,1,17,3,1,0,119
184646,1310902,1,17,4,4,0,123
184647,1310902,1,17,5,0,0,123
184648,1310902,1,17,6,2,0,125
184649,1310902,1,18,1,1,0,126
184650,1310902,1,18,2,1,0,127
184651,1310902,1,18,3,1,0,128
184652,1310902,1,18,4,0,0,128
184653,1310902,1,18,5,0,0,128
184654,1310902,1,18,6,0,0,128
184655,1310902,1,19,1,0,0,128
184656,1310902,1,19,2,2,0,130
184657,1310902,1,19,3,0,0,130
184658,1310902,1,19,4,1,0,131
184659,1310902,1,19,5,4,0,135
184660,1310902,1,19,6,0,0,135
184661,1310902,1,20,1,1,0,136
184662,1310902,1,20,2,1,0,137
184663,1310902,1,20,3,6,0,143
184664,1310902,1,20,4,1,0,144
184665,1310902,1,20,5,2,0,146
184666,1310902,1,20,6,1,0,147
184751,1310946,1,1,1,1,0,1
184752,1310946,1,1,2,1,0,2
184753,1310946,1,1,3,0,0,2
184754,1310946,1,1,4,0,0,2
184755,1310946,1,1,5,4,0,6
184756,1310946,1,1,6,0,0,6
184757,1310946,1,2,1,2,0,8
184758,1310946,1,2,2,0,0,8
184759,1310946,1,2,3,0,0,8
184760,1310946,1,2,4,1,0,9
184761,1310946,1,2,5,2,0,11
184762,1310946,1,2,6,1,0,12
184763,1310946,1,3,1,0,1,12
184764,1310946,1,3,2,0,0,12
184765,1310946,1,3,3,0,0,12
184766,1310946,1,3,4,1,0,13
184767,1310946,1,3,5,0,0,13
184768,1310946,1,3,6,4,0,17
184769,1310946,1,4,1,4,0,21
184770,1310946,1,4,2,4,0,25
184771,1310946,1,4,3,0,0,25
184772,1310946,1,4,4,4,0,29
184773,1310946,1,4,5,1,0,30
184774,1310946,1,4,6,1,0,31
184775,1310946,1,5,1,0,0,31
184776,1310946,1,5,2,1,0,32
184777,1310946,1,5,3,4,0,36
184778,1310946,1,5,4,1,0,37
184779,1310946,1,5,5,5,0,42
184780,1310946,1,5,6,0,1,42
184781,1310946,1,6,1,1,0,43
184782,1310946,1,6,2,0,0,43
184783,1310946,1,6,3,4,0,47
184784,1310946,1,6,4,1,0,48
184785,1310946,1,6,5,0,0,48
184786,1310946,1,6,6,2,0,50
184787,1310946,1,7,1,1,0,51
184788,1310946,1,7,2,1,0,52
184789,1310946,1,7,3,0,0,52
184790,1310946,1,7,4,4,0,56
184791,1310946,1,7,5,1,0,57
184792,1310946,1,7,6,1,0,58
184793,1310946,1,8,1,1,0,59
184794,1310946,1,8,2,1,0,60
184795,1310946,1,8,3,1,0,61
184796,1310946,1,8,4,0,0,61
184797,1310946,1,8,5,1,0,62
184798,1310946,1,8,6,2,0,64
184799,1310946,1,9,1,0,1,64
184800,1310946,1,9,2,0,0,64
184801,1310946,1,9,3,0,0,64
184802,1310946,1,9,4,0,0,64
184803,1310946,1,9,5,0,0,64
184804,1310946,1,9,6,1,0,65
184805,1310946,1,10,1,2,1,67
184806,1310946,1,10,2,0,0,67
184807,1310946,1,10,3,2,0,69
184808,1310946,1,10,4,1,0,70
184809,1310946,1,10,5,0,0,70
184810,1310946,1,10,6,0,0,70
184811,1310946,1,11,1,1,0,71
184812,1310946,1,11,2,1,0,72
184813,1310946,1,11,3,1,0,73
184814,1310946,1,11,4,1,0,74
184815,1310946,1,11,5,0,0,74
184816,1310946,1,11,6,1,0,75
184817,1310946,1,12,1,4,0,79
184818,1310946,1,12,2,1,0,80
184819,1310946,1,12,3,1,0,81
184820,1310946,1,12,4,1,0,82
184821,1310946,1,12,5,1,0,83
184822,1310946,1,12,6,4,0,87
184823,1310946,1,13,1,1,0,88
184824,1310946,1,13,2,4,0,92
184825,1310946,1,13,3,0,0,92
184826,1310946,1,13,4,1,0,93
184827,1310946,1,13,5,1,0,94
184828,1310946,1,13,6,2,0,96
184829,1310946,1,14,1,1,0,97
184830,1310946,1,14,2,0,1,97
184831,1310946,1,14,3,1,0,98
184832,1310946,1,14,4,1,0,99
184833,1310946,1,14,5,1,0,100
184834,1310946,1,14,6,0,0,100
184835,1310946,1,15,1,1,0,101
184836,1310946,1,15,2,4,0,105
184837,1310946,1,15,3,0,0,105
184838,1310946,1,15,4,0,0,105
184839,1310946,1,15,5,1,0,106
184840,1310946,1,15,6,1,1,107
184841,1310946,1,16,1,4,0,111
184842,1310946,1,16,2,1,0,112
184843,1310946,1,16,3,0,0,112
184844,1310946,1,16,4,1,0,113
184845,1310946,1,16,5,1,0,114
184846,1310946,1,16,6,4,0,118
184847,1310946,1,17,1,0,0,118
184848,1310946,1,17,2,4,0,122
184849,1310946,1,17,3,1,0,123
184850,1310946,1,17,4,0,1,123
184851,1310946,1,17,5,1,0,124
184852,1310946,1,17,6,0,0,124
184853,1310946,1,18,1,2,0,126
184854,1310946,1,18,2,1,0,127
184855,1310946,1,18,3,4,0,131
184856,1310946,1,18,4,0,0,131
184857,1310946,1,18,5,1,0,132
184858,1310946,1,18,6,1,0,133
184859,1310946,1,19,1,2,0,135
184860,1310946,1,19,2,13,0,148
184861,1310946,1,19,3,0,1,148
184862,1310946,1,19,4,1,0,149
184863,1310946,1,19,5,1,0,150
184864,1310946,1,19,6,1,0,151
184865,1310946,1,20,1,2,0,153
184866,1310946,1,20,2,1,0,154
184867,1310946,1,20,3,0,0,154
184868,1310946,1,20,4,4,0,158
184869,1310946,1,20,5,0,0,158
184870,1310946,1,20,6,1,0,159
184987,1310947,1,1,1,2,0,2
184988,1310947,1,1,2,0,0,2
184989,1310947,1,1,3,6,0,8
184990,1310947,1,1,4,4,0,12
184991,1310947,1,1,5,0,0,12
184992,1310947,1,1,6,0,0,12
184993,1310947,1,2,1,0,0,12
184994,1310947,1,2,2,0,0,12
184995,1310947,1,2,3,1,0,13
184996,1310947,1,2,4,1,0,14
184997,1310947,1,2,5,0,1,14
184998,1310947,1,2,6,0,0,14
184999,1310947,1,3,1,1,0,15
185000,1310947,1,3,2,0,0,15
185001,1310947,1,3,3,1,0,16
185002,1310947,1,3,4,4,0,20
185003,1310947,1,3,5,1,0,21
185004,1310947,1,3,6,0,0,21
185005,1310947,1,4,1,4,0,25
185006,1310947,1,4,2,6,0,31
185007,1310947,1,4,3,0,1,31
185008,1310947,1,4,4,0,0,31
185009,1310947,1,4,5,0,0,31
185010,1310947,1,4,6,3,0,34
185011,1310947,1,5,1,0,0,34
185012,1310947,1,5,2,1,0,35
185013,1310947,1,5,3,2,0,37
185014,1310947,1,5,4,4,0,41
185015,1310947,1,5,5,0,0,41
185016,1310947,1,5,6,5,0,46
185017,1310947,1,6,1,0,1,46
185018,1310947,1,6,2,0,0,46
185019,1310947,1,6,3,0,0,46
185020,1310947,1,6,4,4,0,50
185021,1310947,1,6,5,1,0,51
185022,1310947,1,6,6,0,1,51
185023,1310947,1,7,1,0,0,51
185024,1310947,1,7,2,0,0,51
185025,1310947,1,7,3,0,0,51
185026,1310947,1,7,4,0,0,51
185027,1310947,1,7,5,4,0,55
185028,1310947,1,7,6,1,0,56
185029,1310947,1,8,1,1,0,57
185030,1310947,1,8,2,0,0,57
185031,1310947,1,8,3,1,0,58
185032,1310947,1,8,4,1,0,59
185033,1310947,1,8,5,0,0,59
185034,1310947,1,8,6,1,0,60
185035,1310947,1,9,1,0,0,60
185036,1310947,1,9,2,1,0,61
185037,1310947,1,9,3,6,0,67
185038,1310947,1,9,4,1,0,68
185039,1310947,1,9,5,0,0,68
185040,1310947,1,9,6,1,0,69
185041,1310947,1,10,1,0,0,69
185042,1310947,1,10,2,1,0,70
185043,1310947,1,10,3,1,0,71
185044,1310947,1,10,4,2,0,73
185045,1310947,1,10,5,1,0,74
185046,1310947,1,10,6,1,0,75
185047,1310947,1,11,1,0,0,75
185048,1310947,1,11,2,1,0,76
185049,1310947,1,11,3,0,0,76
185050,1310947,1,11,4,0,0,76
185051,1310947,1,11,5,1,0,77
185052,1310947,1,11,6,1,0,78
185053,1310947,1,12,1,0,0,78
185054,1310947,1,12,2,1,0,79
185055,1310947,1,12,3,2,0,81
185056,1310947,1,12,4,1,0,82
185057,1310947,1,12,5,4,0,86
185058,1310947,1,12,6,1,0,87
185059,1310947,1,13,1,1,0,88
185060,1310947,1,13,2,0,1,88
185061,1310947,1,13,3,1,0,89
185062,1310947,1,13,4,1,0,90
185063,1310947,1,13,5,1,0,91
185064,1310947,1,13,6,0,0,91
185065,1310947,1,14,1,1,0,92
185066,1310947,1,14,2,1,0,93
185067,1310947,1,14,3,2,0,95
185068,1310947,1,14,4,1,0,96
185069,1310947,1,14,5,2,0,98
185070,1310947,1,14,6,1,0,99
185071,1310947,1,15,1,1,0,100
185072,1310947,1,15,2,1,0,101
185073,1310947,1,15,3,1,0,102
185074,1310947,1,15,4,4,0,106
185075,1310947,1,15,5,0,0,106
185076,1310947,1,15,6,1,0,107
185077,1310947,1,16,1,4,0,111
185078,1310947,1,16,2,1,0,112
185079,1310947,1,16,3,0,0,112
185080,1310947,1,16,4,1,0,113
185081,1310947,1,16,5,1,0,114
185082,1310947,1,16,6,6,0,120
185083,1310947,1,17,1,0,0,120
185084,1310947,1,17,2,1,0,121
185085,1310947,1,17,3,1,0,122
185086,1310947,1,17,4,4,0,126
185087,1310947,1,17,5,0,0,126
185088,1310947,1,17,6,1,0,127
185089,1310947,1,18,1,2,0,129
185090,1310947,1,18,2,4,0,133
185091,1310947,1,18,3,1,0,134
185092,1310947,1,18,4,1,0,135
185093,1310947,1,18,5,1,0,136
185094,1310947,1,18,6,6,0,142
185095,1310947,1,19,1,0,0,142
185096,1310947,1,19,2,3,0,145
185097,1310947,1,19,3,6,0,151
185098,1310947,1,19,4,2,0,153
185099,1310947,1,19,5,2,0,155
185100,1310947,1,19,6,2,0,157
185101,1310947,1,20,1,2,1,159
185102,1310947,1,20,2,1,0,160
185103,1310947,1,20,3,1,0,161
185104,1310947,1,20,4,1,0,162
185105,1310947,1,20,5,6,0,168
185106,1310947,1,20,6,2,0,170
185227,1310948,1,1,1,0,0,0
185228,1310948,1,1,2,0,0,0
185229,1310948,1,1,3,4,0,4
185230,1310948,1,1,4,6,0,10
185231,1310948,1,1,5,0,0,10
185232,1310948,1,1,6,0,0,10
185233,1310948,1,2,1,1,0,11
185234,1310948,1,2,2,1,0,12
185235,1310948,1,2,3,0,0,12
185236,1310948,1,2,4,4,0,16
185237,1310948,1,2,5,0,0,16
185238,1310948,1,2,6,0,0,16
185239,1310948,1,3,1,0,0,16
185240,1310948,1,3,2,0,0,16
185241,1310948,1,3,3,1,0,17
185242,1310948,1,3,4,2,0,19
185243,1310948,1,3,5,4,0,23
185244,1310948,1,3,6,0,0,23
185245,1310948,1,4,1,0,1,23
185246,1310948,1,4,2,3,0,26
185247,1310948,1,4,3,0,0,26
185248,1310948,1,4,4,1,0,27
185249,1310948,1,4,5,1,0,28
185250,1310948,1,4,6,1,0,29
185251,1310948,1,5,1,0,0,29
185252,1310948,1,5,2,1,0,30
185253,1310948,1,5,3,4,0,34
185254,1310948,1,5,4,4,0,38
185255,1310948,1,5,5,0,0,38
185256,1310948,1,5,6,0,0,38
185257,1310948,1,6,1,4,0,42
185258,1310948,1,6,2,6,0,48
185259,1310948,1,6,3,1,0,49
185260,1310948,1,6,4,0,1,49
185261,1310948,1,6,5,1,0,50
185262,1310948,1,6,6,1,0,51
185263,1310948,1,7,1,1,0,52
185264,1310948,1,7,2,1,0,53
185265,1310948,1,7,3,0,0,53
185266,1310948,1,7,4,1,0,54
185267,1310948,1,7,5,1,0,55
185268,1310948,1,7,6,0,1,55
185269,1310948,1,8,1,2,0,57
185270,1310948,1,8,2,2,0,59
185271,1310948,1,8,3,0,0,59
185272,1310948,1,8,4,0,0,59
185273,1310948,1,8,5,0,0,59
185274,1310948,1,8,6,1,0,60
185275,1310948,1,9,1,4,0,64
185276,1310948,1,9,2,0,0,64
185277,1310948,1,9,3,0,1,64
185278,1310948,1,9,4,1,0,65
185279,1310948,1,9,5,1,0,66
185280,1310948,1,9,6,2,0,68
185281,1310948,1,10,1,1,0,69
185282,1310948,1,10,2,1,0,70
185283,1310948,1,10,3,1,0,71
185284,1310948,1,10,4,2,0,73
185285,1310948,1,10,5,0,0,73
185286,1310948,1,10,6,0,0,73
185287,1310948,1,11,1,2,0,75
185288,1310948,1,11,2,0,0,75
185289,1310948,1,11,3,0,0,75
185290,1310948,1,11,4,1,0,76
185291,1310948,1,11,5,1,0,77
185292,1310948,1,11,6,0,0,77
185293,1310948,1,12,1,0,0,77
185294,1310948,1,12,2,2,0,79
185295,1310948,1,12,3,1,0,80
185296,1310948,1,12,4,0,1,80
185297,1310948,1,12,5,1,0,81
185298,1310948,1,12,6,2,0,83
185299,1310948,1,13,1,1,0,84
185300,1310948,1,13,2,1,0,85
185301,1310948,1,13,3,0,0,85
185302,1310948,1,13,4,0,0,85
185303,1310948,1,13,5,0,0,85
185304,1310948,1,13,6,4,0,89
185305,1310948,1,14,1,0,0,89
185306,1310948,1,14,2,1,0,90
185307,1310948,1,14,3,0,0,90
185308,1310948,1,14,4,1,0,91
185309,1310948,1,14,5,1,0,92
185310,1310948,1,14,6,2,0,94
185311,1310948,1,15,1,0,0,94
185312,1310948,1,15,2,1,0,95
185313,1310948,1,15,3,0,0,95
185314,1310948,1,15,4,1,0,96
185315,1310948,1,15,5,1,0,97
185316,1310948,1,15,6,1,0,98
185317,1310948,1,16,1,0,0,98
185318,1310948,1,16,2,0,1,98
185319,1310948,1,16,3,0,0,98
185320,1310948,1,16,4,1,0,99
185321,1310948,1,16,5,1,0,100
185322,1310948,1,16,6,0,0,100
185323,1310948,1,17,1,1,0,101
185324,1310948,1,17,2,1,0,102
185325,1310948,1,17,3,0,0,102
185326,1310948,1,17,4,0,1,102
185327,1310948,1,17,5,1,0,103
185328,1310948,1,17,6,0,0,103
185329,1310948,1,18,1,1,0,104
185330,1310948,1,18,2,0,0,104
185331,1310948,1,18,3,1,0,105
185332,1310948,1,18,4,4,0,109
185333,1310948,1,18,5,0,0,109
185334,1310948,1,18,6,0,0,109
185335,1310948,1,19,1,0,0,109
185336,1310948,1,19,2,1,0,110
185337,1310948,1,19,3,4,0,114
185338,1310948,1,19,4,2,0,116
185339,1310948,1,19,5,1,1,117
185340,1310948,1,19,6,0,0,117
185341,1310948,1,20,1,0,0,117
185342,1310948,1,20,2,2,0,119
185343,1310948,1,20,3,0,0,119
185344,1310948,1,20,4,1,0,120
185345,1310948,1,20,5,1,0,121
185346,1310948,1,20,6,4,0,125
185467,1317150,1,1,1,0,0,0
185468,1317150,1,1,2,1,0,1
185469,1317150,1,1,3,4,0,5
185470,1317150,1,1,4,2,0,7
185471,1317150,1,1,5,6,0,13
185472,1317150,1,1,6,1,0,14
185473,1317150,1,2,1,4,0,18
185474,1317150,1,2,2,0,0,18
185475,1317150,1,2,3,0,0,18
185476,1317150,1,2,4,0,0,18
185477,1317150,1,2,5,0,1,18
185478,1317150,1,2,6,0,0,18
185479,1317150,1,3,1,0,0,18
185480,1317150,1,3,2,0,0,18
185481,1317150,1,3,3,0,0,18
185482,1317150,1,3,4,0,0,18
185483,1317150,1,3,5,4,0,22
185484,1317150,1,3,6,4,0,26
185485,1317150,1,4,1,0,0,26
185486,1317150,1,4,2,0,1,26
185487,1317150,1,4,3,0,0,26
185488,1317150,1,4,4,0,0,26
185489,1317150,1,4,5,1,0,27
185490,1317150,1,4,6,0,0,27
185491,1317150,1,5,1,0,0,27
185492,1317150,1,5,2,4,0,31
185493,1317150,1,5,3,4,0,35
185494,1317150,1,5,4,1,0,36
185495,1317150,1,5,5,2,0,38
185496,1317150,1,5,6,0,0,38
185497,1317150,1,6,1,1,0,39
185498,1317150,1,6,2,0,0,39
185499,1317150,1,6,3,0,0,39
185500,1317150,1,6,4,5,0,44
185501,1317150,1,6,5,0,0,44
185502,1317150,1,6,6,2,0,46
185503,1317150,1,7,1,1,0,47
185504,1317150,1,7,2,6,0,53
185505,1317150,1,7,3,2,0,55
185506,1317150,1,7,4,1,0,56
185507,1317150,1,7,5,0,0,56
185508,1317150,1,7,6,1,0,57
185509,1317150,1,8,1,1,0,58
185510,1317150,1,8,2,4,0,62
185511,1317150,1,8,3,0,0,62
185512,1317150,1,8,4,1,0,63
185513,1317150,1,8,5,3,0,66
185514,1317150,1,8,6,0,0,66
185515,1317150,1,9,1,1,0,67
185516,1317150,1,9,2,1,0,68
185517,1317150,1,9,3,2,0,70
185518,1317150,1,9,4,4,0,74
185519,1317150,1,9,5,0,0,74
185520,1317150,1,9,6,1,0,75
185521,1317150,1,10,1,0,0,75
185522,1317150,1,10,2,1,0,76
185523,1317150,1,10,3,1,0,77
185524,1317150,1,10,4,6,0,83
185525,1317150,1,10,5,1,0,84
185526,1317150,1,10,6,1,0,85
185527,1317150,1,11,1,4,0,89
185528,1317150,1,11,2,2,0,91
185529,1317150,1,11,3,1,0,92
185530,1317150,1,11,4,0,0,92
185531,1317150,1,11,5,1,0,93
185532,1317150,1,11,6,1,0,94
185533,1317150,1,12,1,0,0,94
185534,1317150,1,12,2,0,0,94
185535,1317150,1,12,3,3,0,97
185536,1317150,1,12,4,1,0,98
185537,1317150,1,12,5,1,0,99
185538,1317150,1,12,6,1,0,100
185539,1317150,1,13,1,0,0,100
185540,1317150,1,13,2,0,0,100
185541,1317150,1,13,3,0,1,100
185542,1317150,1,13,4,0,0,100
185543,1317150,1,13,5,0,0,100
185544,1317150,1,13,6,0,0,100
185545,1317150,1,14,1,1,0,101
185546,1317150,1,14,2,0,0,101
185547,1317150,1,14,3,1,0,102
185548,1317150,1,14,4,4,0,106
185549,1317150,1,14,5,1,0,107
185550,1317150,1,14,6,1,0,108
185551,1317150,1,15,1,3,0,111
185552,1317150,1,15,2,1,0,112
185553,1317150,1,15,3,1,0,113
185554,1317150,1,15,4,4,0,117
185555,1317150,1,15,5,1,0,118
185556,1317150,1,15,6,1,0,119
185557,1317150,1,16,1,6,0,125
185558,1317150,1,16,2,4,0,129
185559,1317150,1,16,3,6,0,135
185560,1317150,1,16,4,6,0,141
185561,1317150,1,16,5,1,0,142
185562,1317150,1,16,6,0,0,142
185563,1317150,1,17,1,6,0,148
185564,1317150,1,17,2,6,0,154
185565,1317150,1,17,3,2,0,156
185566,1317150,1,17,4,1,0,157
185567,1317150,1,17,5,2,0,159
185568,1317150,1,17,6,4,0,163
185569,1317150,1,18,1,0,1,163
185570,1317150,1,18,2,1,0,164
185571,1317150,1,18,3,0,0,164
185572,1317150,1,18,4,1,0,165
185573,1317150,1,18,5,0,0,165
185574,1317150,1,18,6,1,0,166
185575,1317150,1,19,1,0,0,166
185576,1317150,1,19,2,2,0,168
185577,1317150,1,19,3,2,0,170
185578,1317150,1,19,4,2,0,172
185579,1317150,1,19,5,1,0,173
185580,1317150,1,19,6,3,0,176
185581,1317150,1,20,1,0,1,176
185582,1317150,1,20,2,2,0,178
185583,1317150,1,20,3,6,0,184
185584,1317150,1,20,4,2,0,186
185585,1317150,1,20,5,1,0,187
185586,1317150,1,20,6,6,0,193
185707,1317151,1,1,1,1,0,1
185708,1317151,1,1,2,0,0,1
185709,1317151,1,1,3,3,0,4
185710,1317151,1,1,4,0,0,4
185711,1317151,1,1,5,1,0,5
185712,1317151,1,1,6,0,0,5
185713,1317151,1,2,1,3,0,8
185714,1317151,1,2,2,0,0,8
185715,1317151,1,2,3,2,0,10
185716,1317151,1,2,4,2,0,12
185717,1317151,1,2,5,2,0,14
185718,1317151,1,2,6,0,0,14
185719,1317151,1,3,1,0,0,14
185720,1317151,1,3,2,1,0,15
185721,1317151,1,3,3,1,0,16
185722,1317151,1,3,4,2,0,18
185723,1317151,1,3,5,4,0,22
185724,1317151,1,3,6,1,0,23
185725,1317151,1,4,1,1,0,24
185726,1317151,1,4,2,1,0,25
185727,1317151,1,4,3,4,0,29
185728,1317151,1,4,4,1,0,30
185729,1317151,1,4,5,1,0,31
185730,1317151,1,4,6,0,0,31
185731,1317151,1,5,1,4,0,35
185732,1317151,1,5,2,0,0,35
185733,1317151,1,5,3,0,1,35
185734,1317151,1,5,4,4,0,39
185735,1317151,1,5,5,1,0,40
185736,1317151,1,5,6,1,0,41
185737,1317151,1,6,1,0,0,41
185738,1317151,1,6,2,1,0,42
185739,1317151,1,6,3,0,1,42
185740,1317151,1,6,4,1,0,43
185741,1317151,1,6,5,1,0,44
185742,1317151,1,6,6,0,0,44
185743,1317151,1,7,1,0,0,44
185744,1317151,1,7,2,1,0,45
185745,1317151,1,7,3,0,0,45
185746,1317151,1,7,4,1,0,46
185747,1317151,1,7,5,0,0,46
185748,1317151,1,7,6,2,0,48
185749,1317151,1,8,1,1,0,49
185750,1317151,1,8,2,2,0,51
185751,1317151,1,8,3,0,0,51
185752,1317151,1,8,4,1,0,52
185753,1317151,1,8,5,2,0,54
185754,1317151,1,8,6,0,0,54
185755,1317151,1,9,1,4,0,58
185756,1317151,1,9,2,1,0,59
185757,1317151,1,9,3,0,0,59
185758,1317151,1,9,4,6,0,65
185759,1317151,1,9,5,2,0,67
185760,1317151,1,9,6,0,0,67
185761,1317151,1,10,1,1,0,68
185762,1317151,1,10,2,1,0,69
185763,1317151,1,10,3,1,0,70
185764,1317151,1,10,4,1,0,71
185765,1317151,1,10,5,1,0,72
185766,1317151,1,10,6,0,0,72
185767,1317151,1,11,1,1,0,73
185768,1317151,1,11,2,1,0,74
185769,1317151,1,11,3,0,0,74
185770,1317151,1,11,4,0,0,74
185771,1317151,1,11,5,1,0,75
185772,1317151,1,11,6,1,0,76
185773,1317151,1,12,1,0,0,76
185774,1317151,1,12,2,4,0,80
185775,1317151,1,12,3,7,0,87
185776,1317151,1,12,4,2,0,89
185777,1317151,1,12,5,6,0,95
185778,1317151,1,12,6,1,0,96
185779,1317151,1,13,1,1,0,97
185780,1317151,1,13,2,1,0,98
185781,1317151,1,13,3,0,0,98
185782,1317151,1,13,4,1,0,99
185783,1317151,1,13,5,0,1,99
185784,1317151,1,13,6,1,0,100
185785,1317151,1,14,1,0,0,100
185786,1317151,1,14,2,0,0,100
185787,1317151,1,14,3,0,0,100
185788,1317151,1,14,4,0,0,100
185789,1317151,1,14,5,1,0,101
185790,1317151,1,14,6,2,0,103
185791,1317151,1,15,1,6,0,109
185792,1317151,1,15,2,0,0,109
185793,1317151,1,15,3,1,0,110
185794,1317151,1,15,4,2,0,112
185795,1317151,1,15,5,0,0,112
185796,1317151,1,15,6,1,0,113
185797,1317151,1,16,1,4,0,117
185798,1317151,1,16,2,1,0,118
185799,1317151,1,16,3,0,0,118
185800,1317151,1,16,4,6,0,124
185801,1317151,1,16,5,4,0,128
185802,1317151,1,16,6,1,0,129
185803,1317151,1,17,1,2,0,131
185804,1317151,1,17,2,0,0,131
185805,1317151,1,17,3,1,0,132
185806,1317151,1,17,4,1,0,133
185807,1317151,1,17,5,2,0,135
185808,1317151,1,17,6,1,0,136
185809,1317151,1,18,1,1,0,137
185810,1317151,1,18,2,1,0,138
185811,1317151,1,18,3,5,0,143
185812,1317151,1,18,4,0,0,143
185813,1317151,1,18,5,1,0,144
185814,1317151,1,18,6,0,0,144
185815,1317151,1,19,1,4,0,148
185816,1317151,1,19,2,0,0,148
185817,1317151,1,19,3,0,1,148
185818,1317151,1,19,4,1,0,149
185819,1317151,1,19,5,1,1,150
185820,1317151,1,19,6,1,0,151
185821,1317151,1,20,1,1,0,152
185822,1317151,1,20,2,1,0,153
185823,1317151,1,20,3,1,0,154
185824,1317151,1,20,4,4,0,158
185825,1317151,1,20,5,4,0,162
185826,1317151,1,20,6,1,0,163
185937,1317482,1,1,1,0,0,0
185938,1317482,1,1,2,4,0,4
185939,1317482,1,1,3,1,0,5
185940,1317482,1,1,4,4,0,9
185941,1317482,1,1,5,5,0,14
185942,1317482,1,1,6,0,0,14
185943,1317482,1,2,1,0,1,14
185944,1317482,1,2,2,1,0,15
185945,1317482,1,2,3,0,0,15
185946,1317482,1,2,4,4,0,19
185947,1317482,1,2,5,4,0,23
185948,1317482,1,2,6,1,0,24
185949,1317482,1,3,1,0,0,24
185950,1317482,1,3,2,0,0,24
185951,1317482,1,3,3,1,0,25
185952,1317482,1,3,4,0,0,25
185953,1317482,1,3,5,0,0,25
185954,1317482,1,3,6,4,0,29
185955,1317482,1,4,1,0,0,29
185956,1317482,1,4,2,2,0,31
185957,1317482,1,4,3,6,0,37
185958,1317482,1,4,4,0,0,37
185959,1317482,1,4,5,1,0,38
185960,1317482,1,4,6,0,0,38
185961,1317482,1,5,1,1,0,39
185962,1317482,1,5,2,6,0,45
185963,1317482,1,5,3,0,0,45
185964,1317482,1,5,4,1,0,46
185965,1317482,1,5,5,0,0,46
185966,1317482,1,5,6,1,0,47
185967,1317482,1,6,1,1,0,48
185968,1317482,1,6,2,0,1,48
185969,1317482,1,6,3,1,0,49
185970,1317482,1,6,4,4,0,53
185971,1317482,1,6,5,0,0,53
185972,1317482,1,6,6,0,0,53
185973,1317482,1,7,1,1,0,54
185974,1317482,1,7,2,0,0,54
185975,1317482,1,7,3,1,0,55
185976,1317482,1,7,4,1,0,56
185977,1317482,1,7,5,0,0,56
185978,1317482,1,7,6,0,0,56
185979,1317482,1,8,1,1,0,57
185980,1317482,1,8,2,0,0,57
185981,1317482,1,8,3,1,0,58
185982,1317482,1,8,4,0,0,58
185983,1317482,1,8,5,2,0,60
185984,1317482,1,8,6,1,0,61
185985,1317482,1,9,1,1,0,62
185986,1317482,1,9,2,1,0,63
185987,1317482,1,9,3,0,0,63
185988,1317482,1,9,4,1,0,64
185989,1317482,1,9,5,1,0,65
185990,1317482,1,9,6,1,0,66
185991,1317482,1,10,1,0,1,66
185992,1317482,1,10,2,0,0,66
185993,1317482,1,10,3,1,0,67
185994,1317482,1,10,4,0,0,67
185995,1317482,1,10,5,1,0,68
185996,1317482,1,10,6,0,0,68
185997,1317482,1,11,1,1,0,69
185998,1317482,1,11,2,2,0,71
185999,1317482,1,11,3,2,0,73
186000,1317482,1,11,4,2,0,75
186001,1317482,1,11,5,0,1,75
186002,1317482,1,11,6,0,0,75
186003,1317482,1,12,1,0,0,75
186004,1317482,1,12,2,2,0,77
186005,1317482,1,12,3,1,0,78
186006,1317482,1,12,4,0,0,78
186007,1317482,1,12,5,1,0,79
186008,1317482,1,12,6,1,0,80
186009,1317482,1,13,1,1,0,81
186010,1317482,1,13,2,1,0,82
186011,1317482,1,13,3,1,0,83
186012,1317482,1,13,4,2,0,85
186013,1317482,1,13,5,0,0,85
186014,1317482,1,13,6,1,0,86
186015,1317482,1,14,1,1,0,87
186016,1317482,1,14,2,0,0,87
186017,1317482,1,14,3,0,0,87
186018,1317482,1,14,4,1,0,88
186019,1317482,1,14,5,0,0,88
186020,1317482,1,14,6,0,0,88
186021,1317482,1,15,1,0,1,88
186022,1317482,1,15,2,0,0,88
186023,1317482,1,15,3,0,0,88
186024,1317482,1,15,4,6,0,94
186025,1317482,1,15,5,0,0,94
186026,1317482,1,15,6,1,0,95
186027,1317482,1,16,1,6,0,101
186028,1317482,1,16,2,0,1,101
186029,1317482,1,16,3,1,0,102
186030,1317482,1,16,4,1,0,103
186031,1317482,1,16,5,2,0,105
186032,1317482,1,16,6,0,0,105
186033,1317482,1,17,1,1,0,106
186034,1317482,1,17,2,0,1,106
186035,1317482,1,17,3,2,0,108
186036,1317482,1,17,4,0,0,108
186037,1317482,1,17,5,1,0,109
186038,1317482,1,17,6,0,0,109
186039,1317482,1,18,1,6,0,115
186040,1317482,1,18,2,1,0,116
186041,1317482,1,18,3,4,0,120
186042,1317482,1,18,4,1,0,121
186043,1317482,1,18,5,1,0,122
186044,1317482,1,18,6,0,1,122
186045,1317482,1,19,1,6,0,128
186046,1317482,1,19,2,0,0,128
186047,1317482,1,19,3,4,0,132
186048,1317482,1,19,4,3,0,135
186049,1317482,1,19,5,4,0,139
186050,1317482,1,19,6,1,0,140
186051,1317482,1,20,1,3,0,143
186052,1317482,1,20,2,1,0,144
186053,1317482,1,20,3,0,0,144
186054,1317482,1,20,4,0,0,144
186055,1317482,1,20,5,1,0,145
186056,1317482,1,20,6,0,1,145
186176,1317483,1,1,1,0,0,0
186177,1317483,1,1,2,4,0,4
186178,1317483,1,1,3,4,0,8
186179,1317483,1,1,4,0,0,8
186180,1317483,1,1,5,0,0,8
186181,1317483,1,1,6,0,0,8
186182,1317483,1,2,1,1,0,9
186183,1317483,1,2,2,1,0,10
186184,1317483,1,2,3,0,0,10
186185,1317483,1,2,4,0,0,10
186186,1317483,1,2,5,0,1,10
186187,1317483,1,2,6,1,0,11
186188,1317483,1,3,1,1,0,12
186189,1317483,1,3,2,2,0,14
186190,1317483,1,3,3,4,0,18
186191,1317483,1,3,4,1,0,19
186192,1317483,1,3,5,2,0,21
186193,1317483,1,3,6,2,0,23
186194,1317483,1,4,1,1,0,24
186195,1317483,1,4,2,0,0,24
186196,1317483,1,4,3,1,0,25
186197,1317483,1,4,4,6,0,31
186198,1317483,1,4,5,0,0,31
186199,1317483,1,4,6,0,0,31
186200,1317483,1,5,1,0,0,31
186201,1317483,1,5,2,0,0,31
186202,1317483,1,5,3,0,0,31
186203,1317483,1,5,4,1,0,32
186204,1317483,1,5,5,0,0,32
186205,1317483,1,5,6,4,0,36
186206,1317483,1,6,1,1,0,37
186207,1317483,1,6,2,4,0,41
186208,1317483,1,6,3,0,0,41
186209,1317483,1,6,4,4,0,45
186210,1317483,1,6,5,0,0,45
186211,1317483,1,6,6,0,0,45
186212,1317483,1,7,1,1,0,46
186213,1317483,1,7,2,1,0,47
186214,1317483,1,7,3,1,0,48
186215,1317483,1,7,4,4,0,52
186216,1317483,1,7,5,1,0,53
186217,1317483,1,7,6,0,0,53
186218,1317483,1,8,1,0,0,53
186219,1317483,1,8,2,4,0,57
186220,1317483,1,8,3,2,0,59
186221,1317483,1,8,4,0,0,59
186222,1317483,1,8,5,1,0,60
186223,1317483,1,8,6,2,0,62
186224,1317483,1,9,1,6,0,68
186225,1317483,1,9,2,1,0,69
186226,1317483,1,9,3,1,0,70
186227,1317483,1,9,4,4,0,74
186228,1317483,1,9,5,1,0,75
186229,1317483,1,9,6,4,0,79
186230,1317483,1,10,1,0,0,79
186231,1317483,1,10,2,1,0,80
186232,1317483,1,10,3,1,0,81
186233,1317483,1,10,4,4,0,85
186234,1317483,1,10,5,1,0,86
186235,1317483,1,10,6,2,0,88
186236,1317483,1,11,1,6,0,94
186237,1317483,1,11,2,1,0,95
186238,1317483,1,11,3,0,1,95
186239,1317483,1,11,4,0,0,95
186240,1317483,1,11,5,0,0,95
186241,1317483,1,11,6,0,0,95
186242,1317483,1,12,1,1,1,96
186243,1317483,1,12,2,0,0,96
186244,1317483,1,12,3,0,0,96
186245,1317483,1,12,4,1,0,97
186246,1317483,1,12,5,0,0,97
186247,1317483,1,12,6,1,0,98
186248,1317483,1,13,1,1,0,99
186249,1317483,1,13,2,1,0,100
186250,1317483,1,13,3,0,1,100
186251,1317483,1,13,4,1,0,101
186252,1317483,1,13,5,1,0,102
186253,1317483,1,13,6,0,0,102
186254,1317483,1,14,1,1,0,103
186255,1317483,1,14,2,0,0,103
186256,1317483,1,14,3,2,0,105
186257,1317483,1,14,4,0,0,105
186258,1317483,1,14,5,2,0,107
186259,1317483,1,14,6,6,0,113
186260,1317483,1,15,1,4,0,117
186261,1317483,1,15,2,1,0,118
186262,1317483,1,15,3,0,0,118
186263,1317483,1,15,4,0,0,118
186264,1317483,1,15,5,1,0,119
186265,1317483,1,15,6,4,0,123
186266,1317483,1,16,1,4,0,127
186267,1317483,1,16,2,4,0,131
186268,1317483,1,16,3,0,0,131
186269,1317483,1,16,4,1,0,132
186270,1317483,1,16,5,3,0,135
186271,1317483,1,16,6,1,0,136
186272,1317483,1,17,1,4,0,140
186273,1317483,1,17,2,6,0,146
186274,1317483,1,17,3,6,0,152
186275,1317483,1,17,4,4,0,156
186276,1317483,1,17,5,0,1,156
186277,1317483,1,17,6,1,0,157
186278,1317483,1,18,1,0,0,157
186279,1317483,1,18,2,1,0,158
186280,1317483,1,18,3,2,0,160
186281,1317483,1,18,4,1,0,161
186282,1317483,1,18,5,0,0,161
186283,1317483,1,18,6,1,0,162
186284,1317483,1,19,1,2,0,164
186285,1317483,1,19,2,4,0,168
186286,1317483,1,19,3,0,0,168
186287,1317483,1,19,4,2,0,170
186288,1317483,1,19,5,0,0,170
186289,1317483,1,19,6,2,0,172
186290,1317483,1,20,1,0,1,172
186291,1317483,1,20,2,0,0,172
186292,1317483,1,20,3,1,0,173
186293,1317483,1,20,4,4,0,177
186294,1317483,1,20,5,1,0,178
186295,1317483,1,20,6,0,1,178
186416,1317486,1,1,1,0,0,0
186417,1317486,1,1,2,4,0,4
186418,1317486,1,1,3,4,0,8
186419,1317486,1,1,4,4,0,12
186420,1317486,1,1,5,0,0,12
186421,1317486,1,1,6,4,0,16
186422,1317486,1,2,1,0,0,16
186423,1317486,1,2,2,0,0,16
186424,1317486,1,2,3,0,0,16
186425,1317486,1,2,4,4,0,20
186426,1317486,1,2,5,1,0,21
186427,1317486,1,2,6,0,0,21
186428,1317486,1,3,1,0,0,21
186429,1317486,1,3,2,0,0,21
186430,1317486,1,3,3,6,0,27
186431,1317486,1,3,4,1,0,28
186432,1317486,1,3,5,0,0,28
186433,1317486,1,3,6,2,0,30
186434,1317486,1,4,1,1,0,31
186435,1317486,1,4,2,1,0,32
186436,1317486,1,4,3,1,0,33
186437,1317486,1,4,4,1,0,34
186438,1317486,1,4,5,1,0,35
186439,1317486,1,4,6,0,0,35
186440,1317486,1,5,1,4,0,39
186441,1317486,1,5,2,1,0,40
186442,1317486,1,5,3,0,0,40
186443,1317486,1,5,4,4,0,44
186444,1317486,1,5,5,6,0,50
186445,1317486,1,5,6,0,0,50
186446,1317486,1,6,1,4,0,54
186447,1317486,1,6,2,0,0,54
186448,1317486,1,6,3,1,0,55
186449,1317486,1,6,4,1,0,56
186450,1317486,1,6,5,1,0,57
186451,1317486,1,6,6,1,0,58
186452,1317486,1,7,1,6,0,64
186453,1317486,1,7,2,6,0,70
186454,1317486,1,7,3,1,0,71
186455,1317486,1,7,4,0,0,71
186456,1317486,1,7,5,0,0,71
186457,1317486,1,7,6,1,0,72
186458,1317486,1,8,1,4,0,76
186459,1317486,1,8,2,6,0,82
186460,1317486,1,8,3,7,0,89
186461,1317486,1,8,4,2,0,91
186462,1317486,1,8,5,1,0,92
186463,1317486,1,8,6,1,0,93
186464,1317486,1,9,1,1,0,94
186465,1317486,1,9,2,1,0,95
186466,1317486,1,9,3,0,0,95
186467,1317486,1,9,4,4,0,99
186468,1317486,1,9,5,1,0,100
186469,1317486,1,9,6,1,0,101
186470,1317486,1,10,1,4,0,105
186471,1317486,1,10,2,1,0,106
186472,1317486,1,10,3,6,0,112
186473,1317486,1,10,4,1,0,113
186474,1317486,1,10,5,1,0,114
186475,1317486,1,10,6,4,0,118
186476,1317486,1,11,1,4,0,122
186477,1317486,1,11,2,0,0,122
186478,1317486,1,11,3,4,0,126
186479,1317486,1,11,4,0,0,126
186480,1317486,1,11,5,1,0,127
186481,1317486,1,11,6,1,0,128
186482,1317486,1,12,1,4,0,132
186483,1317486,1,12,2,0,1,132
186484,1317486,1,12,3,1,0,133
186485,1317486,1,12,4,1,0,134
186486,1317486,1,12,5,0,0,134
186487,1317486,1,12,6,0,0,134
186488,1317486,1,13,1,0,0,134
186489,1317486,1,13,2,0,0,134
186490,1317486,1,13,3,4,0,138
186491,1317486,1,13,4,6,0,144
186492,1317486,1,13,5,4,0,148
186493,1317486,1,13,6,0,0,148
186494,1317486,1,14,1,2,0,150
186495,1317486,1,14,2,0,0,150
186496,1317486,1,14,3,1,0,151
186497,1317486,1,14,4,4,0,155
186498,1317486,1,14,5,4,0,159
186499,1317486,1,14,6,0,0,159
186500,1317486,1,15,1,1,0,160
186501,1317486,1,15,2,1,0,161
186502,1317486,1,15,3,4,0,165
186503,1317486,1,15,4,0,1,165
186504,1317486,1,15,5,1,0,166
186505,1317486,1,15,6,1,0,167
186506,1317486,1,16,1,0,0,167
186507,1317486,1,16,2,0,1,167
186508,1317486,1,16,3,1,0,168
186509,1317486,1,16,4,4,0,172
186510,1317486,1,16,5,0,0,172
186511,1317486,1,16,6,1,0,173
186512,1317486,1,17,1,0,0,173
186513,1317486,1,17,2,1,0,174
186514,1317486,1,17,3,1,0,175
186515,1317486,1,17,4,1,0,176
186516,1317486,1,17,5,1,0,177
186517,1317486,1,17,6,4,0,181
186518,1317486,1,18,1,2,0,183
186519,1317486,1,18,2,0,1,183
186520,1317486,1,18,3,1,0,184
186521,1317486,1,18,4,1,0,185
186522,1317486,1,18,5,1,0,186
186523,1317486,1,18,6,7,0,193
186524,1317486,1,19,1,0,0,193
186525,1317486,1,19,2,0,0,193
186526,1317486,1,19,3,0,1,193
186527,1317486,1,19,4,1,0,194
186528,1317486,1,19,5,0,0,194
186529,1317486,1,19,6,0,1,194
186530,1317486,1,20,1,1,0,195
186531,1317486,1,20,2,2,0,197
186532,1317486,1,20,3,4,0,201
186533,1317486,1,20,4,0,0,201
186534,1317486,1,20,5,6,0,207
186535,1317486,1,20,6,1,0,208
186656,1317487,1,1,1,4,0,4
186657,1317487,1,1,2,0,0,4
186658,1317487,1,1,3,1,0,5
186659,1317487,1,1,4,0,0,5
186660,1317487,1,1,5,0,0,5
186661,1317487,1,1,6,0,0,5
186662,1317487,1,2,1,0,0,5
186663,1317487,1,2,2,0,0,5
186664,1317487,1,2,3,0,0,5
186665,1317487,1,2,4,0,0,5
186666,1317487,1,2,5,3,0,8
186667,1317487,1,2,6,0,0,8
186668,1317487,1,3,1,0,0,8
186669,1317487,1,3,2,4,0,12
186670,1317487,1,3,3,4,0,16
186671,1317487,1,3,4,1,0,17
186672,1317487,1,3,5,0,0,17
186673,1317487,1,3,6,4,0,21
186674,1317487,1,4,1,0,1,21
186675,1317487,1,4,2,0,0,21
186676,1317487,1,4,3,0,0,21
186677,1317487,1,4,4,4,0,25
186678,1317487,1,4,5,0,0,25
186679,1317487,1,4,6,6,0,31
186680,1317487,1,5,1,0,1,31
186681,1317487,1,5,2,0,0,31
186682,1317487,1,5,3,1,0,32
186683,1317487,1,5,4,0,0,32
186684,1317487,1,5,5,1,0,33
186685,1317487,1,5,6,1,0,34
186686,1317487,1,6,1,0,0,34
186687,1317487,1,6,2,0,0,34
186688,1317487,1,6,3,1,0,35
186689,1317487,1,6,4,5,0,40
186690,1317487,1,6,5,0,0,40
186691,1317487,1,6,6,1,0,41
186692,1317487,1,7,1,1,0,42
186693,1317487,1,7,2,1,0,43
186694,1317487,1,7,3,1,0,44
186695,1317487,1,7,4,1,0,45
186696,1317487,1,7,5,1,0,46
186697,1317487,1,7,6,1,0,47
186698,1317487,1,8,1,1,0,48
186699,1317487,1,8,2,4,0,52
186700,1317487,1,8,3,1,0,53
186701,1317487,1,8,4,0,1,53
186702,1317487,1,8,5,1,0,54
186703,1317487,1,8,6,0,0,54
186704,1317487,1,9,1,0,1,54
186705,1317487,1,9,2,0,0,54
186706,1317487,1,9,3,1,0,55
186707,1317487,1,9,4,2,0,57
186708,1317487,1,9,5,1,0,58
186709,1317487,1,9,6,2,0,60
186710,1317487,1,10,1,1,0,61
186711,1317487,1,10,2,2,0,63
186712,1317487,1,10,3,1,0,64
186713,1317487,1,10,4,1,0,65
186714,1317487,1,10,5,4,0,69
186715,1317487,1,10,6,1,0,70
186716,1317487,1,11,1,4,0,74
186717,1317487,1,11,2,0,0,74
186718,1317487,1,11,3,0,0,74
186719,1317487,1,11,4,6,0,80
186720,1317487,1,11,5,1,0,81
186721,1317487,1,11,6,1,0,82
186722,1317487,1,12,1,0,0,82
186723,1317487,1,12,2,1,0,83
186724,1317487,1,12,3,1,0,84
186725,1317487,1,12,4,0,0,84
186726,1317487,1,12,5,4,0,88
186727,1317487,1,12,6,1,0,89
186728,1317487,1,13,1,4,0,93
186729,1317487,1,13,2,6,0,99
186730,1317487,1,13,3,1,0,100
186731,1317487,1,13,4,1,0,101
186732,1317487,1,13,5,1,0,102
186733,1317487,1,13,6,1,0,103
186734,1317487,1,14,1,1,0,104
186735,1317487,1,14,2,2,0,106
186736,1317487,1,14,3,1,0,107
186737,1317487,1,14,4,1,0,108
186738,1317487,1,14,5,3,0,111
186739,1317487,1,14,6,5,0,116
186740,1317487,1,15,1,1,0,117
186741,1317487,1,15,2,6,0,123
186742,1317487,1,15,3,1,0,124
186743,1317487,1,15,4,6,0,130
186744,1317487,1,15,5,0,0,130
186745,1317487,1,15,6,1,0,131
186746,1317487,1,16,1,0,0,131
186747,1317487,1,16,2,2,0,133
186748,1317487,1,16,3,5,0,138
186749,1317487,1,16,4,1,0,139
186750,1317487,1,16,5,1,0,140
186751,1317487,1,16,6,0,0,140
186752,1317487,1,17,1,0,0,140
186753,1317487,1,17,2,0,0,140
186754,1317487,1,17,3,2,0,142
186755,1317487,1,17,4,4,0,146
186756,1317487,1,17,5,0,1,146
186757,1317487,1,17,6,1,0,147
186758,1317487,1,18,1,1,0,148
186759,1317487,1,18,2,0,0,148
186760,1317487,1,18,3,1,0,149
186761,1317487,1,18,4,0,0,149
186762,1317487,1,18,5,0,0,149
186763,1317487,1,18,6,6,0,155
186764,1317487,1,19,1,0,0,155
186765,1317487,1,19,2,2,0,157
186766,1317487,1,19,3,1,0,158
186767,1317487,1,19,4,0,1,158
186768,1317487,1,19,5,1,0,159
186769,1317487,1,19,6,6,0,165
186770,1317487,1,20,1,1,0,166
186771,1317487,1,20,2,5,0,171
186772,1317487,1,20,3,0,1,171
186773,1317487,1,20,4,0,0,171
186774,1317487,1,20,5,1,0,172
186775,1317487,1,20,6,6,0,178
186896,1317903,1,1,1,0,0,0
186897,1317903,1,1,2,0,0,0
186898,1317903,1,1,3,1,0,1
186899,1317903,1,1,4,0,0,1
186900,1317903,1,1,5,4,0,5
186901,1317903,1,1,6,0,0,5
186902,1317903,1,2,1,6,0,11
186903,1317903,1,2,2,1,0,12
186904,1317903,1,2,3,4,0,16
186905,1317903,1,2,4,1,0,17
186906,1317903,1,2,5,1,0,18
186907,1317903,1,2,6,2,0,20
186908,1317903,1,3,1,0,0,20
186909,1317903,1,3,2,0,0,20
186910,1317903,1,3,3,0,0,20
186911,1317903,1,3,4,1,0,21
186912,1317903,1,3,5,0,0,21
186913,1317903,1,3,6,4,0,25
186914,1317903,1,4,1,2,0,27
186915,1317903,1,4,2,6,0,33
186916,1317903,1,4,3,4,0,37
186917,1317903,1,4,4,1,0,38
186918,1317903,1,4,5,1,0,39
186919,1317903,1,4,6,4,0,43
186920,1317903,1,5,1,0,0,43
186921,1317903,1,5,2,0,0,43
186922,1317903,1,5,3,1,0,44
186923,1317903,1,5,4,0,1,44
186924,1317903,1,5,5,0,0,44
186925,1317903,1,5,6,0,0,44
186926,1317903,1,6,1,0,0,44
186927,1317903,1,6,2,0,0,44
186928,1317903,1,6,3,1,0,45
186929,1317903,1,6,4,0,0,45
186930,1317903,1,6,5,0,1,45
186931,1317903,1,6,6,0,0,45
186932,1317903,1,7,1,0,0,45
186933,1317903,1,7,2,0,0,45
186934,1317903,1,7,3,1,0,46
186935,1317903,1,7,4,2,0,48
186936,1317903,1,7,5,1,0,49
186937,1317903,1,7,6,1,0,50
186938,1317903,1,8,1,0,0,50
186939,1317903,1,8,2,1,0,51
186940,1317903,1,8,3,2,0,53
186941,1317903,1,8,4,6,0,59
186942,1317903,1,8,5,1,0,60
186943,1317903,1,8,6,2,0,62
186944,1317903,1,9,1,1,0,63
186945,1317903,1,9,2,0,0,63
186946,1317903,1,9,3,1,0,64
186947,1317903,1,9,4,4,0,68
186948,1317903,1,9,5,1,0,69
186949,1317903,1,9,6,4,0,73
186950,1317903,1,10,1,2,0,75
186951,1317903,1,10,2,4,0,79
186952,1317903,1,10,3,1,0,80
186953,1317903,1,10,4,4,0,84
186954,1317903,1,10,5,4,0,88
186955,1317903,1,10,6,0,1,88
186956,1317903,1,11,1,0,0,88
186957,1317903,1,11,2,0,0,88
186958,1317903,1,11,3,1,0,89
186959,1317903,1,11,4,0,0,89
186960,1317903,1,11,5,1,0,90
186961,1317903,1,11,6,1,0,91
186962,1317903,1,12,1,2,0,93
186963,1317903,1,12,2,4,0,97
186964,1317903,1,12,3,4,0,101
186965,1317903,1,12,4,1,0,102
186966,1317903,1,12,5,0,1,102
186967,1317903,1,12,6,2,0,104
186968,1317903,1,13,1,1,0,105
186969,1317903,1,13,2,3,0,108
186970,1317903,1,13,3,0,0,108
186971,1317903,1,13,4,1,0,109
186972,1317903,1,13,5,4,0,113
186973,1317903,1,13,6,0,0,113
186974,1317903,1,14,1,1,0,114
186975,1317903,1,14,2,0,0,114
186976,1317903,1,14,3,1,0,115
186977,1317903,1,14,4,4,0,119
186978,1317903,1,14,5,1,0,120
186979,1317903,1,14,6,4,0,124
186980,1317903,1,15,1,0,0,124
186981,1317903,1,15,2,1,0,125
186982,1317903,1,15,3,1,0,126
186983,1317903,1,15,4,1,0,127
186984,1317903,1,15,5,0,1,127
186985,1317903,1,15,6,4,0,131
186986,1317903,1,16,1,0,0,131
186987,1317903,1,16,2,4,0,135
186988,1317903,1,16,3,1,0,136
186989,1317903,1,16,4,1,0,137
186990,1317903,1,16,5,1,0,138
186991,1317903,1,16,6,0,1,138
186992,1317903,1,17,1,1,0,139
186993,1317903,1,17,2,2,0,141
186994,1317903,1,17,3,1,0,142
186995,1317903,1,17,4,1,0,143
186996,1317903,1,17,5,1,0,144
186997,1317903,1,17,6,1,0,145
186998,1317903,1,18,1,1,0,146
186999,1317903,1,18,2,2,0,148
187000,1317903,1,18,3,2,0,150
187001,1317903,1,18,4,2,0,152
187002,1317903,1,18,5,1,0,153
187003,1317903,1,18,6,1,0,154
187004,1317903,1,19,1,1,0,155
187005,1317903,1,19,2,7,0,162
187006,1317903,1,19,3,1,0,163
187007,1317903,1,19,4,2,0,165
187008,1317903,1,19,5,6,0,171
187009,1317903,1,19,6,4,0,175
187010,1317903,1,20,1,1,0,176
187011,1317903,1,20,2,0,0,176
187012,1317903,1,20,3,6,0,182
187013,1317903,1,20,4,4,0,186
187014,1317903,1,20,5,0,0,186
187015,1317903,1,20,6,4,0,190
187136,1317904,1,1,1,0,1,0
187137,1317904,1,1,2,0,0,0
187138,1317904,1,1,3,0,0,0
187139,1317904,1,1,4,0,0,0
187140,1317904,1,1,5,0,0,0
187141,1317904,1,1,6,0,0,0
187142,1317904,1,2,1,0,0,0
187143,1317904,1,2,2,0,0,0
187144,1317904,1,2,3,6,0,6
187145,1317904,1,2,4,2,0,8
187146,1317904,1,2,5,3,0,11
187147,1317904,1,2,6,6,0,17
187148,1317904,1,3,1,0,1,17
187149,1317904,1,3,2,0,0,17
187150,1317904,1,3,3,6,0,23
187151,1317904,1,3,4,1,0,24
187152,1317904,1,3,5,0,0,24
187153,1317904,1,3,6,3,0,27
187154,1317904,1,4,1,1,0,28
187155,1317904,1,4,2,2,0,30
187156,1317904,1,4,3,2,0,32
187157,1317904,1,4,4,6,0,38
187158,1317904,1,4,5,2,0,40
187159,1317904,1,4,6,0,0,40
187160,1317904,1,5,1,0,0,40
187161,1317904,1,5,2,0,1,40
187162,1317904,1,5,3,4,0,44
187163,1317904,1,5,4,0,0,44
187164,1317904,1,5,5,4,0,48
187165,1317904,1,5,6,0,0,48
187166,1317904,1,6,1,0,0,48
187167,1317904,1,6,2,1,0,49
187168,1317904,1,6,3,6,0,55
187169,1317904,1,6,4,0,0,55
187170,1317904,1,6,5,0,0,55
187171,1317904,1,6,6,1,0,56
187172,1317904,1,7,1,1,0,57
187173,1317904,1,7,2,4,0,61
187174,1317904,1,7,3,0,1,61
187175,1317904,1,7,4,0,0,61
187176,1317904,1,7,5,1,0,62
187177,1317904,1,7,6,1,0,63
187178,1317904,1,8,1,0,0,63
187179,1317904,1,8,2,1,0,64
187180,1317904,1,8,3,0,0,64
187181,1317904,1,8,4,1,0,65
187182,1317904,1,8,5,1,0,66
187183,1317904,1,8,6,1,0,67
187184,1317904,1,9,1,0,0,67
187185,1317904,1,9,2,1,0,68
187186,1317904,1,9,3,0,0,68
187187,1317904,1,9,4,0,0,68
187188,1317904,1,9,5,1,0,69
187189,1317904,1,9,6,0,0,69
187190,1317904,1,10,1,1,0,70
187191,1317904,1,10,2,1,0,71
187192,1317904,1,10,3,1,0,72
187193,1317904,1,10,4,1,0,73
187194,1317904,1,10,5,1,0,74
187195,1317904,1,10,6,1,0,75
187196,1317904,1,11,1,6,0,81
187197,1317904,1,11,2,1,0,82
187198,1317904,1,11,3,0,0,82
187199,1317904,1,11,4,2,0,84
187200,1317904,1,11,5,0,0,84
187201,1317904,1,11,6,0,0,84
187202,1317904,1,12,1,1,0,85
187203,1317904,1,12,2,3,0,88
187204,1317904,1,12,3,6,0,94
187205,1317904,1,12,4,0,0,94
187206,1317904,1,12,5,1,0,95
187207,1317904,1,12,6,1,0,96
187208,1317904,1,13,1,0,0,96
187209,1317904,1,13,2,1,0,97
187210,1317904,1,13,3,2,0,99
187211,1317904,1,13,4,0,0,99
187212,1317904,1,13,5,1,0,100
187213,1317904,1,13,6,1,0,101
187214,1317904,1,14,1,2,0,103
187215,1317904,1,14,2,1,0,104
187216,1317904,1,14,3,0,0,104
187217,1317904,1,14,4,0,1,104
187218,1317904,1,14,5,0,0,104
187219,1317904,1,14,6,1,0,105
187220,1317904,1,15,1,1,0,106
187221,1317904,1,15,2,1,0,107
187222,1317904,1,15,3,0,0,107
187223,1317904,1,15,4,0,0,107
187224,1317904,1,15,5,1,0,108
187225,1317904,1,15,6,1,0,109
187226,1317904,1,16,1,1,0,110
187227,1317904,1,16,2,1,0,111
187228,1317904,1,16,3,0,0,111
187229,1317904,1,16,4,0,0,111
187230,1317904,1,16,5,0,0,111
187231,1317904,1,16,6,1,0,112
187232,1317904,1,17,1,1,0,113
187233,1317904,1,17,2,2,0,115
187234,1317904,1,17,3,0,1,115
187235,1317904,1,17,4,1,0,116
187236,1317904,1,17,5,1,0,117
187237,1317904,1,17,6,0,0,117
187238,1317904,1,18,1,0,0,117
187239,1317904,1,18,2,4,0,121
187240,1317904,1,18,3,1,0,122
187241,1317904,1,18,4,0,0,122
187242,1317904,1,18,5,1,0,123
187243,1317904,1,18,6,4,0,127
187244,1317904,1,19,1,0,1,127
187245,1317904,1,19,2,0,0,127
187246,1317904,1,19,3,1,0,128
187247,1317904,1,19,4,0,1,128
187248,1317904,1,19,5,1,0,129
187249,1317904,1,19,6,0,1,129
187250,1317904,1,20,1,6,0,135
187251,1317904,1,20,2,1,0,136
187252,1317904,1,20,3,2,0,138
187253,1317904,1,20,4,0,1,138
187370,1317905,1,1,1,0,0,0
187371,1317905,1,1,2,1,0,1
187372,1317905,1,1,3,0,0,1
187373,1317905,1,1,4,0,0,1
187374,1317905,1,1,5,0,0,1
187375,1317905,1,1,6,0,0,1
187376,1317905,1,2,1,0,0,1
187377,1317905,1,2,2,0,0,1
187378,1317905,1,2,3,2,0,3
187379,1317905,1,2,4,0,0,3
187380,1317905,1,2,5,4,0,7
187381,1317905,1,2,6,0,0,7
187382,1317905,1,3,1,0,0,7
187383,1317905,1,3,2,4,0,11
187384,1317905,1,3,3,6,0,17
187385,1317905,1,3,4,2,0,19
187386,1317905,1,3,5,1,0,20
187387,1317905,1,3,6,2,0,22
187388,1317905,1,4,1,2,0,24
187389,1317905,1,4,2,4,0,28
187390,1317905,1,4,3,0,0,28
187391,1317905,1,4,4,4,0,32
187392,1317905,1,4,5,0,0,32
187393,1317905,1,4,6,0,0,32
187394,1317905,1,5,1,1,0,33
187395,1317905,1,5,2,6,0,39
187396,1317905,1,5,3,0,0,39
187397,1317905,1,5,4,1,0,40
187398,1317905,1,5,5,1,0,41
187399,1317905,1,5,6,0,0,41
187400,1317905,1,6,1,0,0,41
187401,1317905,1,6,2,0,0,41
187402,1317905,1,6,3,0,0,41
187403,1317905,1,6,4,0,0,41
187404,1317905,1,6,5,4,0,45
187405,1317905,1,6,6,0,0,45
187406,1317905,1,7,1,4,0,49
187407,1317905,1,7,2,1,0,50
187408,1317905,1,7,3,4,0,54
187409,1317905,1,7,4,1,0,55
187410,1317905,1,7,5,0,0,55
187411,1317905,1,7,6,1,0,56
187412,1317905,1,8,1,1,0,57
187413,1317905,1,8,2,0,1,57
187414,1317905,1,8,3,1,0,58
187415,1317905,1,8,4,1,0,59
187416,1317905,1,8,5,1,0,60
187417,1317905,1,8,6,1,0,61
187418,1317905,1,9,1,1,0,62
187419,1317905,1,9,2,0,0,62
187420,1317905,1,9,3,0,0,62
187421,1317905,1,9,4,0,0,62
187422,1317905,1,9,5,1,0,63
187423,1317905,1,9,6,0,0,63
187424,1317905,1,10,1,0,0,63
187425,1317905,1,10,2,1,0,64
187426,1317905,1,10,3,0,0,64
187427,1317905,1,10,4,0,0,64
187428,1317905,1,10,5,0,0,64
187429,1317905,1,10,6,1,0,65
187430,1317905,1,11,1,1,0,66
187431,1317905,1,11,2,0,0,66
187432,1317905,1,11,3,4,0,70
187433,1317905,1,11,4,0,0,70
187434,1317905,1,11,5,0,0,70
187435,1317905,1,11,6,1,0,71
187436,1317905,1,12,1,0,0,71
187437,1317905,1,12,2,0,0,71
187438,1317905,1,12,3,0,0,71
187439,1317905,1,12,4,1,0,72
187440,1317905,1,12,5,4,0,76
187441,1317905,1,12,6,1,0,77
187442,1317905,1,13,1,0,0,77
187443,1317905,1,13,2,0,0,77
187444,1317905,1,13,3,6,0,83
187445,1317905,1,13,4,0,0,83
187446,1317905,1,13,5,0,0,83
187447,1317905,1,13,6,1,0,84
187448,1317905,1,14,1,2,0,86
187449,1317905,1,14,2,4,0,90
187450,1317905,1,14,3,1,0,91
187451,1317905,1,14,4,4,0,95
187452,1317905,1,14,5,4,0,99
187453,1317905,1,14,6,0,0,99
187454,1317905,1,15,1,6,0,105
187455,1317905,1,15,2,2,0,107
187456,1317905,1,15,3,0,0,107
187457,1317905,1,15,4,0,1,107
187458,1317905,1,15,5,0,0,107
187459,1317905,1,15,6,1,0,108
187460,1317905,1,16,1,1,0,109
187461,1317905,1,16,2,4,0,113
187462,1317905,1,16,3,1,0,114
187463,1317905,1,16,4,6,0,120
187464,1317905,1,16,5,1,0,121
187465,1317905,1,16,6,1,0,122
187466,1317905,1,17,1,6,0,128
187467,1317905,1,17,2,0,1,128
187468,1317905,1,17,3,1,0,129
187469,1317905,1,17,4,1,0,130
187470,1317905,1,17,5,1,0,131
187471,1317905,1,17,6,1,0,132
187472,1317905,1,18,1,1,0,133
187473,1317905,1,18,2,1,0,134
187474,1317905,1,18,3,1,0,135
187475,1317905,1,18,4,1,0,136
187476,1317905,1,18,5,0,0,136
187477,1317905,1,18,6,1,0,137
187478,1317905,1,19,1,2,0,139
187479,1317905,1,19,2,1,0,140
187480,1317905,1,19,3,1,0,141
187481,1317905,1,19,4,1,0,142
187482,1317905,1,19,5,6,0,148
187483,1317905,1,19,6,6,0,154
187484,1317905,1,20,1,4,0,158
187485,1317905,1,20,2,4,0,162
187486,1317905,1,20,3,0,1,162
187487,1317905,1,20,4,0,0,162
187488,1317905,1,20,5,1,1,163
187489,1317905,1,20,6,1,0,164
187604,1317906,1,1,1,0,0,0
187605,1317906,1,1,2,1,0,1
187606,1317906,1,1,3,1,0,2
187607,1317906,1,1,4,2,0,4
187608,1317906,1,1,5,4,0,8
187609,1317906,1,1,6,0,0,8
187610,1317906,1,2,1,0,0,8
187611,1317906,1,2,2,1,0,9
187612,1317906,1,2,3,0,0,9
187613,1317906,1,2,4,4,0,13
187614,1317906,1,2,5,1,0,14
187615,1317906,1,2,6,0,0,14
187616,1317906,1,3,1,7,0,21
187617,1317906,1,3,2,1,0,22
187618,1317906,1,3,3,6,0,28
187619,1317906,1,3,4,4,0,32
187620,1317906,1,3,5,1,0,33
187621,1317906,1,3,6,6,0,39
187622,1317906,1,4,1,1,0,40
187623,1317906,1,4,2,1,0,41
187624,1317906,1,4,3,1,0,42
187625,1317906,1,4,4,1,0,43
187626,1317906,1,4,5,2,0,45
187627,1317906,1,4,6,1,0,46
187628,1317906,1,5,1,1,0,47
187629,1317906,1,5,2,0,0,47
187630,1317906,1,5,3,6,0,53
187631,1317906,1,5,4,0,1,53
187632,1317906,1,5,5,0,0,53
187633,1317906,1,5,6,1,0,54
187634,1317906,1,6,1,1,0,55
187635,1317906,1,6,2,6,0,61
187636,1317906,1,6,3,0,1,61
187637,1317906,1,6,4,0,0,61
187638,1317906,1,6,5,4,0,65
187639,1317906,1,6,6,0,0,65
187640,1317906,1,7,1,1,0,66
187641,1317906,1,7,2,0,0,66
187642,1317906,1,7,3,0,0,66
187643,1317906,1,7,4,1,0,67
187644,1317906,1,7,5,0,0,67
187645,1317906,1,7,6,1,0,68
187646,1317906,1,8,1,0,0,68
187647,1317906,1,8,2,4,0,72
187648,1317906,1,8,3,1,0,73
187649,1317906,1,8,4,1,0,74
187650,1317906,1,8,5,2,0,76
187651,1317906,1,8,6,1,0,77
187652,1317906,1,9,1,1,0,78
187653,1317906,1,9,2,3,0,81
187654,1317906,1,9,3,0,0,81
187655,1317906,1,9,4,1,0,82
187656,1317906,1,9,5,1,0,83
187657,1317906,1,9,6,1,0,84
187658,1317906,1,10,1,1,0,85
187659,1317906,1,10,2,1,0,86
187660,1317906,1,10,3,4,0,90
187661,1317906,1,10,4,1,0,91
187662,1317906,1,10,5,4,0,95
187663,1317906,1,10,6,1,0,96
187664,1317906,1,11,1,1,0,97
187665,1317906,1,11,2,2,0,99
187666,1317906,1,11,3,4,0,103
187667,1317906,1,11,4,2,0,105
187668,1317906,1,11,5,1,0,106
187669,1317906,1,11,6,1,0,107
187670,1317906,1,12,1,0,0,107
187671,1317906,1,12,2,1,1,108
187672,1317906,1,12,3,0,0,108
187673,1317906,1,12,4,1,0,109
187674,1317906,1,12,5,1,0,110
187675,1317906,1,12,6,4,0,114
187676,1317906,1,13,1,1,0,115
187677,1317906,1,13,2,1,0,116
187678,1317906,1,13,3,4,0,120
187679,1317906,1,13,4,1,0,121
187680,1317906,1,13,5,1,0,122
187681,1317906,1,13,6,1,0,123
187682,1317906,1,14,1,1,0,124
187683,1317906,1,14,2,1,0,125
187684,1317906,1,14,3,5,0,130
187685,1317906,1,14,4,1,0,131
187686,1317906,1,14,5,1,0,132
187687,1317906,1,14,6,0,0,132
187688,1317906,1,15,1,6,0,138
187689,1317906,1,15,2,1,0,139
187690,1317906,1,15,3,2,0,141
187691,1317906,1,15,4,1,0,142
187692,1317906,1,15,5,4,0,146
187693,1317906,1,15,6,0,1,146
187694,1317906,1,16,1,1,0,147
187695,1317906,1,16,2,1,0,148
187696,1317906,1,16,3,1,0,149
187697,1317906,1,16,4,0,0,149
187698,1317906,1,16,5,1,0,150
187699,1317906,1,16,6,1,0,151
187700,1317906,1,17,1,0,0,151
187701,1317906,1,17,2,1,0,152
187702,1317906,1,17,3,1,0,153
187703,1317906,1,17,4,4,0,157
187704,1317906,1,17,5,1,0,158
187705,1317906,1,17,6,0,0,158
187706,1317906,1,18,1,1,0,159
187707,1317906,1,18,2,1,0,160
187708,1317906,1,18,3,1,0,161
187709,1317906,1,18,4,1,0,162
187710,1317906,1,18,5,1,0,163
187711,1317906,1,18,6,1,0,164
187712,1317906,1,19,1,0,1,164
187713,1317906,1,19,2,1,0,165
187714,1317906,1,19,3,1,0,166
187715,1317906,1,19,4,1,0,167
187716,1317906,1,19,5,6,0,173
187717,1317906,1,19,6,7,0,180
187718,1317906,1,20,1,1,0,181
187719,1317906,1,20,2,0,0,181
187720,1317906,1,20,3,3,0,184
187721,1317906,1,20,4,2,0,186
187722,1317906,1,20,5,1,0,187
187723,1317906,1,20,6,4,0,191
187839,1317907,1,1,1,0,0,0
187840,1317907,1,1,2,1,0,1
187841,1317907,1,1,3,0,0,1
187842,1317907,1,1,4,0,0,1
187843,1317907,1,1,5,4,0,5
187844,1317907,1,1,6,0,0,5
187845,1317907,1,2,1,1,0,6
187846,1317907,1,2,2,4,0,10
187847,1317907,1,2,3,1,0,11
187848,1317907,1,2,4,1,0,12
187849,1317907,1,2,5,1,0,13
187850,1317907,1,2,6,2,0,15
187851,1317907,1,3,1,1,0,16
187852,1317907,1,3,2,4,0,20
187853,1317907,1,3,3,4,0,24
187854,1317907,1,3,4,0,0,24
187855,1317907,1,3,5,1,0,25
187856,1317907,1,3,6,2,0,27
187857,1317907,1,4,1,1,0,28
187858,1317907,1,4,2,0,0,28
187859,1317907,1,4,3,6,0,34
187860,1317907,1,4,4,0,0,34
187861,1317907,1,4,5,2,0,36
187862,1317907,1,4,6,1,0,37
187863,1317907,1,5,1,1,0,38
187864,1317907,1,5,2,0,0,38
187865,1317907,1,5,3,0,1,38
187866,1317907,1,5,4,0,0,38
187867,1317907,1,5,5,0,0,38
187868,1317907,1,5,6,1,0,39
187869,1317907,1,6,1,0,0,39
187870,1317907,1,6,2,6,0,45
187871,1317907,1,6,3,1,0,46
187872,1317907,1,6,4,4,0,50
187873,1317907,1,6,5,2,0,52
187874,1317907,1,6,6,1,0,53
187875,1317907,1,7,1,4,0,57
187876,1317907,1,7,2,0,0,57
187877,1317907,1,7,3,1,0,58
187878,1317907,1,7,4,1,0,59
187879,1317907,1,7,5,1,0,60
187880,1317907,1,7,6,1,0,61
187881,1317907,1,8,1,1,0,62
187882,1317907,1,8,2,0,0,62
187883,1317907,1,8,3,1,0,63
187884,1317907,1,8,4,1,0,64
187885,1317907,1,8,5,6,0,70
187886,1317907,1,8,6,6,0,76
187887,1317907,1,9,1,6,0,82
187888,1317907,1,9,2,0,0,82
187889,1317907,1,9,3,1,0,83
187890,1317907,1,9,4,1,0,84
187891,1317907,1,9,5,1,0,85
187892,1317907,1,9,6,1,0,86
187893,1317907,1,10,1,1,0,87
187894,1317907,1,10,2,1,0,88
187895,1317907,1,10,3,1,0,89
187896,1317907,1,10,4,0,0,89
187897,1317907,1,10,5,1,0,90
187898,1317907,1,10,6,5,0,95
187899,1317907,1,11,1,4,0,99
187900,1317907,1,11,2,6,0,105
187901,1317907,1,11,3,1,0,106
187902,1317907,1,11,4,4,0,110
187903,1317907,1,11,5,1,0,111
187904,1317907,1,11,6,1,0,112
187905,1317907,1,12,1,1,0,113
187906,1317907,1,12,2,0,0,113
187907,1317907,1,12,3,1,0,114
187908,1317907,1,12,4,0,1,114
187909,1317907,1,12,5,1,0,115
187910,1317907,1,12,6,1,0,116
187911,1317907,1,13,1,4,0,120
187912,1317907,1,13,2,0,0,120
187913,1317907,1,13,3,1,0,121
187914,1317907,1,13,4,1,0,122
187915,1317907,1,13,5,0,0,122
187916,1317907,1,13,6,0,1,122
187917,1317907,1,14,1,0,0,122
187918,1317907,1,14,2,1,0,123
187919,1317907,1,14,3,4,0,127
187920,1317907,1,14,4,1,0,128
187921,1317907,1,14,5,4,0,132
187922,1317907,1,14,6,1,0,133
187923,1317907,1,15,1,1,0,134
187924,1317907,1,15,2,0,0,134
187925,1317907,1,15,3,1,0,135
187926,1317907,1,15,4,0,0,135
187927,1317907,1,15,5,4,0,139
187928,1317907,1,15,6,2,0,141
187929,1317907,1,16,1,1,0,142
187930,1317907,1,16,2,0,1,142
187931,1317907,1,16,3,1,0,143
187932,1317907,1,16,4,1,0,144
187933,1317907,1,16,5,1,0,145
187934,1317907,1,16,6,1,0,146
187935,1317907,1,17,1,4,0,150
187936,1317907,1,17,2,0,0,150
187937,1317907,1,17,3,4,0,154
187938,1317907,1,17,4,2,0,156
187939,1317907,1,17,5,0,0,156
187940,1317907,1,17,6,0,0,156
187941,1317907,1,18,1,1,0,157
187942,1317907,1,18,2,1,1,158
187943,1317907,1,18,3,1,0,159
187944,1317907,1,18,4,1,0,160
187945,1317907,1,18,5,1,0,161
187946,1317907,1,18,6,1,0,162
187947,1317907,1,19,1,0,0,162
187948,1317907,1,19,2,0,0,162
187949,1317907,1,19,3,6,0,168
187950,1317907,1,19,4,4,0,172
187951,1317907,1,19,5,6,0,178
187952,1317907,1,19,6,3,0,181
187953,1317907,1,20,1,0,1,181
187954,1317907,1,20,2,6,0,187
187955,1317907,1,20,3,0,0,187
187956,1317907,1,20,4,0,1,187
187957,1317907,1,20,5,0,0,187
187958,1317907,1,20,6,1,0,188
188053,1317908,1,1,1,0,0,0
188054,1317908,1,1,2,0,0,0
188055,1317908,1,1,3,1,0,1
188056,1317908,1,1,4,0,0,1
188057,1317908,1,1,5,0,0,1
188058,1317908,1,1,6,7,0,8
188059,1317908,1,2,1,1,0,9
188060,1317908,1,2,2,0,0,9
188061,1317908,1,2,3,0,0,9
188062,1317908,1,2,4,2,0,11
188063,1317908,1,2,5,0,0,11
188064,1317908,1,2,6,4,0,15
188065,1317908,1,3,1,2,0,17
188066,1317908,1,3,2,1,0,18
188067,1317908,1,3,3,4,0,22
188068,1317908,1,3,4,2,0,24
188069,1317908,1,3,5,1,0,25
188070,1317908,1,3,6,0,0,25
188071,1317908,1,4,1,0,0,25
188072,1317908,1,4,2,0,0,25
188073,1317908,1,4,3,4,0,29
188074,1317908,1,4,4,1,0,30
188075,1317908,1,4,5,0,0,30
188076,1317908,1,4,6,0,0,30
188077,1317908,1,5,1,1,0,31
188078,1317908,1,5,2,6,0,37
188079,1317908,1,5,3,0,0,37
188080,1317908,1,5,4,1,0,38
188081,1317908,1,5,5,0,0,38
188082,1317908,1,5,6,0,0,38
188083,1317908,1,6,1,1,0,39
188084,1317908,1,6,2,2,0,41
188085,1317908,1,6,3,2,0,43
188086,1317908,1,6,4,2,0,45
188087,1317908,1,6,5,6,0,51
188088,1317908,1,6,6,1,0,52
188089,1317908,1,7,1,1,0,53
188090,1317908,1,7,2,1,0,54
188091,1317908,1,7,3,0,0,54
188092,1317908,1,7,4,4,0,58
188093,1317908,1,7,5,0,0,58
188094,1317908,1,7,6,0,0,58
188095,1317908,1,8,1,4,0,62
188096,1317908,1,8,2,0,0,62
188097,1317908,1,8,3,0,1,62
188098,1317908,1,8,4,0,1,62
188099,1317908,1,8,5,2,0,64
188100,1317908,1,8,6,4,0,68
188101,1317908,1,9,1,1,0,69
188102,1317908,1,9,2,0,0,69
188103,1317908,1,9,3,1,0,70
188104,1317908,1,9,4,1,0,71
188105,1317908,1,9,5,0,0,71
188106,1317908,1,9,6,1,0,72
188107,1317908,1,10,1,1,0,73
188108,1317908,1,10,2,4,0,77
188109,1317908,1,10,3,0,0,77
188110,1317908,1,10,4,1,0,78
188111,1317908,1,10,5,0,0,78
188112,1317908,1,10,6,0,0,78
188113,1317908,1,11,1,6,0,84
188114,1317908,1,11,2,1,0,85
188115,1317908,1,11,3,1,0,86
188116,1317908,1,11,4,1,0,87
188117,1317908,1,11,5,1,0,88
188118,1317908,1,11,6,3,0,91
188119,1317908,1,12,1,4,0,95
188120,1317908,1,12,2,0,0,95
188121,1317908,1,12,3,1,0,96
188122,1317908,1,12,4,1,0,97
188123,1317908,1,12,5,1,0,98
188124,1317908,1,12,6,0,1,98
188125,1317908,1,13,1,1,0,99
188126,1317908,1,13,2,1,0,100
188127,1317908,1,13,3,1,0,101
188128,1317908,1,13,4,1,0,102
188129,1317908,1,13,5,1,0,103
188130,1317908,1,13,6,1,0,104
188131,1317908,1,14,1,0,0,104
188132,1317908,1,14,2,1,0,105
188133,1317908,1,14,3,1,0,106
188134,1317908,1,14,4,1,0,107
188135,1317908,1,14,5,0,0,107
188136,1317908,1,14,6,2,0,109
188137,1317908,1,15,1,2,0,111
188138,1317908,1,15,2,1,0,112
188139,1317908,1,15,3,0,0,112
188140,1317908,1,15,4,2,0,114
188141,1317908,1,15,5,1,0,115
188142,1317908,1,15,6,6,0,121
188143,1317908,1,16,1,1,0,122
188144,1317908,1,16,2,4,0,126
188145,1317908,1,16,3,4,0,130
188146,1317908,1,16,4,0,0,130
188147,1317908,1,16,5,6,0,136
188148,1317908,1,16,6,1,0,137
188149,1317908,1,17,1,1,0,138
188150,1317908,1,17,2,6,0,144
188151,1317908,1,17,3,0,1,144
188152,1317908,1,17,4,1,0,145
188153,1317908,1,17,5,1,0,146
188154,1317908,1,17,6,1,0,147
188155,1317908,1,18,1,1,0,148
188156,1317908,1,18,2,1,0,149
188157,1317908,1,18,3,0,1,149
188158,1317908,1,18,4,1,0,150
188159,1317908,1,18,5,1,0,151
188160,1317908,1,18,6,0,0,151
188161,1317908,1,19,1,2,0,153
188162,1317908,1,19,2,1,0,154
188163,1317908,1,19,3,0,0,154
188164,1317908,1,19,4,0,0,154
188165,1317908,1,19,5,6,0,160
188166,1317908,1,19,6,2,0,162
188167,1317908,1,20,1,7,0,169
188168,1317908,1,20,2,2,0,171
188169,1317908,1,20,3,2,0,173
188170,1317908,1,20,4,4,0,177
188171,1317908,1,20,5,4,0,181
188172,1317908,1,20,6,4,0,185
188293,1317909,1,1,1,1,0,1
188294,1317909,1,1,2,0,0,1
188295,1317909,1,1,3,0,0,1
188296,1317909,1,1,4,1,0,2
188297,1317909,1,1,5,1,0,3
188298,1317909,1,1,6,1,0,4
188299,1317909,1,2,1,0,0,4
188300,1317909,1,2,2,1,0,5
188301,1317909,1,2,3,4,0,9
188302,1317909,1,2,4,3,0,12
188303,1317909,1,2,5,0,0,12
188304,1317909,1,2,6,1,0,13
188305,1317909,1,3,1,6,0,19
188306,1317909,1,3,2,1,0,20
188307,1317909,1,3,3,4,0,24
188308,1317909,1,3,4,0,0,24
188309,1317909,1,3,5,2,0,26
188310,1317909,1,3,6,1,0,27
188311,1317909,1,4,1,0,0,27
188312,1317909,1,4,2,4,0,31
188313,1317909,1,4,3,0,1,31
188314,1317909,1,4,4,1,0,32
188315,1317909,1,4,5,4,0,36
188316,1317909,1,4,6,0,1,36
188317,1317909,1,5,1,0,0,36
188318,1317909,1,5,2,0,0,36
188319,1317909,1,5,3,1,0,37
188320,1317909,1,5,4,0,0,37
188321,1317909,1,5,5,2,0,39
188322,1317909,1,5,6,0,0,39
188323,1317909,1,6,1,2,0,41
188324,1317909,1,6,2,0,0,41
188325,1317909,1,6,3,1,0,42
188326,1317909,1,6,4,1,0,43
188327,1317909,1,6,5,0,0,43
188328,1317909,1,6,6,0,0,43
188329,1317909,1,7,1,0,0,43
188330,1317909,1,7,2,0,0,43
188331,1317909,1,7,3,1,0,44
188332,1317909,1,7,4,0,0,44
188333,1317909,1,7,5,1,0,45
188334,1317909,1,7,6,1,0,46
188335,1317909,1,8,1,2,0,48
188336,1317909,1,8,2,1,0,49
188337,1317909,1,8,3,0,0,49
188338,1317909,1,8,4,1,0,50
188339,1317909,1,8,5,1,0,51
188340,1317909,1,8,6,6,0,57
188341,1317909,1,9,1,1,0,58
188342,1317909,1,9,2,4,0,62
188343,1317909,1,9,3,4,0,66
188344,1317909,1,9,4,2,0,68
188345,1317909,1,9,5,1,0,69
188346,1317909,1,9,6,4,0,73
188347,1317909,1,10,1,2,0,75
188348,1317909,1,10,2,2,0,77
188349,1317909,1,10,3,6,0,83
188350,1317909,1,10,4,1,0,84
188351,1317909,1,10,5,1,0,85
188352,1317909,1,10,6,0,0,85
188353,1317909,1,11,1,2,0,87
188354,1317909,1,11,2,1,0,88
188355,1317909,1,11,3,6,0,94
188356,1317909,1,11,4,4,0,98
188357,1317909,1,11,5,1,0,99
188358,1317909,1,11,6,6,0,105
188359,1317909,1,12,1,0,0,105
188360,1317909,1,12,2,1,0,106
188361,1317909,1,12,3,1,0,107
188362,1317909,1,12,4,0,1,107
188363,1317909,1,12,5,0,0,107
188364,1317909,1,12,6,4,0,111
188365,1317909,1,13,1,1,0,112
188366,1317909,1,13,2,2,0,114
188367,1317909,1,13,3,1,0,115
188368,1317909,1,13,4,0,0,115
188369,1317909,1,13,5,4,0,119
188370,1317909,1,13,6,0,0,119
188371,1317909,1,14,1,2,0,121
188372,1317909,1,14,2,5,0,126
188373,1317909,1,14,3,1,0,127
188374,1317909,1,14,4,6,0,133
188375,1317909,1,14,5,1,0,134
188376,1317909,1,14,6,1,0,135
188377,1317909,1,15,1,6,0,141
188378,1317909,1,15,2,1,0,142
188379,1317909,1,15,3,0,0,142
188380,1317909,1,15,4,6,0,148
188381,1317909,1,15,5,1,0,149
188382,1317909,1,15,6,2,0,151
188383,1317909,1,16,1,4,0,155
188384,1317909,1,16,2,1,0,156
188385,1317909,1,16,3,6,0,162
188386,1317909,1,16,4,1,0,163
188387,1317909,1,16,5,1,0,164
188388,1317909,1,16,6,2,0,166
188389,1317909,1,17,1,6,0,172
188390,1317909,1,17,2,1,0,173
188391,1317909,1,17,3,7,0,180
188392,1317909,1,17,4,1,0,181
188393,1317909,1,17,5,2,0,183
188394,1317909,1,17,6,1,0,184
188395,1317909,1,18,1,6,0,190
188396,1317909,1,18,2,0,1,190
188397,1317909,1,18,3,0,0,190
188398,1317909,1,18,4,0,0,190
188399,1317909,1,18,5,1,0,191
188400,1317909,1,18,6,6,0,197
188401,1317909,1,19,1,4,0,201
188402,1317909,1,19,2,1,0,202
188403,1317909,1,19,3,1,0,203
188404,1317909,1,19,4,1,0,204
188405,1317909,1,19,5,1,0,205
188406,1317909,1,19,6,2,0,207
188407,1317909,1,20,1,1,0,208
188408,1317909,1,20,2,0,1,208
188409,1317909,1,20,3,1,0,209
188410,1317909,1,20,4,1,0,210
188411,1317909,1,20,5,4,0,214
188412,1317909,1,20,6,1,0,215
188533,1317910,1,1,1,0,0,0
188534,1317910,1,1,2,1,0,1
188535,1317910,1,1,3,0,0,1
188536,1317910,1,1,4,1,0,2
188537,1317910,1,1,5,0,0,2
188538,1317910,1,1,6,1,0,3
188539,1317910,1,2,1,1,0,4
188540,1317910,1,2,2,1,0,5
188541,1317910,1,2,3,0,0,5
188542,1317910,1,2,4,4,0,9
188543,1317910,1,2,5,2,0,11
188544,1317910,1,2,6,0,0,11
188545,1317910,1,3,1,1,0,12
188546,1317910,1,3,2,0,0,12
188547,1317910,1,3,3,0,0,12
188548,1317910,1,3,4,6,0,18
188549,1317910,1,3,5,0,1,18
188550,1317910,1,3,6,4,0,22
188551,1317910,1,4,1,1,0,23
188552,1317910,1,4,2,0,0,23
188553,1317910,1,4,3,1,0,24
188554,1317910,1,4,4,0,0,24
188555,1317910,1,4,5,1,0,25
188556,1317910,1,4,6,1,0,26
188557,1317910,1,5,1,4,0,30
188558,1317910,1,5,2,1,0,31
188559,1317910,1,5,3,1,0,32
188560,1317910,1,5,4,1,0,33
188561,1317910,1,5,5,1,0,34
188562,1317910,1,5,6,0,0,34
188563,1317910,1,6,1,6,0,40
188564,1317910,1,6,2,4,0,44
188565,1317910,1,6,3,1,0,45
188566,1317910,1,6,4,0,0,45
188567,1317910,1,6,5,1,0,46
188568,1317910,1,6,6,1,0,47
188569,1317910,1,7,1,1,0,48
188570,1317910,1,7,2,0,1,48
188571,1317910,1,7,3,0,0,48
188572,1317910,1,7,4,0,0,48
188573,1317910,1,7,5,0,0,48
188574,1317910,1,7,6,1,0,49
188575,1317910,1,8,1,0,0,49
188576,1317910,1,8,2,4,0,53
188577,1317910,1,8,3,1,0,54
188578,1317910,1,8,4,1,0,55
188579,1317910,1,8,5,1,0,56
188580,1317910,1,8,6,0,0,56
188581,1317910,1,9,1,0,0,56
188582,1317910,1,9,2,1,0,57
188583,1317910,1,9,3,0,1,57
188584,1317910,1,9,4,1,0,58
188585,1317910,1,9,5,1,0,59
188586,1317910,1,9,6,0,0,59
188587,1317910,1,10,1,0,0,59
188588,1317910,1,10,2,0,0,59
188589,1317910,1,10,3,1,0,60
188590,1317910,1,10,4,0,0,60
188591,1317910,1,10,5,0,0,60
188592,1317910,1,10,6,4,0,64
188593,1317910,1,11,1,4,0,68
188594,1317910,1,11,2,0,0,68
188595,1317910,1,11,3,1,0,69
188596,1317910,1,11,4,4,0,73
188597,1317910,1,11,5,1,0,74
188598,1317910,1,11,6,3,0,77
188599,1317910,1,12,1,1,0,78
188600,1317910,1,12,2,4,0,82
188601,1317910,1,12,3,0,0,82
188602,1317910,1,12,4,1,0,83
188603,1317910,1,12,5,1,0,84
188604,1317910,1,12,6,1,0,85
188605,1317910,1,13,1,1,0,86
188606,1317910,1,13,2,1,0,87
188607,1317910,1,13,3,1,0,88
188608,1317910,1,13,4,1,0,89
188609,1317910,1,13,5,1,0,90
188610,1317910,1,13,6,0,0,90
188611,1317910,1,14,1,1,0,91
188612,1317910,1,14,2,1,0,92
188613,1317910,1,14,3,4,0,96
188614,1317910,1,14,4,6,0,102
188615,1317910,1,14,5,1,0,103
188616,1317910,1,14,6,1,0,104
188617,1317910,1,15,1,0,0,104
188618,1317910,1,15,2,0,1,104
188619,1317910,1,15,3,0,0,104
188620,1317910,1,15,4,1,0,105
188621,1317910,1,15,5,0,0,105
188622,1317910,1,15,6,1,0,106
188623,1317910,1,16,1,1,0,107
188624,1317910,1,16,2,1,0,108
188625,1317910,1,16,3,6,0,114
188626,1317910,1,16,4,1,0,115
188627,1317910,1,16,5,0,0,115
188628,1317910,1,16,6,1,0,116
188629,1317910,1,17,1,2,0,118
188630,1317910,1,17,2,1,0,119
188631,1317910,1,17,3,0,0,119
188632,1317910,1,17,4,1,0,120
188633,1317910,1,17,5,1,0,121
188634,1317910,1,17,6,0,1,121
188635,1317910,1,18,1,1,0,122
188636,1317910,1,18,2,1,0,123
188637,1317910,1,18,3,0,0,123
188638,1317910,1,18,4,1,0,124
188639,1317910,1,18,5,1,0,125
188640,1317910,1,18,6,1,0,126
188641,1317910,1,19,1,2,0,128
188642,1317910,1,19,2,1,0,129
188643,1317910,1,19,3,1,0,130
188644,1317910,1,19,4,1,0,131
188645,1317910,1,19,5,3,0,134
188646,1317910,1,19,6,2,0,136
188647,1317910,1,20,1,0,1,136
188648,1317910,1,20,2,0,0,136
188649,1317910,1,20,3,3,0,139
188650,1317910,1,20,4,0,1,139
188651,1317910,1,20,5,4,0,143
188652,1317910,1,20,6,2,0,145
188767,1321484,1,1,1,2,0,2
188768,1321484,1,1,2,4,0,6
188769,1321484,1,1,3,1,0,7
188770,1321484,1,1,4,0,0,7
188771,1321484,1,1,5,4,0,11
188772,1321484,1,1,6,1,0,12
188773,1321484,1,2,1,0,0,12
188774,1321484,1,2,2,1,0,13
188775,1321484,1,2,3,0,0,13
188776,1321484,1,2,4,6,0,19
188777,1321484,1,2,5,1,0,20
188778,1321484,1,2,6,4,0,24
188779,1321484,1,3,1,1,0,25
188780,1321484,1,3,2,4,0,29
188781,1321484,1,3,3,1,0,30
188782,1321484,1,3,4,0,0,30
188783,1321484,1,3,5,0,1,30
188784,1321484,1,3,6,0,0,30
188785,1321484,1,4,1,6,0,36
188786,1321484,1,4,2,1,0,37
188787,1321484,1,4,3,0,0,37
188788,1321484,1,4,4,1,0,38
188789,1321484,1,4,5,0,0,38
188790,1321484,1,4,6,1,0,39
188791,1321484,1,5,1,0,0,39
188792,1321484,1,5,2,2,0,41
188793,1321484,1,5,3,1,0,42
188794,1321484,1,5,4,0,1,42
188795,1321484,1,5,5,4,0,46
188796,1321484,1,5,6,0,0,46
188797,1321484,1,5,7,1,0,47
188798,1321484,1,6,2,1,0,48
188799,1321484,1,6,3,1,0,49
188800,1321484,1,6,4,1,0,50
188801,1321484,1,6,5,1,0,51
188802,1321484,1,6,6,1,0,52
188803,1321484,1,6,7,0,0,52
188804,1321484,1,7,2,0,0,52
188805,1321484,1,7,3,0,0,52
188806,1321484,1,7,4,1,0,53
188807,1321484,1,7,5,0,0,53
188808,1321484,1,7,6,1,0,54
188809,1321484,1,7,7,0,1,54
188810,1321484,1,8,2,1,0,55
188811,1321484,1,8,3,1,0,56
188812,1321484,1,8,4,4,0,60
188813,1321484,1,8,5,2,0,62
188814,1321484,1,8,6,4,0,66
188815,1321484,1,8,7,1,0,67
188816,1321484,1,9,2,1,0,68
188817,1321484,1,9,3,1,0,69
188818,1321484,1,9,4,1,0,70
188819,1321484,1,9,5,2,0,72
188820,1321484,1,9,6,4,0,76
188821,1321484,1,9,7,0,0,76
188822,1321484,1,10,2,0,0,76
188823,1321484,1,10,3,0,0,76
188824,1321484,1,10,4,0,0,76
188825,1321484,1,10,5,0,0,76
188826,1321484,1,10,6,1,0,77
188827,1321484,1,10,7,1,0,78
188828,1321484,1,11,2,2,0,80
188829,1321484,1,11,3,0,0,80
188830,1321484,1,11,4,0,0,80
188831,1321484,1,11,5,1,0,81
188832,1321484,1,11,6,2,0,83
188833,1321484,1,11,7,2,0,85
188834,1321484,1,12,2,1,0,86
188835,1321484,1,12,3,6,0,92
188836,1321484,1,12,4,1,0,93
188837,1321484,1,12,5,0,1,93
188838,1321484,1,12,6,1,0,94
188839,1321484,1,12,7,4,0,98
188840,1321484,1,13,2,0,0,98
188841,1321484,1,13,3,0,1,98
188842,1321484,1,13,4,0,1,98
188843,1321484,1,13,5,0,0,98
188844,1321484,1,13,6,0,0,98
188845,1321484,1,13,7,0,0,98
188846,1321484,1,14,2,1,0,99
188847,1321484,1,14,3,1,0,100
188848,1321484,1,14,4,0,0,100
188849,1321484,1,14,5,1,0,101
188850,1321484,1,14,6,1,0,102
188851,1321484,1,14,7,1,0,103
188852,1321484,1,15,2,1,0,104
188853,1321484,1,15,3,1,0,105
188854,1321484,1,15,4,1,0,106
188855,1321484,1,15,5,0,0,106
188856,1321484,1,15,6,2,0,108
188857,1321484,1,15,7,1,0,109
188858,1321484,1,16,2,0,0,109
188859,1321484,1,16,3,0,0,109
188860,1321484,1,16,4,1,0,110
188861,1321484,1,16,5,1,0,111
188862,1321484,1,16,6,0,1,111
188863,1321484,1,16,7,0,0,111
188864,1321484,1,17,2,4,0,115
188865,1321484,1,17,3,0,0,115
188866,1321484,1,17,4,1,0,116
188867,1321484,1,17,5,0,0,116
188868,1321484,1,17,6,1,0,117
188869,1321484,1,17,7,4,0,121
188870,1321484,1,18,2,1,1,122
188871,1321484,1,18,3,1,0,123
188872,1321484,1,18,4,2,0,125
188873,1321484,1,18,5,1,0,126
188874,1321484,1,18,6,1,0,127
188875,1321484,1,18,7,1,0,128
188876,1321484,1,19,2,1,0,129
188877,1321484,1,19,3,0,0,129
188878,1321484,1,19,4,0,0,129
188879,1321484,1,19,5,0,0,129
188880,1321484,1,19,6,1,0,130
188881,1321484,1,19,7,0,1,130
188882,1321484,1,20,2,1,0,131
188883,1321484,1,20,3,1,0,132
188884,1321484,1,20,4,0,1,132
188995,1322276,1,1,1,0,0,0
188996,1322276,1,1,2,1,0,1
188997,1322276,1,1,3,0,0,1
188998,1322276,1,1,4,1,0,2
188999,1322276,1,1,5,0,0,2
189000,1322276,1,1,6,4,0,6
189001,1322276,1,2,1,0,0,6
189002,1322276,1,2,2,1,0,7
189003,1322276,1,2,3,5,0,12
189004,1322276,1,2,4,1,0,13
189005,1322276,1,2,5,0,0,13
189006,1322276,1,2,6,1,0,14
189007,1322276,1,3,1,4,0,18
189008,1322276,1,3,2,1,0,19
189009,1322276,1,3,3,0,0,19
189010,1322276,1,3,4,0,0,19
189011,1322276,1,3,5,1,0,20
189012,1322276,1,3,6,1,0,21
189013,1322276,1,4,1,6,0,27
189014,1322276,1,4,2,0,0,27
189015,1322276,1,4,3,1,0,28
189016,1322276,1,4,4,1,0,29
189017,1322276,1,4,5,0,0,29
189018,1322276,1,4,6,1,0,30
189019,1322276,1,5,1,0,0,30
189020,1322276,1,5,2,0,0,30
189021,1322276,1,5,3,4,0,34
189022,1322276,1,5,4,1,0,35
189023,1322276,1,5,5,0,0,35
189024,1322276,1,5,6,1,0,36
189025,1322276,1,6,1,0,1,36
189026,1322276,1,6,2,2,0,38
189027,1322276,1,6,3,0,0,38
189028,1322276,1,6,4,0,0,38
189029,1322276,1,6,5,4,0,42
189030,1322276,1,6,6,0,0,42
189031,1322276,1,7,1,4,0,46
189032,1322276,1,7,2,4,0,50
189033,1322276,1,7,3,0,0,50
189034,1322276,1,7,4,0,0,50
189035,1322276,1,7,5,1,0,51
189036,1322276,1,7,6,0,0,51
189037,1322276,1,8,1,0,0,51
189038,1322276,1,8,2,1,0,52
189039,1322276,1,8,3,2,0,54
189040,1322276,1,8,4,1,0,55
189041,1322276,1,8,5,4,0,59
189042,1322276,1,8,6,0,0,59
189043,1322276,1,9,1,1,0,60
189044,1322276,1,9,2,1,0,61
189045,1322276,1,9,3,1,0,62
189046,1322276,1,9,4,0,0,62
189047,1322276,1,9,5,1,0,63
189048,1322276,1,9,6,6,0,69
189049,1322276,1,10,1,0,1,69
189050,1322276,1,10,2,4,0,73
189051,1322276,1,10,3,0,0,73
189052,1322276,1,10,4,1,0,74
189053,1322276,1,10,5,0,0,74
189054,1322276,1,10,6,1,0,75
189055,1322276,1,11,1,4,0,79
189056,1322276,1,11,2,1,0,80
189057,1322276,1,11,3,1,0,81
189058,1322276,1,11,4,1,0,82
189059,1322276,1,11,5,0,0,82
189060,1322276,1,11,6,0,0,82
189061,1322276,1,12,1,4,0,86
189062,1322276,1,12,2,2,0,88
189063,1322276,1,12,3,1,0,89
189064,1322276,1,12,4,6,0,95
189065,1322276,1,12,5,1,0,96
189066,1322276,1,12,6,1,0,97
189067,1322276,1,13,1,4,0,101
189068,1322276,1,13,2,6,0,107
189069,1322276,1,13,3,1,0,108
189070,1322276,1,13,4,0,1,108
189071,1322276,1,13,5,0,0,108
189072,1322276,1,13,6,2,0,110
189073,1322276,1,14,1,1,0,111
189074,1322276,1,14,2,1,0,112
189075,1322276,1,14,3,4,0,116
189076,1322276,1,14,4,0,0,116
189077,1322276,1,14,5,0,0,116
189078,1322276,1,14,6,0,0,116
189079,1322276,1,15,1,1,0,117
189080,1322276,1,15,2,0,0,117
189081,1322276,1,15,3,0,0,117
189082,1322276,1,15,4,1,0,118
189083,1322276,1,15,5,0,0,118
189084,1322276,1,15,6,1,0,119
189085,1322276,1,16,1,1,0,120
189086,1322276,1,16,2,1,0,121
189087,1322276,1,16,3,1,0,122
189088,1322276,1,16,4,0,0,122
189089,1322276,1,16,5,6,0,128
189090,1322276,1,16,6,1,0,129
189091,1322276,1,17,1,6,0,135
189092,1322276,1,17,2,4,0,139
189093,1322276,1,17,3,1,0,140
189094,1322276,1,17,4,4,0,144
189095,1322276,1,17,5,1,0,145
189096,1322276,1,17,6,1,0,146
189097,1322276,1,18,1,1,0,147
189098,1322276,1,18,2,6,0,153
189099,1322276,1,18,3,2,0,155
189100,1322276,1,18,4,2,0,157
189101,1322276,1,18,5,6,0,163
189102,1322276,1,18,6,1,0,164
189103,1322276,1,19,1,4,0,168
189104,1322276,1,19,2,0,0,168
189105,1322276,1,19,3,4,0,172
189106,1322276,1,19,4,4,0,176
189107,1322276,1,19,5,4,0,180
189108,1322276,1,19,6,6,0,186
189109,1322276,1,20,1,2,0,188
189110,1322276,1,20,2,2,0,190
189111,1322276,1,20,3,0,1,190
189112,1322276,1,20,4,0,1,190
189113,1322276,1,20,5,0,1,190
189114,1322276,1,20,6,1,0,191
189228,1322334,1,1,1,0,0,0
189229,1322334,1,1,2,0,0,0
189230,1322334,1,1,3,1,0,1
189231,1322334,1,1,4,0,0,1
189232,1322334,1,1,5,0,0,1
189233,1322334,1,1,6,0,0,1
189234,1322334,1,2,1,1,0,2
189235,1322334,1,2,2,1,0,3
189236,1322334,1,2,3,4,0,7
189237,1322334,1,2,4,0,0,7
189238,1322334,1,2,5,4,0,11
189239,1322334,1,2,6,0,0,11
189240,1322334,1,3,1,0,0,11
189241,1322334,1,3,2,1,0,12
189242,1322334,1,3,3,0,0,12
189243,1322334,1,3,4,4,0,16
189244,1322334,1,3,5,0,0,16
189245,1322334,1,3,6,4,0,20
189246,1322334,1,4,1,0,0,20
189247,1322334,1,4,2,6,0,26
189248,1322334,1,4,3,1,0,27
189249,1322334,1,4,4,0,0,27
189250,1322334,1,4,5,0,0,27
189251,1322334,1,4,6,0,0,27
189252,1322334,1,5,1,0,0,27
189253,1322334,1,5,2,4,0,31
189254,1322334,1,5,3,1,0,32
189255,1322334,1,5,4,0,0,32
189256,1322334,1,5,5,2,0,34
189257,1322334,1,5,6,0,0,34
189258,1322334,1,6,1,1,0,35
189259,1322334,1,6,2,0,0,35
189260,1322334,1,6,3,1,0,36
189261,1322334,1,6,4,4,0,40
189262,1322334,1,6,5,2,0,42
189263,1322334,1,6,6,1,0,43
189264,1322334,1,7,1,1,0,44
189265,1322334,1,7,2,4,0,48
189266,1322334,1,7,3,2,0,50
189267,1322334,1,7,4,1,0,51
189268,1322334,1,7,5,0,0,51
189269,1322334,1,7,6,1,0,52
189270,1322334,1,8,1,0,1,52
189271,1322334,1,8,2,0,0,52
189272,1322334,1,8,3,0,0,52
189273,1322334,1,8,4,0,0,52
189274,1322334,1,8,5,0,0,52
189275,1322334,1,8,6,1,0,53
189276,1322334,1,9,1,0,0,53
189277,1322334,1,9,2,1,0,54
189278,1322334,1,9,3,0,0,54
189279,1322334,1,9,4,4,0,58
189280,1322334,1,9,5,1,0,59
189281,1322334,1,9,6,1,0,60
189282,1322334,1,10,1,1,0,61
189283,1322334,1,10,2,6,0,67
189284,1322334,1,10,3,1,0,68
189285,1322334,1,10,4,1,0,69
189286,1322334,1,10,5,1,0,70
189287,1322334,1,10,6,1,0,71
189288,1322334,1,11,1,1,0,72
189289,1322334,1,11,2,4,0,76
189290,1322334,1,11,3,1,0,77
189291,1322334,1,11,4,1,0,78
189292,1322334,1,11,5,2,0,80
189293,1322334,1,11,6,4,0,84
189294,1322334,1,12,1,0,0,84
189295,1322334,1,12,2,1,0,85
189296,1322334,1,12,3,1,0,86
189297,1322334,1,12,4,0,0,86
189298,1322334,1,12,5,1,0,87
189299,1322334,1,12,6,4,0,91
189300,1322334,1,13,1,1,0,92
189301,1322334,1,13,2,0,0,92
189302,1322334,1,13,3,1,0,93
189303,1322334,1,13,4,1,0,94
189304,1322334,1,13,5,0,1,94
189305,1322334,1,13,6,0,0,94
189306,1322334,1,14,1,1,0,95
189307,1322334,1,14,2,2,0,97
189308,1322334,1,14,3,1,0,98
189309,1322334,1,14,4,1,0,99
189310,1322334,1,14,5,1,0,100
189311,1322334,1,14,6,4,0,104
189312,1322334,1,15,1,4,0,108
189313,1322334,1,15,2,1,0,109
189314,1322334,1,15,3,1,0,110
189315,1322334,1,15,4,1,0,111
189316,1322334,1,15,5,0,0,111
189317,1322334,1,15,6,0,1,111
189318,1322334,1,16,1,1,0,112
189319,1322334,1,16,2,0,0,112
189320,1322334,1,16,3,1,0,113
189321,1322334,1,16,4,1,0,114
189322,1322334,1,16,5,1,0,115
189323,1322334,1,16,6,1,0,116
189324,1322334,1,17,1,4,0,120
189325,1322334,1,17,2,1,0,121
189326,1322334,1,17,3,2,0,123
189327,1322334,1,17,4,4,0,127
189328,1322334,1,17,5,1,0,128
189329,1322334,1,17,6,4,0,132
189330,1322334,1,18,1,4,0,136
189331,1322334,1,18,2,0,1,136
189332,1322334,1,18,3,1,0,137
189333,1322334,1,18,4,3,0,140
189334,1322334,1,18,5,2,0,142
189335,1322334,1,18,6,2,0,144
189336,1322334,1,19,1,6,0,150
189337,1322334,1,19,2,2,0,152
189338,1322334,1,19,3,1,0,153
189339,1322334,1,19,4,1,0,154
189340,1322334,1,19,5,0,1,154
189341,1322334,1,19,6,0,0,154
189342,1322334,1,20,1,4,0,158
189343,1322334,1,20,2,1,0,159
189344,1322334,1,20,3,0,0,159
189345,1322334,1,20,4,0,0,159
189346,1322334,1,20,5,6,0,165
189347,1322334,1,20,6,2,0,167
189468,1322335,1,1,1,0,0,0
189469,1322335,1,1,2,4,0,4
189470,1322335,1,1,3,1,0,5
189471,1322335,1,1,4,0,0,5
189472,1322335,1,1,5,0,0,5
189473,1322335,1,1,6,0,0,5
189474,1322335,1,2,1,4,0,9
189475,1322335,1,2,2,4,0,13
189476,1322335,1,2,3,0,0,13
189477,1322335,1,2,4,1,0,14
189478,1322335,1,2,5,0,0,14
189479,1322335,1,2,6,1,0,15
189480,1322335,1,3,1,1,0,16
189481,1322335,1,3,2,0,1,16
189482,1322335,1,3,3,1,0,17
189483,1322335,1,3,4,0,0,17
189484,1322335,1,3,5,0,0,17
189485,1322335,1,3,6,3,0,20
189486,1322335,1,4,1,4,0,24
189487,1322335,1,4,2,0,0,24
189488,1322335,1,4,3,0,0,24
189489,1322335,1,4,4,1,0,25
189490,1322335,1,4,5,1,0,26
189491,1322335,1,4,6,0,0,26
189492,1322335,1,5,1,2,0,28
189493,1322335,1,5,2,1,0,29
189494,1322335,1,5,3,1,0,30
189495,1322335,1,5,4,0,0,30
189496,1322335,1,5,5,4,0,34
189497,1322335,1,5,6,1,0,35
189498,1322335,1,6,1,1,0,36
189499,1322335,1,6,2,0,0,36
189500,1322335,1,6,3,0,0,36
189501,1322335,1,6,4,1,0,37
189502,1322335,1,6,5,0,0,37
189503,1322335,1,6,6,5,0,42
189504,1322335,1,7,1,0,0,42
189505,1322335,1,7,2,1,0,43
189506,1322335,1,7,3,0,0,43
189507,1322335,1,7,4,1,0,44
189508,1322335,1,7,5,0,0,44
189509,1322335,1,7,6,2,0,46
189510,1322335,1,8,1,1,0,47
189511,1322335,1,8,2,0,0,47
189512,1322335,1,8,3,1,0,48
189513,1322335,1,8,4,1,0,49
189514,1322335,1,8,5,0,0,49
189515,1322335,1,8,6,2,0,51
189516,1322335,1,9,1,1,0,52
189517,1322335,1,9,2,2,0,54
189518,1322335,1,9,3,0,0,54
189519,1322335,1,9,4,1,0,55
189520,1322335,1,9,5,6,0,61
189521,1322335,1,9,6,1,0,62
189522,1322335,1,10,1,6,0,68
189523,1322335,1,10,2,2,0,70
189524,1322335,1,10,3,0,0,70
189525,1322335,1,10,4,0,0,70
189526,1322335,1,10,5,0,0,70
189527,1322335,1,10,6,0,0,70
189528,1322335,1,11,1,1,0,71
189529,1322335,1,11,2,0,0,71
189530,1322335,1,11,3,1,0,72
189531,1322335,1,11,4,1,0,73
189532,1322335,1,11,5,4,0,77
189533,1322335,1,11,6,0,1,77
189534,1322335,1,12,1,1,0,78
189535,1322335,1,12,2,1,0,79
189536,1322335,1,12,3,1,0,80
189537,1322335,1,12,4,0,0,80
189538,1322335,1,12,5,1,0,81
189539,1322335,1,12,6,1,0,82
189540,1322335,1,13,1,1,0,83
189541,1322335,1,13,2,1,0,84
189542,1322335,1,13,3,1,0,85
189543,1322335,1,13,4,1,0,86
189544,1322335,1,13,5,2,0,88
189545,1322335,1,13,6,0,1,88
189546,1322335,1,14,1,1,0,89
189547,1322335,1,14,2,0,0,89
189548,1322335,1,14,3,0,0,89
189549,1322335,1,14,4,1,0,90
189550,1322335,1,14,5,1,0,91
189551,1322335,1,14,6,1,0,92
189552,1322335,1,15,1,6,0,98
189553,1322335,1,15,2,1,0,99
189554,1322335,1,15,3,1,0,100
189555,1322335,1,15,4,6,0,106
189556,1322335,1,15,5,4,0,110
189557,1322335,1,15,6,4,0,114
189558,1322335,1,16,1,2,0,116
189559,1322335,1,16,2,1,0,117
189560,1322335,1,16,3,1,0,118
189561,1322335,1,16,4,2,0,120
189562,1322335,1,16,5,4,0,124
189563,1322335,1,16,6,1,0,125
189564,1322335,1,17,1,1,0,126
189565,1322335,1,17,2,1,0,127
189566,1322335,1,17,3,1,0,128
189567,1322335,1,17,4,0,0,128
189568,1322335,1,17,5,1,0,129
189569,1322335,1,17,6,1,0,130
189570,1322335,1,18,1,0,1,130
189571,1322335,1,18,2,0,0,130
189572,1322335,1,18,3,4,0,134
189573,1322335,1,18,4,0,0,134
189574,1322335,1,18,5,1,0,135
189575,1322335,1,18,6,2,0,137
189576,1322335,1,19,1,0,0,137
189577,1322335,1,19,2,0,1,137
189578,1322335,1,19,3,0,1,137
189579,1322335,1,19,4,1,0,138
189580,1322335,1,19,5,4,0,142
189581,1322335,1,19,6,0,1,142
189582,1322335,1,20,1,1,0,143
189583,1322335,1,20,2,1,0,144
189584,1322335,1,20,3,0,1,144
189585,1322335,1,20,4,1,0,145
189586,1322335,1,20,5,1,0,146
189587,1322335,1,20,6,1,0,147
189698,1322336,1,1,1,1,0,1
189699,1322336,1,1,2,0,0,1
189700,1322336,1,1,3,1,0,2
189701,1322336,1,1,4,0,0,2
189702,1322336,1,1,5,0,0,2
189703,1322336,1,1,6,3,0,5
189704,1322336,1,2,1,3,0,8
189705,1322336,1,2,2,4,0,12
189706,1322336,1,2,3,0,0,12
189707,1322336,1,2,4,0,1,12
189708,1322336,1,2,5,1,0,13
189709,1322336,1,2,6,1,0,14
189710,1322336,1,3,1,0,0,14
189711,1322336,1,3,2,4,0,18
189712,1322336,1,3,3,0,0,18
189713,1322336,1,3,4,0,0,18
189714,1322336,1,3,5,1,0,19
189715,1322336,1,3,6,0,0,19
189716,1322336,1,4,1,1,0,20
189717,1322336,1,4,2,1,0,21
189718,1322336,1,4,3,0,0,21
189719,1322336,1,4,4,3,0,24
189720,1322336,1,4,5,0,0,24
189721,1322336,1,4,6,2,0,26
189722,1322336,1,5,1,4,0,30
189723,1322336,1,5,2,0,0,30
189724,1322336,1,5,3,0,0,30
189725,1322336,1,5,4,0,0,30
189726,1322336,1,5,5,0,0,30
189727,1322336,1,5,6,0,0,30
189728,1322336,1,6,1,4,0,34
189729,1322336,1,6,2,0,0,34
189730,1322336,1,6,3,1,0,35
189731,1322336,1,6,4,4,0,39
189732,1322336,1,6,5,1,0,40
189733,1322336,1,6,6,1,0,41
189734,1322336,1,7,1,0,0,41
189735,1322336,1,7,2,4,0,45
189736,1322336,1,7,3,1,0,46
189737,1322336,1,7,4,4,0,50
189738,1322336,1,7,5,2,0,52
189739,1322336,1,7,6,1,0,53
189740,1322336,1,8,1,0,0,53
189741,1322336,1,8,2,0,0,53
189742,1322336,1,8,3,0,1,53
189743,1322336,1,8,4,1,0,54
189744,1322336,1,8,5,0,0,54
189745,1322336,1,8,6,0,0,54
189746,1322336,1,9,1,2,0,56
189747,1322336,1,9,2,0,0,56
189748,1322336,1,9,3,1,0,57
189749,1322336,1,9,4,2,0,59
189750,1322336,1,9,5,0,0,59
189751,1322336,1,9,6,0,1,59
189752,1322336,1,10,1,1,0,60
189753,1322336,1,10,2,0,0,60
189754,1322336,1,10,3,1,0,61
189755,1322336,1,10,4,0,0,61
189756,1322336,1,10,5,1,0,62
189757,1322336,1,10,6,1,0,63
189758,1322336,1,11,1,0,0,63
189759,1322336,1,11,2,2,0,65
189760,1322336,1,11,3,1,0,66
189761,1322336,1,11,4,0,1,66
189762,1322336,1,11,5,1,0,67
189763,1322336,1,11,6,0,0,67
189764,1322336,1,12,1,0,0,67
189765,1322336,1,12,2,0,0,67
189766,1322336,1,12,3,1,0,68
189767,1322336,1,12,4,1,0,69
189768,1322336,1,12,5,0,0,69
189769,1322336,1,12,6,1,0,70
189770,1322336,1,13,1,1,0,71
189771,1322336,1,13,2,1,0,72
189772,1322336,1,13,3,1,0,73
189773,1322336,1,13,4,0,0,73
189774,1322336,1,13,5,1,0,74
189775,1322336,1,13,6,0,0,74
189776,1322336,1,14,1,0,0,74
189777,1322336,1,14,2,4,0,78
189778,1322336,1,14,3,0,1,78
189779,1322336,1,14,4,1,0,79
189780,1322336,1,14,5,1,0,80
189781,1322336,1,14,6,0,0,80
189782,1322336,1,15,1,1,0,81
189783,1322336,1,15,2,1,0,82
189784,1322336,1,15,3,1,0,83
189785,1322336,1,15,4,1,0,84
189786,1322336,1,15,5,3,0,87
189787,1322336,1,15,6,1,0,88
189788,1322336,1,16,1,2,0,90
189789,1322336,1,16,2,0,0,90
189790,1322336,1,16,3,1,0,91
189791,1322336,1,16,4,2,0,93
189792,1322336,1,16,5,1,0,94
189793,1322336,1,16,6,2,0,96
189794,1322336,1,17,1,1,0,97
189795,1322336,1,17,2,2,0,99
189796,1322336,1,17,3,1,0,100
189797,1322336,1,17,4,1,0,101
189798,1322336,1,17,5,1,1,102
189799,1322336,1,17,6,0,0,102
189800,1322336,1,18,1,4,0,106
189801,1322336,1,18,2,1,0,107
189802,1322336,1,18,3,2,0,109
189803,1322336,1,18,4,1,0,110
189804,1322336,1,18,5,0,0,110
189805,1322336,1,18,6,0,1,110
189806,1322336,1,19,1,0,0,110
189807,1322336,1,19,2,1,0,111
189808,1322336,1,19,3,3,0,114
189809,1322336,1,19,4,2,0,116
189810,1322336,1,19,5,6,0,122
189811,1322336,1,19,6,6,0,128
189812,1322336,1,20,1,0,1,128
189813,1322336,1,20,2,1,0,129
189814,1322336,1,20,3,2,0,131
189815,1322336,1,20,4,4,0,135
189816,1322336,1,20,5,0,0,135
189817,1322336,1,20,6,2,0,137
189925,1322337,1,1,1,0,0,0
189926,1322337,1,1,2,0,0,0
189927,1322337,1,1,3,0,0,0
189928,1322337,1,1,4,4,0,4
189929,1322337,1,1,5,4,0,8
189930,1322337,1,1,6,1,0,9
189931,1322337,1,2,1,4,0,13
189932,1322337,1,2,2,1,0,14
189933,1322337,1,2,3,1,0,15
189934,1322337,1,2,4,1,0,16
189935,1322337,1,2,5,0,0,16
189936,1322337,1,2,6,4,0,20
189937,1322337,1,3,1,4,0,24
189938,1322337,1,3,2,0,0,24
189939,1322337,1,3,3,0,0,24
189940,1322337,1,3,4,0,0,24
189941,1322337,1,3,5,0,0,24
189942,1322337,1,3,6,0,0,24
189943,1322337,1,4,1,0,0,24
189944,1322337,1,4,2,0,0,24
189945,1322337,1,4,3,4,0,28
189946,1322337,1,4,4,1,0,29
189947,1322337,1,4,5,1,0,30
189948,1322337,1,4,6,0,0,30
189949,1322337,1,5,1,0,0,30
189950,1322337,1,5,2,0,1,30
189951,1322337,1,5,3,1,0,31
189952,1322337,1,5,4,0,0,31
189953,1322337,1,5,5,1,0,32
189954,1322337,1,5,6,0,0,32
189955,1322337,1,6,1,0,0,32
189956,1322337,1,6,2,5,0,37
189957,1322337,1,6,3,1,0,38
189958,1322337,1,6,4,0,0,38
189959,1322337,1,6,5,4,0,42
189960,1322337,1,6,6,0,0,42
189961,1322337,1,7,1,1,0,43
189962,1322337,1,7,2,1,0,44
189963,1322337,1,7,3,1,0,45
189964,1322337,1,7,4,2,0,47
189965,1322337,1,7,5,1,0,48
189966,1322337,1,7,6,0,0,48
189967,1322337,1,8,1,0,0,48
189968,1322337,1,8,2,4,0,52
189969,1322337,1,8,3,1,0,53
189970,1322337,1,8,4,1,0,54
189971,1322337,1,8,5,0,1,54
189972,1322337,1,8,6,1,0,55
189973,1322337,1,9,1,0,0,55
189974,1322337,1,9,2,4,0,59
189975,1322337,1,9,3,0,0,59
189976,1322337,1,9,4,2,0,61
189977,1322337,1,9,5,1,0,62
189978,1322337,1,9,6,0,0,62
189979,1322337,1,10,1,0,1,62
189980,1322337,1,10,2,1,0,63
189981,1322337,1,10,3,0,0,63
189982,1322337,1,10,4,1,0,64
189983,1322337,1,10,5,1,0,65
189984,1322337,1,10,6,0,0,65
189985,1322337,1,11,1,0,0,65
189986,1322337,1,11,2,0,1,65
189987,1322337,1,11,3,0,0,65
189988,1322337,1,11,4,1,0,66
189989,1322337,1,11,5,1,0,67
189990,1322337,1,11,6,0,0,67
189991,1322337,1,12,1,1,0,68
189992,1322337,1,12,2,1,0,69
189993,1322337,1,12,3,0,0,69
189994,1322337,1,12,4,2,0,71
189995,1322337,1,12,5,1,0,72
189996,1322337,1,12,6,0,0,72
189997,1322337,1,13,1,1,0,73
189998,1322337,1,13,2,1,0,74
189999,1322337,1,13,3,1,0,75
190000,1322337,1,13,4,0,0,75
190001,1322337,1,13,5,0,0,75
190002,1322337,1,13,6,0,0,75
190003,1322337,1,14,1,2,0,77
190004,1322337,1,14,2,0,1,77
190005,1322337,1,14,3,1,0,78
190006,1322337,1,14,4,1,0,79
190007,1322337,1,14,5,0,0,79
190008,1322337,1,14,6,1,0,80
190009,1322337,1,15,1,4,0,84
190010,1322337,1,15,2,1,0,85
190011,1322337,1,15,3,0,0,85
190012,1322337,1,15,4,1,0,86
190013,1322337,1,15,5,1,0,87
190014,1322337,1,15,6,4,0,91
190015,1322337,1,16,1,0,0,91
190016,1322337,1,16,2,4,0,95
190017,1322337,1,16,3,3,0,98
190018,1322337,1,16,4,4,0,102
190019,1322337,1,16,5,1,0,103
190020,1322337,1,16,6,1,0,104
190021,1322337,1,17,1,1,0,105
190022,1322337,1,17,2,1,0,106
190023,1322337,1,17,3,1,0,107
190024,1322337,1,17,4,0,0,107
190025,1322337,1,17,5,1,0,108
190026,1322337,1,17,6,2,0,110
190027,1322337,1,18,1,2,0,112
190028,1322337,1,18,2,1,0,113
190029,1322337,1,18,3,0,0,113
190030,1322337,1,18,4,2,0,115
190031,1322337,1,18,5,1,0,116
190032,1322337,1,18,6,1,0,117
190033,1322337,1,19,1,1,0,118
190034,1322337,1,19,2,1,0,119
190035,1322337,1,19,3,4,0,123
190036,1322337,1,19,4,0,0,123
190037,1322337,1,19,5,4,0,127
190038,1322337,1,19,6,1,0,128
190039,1322337,1,20,1,0,1,128
190040,1322337,1,20,2,0,1,128
190041,1322337,1,20,3,0,0,128
190042,1322337,1,20,4,1,0,129
190043,1322337,1,20,5,0,0,129
190044,1322337,1,20,6,1,0,130
190142,1322338,1,1,1,3,0,3
190143,1322338,1,1,2,0,0,3
190144,1322338,1,1,3,0,0,3
190145,1322338,1,1,4,4,0,7
190146,1322338,1,1,5,1,0,8
190147,1322338,1,1,6,0,0,8
190148,1322338,1,2,1,0,0,8
190149,1322338,1,2,2,4,0,12
190150,1322338,1,2,3,0,0,12
190151,1322338,1,2,4,1,0,13
190152,1322338,1,2,5,4,0,17
190153,1322338,1,2,6,0,0,17
190154,1322338,1,3,1,0,0,17
190155,1322338,1,3,2,0,0,17
190156,1322338,1,3,3,6,0,23
190157,1322338,1,3,4,0,0,23
190158,1322338,1,3,5,6,0,29
190159,1322338,1,3,6,3,0,32
190160,1322338,1,4,1,1,0,33
190161,1322338,1,4,2,1,0,34
190162,1322338,1,4,3,1,0,35
190163,1322338,1,4,4,4,0,39
190164,1322338,1,4,5,2,0,41
190165,1322338,1,4,6,0,0,41
190166,1322338,1,5,1,4,0,45
190167,1322338,1,5,2,0,1,45
190168,1322338,1,5,3,1,0,46
190169,1322338,1,5,4,0,0,46
190170,1322338,1,5,5,1,0,47
190171,1322338,1,5,6,0,0,47
190172,1322338,1,6,1,4,0,51
190173,1322338,1,6,2,0,0,51
190174,1322338,1,6,3,1,0,52
190175,1322338,1,6,4,1,0,53
190176,1322338,1,6,5,1,0,54
190177,1322338,1,6,6,0,0,54
190178,1322338,1,7,1,1,0,55
190179,1322338,1,7,2,1,0,56
190180,1322338,1,7,3,4,0,60
190181,1322338,1,7,4,1,0,61
190182,1322338,1,7,5,0,0,61
190183,1322338,1,7,6,0,0,61
190184,1322338,1,8,1,1,0,62
190185,1322338,1,8,2,0,0,62
190186,1322338,1,8,3,2,0,64
190187,1322338,1,8,4,1,0,65
190188,1322338,1,8,5,2,0,67
190189,1322338,1,8,6,1,0,68
190190,1322338,1,9,1,2,0,70
190191,1322338,1,9,2,0,0,70
190192,1322338,1,9,3,1,0,71
190193,1322338,1,9,4,6,0,77
190194,1322338,1,9,5,3,0,80
190195,1322338,1,9,6,1,0,81
190196,1322338,1,10,1,2,0,83
190197,1322338,1,10,2,1,0,84
190198,1322338,1,10,3,1,0,85
190199,1322338,1,10,4,0,0,85
190200,1322338,1,10,5,1,0,86
190201,1322338,1,10,6,1,0,87
190202,1322338,1,11,1,1,0,88
190203,1322338,1,11,2,0,0,88
190204,1322338,1,11,3,6,0,94
190205,1322338,1,11,4,5,0,99
190206,1322338,1,11,5,0,0,99
190207,1322338,1,11,6,2,0,101
190208,1322338,1,12,1,1,0,102
190209,1322338,1,12,2,1,0,103
190210,1322338,1,12,3,4,0,107
190211,1322338,1,12,4,1,0,108
190212,1322338,1,12,5,1,0,109
190213,1322338,1,12,6,0,0,109
190214,1322338,1,13,1,1,0,110
190215,1322338,1,13,2,4,0,114
190216,1322338,1,13,3,1,0,115
190217,1322338,1,13,4,1,0,116
190218,1322338,1,13,5,6,0,122
190219,1322338,1,13,6,1,0,123
190220,1322338,1,14,1,4,0,127
190221,1322338,1,14,2,0,1,127
190222,1322338,1,14,3,1,0,128
190223,1322338,1,14,4,2,0,130
190224,1322338,1,14,5,1,0,131
190225,1322338,1,14,6,1,0,132
190226,1322338,1,15,1,2,0,134
190227,1322338,1,15,2,2,0,136
190228,1322338,1,15,3,0,0,136
190229,1322338,1,15,4,1,0,137
190230,1322338,1,15,5,6,0,143
190231,1322338,1,15,6,0,0,143
190232,1322338,1,16,1,1,0,144
190233,1322338,1,16,2,1,0,145
190234,1322338,1,16,3,6,0,151
190235,1322338,1,16,4,6,0,157
190236,1322338,1,16,5,2,0,159
190237,1322338,1,16,6,2,0,161
190238,1322338,1,17,1,0,1,161
190239,1322338,1,17,2,0,0,161
190240,1322338,1,17,3,2,0,163
190241,1322338,1,17,4,0,1,163
190242,1322338,1,17,5,1,0,164
190243,1322338,1,17,6,2,0,166
190244,1322338,1,18,1,2,0,168
190245,1322338,1,18,2,1,0,169
190246,1322338,1,18,3,6,0,175
190247,1322338,1,18,4,2,0,177
190248,1322338,1,18,5,1,0,178
190249,1322338,1,18,6,2,0,180
190250,1322338,1,19,1,0,0,180
190251,1322338,1,19,2,6,0,186
190252,1322338,1,19,3,6,0,192
190253,1322338,1,19,4,4,0,196
190254,1322338,1,19,5,1,0,197
190255,1322338,1,19,6,0,0,197
190256,1322338,1,20,1,2,0,199
190257,1322338,1,20,2,2,0,201
190258,1322338,1,20,3,4,0,205
190259,1322338,1,20,4,0,1,205
190260,1322338,1,20,5,2,0,207
190261,1322338,1,20,6,1,0,208
190382,1322339,1,1,1,1,0,1
190383,1322339,1,1,2,0,0,1
190384,1322339,1,1,3,0,0,1
190385,1322339,1,1,4,0,0,1
190386,1322339,1,1,5,0,0,1
190387,1322339,1,1,6,0,0,1
190388,1322339,1,2,1,3,0,4
190389,1322339,1,2,2,0,0,4
190390,1322339,1,2,3,0,0,4
190391,1322339,1,2,4,1,0,5
190392,1322339,1,2,5,0,0,5
190393,1322339,1,2,6,2,0,7
190394,1322339,1,3,1,0,1,7
190395,1322339,1,3,2,0,0,7
190396,1322339,1,3,3,1,0,8
190397,1322339,1,3,4,1,0,9
190398,1322339,1,3,5,0,0,9
190399,1322339,1,3,6,1,0,10
190400,1322339,1,4,1,4,0,14
190401,1322339,1,4,2,4,0,18
190402,1322339,1,4,3,0,0,18
190403,1322339,1,4,4,0,0,18
190404,1322339,1,4,5,0,0,18
190405,1322339,1,4,6,2,0,20
190406,1322339,1,5,1,4,0,24
190407,1322339,1,5,2,1,0,25
190408,1322339,1,5,3,4,0,29
190409,1322339,1,5,4,4,0,33
190410,1322339,1,5,5,2,0,35
190411,1322339,1,5,6,0,0,35
190412,1322339,1,6,1,1,0,36
190413,1322339,1,6,2,1,0,37
190414,1322339,1,6,3,4,0,41
190415,1322339,1,6,4,0,1,41
190416,1322339,1,6,5,0,0,41
190417,1322339,1,6,6,0,0,41
190418,1322339,1,7,1,1,0,42
190419,1322339,1,7,2,0,0,42
190420,1322339,1,7,3,1,0,43
190421,1322339,1,7,4,1,0,44
190422,1322339,1,7,5,0,0,44
190423,1322339,1,7,6,0,0,44
190424,1322339,1,8,1,1,0,45
190425,1322339,1,8,2,1,0,46
190426,1322339,1,8,3,4,0,50
190427,1322339,1,8,4,1,0,51
190428,1322339,1,8,5,4,0,55
190429,1322339,1,8,6,6,0,61
190430,1322339,1,9,1,1,0,62
190431,1322339,1,9,2,2,0,64
190432,1322339,1,9,3,1,0,65
190433,1322339,1,9,4,2,0,67
190434,1322339,1,9,5,0,0,67
190435,1322339,1,9,6,6,0,73
190436,1322339,1,10,1,1,0,74
190437,1322339,1,10,2,2,0,76
190438,1322339,1,10,3,1,0,77
190439,1322339,1,10,4,1,0,78
190440,1322339,1,10,5,1,0,79
190441,1322339,1,10,6,1,0,80
190442,1322339,1,11,1,2,0,82
190443,1322339,1,11,2,1,0,83
190444,1322339,1,11,3,2,0,85
190445,1322339,1,11,4,1,0,86
190446,1322339,1,11,5,1,0,87
190447,1322339,1,11,6,2,0,89
190448,1322339,1,12,1,1,0,90
190449,1322339,1,12,2,1,0,91
190450,1322339,1,12,3,1,0,92
190451,1322339,1,12,4,1,0,93
190452,1322339,1,12,5,1,0,94
190453,1322339,1,12,6,2,0,96
190454,1322339,1,13,1,4,0,100
190455,1322339,1,13,2,0,0,100
190456,1322339,1,13,3,1,0,101
190457,1322339,1,13,4,2,0,103
190458,1322339,1,13,5,1,0,104
190459,1322339,1,13,6,0,0,104
190460,1322339,1,14,1,2,0,106
190461,1322339,1,14,2,0,0,106
190462,1322339,1,14,3,6,0,112
190463,1322339,1,14,4,1,0,113
190464,1322339,1,14,5,4,0,117
190465,1322339,1,14,6,1,0,118
190466,1322339,1,15,1,6,0,124
190467,1322339,1,15,2,1,0,125
190468,1322339,1,15,3,0,0,125
190469,1322339,1,15,4,4,0,129
190470,1322339,1,15,5,0,1,129
190471,1322339,1,15,6,0,0,129
190472,1322339,1,16,1,1,0,130
190473,1322339,1,16,2,0,0,130
190474,1322339,1,16,3,1,0,131
190475,1322339,1,16,4,0,0,131
190476,1322339,1,16,5,2,0,133
190477,1322339,1,16,6,5,0,138
190478,1322339,1,17,1,1,0,139
190479,1322339,1,17,2,0,0,139
190480,1322339,1,17,3,1,0,140
190481,1322339,1,17,4,1,0,141
190482,1322339,1,17,5,6,0,147
190483,1322339,1,17,6,5,0,152
190484,1322339,1,18,1,1,0,153
190485,1322339,1,18,2,0,0,153
190486,1322339,1,18,3,4,0,157
190487,1322339,1,18,4,0,0,157
190488,1322339,1,18,5,4,0,161
190489,1322339,1,18,6,0,0,161
190490,1322339,1,19,1,0,0,161
190491,1322339,1,19,2,4,0,165
190492,1322339,1,19,3,2,0,167
190493,1322339,1,19,4,0,1,167
190494,1322339,1,19,5,1,0,168
190495,1322339,1,19,6,2,0,170
190496,1322339,1,20,1,0,1,170
190497,1322339,1,20,2,0,0,170
190498,1322339,1,20,3,0,0,170
190499,1322339,1,20,4,0,1,170
190500,1322339,1,20,5,1,0,171
190501,1322339,1,20,6,2,0,173
190621,1322340,1,1,1,0,0,0
190622,1322340,1,1,2,4,0,4
190623,1322340,1,1,3,0,0,4
190624,1322340,1,1,4,4,0,8
190625,1322340,1,1,5,4,0,12
190626,1322340,1,1,6,0,1,12
190627,1322340,1,2,1,0,0,12
190628,1322340,1,2,2,1,0,13
190629,1322340,1,2,3,1,0,14
190630,1322340,1,2,4,4,0,18
190631,1322340,1,2,5,4,0,22
190632,1322340,1,2,6,0,0,22
190633,1322340,1,3,1,4,0,26
190634,1322340,1,3,2,0,0,26
190635,1322340,1,3,3,0,0,26
190636,1322340,1,3,4,4,0,30
190637,1322340,1,3,5,0,0,30
190638,1322340,1,3,6,0,0,30
190639,1322340,1,4,1,4,0,34
190640,1322340,1,4,2,4,0,38
190641,1322340,1,4,3,0,0,38
190642,1322340,1,4,4,0,0,38
190643,1322340,1,4,5,3,0,41
190644,1322340,1,4,6,1,0,42
190645,1322340,1,5,1,0,0,42
190646,1322340,1,5,2,0,0,42
190647,1322340,1,5,3,0,0,42
190648,1322340,1,5,4,2,0,44
190649,1322340,1,5,5,2,0,46
190650,1322340,1,5,6,0,0,46
190651,1322340,1,6,1,1,0,47
190652,1322340,1,6,2,0,1,47
190653,1322340,1,6,3,2,0,49
190654,1322340,1,6,4,0,0,49
190655,1322340,1,6,5,0,0,49
190656,1322340,1,6,6,2,0,51
190657,1322340,1,7,1,1,0,52
190658,1322340,1,7,2,2,0,54
190659,1322340,1,7,3,1,0,55
190660,1322340,1,7,4,1,0,56
190661,1322340,1,7,5,1,0,57
190662,1322340,1,7,6,1,0,58
190663,1322340,1,8,1,1,0,59
190664,1322340,1,8,2,0,0,59
190665,1322340,1,8,3,1,0,60
190666,1322340,1,8,4,1,0,61
190667,1322340,1,8,5,1,0,62
190668,1322340,1,8,6,1,0,63
190669,1322340,1,9,1,1,0,64
190670,1322340,1,9,2,2,0,66
190671,1322340,1,9,3,6,0,72
190672,1322340,1,9,4,2,0,74
190673,1322340,1,9,5,0,0,74
190674,1322340,1,9,6,1,0,75
190675,1322340,1,10,1,4,0,79
190676,1322340,1,10,2,1,0,80
190677,1322340,1,10,3,1,0,81
190678,1322340,1,10,4,0,0,81
190679,1322340,1,10,5,1,0,82
190680,1322340,1,10,6,1,0,83
190681,1322340,1,11,1,1,0,84
190682,1322340,1,11,2,1,0,85
190683,1322340,1,11,3,2,0,87
190684,1322340,1,11,4,1,0,88
190685,1322340,1,11,5,1,0,89
190686,1322340,1,11,6,1,0,90
190687,1322340,1,12,1,6,0,96
190688,1322340,1,12,2,1,0,97
190689,1322340,1,12,3,0,1,97
190690,1322340,1,12,4,0,0,97
190691,1322340,1,12,5,0,0,97
190692,1322340,1,12,6,1,0,98
190693,1322340,1,13,1,1,0,99
190694,1322340,1,13,2,2,0,101
190695,1322340,1,13,3,0,0,101
190696,1322340,1,13,4,0,0,101
190697,1322340,1,13,5,1,0,102
190698,1322340,1,13,6,2,0,104
190699,1322340,1,14,1,1,0,105
190700,1322340,1,14,2,1,0,106
190701,1322340,1,14,3,1,0,107
190702,1322340,1,14,4,6,0,113
190703,1322340,1,14,5,1,0,114
190704,1322340,1,14,6,2,0,116
190705,1322340,1,15,1,1,0,117
190706,1322340,1,15,2,1,0,118
190707,1322340,1,15,3,4,0,122
190708,1322340,1,15,4,1,0,123
190709,1322340,1,15,5,6,0,129
190710,1322340,1,15,6,1,0,130
190711,1322340,1,16,1,2,0,132
190712,1322340,1,16,2,1,0,133
190713,1322340,1,16,3,1,0,134
190714,1322340,1,16,4,0,0,134
190715,1322340,1,16,5,0,1,134
190716,1322340,1,16,6,0,0,134
190717,1322340,1,17,1,1,0,135
190718,1322340,1,17,2,1,0,136
190719,1322340,1,17,3,1,0,137
190720,1322340,1,17,4,2,0,139
190721,1322340,1,17,5,1,0,140
190722,1322340,1,17,6,0,0,140
190723,1322340,1,18,1,2,0,142
190724,1322340,1,18,2,4,0,146
190725,1322340,1,18,3,1,0,147
190726,1322340,1,18,4,0,0,147
190727,1322340,1,18,5,4,0,151
190728,1322340,1,18,6,0,0,151
190729,1322340,1,19,1,6,0,157
190730,1322340,1,19,2,0,0,157
190731,1322340,1,19,3,1,0,158
190732,1322340,1,19,4,0,1,158
190733,1322340,1,19,5,0,1,158
190734,1322340,1,19,6,1,0,159
190735,1322340,1,20,1,1,0,160
190736,1322340,1,20,2,0,0,160
190737,1322340,1,20,3,1,0,161
190738,1322340,1,20,4,0,1,161
190739,1322340,1,20,5,1,0,162
190740,1322340,1,20,6,1,0,163
190858,1322363,1,1,1,0,0,0
190859,1322363,1,1,2,0,0,0
190860,1322363,1,1,3,0,0,0
190861,1322363,1,1,4,4,0,4
190862,1322363,1,1,5,0,0,4
190863,1322363,1,1,6,4,0,8
190864,1322363,1,2,1,0,0,8
190865,1322363,1,2,2,0,0,8
190866,1322363,1,2,3,6,0,14
190867,1322363,1,2,4,4,0,18
190868,1322363,1,2,5,0,1,18
190869,1322363,1,2,6,0,0,18
190870,1322363,1,3,1,1,0,19
190871,1322363,1,3,2,0,0,19
190872,1322363,1,3,3,0,0,19
190873,1322363,1,3,4,6,0,25
190874,1322363,1,3,5,2,0,27
190875,1322363,1,3,6,1,0,28
190876,1322363,1,4,1,0,0,28
190877,1322363,1,4,2,1,0,29
190878,1322363,1,4,3,0,0,29
190879,1322363,1,4,4,0,1,29
190880,1322363,1,4,5,1,0,30
190881,1322363,1,4,6,4,0,34
190882,1322363,1,5,1,2,0,36
190883,1322363,1,5,2,1,0,37
190884,1322363,1,5,3,1,0,38
190885,1322363,1,5,4,1,0,39
190886,1322363,1,5,5,0,0,39
190887,1322363,1,5,6,4,0,43
190888,1322363,1,6,1,0,0,43
190889,1322363,1,6,2,1,0,44
190890,1322363,1,6,3,0,0,44
190891,1322363,1,6,4,4,0,48
190892,1322363,1,6,5,1,0,49
190893,1322363,1,6,6,1,0,50
190894,1322363,1,7,1,4,0,54
190895,1322363,1,7,2,1,0,55
190896,1322363,1,7,3,1,0,56
190897,1322363,1,7,4,1,0,57
190898,1322363,1,7,5,1,0,58
190899,1322363,1,7,6,1,0,59
190900,1322363,1,8,1,2,0,61
190901,1322363,1,8,2,1,0,62
190902,1322363,1,8,3,1,0,63
190903,1322363,1,8,4,6,0,69
190904,1322363,1,8,5,1,0,70
190905,1322363,1,8,6,1,0,71
190906,1322363,1,9,1,0,0,71
190907,1322363,1,9,2,0,0,71
190908,1322363,1,9,3,1,0,72
190909,1322363,1,9,4,1,0,73
190910,1322363,1,9,5,1,0,74
190911,1322363,1,9,6,4,0,78
190912,1322363,1,10,1,1,0,79
190913,1322363,1,10,2,1,0,80
190914,1322363,1,10,3,1,0,81
190915,1322363,1,10,4,0,0,81
190916,1322363,1,10,5,1,0,82
190917,1322363,1,10,6,1,0,83
190918,1322363,1,11,1,1,0,84
190919,1322363,1,11,2,1,0,85
190920,1322363,1,11,3,2,0,87
190921,1322363,1,11,4,1,0,88
190922,1322363,1,11,5,0,0,88
190923,1322363,1,11,6,1,0,89
190924,1322363,1,12,1,2,0,91
190925,1322363,1,12,2,0,1,91
190926,1322363,1,12,3,1,0,92
190927,1322363,1,12,4,0,0,92
190928,1322363,1,12,5,6,0,98
190929,1322363,1,12,6,0,0,98
190930,1322363,1,13,1,0,0,98
190931,1322363,1,13,2,1,0,99
190932,1322363,1,13,3,0,1,99
190933,1322363,1,13,4,0,0,99
190934,1322363,1,13,5,0,0,99
190935,1322363,1,13,6,1,0,100
190936,1322363,1,14,1,1,0,101
190937,1322363,1,14,2,0,0,101
190938,1322363,1,14,3,1,0,102
190939,1322363,1,14,4,0,0,102
190940,1322363,1,14,5,1,0,103
190941,1322363,1,14,6,1,0,104
190942,1322363,1,15,1,0,0,104
190943,1322363,1,15,2,6,0,110
190944,1322363,1,15,3,6,0,116
190945,1322363,1,15,4,0,0,116
190946,1322363,1,15,5,0,0,116
190947,1322363,1,15,6,1,0,117
190948,1322363,1,16,1,1,0,118
190949,1322363,1,16,2,4,0,122
190950,1322363,1,16,3,0,1,122
190951,1322363,1,16,4,1,0,123
190952,1322363,1,16,5,1,0,124
190953,1322363,1,16,6,1,0,125
190954,1322363,1,17,1,6,0,131
190955,1322363,1,17,2,2,0,133
190956,1322363,1,17,3,1,0,134
190957,1322363,1,17,4,0,1,134
190958,1322363,1,17,5,0,0,134
190959,1322363,1,17,6,0,0,134
190960,1322363,1,18,1,1,0,135
190961,1322363,1,18,2,0,0,135
190962,1322363,1,18,3,0,1,135
190963,1322363,1,18,4,0,0,135
190964,1322363,1,18,5,1,0,136
190965,1322363,1,18,6,1,0,137
190966,1322363,1,19,1,2,0,139
190967,1322363,1,19,2,1,1,140
190968,1322363,1,19,3,1,0,141
190969,1322363,1,19,4,0,1,141
190970,1322363,1,19,5,0,0,141
190971,1322363,1,19,6,0,1,141
191060,1322364,1,1,1,1,0,1
191061,1322364,1,1,2,0,0,1
191062,1322364,1,1,3,0,0,1
191063,1322364,1,1,4,1,0,2
191064,1322364,1,1,5,4,0,6
191065,1322364,1,1,6,0,0,6
191066,1322364,1,2,1,0,0,6
191067,1322364,1,2,2,0,0,6
191068,1322364,1,2,3,0,0,6
191069,1322364,1,2,4,0,0,6
191070,1322364,1,2,5,0,0,6
191071,1322364,1,2,6,0,0,6
191072,1322364,1,3,1,1,0,7
191073,1322364,1,3,2,0,0,7
191074,1322364,1,3,3,4,0,11
191075,1322364,1,3,4,1,0,12
191076,1322364,1,3,5,4,0,16
191077,1322364,1,3,6,0,0,16
191078,1322364,1,4,1,0,0,16
191079,1322364,1,4,2,4,0,20
191080,1322364,1,4,3,1,0,21
191081,1322364,1,4,4,0,0,21
191082,1322364,1,4,5,0,0,21
191083,1322364,1,4,6,4,0,25
191084,1322364,1,5,1,0,0,25
191085,1322364,1,5,2,0,0,25
191086,1322364,1,5,3,1,0,26
191087,1322364,1,5,4,0,0,26
191088,1322364,1,5,5,6,0,32
191089,1322364,1,5,6,6,0,38
191090,1322364,1,6,1,1,0,39
191091,1322364,1,6,2,1,0,40
191092,1322364,1,6,3,1,0,41
191093,1322364,1,6,4,4,0,45
191094,1322364,1,6,5,1,0,46
191095,1322364,1,6,6,2,0,48
191096,1322364,1,7,1,4,0,52
191097,1322364,1,7,2,2,0,54
191098,1322364,1,7,3,1,0,55
191099,1322364,1,7,4,0,0,55
191100,1322364,1,7,5,0,0,55
191101,1322364,1,7,6,1,0,56
191102,1322364,1,8,1,0,0,56
191103,1322364,1,8,2,0,0,56
191104,1322364,1,8,3,4,0,60
191105,1322364,1,8,4,1,0,61
191106,1322364,1,8,5,4,0,65
191107,1322364,1,8,6,1,0,66
191108,1322364,1,9,1,6,0,72
191109,1322364,1,9,2,1,0,73
191110,1322364,1,9,3,0,0,73
191111,1322364,1,9,4,0,0,73
191112,1322364,1,9,5,1,0,74
191113,1322364,1,9,6,1,0,75
191114,1322364,1,10,1,1,0,76
191115,1322364,1,10,2,0,0,76
191116,1322364,1,10,3,0,1,76
191117,1322364,1,10,4,0,0,76
191118,1322364,1,10,5,1,0,77
191119,1322364,1,10,6,1,0,78
191120,1322364,1,11,1,1,0,79
191121,1322364,1,11,2,0,0,79
191122,1322364,1,11,3,1,0,80
191123,1322364,1,11,4,1,0,81
191124,1322364,1,11,5,1,0,82
191125,1322364,1,11,6,7,0,89
191126,1322364,1,12,1,4,0,93
191127,1322364,1,12,2,1,0,94
191128,1322364,1,12,3,2,0,96
191129,1322364,1,12,4,6,0,102
191130,1322364,1,12,5,4,0,106
191131,1322364,1,12,6,1,0,107
191132,1322364,1,13,1,0,0,107
191133,1322364,1,13,2,1,0,108
191134,1322364,1,13,3,6,0,114
191135,1322364,1,13,4,1,0,115
191136,1322364,1,13,5,0,0,115
191137,1322364,1,13,6,1,0,116
191138,1322364,1,14,1,1,0,117
191139,1322364,1,14,2,1,0,118
191140,1322364,1,14,3,4,0,122
191141,1322364,1,14,4,0,0,122
191142,1322364,1,14,5,0,1,122
191143,1322364,1,14,6,1,0,123
191144,1322364,1,15,1,1,0,124
191145,1322364,1,15,2,6,0,130
191146,1322364,1,15,3,1,0,131
191147,1322364,1,15,4,0,0,131
191148,1322364,1,15,5,1,0,132
191149,1322364,1,15,6,1,0,133
191150,1322364,1,16,1,0,0,133
191151,1322364,1,16,2,2,0,135
191152,1322364,1,16,3,0,0,135
191153,1322364,1,16,4,4,0,139
191154,1322364,1,16,5,1,0,140
191155,1322364,1,16,6,6,0,146
191156,1322364,1,17,1,0,0,146
191157,1322364,1,17,2,1,0,147
191158,1322364,1,17,3,6,0,153
191159,1322364,1,17,4,1,0,154
191160,1322364,1,17,5,2,1,156
191161,1322364,1,17,6,2,0,158
191162,1322364,1,18,1,4,0,162
191163,1322364,1,18,2,0,1,162
191164,1322364,1,18,3,1,0,163
191165,1322364,1,18,4,4,0,167
191166,1322364,1,18,5,1,0,168
191167,1322364,1,18,6,0,0,168
191168,1322364,1,19,1,1,0,169
191169,1322364,1,19,2,2,0,171
191170,1322364,1,19,3,2,0,173
191171,1322364,1,19,4,4,0,177
191172,1322364,1,19,5,2,0,179
191173,1322364,1,19,6,0,1,179
191174,1322364,1,20,1,0,0,179
191175,1322364,1,20,2,0,0,179
191176,1322364,1,20,3,1,1,180
191177,1322364,1,20,4,0,0,180
191178,1322364,1,20,5,1,0,181
191179,1322364,1,20,6,1,0,182
191299,1323295,1,1,1,1,0,1
191300,1323295,1,1,2,2,0,3
191301,1323295,1,1,3,0,0,3
191302,1323295,1,1,4,4,0,7
191303,1323295,1,1,5,1,0,8
191304,1323295,1,1,6,0,0,8
191305,1323295,1,2,1,2,0,10
191306,1323295,1,2,2,0,0,10
191307,1323295,1,2,3,1,0,11
191308,1323295,1,2,4,1,0,12
191309,1323295,1,2,5,0,0,12
191310,1323295,1,2,6,0,0,12
191311,1323295,1,3,1,0,0,12
191312,1323295,1,3,2,2,0,14
191313,1323295,1,3,3,1,0,15
191314,1323295,1,3,4,0,1,15
191315,1323295,1,3,5,4,0,19
191316,1323295,1,3,6,1,0,20
191317,1323295,1,4,1,1,0,21
191318,1323295,1,4,2,3,0,24
191319,1323295,1,4,3,1,0,25
191320,1323295,1,4,4,0,0,25
191321,1323295,1,4,5,2,0,27
191322,1323295,1,4,6,2,0,29
191323,1323295,1,5,1,4,0,33
191324,1323295,1,5,2,1,0,34
191325,1323295,1,5,3,0,0,34
191326,1323295,1,5,4,1,0,35
191327,1323295,1,5,5,0,0,35
191328,1323295,1,5,6,1,0,36
191329,1323295,1,6,1,1,0,37
191330,1323295,1,6,2,4,0,41
191331,1323295,1,6,3,0,0,41
191332,1323295,1,6,4,1,0,42
191333,1323295,1,6,5,1,0,43
191334,1323295,1,6,6,0,0,43
191335,1323295,1,7,1,0,1,43
191336,1323295,1,7,2,1,0,44
191337,1323295,1,7,3,4,0,48
191338,1323295,1,7,4,2,0,50
191339,1323295,1,7,5,1,0,51
191340,1323295,1,7,6,0,0,51
191341,1323295,1,8,1,1,0,52
191342,1323295,1,8,2,1,0,53
191343,1323295,1,8,3,1,0,54
191344,1323295,1,8,4,4,0,58
191345,1323295,1,8,5,1,0,59
191346,1323295,1,8,6,1,0,60
191347,1323295,1,9,1,1,0,61
191348,1323295,1,9,2,1,0,62
191349,1323295,1,9,3,0,0,62
191350,1323295,1,9,4,1,0,63
191351,1323295,1,9,5,1,0,64
191352,1323295,1,9,6,1,0,65
191353,1323295,1,10,1,1,0,66
191354,1323295,1,10,2,1,0,67
191355,1323295,1,10,3,4,0,71
191356,1323295,1,10,4,1,0,72
191357,1323295,1,10,5,1,0,73
191358,1323295,1,10,6,1,0,74
191359,1323295,1,11,1,1,0,75
191360,1323295,1,11,2,0,0,75
191361,1323295,1,11,3,0,0,75
191362,1323295,1,11,4,4,0,79
191363,1323295,1,11,5,1,0,80
191364,1323295,1,11,6,0,0,80
191365,1323295,1,12,1,6,0,86
191366,1323295,1,12,2,4,0,90
191367,1323295,1,12,3,2,0,92
191368,1323295,1,12,4,4,0,96
191369,1323295,1,12,5,1,0,97
191370,1323295,1,12,6,1,0,98
191371,1323295,1,13,1,1,0,99
191372,1323295,1,13,2,0,1,99
191373,1323295,1,13,3,2,0,101
191374,1323295,1,13,4,1,0,102
191375,1323295,1,13,5,1,0,103
191376,1323295,1,13,6,4,0,107
191377,1323295,1,14,1,4,0,111
191378,1323295,1,14,2,2,0,113
191379,1323295,1,14,3,0,0,113
191380,1323295,1,14,4,1,0,114
191381,1323295,1,14,5,0,0,114
191382,1323295,1,14,6,0,0,114
191383,1323295,1,15,1,1,0,115
191384,1323295,1,15,2,1,0,116
191385,1323295,1,15,3,4,0,120
191386,1323295,1,15,4,1,0,121
191387,1323295,1,15,5,6,0,127
191388,1323295,1,15,6,1,0,128
191389,1323295,1,16,1,1,0,129
191390,1323295,1,16,2,1,0,130
191391,1323295,1,16,3,1,0,131
191392,1323295,1,16,4,1,0,132
191393,1323295,1,16,5,4,0,136
191394,1323295,1,16,6,4,0,140
191395,1323295,1,17,1,4,0,144
191396,1323295,1,17,2,2,0,146
191397,1323295,1,17,3,1,0,147
191398,1323295,1,17,4,0,0,147
191399,1323295,1,17,5,5,0,152
191400,1323295,1,17,6,1,0,153
191401,1323295,1,18,1,4,0,157
191402,1323295,1,18,2,1,0,158
191403,1323295,1,18,3,0,0,158
191404,1323295,1,18,4,4,0,162
191405,1323295,1,18,5,1,0,163
191406,1323295,1,18,6,4,0,167
191407,1323295,1,19,1,4,0,171
191408,1323295,1,19,2,6,0,177
191409,1323295,1,19,3,6,0,183
191410,1323295,1,19,4,1,0,184
191411,1323295,1,19,5,1,0,185
191412,1323295,1,19,6,1,0,186
191413,1323295,1,20,1,1,0,187
191414,1323295,1,20,2,1,0,188
191415,1323295,1,20,3,2,1,190
191416,1323295,1,20,4,4,0,194
191417,1323295,1,20,5,7,0,201
191418,1323295,1,20,6,4,0,205
191539,1323296,1,1,1,0,1,0
191540,1323296,1,1,2,0,0,0
191541,1323296,1,1,3,0,0,0
191542,1323296,1,1,4,5,0,5
191543,1323296,1,1,5,0,0,5
191544,1323296,1,1,6,0,1,5
191545,1323296,1,2,1,1,0,6
191546,1323296,1,2,2,0,0,6
191547,1323296,1,2,3,0,0,6
191548,1323296,1,2,4,0,0,6
191549,1323296,1,2,5,0,0,6
191550,1323296,1,2,6,0,0,6
191551,1323296,1,3,1,0,0,6
191552,1323296,1,3,2,0,0,6
191553,1323296,1,3,3,0,1,6
191554,1323296,1,3,4,0,0,6
191555,1323296,1,3,5,0,0,6
191556,1323296,1,3,6,4,0,10
191557,1323296,1,4,1,0,0,10
191558,1323296,1,4,2,0,0,10
191559,1323296,1,4,3,1,0,11
191560,1323296,1,4,4,0,0,11
191561,1323296,1,4,5,0,0,11
191562,1323296,1,4,6,4,0,15
191563,1323296,1,5,1,0,0,15
191564,1323296,1,5,2,4,0,19
191565,1323296,1,5,3,1,0,20
191566,1323296,1,5,4,0,1,20
191567,1323296,1,5,5,0,0,20
191568,1323296,1,5,6,0,0,20
191569,1323296,1,6,1,4,0,24
191570,1323296,1,6,2,1,0,25
191571,1323296,1,6,3,1,0,26
191572,1323296,1,6,4,0,0,26
191573,1323296,1,6,5,0,0,26
191574,1323296,1,6,6,0,0,26
191575,1323296,1,7,1,1,0,27
191576,1323296,1,7,2,2,0,29
191577,1323296,1,7,3,1,0,30
191578,1323296,1,7,4,1,0,31
191579,1323296,1,7,5,0,1,31
191580,1323296,1,7,6,1,0,32
191581,1323296,1,8,1,0,0,32
191582,1323296,1,8,2,0,0,32
191583,1323296,1,8,3,2,0,34
191584,1323296,1,8,4,2,0,36
191585,1323296,1,8,5,2,0,38
191586,1323296,1,8,6,0,0,38
191587,1323296,1,9,1,1,0,39
191588,1323296,1,9,2,0,0,39
191589,1323296,1,9,3,1,0,40
191590,1323296,1,9,4,0,0,40
191591,1323296,1,9,5,0,0,40
191592,1323296,1,9,6,1,0,41
191593,1323296,1,10,1,0,0,41
191594,1323296,1,10,2,0,0,41
191595,1323296,1,10,3,2,0,43
191596,1323296,1,10,4,3,0,46
191597,1323296,1,10,5,0,0,46
191598,1323296,1,10,6,0,0,46
191599,1323296,1,11,1,2,0,48
191600,1323296,1,11,2,2,0,50
191601,1323296,1,11,3,0,0,50
191602,1323296,1,11,4,0,0,50
191603,1323296,1,11,5,1,0,51
191604,1323296,1,11,6,1,0,52
191605,1323296,1,12,1,1,0,53
191606,1323296,1,12,2,0,0,53
191607,1323296,1,12,3,0,0,53
191608,1323296,1,12,4,1,0,54
191609,1323296,1,12,5,1,0,55
191610,1323296,1,12,6,0,0,55
191611,1323296,1,13,1,1,0,56
191612,1323296,1,13,2,6,0,62
191613,1323296,1,13,3,1,0,63
191614,1323296,1,13,4,0,0,63
191615,1323296,1,13,5,4,0,67
191616,1323296,1,13,6,0,0,67
191617,1323296,1,14,1,1,0,68
191618,1323296,1,14,2,4,0,72
191619,1323296,1,14,3,1,0,73
191620,1323296,1,14,4,1,0,74
191621,1323296,1,14,5,0,0,74
191622,1323296,1,14,6,1,0,75
191623,1323296,1,15,1,1,0,76
191624,1323296,1,15,2,4,0,80
191625,1323296,1,15,3,4,0,84
191626,1323296,1,15,4,0,0,84
191627,1323296,1,15,5,2,0,86
191628,1323296,1,15,6,1,0,87
191629,1323296,1,16,1,1,0,88
191630,1323296,1,16,2,1,0,89
191631,1323296,1,16,3,1,0,90
191632,1323296,1,16,4,1,0,91
191633,1323296,1,16,5,2,0,93
191634,1323296,1,16,6,1,0,94
191635,1323296,1,17,1,2,0,96
191636,1323296,1,17,2,1,0,97
191637,1323296,1,17,3,0,0,97
191638,1323296,1,17,4,1,0,98
191639,1323296,1,17,5,1,0,99
191640,1323296,1,17,6,6,0,105
191641,1323296,1,18,1,4,0,109
191642,1323296,1,18,2,0,0,109
191643,1323296,1,18,3,2,0,111
191644,1323296,1,18,4,0,1,111
191645,1323296,1,18,5,1,0,112
191646,1323296,1,18,6,1,0,113
191647,1323296,1,19,1,3,0,116
191648,1323296,1,19,2,0,1,116
191649,1323296,1,19,3,1,0,117
191650,1323296,1,19,4,5,0,122
191651,1323296,1,19,5,0,0,122
191652,1323296,1,19,6,1,0,123
191653,1323296,1,20,1,0,0,123
191654,1323296,1,20,2,1,0,124
191655,1323296,1,20,3,2,0,126
191656,1323296,1,20,4,0,1,126
191657,1323296,1,20,5,7,0,133
191658,1323296,1,20,6,2,0,135
191764,1323297,1,1,1,4,0,4
191765,1323297,1,1,2,0,0,4
191766,1323297,1,1,3,0,0,4
191767,1323297,1,1,4,1,0,5
191768,1323297,1,1,5,0,0,5
191769,1323297,1,1,6,1,0,6
191770,1323297,1,2,1,0,0,6
191771,1323297,1,2,2,0,0,6
191772,1323297,1,2,3,1,0,7
191773,1323297,1,2,4,1,0,8
191774,1323297,1,2,5,6,0,14
191775,1323297,1,2,6,0,0,14
191776,1323297,1,3,1,4,0,18
191777,1323297,1,3,2,0,0,18
191778,1323297,1,3,3,6,0,24
191779,1323297,1,3,4,1,0,25
191780,1323297,1,3,5,0,0,25
191781,1323297,1,3,6,4,0,29
191782,1323297,1,4,1,0,1,29
191783,1323297,1,4,2,0,0,29
191784,1323297,1,4,3,0,0,29
191785,1323297,1,4,4,1,0,30
191786,1323297,1,4,5,4,0,34
191787,1323297,1,4,6,1,0,35
191788,1323297,1,5,1,0,0,35
191789,1323297,1,5,2,1,0,36
191790,1323297,1,5,3,0,0,36
191791,1323297,1,5,4,4,0,40
191792,1323297,1,5,5,1,0,41
191793,1323297,1,5,6,0,0,41
191794,1323297,1,6,1,4,0,45
191795,1323297,1,6,2,0,1,45
191796,1323297,1,6,3,0,1,45
191797,1323297,1,6,4,0,0,45
191798,1323297,1,6,5,0,0,45
191799,1323297,1,6,6,0,0,45
191800,1323297,1,7,1,0,0,45
191801,1323297,1,7,2,0,0,45
191802,1323297,1,7,3,2,0,47
191803,1323297,1,7,4,1,0,48
191804,1323297,1,7,5,1,0,49
191805,1323297,1,7,6,0,0,49
191806,1323297,1,8,1,0,0,49
191807,1323297,1,8,2,1,0,50
191808,1323297,1,8,3,1,0,51
191809,1323297,1,8,4,1,0,52
191810,1323297,1,8,5,0,0,52
191811,1323297,1,8,6,1,0,53
191812,1323297,1,9,1,0,0,53
191813,1323297,1,9,2,1,0,54
191814,1323297,1,9,3,0,1,54
191815,1323297,1,9,4,0,0,54
191816,1323297,1,9,5,1,0,55
191817,1323297,1,9,6,0,0,55
191818,1323297,1,10,1,0,1,55
191819,1323297,1,10,2,0,0,55
191820,1323297,1,10,3,0,0,55
191821,1323297,1,10,4,0,0,55
191822,1323297,1,10,5,1,0,56
191823,1323297,1,10,6,0,0,56
191824,1323297,1,11,1,0,0,56
191825,1323297,1,11,2,0,0,56
191826,1323297,1,11,3,1,0,57
191827,1323297,1,11,4,0,0,57
191828,1323297,1,11,5,1,0,58
191829,1323297,1,11,6,0,0,58
191830,1323297,1,12,1,0,0,58
191831,1323297,1,12,2,1,0,59
191832,1323297,1,12,3,1,0,60
191833,1323297,1,12,4,1,0,61
191834,1323297,1,12,5,0,0,61
191835,1323297,1,12,6,4,0,65
191836,1323297,1,13,1,1,0,66
191837,1323297,1,13,2,0,0,66
191838,1323297,1,13,3,1,0,67
191839,1323297,1,13,4,0,0,67
191840,1323297,1,13,5,0,0,67
191841,1323297,1,13,6,0,1,67
191842,1323297,1,14,1,1,0,68
191843,1323297,1,14,2,4,0,72
191844,1323297,1,14,3,4,0,76
191845,1323297,1,14,4,0,0,76
191846,1323297,1,14,5,0,0,76
191847,1323297,1,14,6,0,0,76
191848,1323297,1,15,1,6,0,82
191849,1323297,1,15,2,6,0,88
191850,1323297,1,15,3,6,0,94
191851,1323297,1,15,4,6,0,100
191852,1323297,1,15,5,4,0,104
191853,1323297,1,15,6,6,0,110
191854,1323297,1,16,1,0,0,110
191855,1323297,1,16,2,1,0,111
191856,1323297,1,16,3,0,0,111
191857,1323297,1,16,4,1,0,112
191858,1323297,1,16,5,4,0,116
191859,1323297,1,16,6,4,0,120
191860,1323297,1,17,1,1,0,121
191861,1323297,1,17,2,2,0,123
191862,1323297,1,17,3,0,0,123
191863,1323297,1,17,4,6,0,129
191864,1323297,1,17,5,1,0,130
191865,1323297,1,17,6,7,0,137
191866,1323297,1,18,1,0,0,137
191867,1323297,1,18,2,0,0,137
191868,1323297,1,18,3,6,0,143
191869,1323297,1,18,4,0,0,143
191870,1323297,1,18,5,2,0,145
191871,1323297,1,18,6,1,0,146
191872,1323297,1,19,1,0,1,146
191873,1323297,1,19,2,1,0,147
191874,1323297,1,19,3,1,0,148
191875,1323297,1,19,4,0,0,148
191876,1323297,1,19,5,2,0,150
191877,1323297,1,19,6,0,1,150
191878,1323297,1,20,1,0,0,150
191879,1323297,1,20,2,1,0,151
191880,1323297,1,20,3,1,0,152
191881,1323297,1,20,4,1,0,153
191882,1323297,1,20,5,0,0,153
191883,1323297,1,20,6,3,0,156
192004,1327228,1,1,1,1,0,1
192005,1327228,1,1,2,4,0,5
192006,1327228,1,1,3,1,0,6
192007,1327228,1,1,4,1,0,7
192008,1327228,1,1,5,1,0,8
192009,1327228,1,1,6,1,0,9
192010,1327228,1,2,1,0,0,9
192011,1327228,1,2,2,0,0,9
192012,1327228,1,2,3,0,0,9
192013,1327228,1,2,4,1,0,10
192014,1327228,1,2,5,4,0,14
192015,1327228,1,2,6,1,0,15
192016,1327228,1,3,1,3,0,18
192017,1327228,1,3,2,4,0,22
192018,1327228,1,3,3,4,0,26
192019,1327228,1,3,4,1,0,27
192020,1327228,1,3,5,4,0,31
192021,1327228,1,3,6,1,0,32
192022,1327228,1,4,1,0,0,32
192023,1327228,1,4,2,1,0,33
192024,1327228,1,4,3,1,0,34
192025,1327228,1,4,4,1,0,35
192026,1327228,1,4,5,0,0,35
192027,1327228,1,4,6,1,0,36
192028,1327228,1,5,1,0,0,36
192029,1327228,1,5,2,1,0,37
192030,1327228,1,5,3,1,0,38
192031,1327228,1,5,4,4,0,42
192032,1327228,1,5,5,1,0,43
192033,1327228,1,5,6,0,0,43
192034,1327228,1,6,1,4,0,47
192035,1327228,1,6,2,0,0,47
192036,1327228,1,6,3,1,0,48
192037,1327228,1,6,4,0,0,48
192038,1327228,1,6,5,1,0,49
192039,1327228,1,6,6,2,0,51
192040,1327228,1,7,1,1,0,52
192041,1327228,1,7,2,4,0,56
192042,1327228,1,7,3,1,0,57
192043,1327228,1,7,4,1,0,58
192044,1327228,1,7,5,4,0,62
192045,1327228,1,7,6,1,0,63
192046,1327228,1,8,1,1,0,64
192047,1327228,1,8,2,2,0,66
192048,1327228,1,8,3,0,0,66
192049,1327228,1,8,4,1,0,67
192050,1327228,1,8,5,1,0,68
192051,1327228,1,8,6,2,0,70
192052,1327228,1,9,1,1,0,71
192053,1327228,1,9,2,2,0,73
192054,1327228,1,9,3,1,0,74
192055,1327228,1,9,4,1,0,75
192056,1327228,1,9,5,6,0,81
192057,1327228,1,9,6,2,0,83
192058,1327228,1,10,1,0,0,83
192059,1327228,1,10,2,2,0,85
192060,1327228,1,10,3,0,1,85
192061,1327228,1,10,4,0,0,85
192062,1327228,1,10,5,2,0,87
192063,1327228,1,10,6,0,0,87
192064,1327228,1,11,1,1,0,88
192065,1327228,1,11,2,1,0,89
192066,1327228,1,11,3,1,0,90
192067,1327228,1,11,4,1,0,91
192068,1327228,1,11,5,1,0,92
192069,1327228,1,11,6,1,0,93
192070,1327228,1,12,1,1,0,94
192071,1327228,1,12,2,1,0,95
192072,1327228,1,12,3,1,0,96
192073,1327228,1,12,4,6,0,102
192074,1327228,1,12,5,1,0,103
192075,1327228,1,12,6,1,0,104
192076,1327228,1,13,1,1,0,105
192077,1327228,1,13,2,0,0,105
192078,1327228,1,13,3,0,0,105
192079,1327228,1,13,4,0,0,105
192080,1327228,1,13,5,1,0,106
192081,1327228,1,13,6,1,0,107
192082,1327228,1,14,1,1,0,108
192083,1327228,1,14,2,1,0,109
192084,1327228,1,14,3,0,1,109
192085,1327228,1,14,4,0,0,109
192086,1327228,1,14,5,0,0,109
192087,1327228,1,14,6,1,0,110
192088,1327228,1,15,1,4,0,114
192089,1327228,1,15,2,1,0,115
192090,1327228,1,15,3,2,0,117
192091,1327228,1,15,4,0,1,117
192092,1327228,1,15,5,2,0,119
192093,1327228,1,15,6,1,0,120
192094,1327228,1,16,1,0,1,120
192095,1327228,1,16,2,0,0,120
192096,1327228,1,16,3,2,0,122
192097,1327228,1,16,4,1,0,123
192098,1327228,1,16,5,2,0,125
192099,1327228,1,16,6,0,0,125
192100,1327228,1,17,1,0,0,125
192101,1327228,1,17,2,6,0,131
192102,1327228,1,17,3,1,0,132
192103,1327228,1,17,4,1,0,133
192104,1327228,1,17,5,1,0,134
192105,1327228,1,17,6,3,0,137
192106,1327228,1,18,1,0,1,137
192107,1327228,1,18,2,1,0,138
192108,1327228,1,18,3,1,0,139
192109,1327228,1,18,4,1,0,140
192110,1327228,1,18,5,0,0,140
192111,1327228,1,18,6,1,0,141
192112,1327228,1,19,1,6,0,147
192113,1327228,1,19,2,1,0,148
192114,1327228,1,19,3,0,0,148
192115,1327228,1,19,4,1,0,149
192116,1327228,1,19,5,0,0,149
192117,1327228,1,19,6,1,0,150
192118,1327228,1,20,1,6,0,156
192119,1327228,1,20,2,0,1,156
192120,1327228,1,20,3,1,0,157
192121,1327228,1,20,4,0,1,157
192122,1327228,1,20,5,0,0,157
192123,1327228,1,20,6,1,0,158
192240,1327229,1,1,1,1,0,1
192241,1327229,1,1,2,0,0,1
192242,1327229,1,1,3,1,0,2
192243,1327229,1,1,4,0,0,2
192244,1327229,1,1,5,1,0,3
192245,1327229,1,1,6,0,0,3
192246,1327229,1,2,1,6,0,9
192247,1327229,1,2,2,0,0,9
192248,1327229,1,2,3,1,0,10
192249,1327229,1,2,4,0,0,10
192250,1327229,1,2,5,2,0,12
192251,1327229,1,2,6,1,0,13
192252,1327229,1,3,1,0,0,13
192253,1327229,1,3,2,0,0,13
192254,1327229,1,3,3,0,0,13
192255,1327229,1,3,4,4,0,17
192256,1327229,1,3,5,6,0,23
192257,1327229,1,3,6,1,0,24
192258,1327229,1,4,1,1,0,25
192259,1327229,1,4,2,1,0,26
192260,1327229,1,4,3,0,0,26
192261,1327229,1,4,4,4,0,30
192262,1327229,1,4,5,1,0,31
192263,1327229,1,4,6,1,0,32
192264,1327229,1,5,1,4,0,36
192265,1327229,1,5,2,1,0,37
192266,1327229,1,5,3,0,0,37
192267,1327229,1,5,4,0,0,37
192268,1327229,1,5,5,4,0,41
192269,1327229,1,5,6,1,0,42
192270,1327229,1,6,1,0,1,42
192271,1327229,1,6,2,0,1,42
192272,1327229,1,6,3,0,0,42
192273,1327229,1,6,4,2,0,44
192274,1327229,1,6,5,0,0,44
192275,1327229,1,6,6,4,0,48
192276,1327229,1,7,1,2,0,50
192277,1327229,1,7,2,1,0,51
192278,1327229,1,7,3,0,0,51
192279,1327229,1,7,4,1,0,52
192280,1327229,1,7,5,0,0,52
192281,1327229,1,7,6,1,0,53
192282,1327229,1,8,1,1,0,54
192283,1327229,1,8,2,1,0,55
192284,1327229,1,8,3,0,0,55
192285,1327229,1,8,4,2,0,57
192286,1327229,1,8,5,1,0,58
192287,1327229,1,8,6,4,0,62
192288,1327229,1,9,1,0,0,62
192289,1327229,1,9,2,1,0,63
192290,1327229,1,9,3,0,0,63
192291,1327229,1,9,4,2,0,65
192292,1327229,1,9,5,1,0,66
192293,1327229,1,9,6,0,0,66
192294,1327229,1,10,1,4,0,70
192295,1327229,1,10,2,2,0,72
192296,1327229,1,10,3,1,0,73
192297,1327229,1,10,4,1,0,74
192298,1327229,1,10,5,2,0,76
192299,1327229,1,10,6,4,0,80
192300,1327229,1,11,1,1,0,81
192301,1327229,1,11,2,2,0,83
192302,1327229,1,11,3,4,0,87
192303,1327229,1,11,4,4,0,91
192304,1327229,1,11,5,1,0,92
192305,1327229,1,11,6,1,0,93
192306,1327229,1,12,1,2,0,95
192307,1327229,1,12,2,0,0,95
192308,1327229,1,12,3,0,1,95
192309,1327229,1,12,4,0,0,95
192310,1327229,1,12,5,0,0,95
192311,1327229,1,12,6,1,0,96
192312,1327229,1,13,1,1,0,97
192313,1327229,1,13,2,4,0,101
192314,1327229,1,13,3,0,1,101
192315,1327229,1,13,4,0,0,101
192316,1327229,1,13,5,1,0,102
192317,1327229,1,13,6,1,0,103
192318,1327229,1,14,1,0,0,103
192319,1327229,1,14,2,2,0,105
192320,1327229,1,14,3,6,0,111
192321,1327229,1,14,4,0,0,111
192322,1327229,1,14,5,1,0,112
192323,1327229,1,14,6,2,0,114
192324,1327229,1,15,1,5,0,119
192325,1327229,1,15,2,0,0,119
192326,1327229,1,15,3,1,0,120
192327,1327229,1,15,4,1,0,121
192328,1327229,1,15,5,6,0,127
192329,1327229,1,15,6,6,0,133
192330,1327229,1,16,1,4,0,137
192331,1327229,1,16,2,1,0,138
192332,1327229,1,16,3,2,0,140
192333,1327229,1,16,4,4,0,144
192334,1327229,1,16,5,1,0,145
192335,1327229,1,16,6,6,0,151
192336,1327229,1,17,1,1,0,152
192337,1327229,1,17,2,0,0,152
192338,1327229,1,17,3,6,0,158
192339,1327229,1,17,4,1,0,159
192340,1327229,1,17,5,1,0,160
192341,1327229,1,17,6,0,1,160
192342,1327229,1,18,1,1,0,161
192343,1327229,1,18,2,1,0,162
192344,1327229,1,18,3,4,0,166
192345,1327229,1,18,4,1,0,167
192346,1327229,1,18,5,1,0,168
192347,1327229,1,18,6,4,0,172
192348,1327229,1,19,1,4,0,176
192349,1327229,1,19,2,1,0,177
192350,1327229,1,19,3,0,0,177
192351,1327229,1,19,4,1,0,178
192352,1327229,1,19,5,0,0,178
192353,1327229,1,19,6,2,0,180
192354,1327229,1,20,1,2,0,182
192355,1327229,1,20,2,4,0,186
192356,1327229,1,20,3,0,0,186
192357,1327229,1,20,4,1,0,187
192358,1327229,1,20,5,6,0,193
192359,1327229,1,20,6,6,0,199
192477,1327230,1,1,1,1,0,1
192478,1327230,1,1,2,1,0,2
192479,1327230,1,1,3,1,0,3
192480,1327230,1,1,4,0,0,3
192481,1327230,1,1,5,0,0,3
192482,1327230,1,1,6,4,0,7
192483,1327230,1,2,1,4,0,11
192484,1327230,1,2,2,1,0,12
192485,1327230,1,2,3,1,0,13
192486,1327230,1,2,4,1,0,14
192487,1327230,1,2,5,0,0,14
192488,1327230,1,2,6,4,0,18
192489,1327230,1,3,1,0,1,18
192490,1327230,1,3,2,1,0,19
192491,1327230,1,3,3,1,0,20
192492,1327230,1,3,4,1,0,21
192493,1327230,1,3,5,0,0,21
192494,1327230,1,3,6,0,0,21
192495,1327230,1,4,1,4,0,25
192496,1327230,1,4,2,0,0,25
192497,1327230,1,4,3,0,0,25
192498,1327230,1,4,4,3,0,28
192499,1327230,1,4,5,4,0,32
192500,1327230,1,4,6,4,0,36
192501,1327230,1,5,1,0,0,36
192502,1327230,1,5,2,0,0,36
192503,1327230,1,5,3,0,0,36
192504,1327230,1,5,4,1,0,37
192505,1327230,1,5,5,4,0,41
192506,1327230,1,5,6,4,0,45
192507,1327230,1,6,1,0,0,45
192508,1327230,1,6,2,1,0,46
192509,1327230,1,6,3,1,0,47
192510,1327230,1,6,4,2,0,49
192511,1327230,1,6,5,4,0,53
192512,1327230,1,6,6,4,0,57
192513,1327230,1,7,1,4,0,61
192514,1327230,1,7,2,0,1,61
192515,1327230,1,7,3,4,0,65
192516,1327230,1,7,4,1,0,66
192517,1327230,1,7,5,1,0,67
192518,1327230,1,7,6,4,0,71
192519,1327230,1,8,1,1,0,72
192520,1327230,1,8,2,1,0,73
192521,1327230,1,8,3,1,0,74
192522,1327230,1,8,4,1,0,75
192523,1327230,1,8,5,1,0,76
192524,1327230,1,8,6,1,0,77
192525,1327230,1,9,1,4,0,81
192526,1327230,1,9,2,1,0,82
192527,1327230,1,9,3,0,1,82
192528,1327230,1,9,4,1,0,83
192529,1327230,1,9,5,0,0,83
192530,1327230,1,9,6,1,0,84
192531,1327230,1,10,1,0,0,84
192532,1327230,1,10,2,1,0,85
192533,1327230,1,10,3,0,0,85
192534,1327230,1,10,4,1,0,86
192535,1327230,1,10,5,2,0,88
192536,1327230,1,10,6,1,0,89
192537,1327230,1,11,1,1,0,90
192538,1327230,1,11,2,0,0,90
192539,1327230,1,11,3,6,0,96
192540,1327230,1,11,4,1,0,97
192541,1327230,1,11,5,1,0,98
192542,1327230,1,11,6,6,0,104
192543,1327230,1,12,1,1,0,105
192544,1327230,1,12,2,1,0,106
192545,1327230,1,12,3,4,0,110
192546,1327230,1,12,4,4,0,114
192547,1327230,1,12,5,1,0,115
192548,1327230,1,12,6,1,0,116
192549,1327230,1,13,1,1,0,117
192550,1327230,1,13,2,4,0,121
192551,1327230,1,13,3,1,0,122
192552,1327230,1,13,4,1,0,123
192553,1327230,1,13,5,1,0,124
192554,1327230,1,13,6,4,0,128
192555,1327230,1,14,1,1,0,129
192556,1327230,1,14,2,6,0,135
192557,1327230,1,14,3,1,0,136
192558,1327230,1,14,4,1,0,137
192559,1327230,1,14,5,1,0,138
192560,1327230,1,14,6,1,0,139
192561,1327230,1,15,1,4,0,143
192562,1327230,1,15,2,1,0,144
192563,1327230,1,15,3,1,0,145
192564,1327230,1,15,4,1,0,146
192565,1327230,1,15,5,5,0,151
192566,1327230,1,15,6,1,0,152
192567,1327230,1,16,1,2,0,154
192568,1327230,1,16,2,0,0,154
192569,1327230,1,16,3,4,0,158
192570,1327230,1,16,4,0,0,158
192571,1327230,1,16,5,6,0,164
192572,1327230,1,16,6,4,0,168
192573,1327230,1,17,1,0,0,168
192574,1327230,1,17,2,1,0,169
192575,1327230,1,17,3,3,0,172
192576,1327230,1,17,4,0,0,172
192577,1327230,1,17,5,4,0,176
192578,1327230,1,17,6,2,0,178
192579,1327230,1,18,1,6,0,184
192580,1327230,1,18,2,2,0,186
192581,1327230,1,18,3,1,0,187
192582,1327230,1,18,4,1,0,188
192583,1327230,1,18,5,0,0,188
192584,1327230,1,18,6,4,0,192
192585,1327230,1,19,1,4,0,196
192586,1327230,1,19,2,3,0,199
192587,1327230,1,19,3,6,0,205
192588,1327230,1,19,4,4,0,209
192589,1327230,1,19,5,1,0,210
192590,1327230,1,19,6,1,0,211
192591,1327230,1,20,1,0,0,211
192592,1327230,1,20,2,1,0,212
192593,1327230,1,20,3,4,0,216
192594,1327230,1,20,4,1,0,217
192595,1327230,1,20,5,2,0,219
192596,1327230,1,20,6,2,0,221
192717,1327231,1,1,1,0,0,0
192718,1327231,1,1,2,4,0,4
192719,1327231,1,1,3,0,0,4
192720,1327231,1,1,4,1,0,5
192721,1327231,1,1,5,1,0,6
192722,1327231,1,1,6,1,0,7
192723,1327231,1,2,1,0,0,7
192724,1327231,1,2,2,4,0,11
192725,1327231,1,2,3,0,0,11
192726,1327231,1,2,4,0,0,11
192727,1327231,1,2,5,4,0,15
192728,1327231,1,2,6,0,0,15
192729,1327231,1,3,1,1,0,16
192730,1327231,1,3,2,4,0,20
192731,1327231,1,3,3,0,0,20
192732,1327231,1,3,4,1,0,21
192733,1327231,1,3,5,0,0,21
192734,1327231,1,3,6,2,0,23
192735,1327231,1,4,1,0,0,23
192736,1327231,1,4,2,2,0,25
192737,1327231,1,4,3,0,0,25
192738,1327231,1,4,4,1,0,26
192739,1327231,1,4,5,1,0,27
192740,1327231,1,4,6,4,0,31
192741,1327231,1,5,1,4,0,35
192742,1327231,1,5,2,0,0,35
192743,1327231,1,5,3,1,0,36
192744,1327231,1,5,4,4,0,40
192745,1327231,1,5,5,0,0,40
192746,1327231,1,5,6,2,0,42
192747,1327231,1,6,1,1,0,43
192748,1327231,1,6,2,4,0,47
192749,1327231,1,6,3,3,0,50
192750,1327231,1,6,4,0,0,50
192751,1327231,1,6,5,1,0,51
192752,1327231,1,6,6,1,0,52
192753,1327231,1,7,1,1,0,53
192754,1327231,1,7,2,1,0,54
192755,1327231,1,7,3,1,0,55
192756,1327231,1,7,4,1,0,56
192757,1327231,1,7,5,1,0,57
192758,1327231,1,7,6,2,0,59
192759,1327231,1,8,1,1,0,60
192760,1327231,1,8,2,1,0,61
192761,1327231,1,8,3,4,0,65
192762,1327231,1,8,4,4,0,69
192763,1327231,1,8,5,1,0,70
192764,1327231,1,8,6,1,0,71
192765,1327231,1,9,1,1,0,72
192766,1327231,1,9,2,0,0,72
192767,1327231,1,9,3,1,0,73
192768,1327231,1,9,4,0,0,73
192769,1327231,1,9,5,0,0,73
192770,1327231,1,9,6,1,0,74
192771,1327231,1,10,1,1,0,75
192772,1327231,1,10,2,2,0,77
192773,1327231,1,10,3,1,0,78
192774,1327231,1,10,4,1,0,79
192775,1327231,1,10,5,1,0,80
192776,1327231,1,10,6,2,0,82
192777,1327231,1,11,1,1,0,83
192778,1327231,1,11,2,0,0,83
192779,1327231,1,11,3,1,0,84
192780,1327231,1,11,4,1,0,85
192781,1327231,1,11,5,6,0,91
192782,1327231,1,11,6,1,0,92
192783,1327231,1,12,1,1,0,93
192784,1327231,1,12,2,2,0,95
192785,1327231,1,12,3,1,0,96
192786,1327231,1,12,4,1,0,97
192787,1327231,1,12,5,0,1,97
192788,1327231,1,12,6,1,0,98
192789,1327231,1,13,1,0,0,98
192790,1327231,1,13,2,1,0,99
192791,1327231,1,13,3,1,0,100
192792,1327231,1,13,4,1,0,101
192793,1327231,1,13,5,1,0,102
192794,1327231,1,13,6,2,0,104
192795,1327231,1,14,1,4,0,108
192796,1327231,1,14,2,2,0,110
192797,1327231,1,14,3,1,0,111
192798,1327231,1,14,4,1,0,112
192799,1327231,1,14,5,1,0,113
192800,1327231,1,14,6,0,0,113
192801,1327231,1,15,1,2,0,115
192802,1327231,1,15,2,0,0,115
192803,1327231,1,15,3,1,0,116
192804,1327231,1,15,4,2,0,118
192805,1327231,1,15,5,1,0,119
192806,1327231,1,15,6,1,0,120
192807,1327231,1,16,1,1,0,121
192808,1327231,1,16,2,1,0,122
192809,1327231,1,16,3,4,0,126
192810,1327231,1,16,4,1,0,127
192811,1327231,1,16,5,2,0,129
192812,1327231,1,16,6,1,0,130
192813,1327231,1,17,1,0,0,130
192814,1327231,1,17,2,1,0,131
192815,1327231,1,17,3,2,0,133
192816,1327231,1,17,4,2,0,135
192817,1327231,1,17,5,1,0,136
192818,1327231,1,17,6,1,0,137
192819,1327231,1,18,1,1,0,138
192820,1327231,1,18,2,1,0,139
192821,1327231,1,18,3,1,0,140
192822,1327231,1,18,4,4,0,144
192823,1327231,1,18,5,1,0,145
192824,1327231,1,18,6,1,0,146
192825,1327231,1,19,1,1,0,147
192826,1327231,1,19,2,2,0,149
192827,1327231,1,19,3,0,1,149
192828,1327231,1,19,4,1,0,150
192829,1327231,1,19,5,1,0,151
192830,1327231,1,19,6,1,0,152
192831,1327231,1,20,1,0,1,152
192832,1327231,1,20,2,0,1,152
192833,1327231,1,20,3,6,0,158
192834,1327231,1,20,4,1,0,159
192835,1327231,1,20,5,1,0,160
192836,1327231,1,20,6,6,0,166
192953,1327232,1,1,1,1,0,1
192954,1327232,1,1,2,2,0,3
192955,1327232,1,1,3,0,0,3
192956,1327232,1,1,4,0,0,3
192957,1327232,1,1,5,4,0,7
192958,1327232,1,1,6,0,0,7
192959,1327232,1,2,1,1,0,8
192960,1327232,1,2,2,0,0,8
192961,1327232,1,2,3,2,0,10
192962,1327232,1,2,4,2,0,12
192963,1327232,1,2,5,0,0,12
192964,1327232,1,2,6,1,0,13
192965,1327232,1,3,1,1,0,14
192966,1327232,1,3,2,1,0,15
192967,1327232,1,3,3,1,0,16
192968,1327232,1,3,4,1,0,17
192969,1327232,1,3,5,0,1,17
192970,1327232,1,3,6,0,0,17
192971,1327232,1,4,1,1,0,18
192972,1327232,1,4,2,1,0,19
192973,1327232,1,4,3,1,0,20
192974,1327232,1,4,4,1,0,21
192975,1327232,1,4,5,1,0,22
192976,1327232,1,4,6,0,0,22
192977,1327232,1,5,1,0,0,22
192978,1327232,1,5,2,1,0,23
192979,1327232,1,5,3,1,0,24
192980,1327232,1,5,4,1,0,25
192981,1327232,1,5,5,4,0,29
192982,1327232,1,5,6,4,0,33
192983,1327232,1,6,1,2,0,35
192984,1327232,1,6,2,6,0,41
192985,1327232,1,6,3,0,0,41
192986,1327232,1,6,4,1,0,42
192987,1327232,1,6,5,0,1,42
192988,1327232,1,6,6,1,0,43
192989,1327232,1,7,1,1,0,44
192990,1327232,1,7,2,1,0,45
192991,1327232,1,7,3,1,0,46
192992,1327232,1,7,4,0,0,46
192993,1327232,1,7,5,2,0,48
192994,1327232,1,7,6,1,0,49
192995,1327232,1,8,1,1,0,50
192996,1327232,1,8,2,1,0,51
192997,1327232,1,8,3,0,1,51
192998,1327232,1,8,4,1,0,52
192999,1327232,1,8,5,0,0,52
193000,1327232,1,8,6,0,0,52
193001,1327232,1,9,1,4,0,56
193002,1327232,1,9,2,1,0,57
193003,1327232,1,9,3,1,0,58
193004,1327232,1,9,4,0,0,58
193005,1327232,1,9,5,0,0,58
193006,1327232,1,9,6,1,0,59
193007,1327232,1,10,1,1,0,60
193008,1327232,1,10,2,1,0,61
193009,1327232,1,10,3,2,0,63
193010,1327232,1,10,4,2,0,65
193011,1327232,1,10,5,0,0,65
193012,1327232,1,10,6,1,0,66
193013,1327232,1,11,1,1,0,67
193014,1327232,1,11,2,6,0,73
193015,1327232,1,11,3,1,0,74
193016,1327232,1,11,4,1,0,75
193017,1327232,1,11,5,0,0,75
193018,1327232,1,11,6,1,0,76
193019,1327232,1,12,1,4,0,80
193020,1327232,1,12,2,1,0,81
193021,1327232,1,12,3,0,1,81
193022,1327232,1,12,4,1,0,82
193023,1327232,1,12,5,1,0,83
193024,1327232,1,12,6,0,0,83
193025,1327232,1,13,1,1,0,84
193026,1327232,1,13,2,4,0,88
193027,1327232,1,13,3,0,1,88
193028,1327232,1,13,4,0,0,88
193029,1327232,1,13,5,0,0,88
193030,1327232,1,13,6,0,1,88
193031,1327232,1,14,1,4,0,92
193032,1327232,1,14,2,1,0,93
193033,1327232,1,14,3,6,0,99
193034,1327232,1,14,4,1,1,100
193035,1327232,1,14,5,2,0,102
193036,1327232,1,14,6,4,0,106
193037,1327232,1,15,1,1,0,107
193038,1327232,1,15,2,1,0,108
193039,1327232,1,15,3,2,0,110
193040,1327232,1,15,4,1,0,111
193041,1327232,1,15,5,1,0,112
193042,1327232,1,15,6,2,0,114
193043,1327232,1,16,1,1,0,115
193044,1327232,1,16,2,1,0,116
193045,1327232,1,16,3,1,0,117
193046,1327232,1,16,4,1,0,118
193047,1327232,1,16,5,0,1,118
193048,1327232,1,16,6,0,0,118
193049,1327232,1,17,1,1,0,119
193050,1327232,1,17,2,1,0,120
193051,1327232,1,17,3,0,0,120
193052,1327232,1,17,4,6,0,126
193053,1327232,1,17,5,2,0,128
193054,1327232,1,17,6,1,0,129
193055,1327232,1,18,1,1,0,130
193056,1327232,1,18,2,0,0,130
193057,1327232,1,18,3,1,0,131
193058,1327232,1,18,4,0,1,131
193059,1327232,1,18,5,3,0,134
193060,1327232,1,18,6,0,0,134
193061,1327232,1,19,1,0,0,134
193062,1327232,1,19,2,4,0,138
193063,1327232,1,19,3,1,0,139
193064,1327232,1,19,4,0,0,139
193065,1327232,1,19,5,6,0,145
193066,1327232,1,19,6,0,1,145
193187,1327233,1,1,1,2,0,2
193188,1327233,1,1,2,0,0,2
193189,1327233,1,1,3,0,0,2
193190,1327233,1,1,4,0,0,2
193191,1327233,1,1,5,0,0,2
193192,1327233,1,1,6,0,0,2
193193,1327233,1,2,1,0,0,2
193194,1327233,1,2,2,0,0,2
193195,1327233,1,2,3,0,0,2
193196,1327233,1,2,4,2,0,4
193197,1327233,1,2,5,0,0,4
193198,1327233,1,2,6,1,0,5
193199,1327233,1,3,1,1,0,6
193200,1327233,1,3,2,6,0,12
193201,1327233,1,3,3,1,0,13
193202,1327233,1,3,4,1,0,14
193203,1327233,1,3,5,0,1,14
193204,1327233,1,3,6,0,0,14
193205,1327233,1,4,1,1,0,15
193206,1327233,1,4,2,0,1,15
193207,1327233,1,4,3,1,0,16
193208,1327233,1,4,4,4,0,20
193209,1327233,1,4,5,2,0,22
193210,1327233,1,4,6,4,0,26
193211,1327233,1,5,1,0,0,26
193212,1327233,1,5,2,0,0,26
193213,1327233,1,5,3,1,0,27
193214,1327233,1,5,4,4,0,31
193215,1327233,1,5,5,0,0,31
193216,1327233,1,5,6,1,0,32
193217,1327233,1,6,1,2,0,34
193218,1327233,1,6,2,1,0,35
193219,1327233,1,6,3,0,0,35
193220,1327233,1,6,4,4,0,39
193221,1327233,1,6,5,1,0,40
193222,1327233,1,6,6,0,0,40
193223,1327233,1,7,1,1,0,41
193224,1327233,1,7,2,1,0,42
193225,1327233,1,7,3,1,0,43
193226,1327233,1,7,4,4,0,47
193227,1327233,1,7,5,0,0,47
193228,1327233,1,7,6,1,0,48
193229,1327233,1,8,1,1,0,49
193230,1327233,1,8,2,1,0,50
193231,1327233,1,8,3,1,0,51
193232,1327233,1,8,4,6,0,57
193233,1327233,1,8,5,1,0,58
193234,1327233,1,8,6,0,0,58
193235,1327233,1,9,1,1,0,59
193236,1327233,1,9,2,2,0,61
193237,1327233,1,9,3,1,0,62
193238,1327233,1,9,4,0,1,62
193239,1327233,1,9,5,1,0,63
193240,1327233,1,9,6,0,0,63
193241,1327233,1,10,1,1,0,64
193242,1327233,1,10,2,1,0,65
193243,1327233,1,10,3,1,0,66
193244,1327233,1,10,4,4,0,70
193245,1327233,1,10,5,0,0,70
193246,1327233,1,10,6,0,0,70
193247,1327233,1,11,1,1,0,71
193248,1327233,1,11,2,1,0,72
193249,1327233,1,11,3,1,0,73
193250,1327233,1,11,4,1,0,74
193251,1327233,1,11,5,4,0,78
193252,1327233,1,11,6,1,0,79
193253,1327233,1,12,1,6,0,85
193254,1327233,1,12,2,0,0,85
193255,1327233,1,12,3,1,0,86
193256,1327233,1,12,4,1,0,87
193257,1327233,1,12,5,1,0,88
193258,1327233,1,12,6,1,0,89
193259,1327233,1,13,1,0,0,89
193260,1327233,1,13,2,4,0,93
193261,1327233,1,13,3,1,0,94
193262,1327233,1,13,4,1,0,95
193263,1327233,1,13,5,1,0,96
193264,1327233,1,13,6,1,0,97
193265,1327233,1,14,1,1,0,98
193266,1327233,1,14,2,1,0,99
193267,1327233,1,14,3,6,0,105
193268,1327233,1,14,4,1,0,106
193269,1327233,1,14,5,1,0,107
193270,1327233,1,14,6,1,0,108
193271,1327233,1,15,1,1,0,109
193272,1327233,1,15,2,1,0,110
193273,1327233,1,15,3,0,1,110
193274,1327233,1,15,4,0,0,110
193275,1327233,1,15,5,2,0,112
193276,1327233,1,15,6,1,0,113
193277,1327233,1,16,1,4,0,117
193278,1327233,1,16,2,1,0,118
193279,1327233,1,16,3,6,0,124
193280,1327233,1,16,4,1,0,125
193281,1327233,1,16,5,1,0,126
193282,1327233,1,16,6,1,0,127
193283,1327233,1,17,1,2,0,129
193284,1327233,1,17,2,6,0,135
193285,1327233,1,17,3,1,0,136
193286,1327233,1,17,4,0,0,136
193287,1327233,1,17,5,0,0,136
193288,1327233,1,17,6,0,1,136
193289,1327233,1,18,1,0,0,136
193290,1327233,1,18,2,0,0,136
193291,1327233,1,18,3,1,0,137
193292,1327233,1,18,4,1,0,138
193293,1327233,1,18,5,1,0,139
193294,1327233,1,18,6,2,0,141
193295,1327233,1,19,1,1,0,142
193296,1327233,1,19,2,2,0,144
193297,1327233,1,19,3,1,0,145
193298,1327233,1,19,4,4,0,149
193299,1327233,1,19,5,1,0,150
193300,1327233,1,19,6,0,0,150
193301,1327233,1,20,1,4,0,154
193302,1327233,1,20,2,6,0,160
193303,1327233,1,20,3,2,0,162
193304,1327233,1,20,4,1,0,163
193305,1327233,1,20,5,6,0,169
193306,1327233,1,20,6,0,1,169
193394,1327234,1,1,1,2,0,2
193395,1327234,1,1,2,4,0,6
193396,1327234,1,1,3,1,0,7
193397,1327234,1,1,4,1,0,8
193398,1327234,1,1,5,4,0,12
193399,1327234,1,1,6,1,0,13
193400,1327234,1,2,1,4,0,17
193401,1327234,1,2,2,0,0,17
193402,1327234,1,2,3,1,0,18
193403,1327234,1,2,4,1,0,19
193404,1327234,1,2,5,1,0,20
193405,1327234,1,2,6,0,0,20
193406,1327234,1,3,1,1,0,21
193407,1327234,1,3,2,0,0,21
193408,1327234,1,3,3,2,0,23
193409,1327234,1,3,4,4,0,27
193410,1327234,1,3,5,4,0,31
193411,1327234,1,3,6,4,0,35
193412,1327234,1,4,1,1,0,36
193413,1327234,1,4,2,0,0,36
193414,1327234,1,4,3,0,0,36
193415,1327234,1,4,4,1,0,37
193416,1327234,1,4,5,1,0,38
193417,1327234,1,4,6,1,0,39
193418,1327234,1,5,1,0,1,39
193419,1327234,1,5,2,0,0,39
193420,1327234,1,5,3,0,1,39
193421,1327234,1,5,4,5,0,44
193422,1327234,1,5,5,4,0,48
193423,1327234,1,5,6,0,0,48
193424,1327234,1,6,1,0,0,48
193425,1327234,1,6,2,2,0,50
193426,1327234,1,6,3,1,0,51
193427,1327234,1,6,4,1,0,52
193428,1327234,1,6,5,4,0,56
193429,1327234,1,6,6,1,0,57
193430,1327234,1,7,1,0,0,57
193431,1327234,1,7,2,4,0,61
193432,1327234,1,7,3,1,0,62
193433,1327234,1,7,4,1,0,63
193434,1327234,1,7,5,1,0,64
193435,1327234,1,7,6,1,0,65
193436,1327234,1,8,1,4,0,69
193437,1327234,1,8,2,1,0,70
193438,1327234,1,8,3,1,0,71
193439,1327234,1,8,4,1,0,72
193440,1327234,1,8,5,4,0,76
193441,1327234,1,8,6,1,0,77
193442,1327234,1,9,1,5,0,82
193443,1327234,1,9,2,1,0,83
193444,1327234,1,9,3,6,0,89
193445,1327234,1,9,4,1,0,90
193446,1327234,1,9,5,6,0,96
193447,1327234,1,9,6,1,0,97
193448,1327234,1,10,1,1,0,98
193449,1327234,1,10,2,1,0,99
193450,1327234,1,10,3,1,0,100
193451,1327234,1,10,4,1,0,101
193452,1327234,1,10,5,0,1,101
193453,1327234,1,10,6,1,0,102
193454,1327234,1,11,1,1,0,103
193455,1327234,1,11,2,0,0,103
193456,1327234,1,11,3,2,0,105
193457,1327234,1,11,4,6,0,111
193458,1327234,1,11,5,1,0,112
193459,1327234,1,11,6,1,0,113
193460,1327234,1,12,1,1,0,114
193461,1327234,1,12,2,1,0,115
193462,1327234,1,12,3,1,0,116
193463,1327234,1,12,4,1,0,117
193464,1327234,1,12,5,1,0,118
193465,1327234,1,12,6,4,0,122
193466,1327234,1,13,1,2,0,124
193467,1327234,1,13,2,0,0,124
193468,1327234,1,13,3,1,0,125
193469,1327234,1,13,4,1,0,126
193470,1327234,1,13,5,4,0,130
193471,1327234,1,13,6,4,0,134
193472,1327234,1,14,1,1,0,135
193473,1327234,1,14,2,1,0,136
193474,1327234,1,14,3,0,0,136
193475,1327234,1,14,4,6,0,142
193476,1327234,1,14,5,0,0,142
193477,1327234,1,14,6,4,0,146
193478,1327234,1,15,1,1,0,147
193479,1327234,1,15,2,0,0,147
193480,1327234,1,15,3,1,0,148
193481,1327234,1,15,4,0,0,148
193482,1327234,1,15,5,1,0,149
193483,1327234,1,15,6,0,0,149
193484,1327234,1,16,1,0,0,149
193485,1327234,1,16,2,1,0,150
193486,1327234,1,16,3,1,0,151
193487,1327234,1,16,4,1,0,152
193488,1327234,1,16,5,1,0,153
193489,1327234,1,16,6,1,0,154
193490,1327234,1,17,1,1,0,155
193491,1327234,1,17,2,4,0,159
193492,1327234,1,17,3,1,0,160
193493,1327234,1,17,4,0,0,160
193494,1327234,1,17,5,2,0,162
193495,1327234,1,17,6,6,0,168
193496,1327234,1,18,1,0,0,168
193497,1327234,1,18,2,1,0,169
193498,1327234,1,18,3,1,0,170
193499,1327234,1,18,4,5,0,175
193500,1327234,1,18,5,6,0,181
193501,1327234,1,18,6,1,0,182
193502,1327234,1,19,1,2,0,184
193503,1327234,1,19,2,1,0,185
193504,1327234,1,19,3,1,0,186
193505,1327234,1,19,4,0,0,186
193506,1327234,1,19,5,1,0,187
193507,1327234,1,19,6,2,0,189
193508,1327234,1,20,1,6,0,195
193509,1327234,1,20,2,4,0,199
193510,1327234,1,20,3,1,0,200
193511,1327234,1,20,4,6,0,206
193512,1327234,1,20,5,1,0,207
193513,1327234,1,20,6,2,0,209
193634,1327269,1,1,1,1,0,1
193635,1327269,1,1,2,2,0,3
193636,1327269,1,1,3,0,0,3
193637,1327269,1,1,4,0,0,3
193638,1327269,1,1,5,0,1,3
193639,1327269,1,1,6,0,1,3
193640,1327269,1,2,1,0,0,3
193641,1327269,1,2,2,0,0,3
193642,1327269,1,2,3,0,0,3
193643,1327269,1,2,4,0,0,3
193644,1327269,1,2,5,2,0,5
193645,1327269,1,2,6,0,1,5
193646,1327269,1,3,1,0,0,5
193647,1327269,1,3,2,0,0,5
193648,1327269,1,3,3,0,0,5
193649,1327269,1,3,4,0,0,5
193650,1327269,1,3,5,0,0,5
193651,1327269,1,3,6,0,0,5
193652,1327269,1,4,1,1,0,6
193653,1327269,1,4,2,1,0,7
193654,1327269,1,4,3,6,0,13
193655,1327269,1,4,4,0,0,13
193656,1327269,1,4,5,1,0,14
193657,1327269,1,4,6,4,0,18
193658,1327269,1,5,1,0,0,18
193659,1327269,1,5,2,1,0,19
193660,1327269,1,5,3,0,0,19
193661,1327269,1,5,4,1,0,20
193662,1327269,1,5,5,0,0,20
193663,1327269,1,5,6,1,0,21
193664,1327269,1,6,1,2,0,23
193665,1327269,1,6,2,4,0,27
193666,1327269,1,6,3,5,0,32
193667,1327269,1,6,4,1,0,33
193668,1327269,1,6,5,4,0,37
193669,1327269,1,6,6,4,0,41
193670,1327269,1,7,1,1,0,42
193671,1327269,1,7,2,1,0,43
193672,1327269,1,7,3,1,0,44
193673,1327269,1,7,4,1,0,45
193674,1327269,1,7,5,4,0,49
193675,1327269,1,7,6,0,0,49
193676,1327269,1,8,1,0,0,49
193677,1327269,1,8,2,0,1,49
193678,1327269,1,8,3,0,0,49
193679,1327269,1,8,4,0,0,49
193680,1327269,1,8,5,1,0,50
193681,1327269,1,8,6,4,0,54
193682,1327269,1,9,1,0,0,54
193683,1327269,1,9,2,1,0,55
193684,1327269,1,9,3,3,0,58
193685,1327269,1,9,4,1,0,59
193686,1327269,1,9,5,0,0,59
193687,1327269,1,9,6,0,0,59
193688,1327269,1,10,1,1,0,60
193689,1327269,1,10,2,0,1,60
193690,1327269,1,10,3,0,0,60
193691,1327269,1,10,4,4,0,64
193692,1327269,1,10,5,0,0,64
193693,1327269,1,10,6,0,0,64
193694,1327269,1,11,1,0,1,64
193695,1327269,1,11,2,0,0,64
193696,1327269,1,11,3,0,0,64
193697,1327269,1,11,4,1,0,65
193698,1327269,1,11,5,1,0,66
193699,1327269,1,11,6,0,0,66
193700,1327269,1,12,1,0,0,66
193701,1327269,1,12,2,1,0,67
193702,1327269,1,12,3,1,0,68
193703,1327269,1,12,4,0,0,68
193704,1327269,1,12,5,0,0,68
193705,1327269,1,12,6,0,0,68
193706,1327269,1,13,1,0,0,68
193707,1327269,1,13,2,1,1,69
193708,1327269,1,13,3,0,1,69
193709,1327269,1,13,4,0,0,69
193710,1327269,1,13,5,0,0,69
193711,1327269,1,13,6,1,0,70
193712,1327269,1,14,1,0,0,70
193713,1327269,1,14,2,0,0,70
193714,1327269,1,14,3,2,0,72
193715,1327269,1,14,4,0,0,72
193716,1327269,1,14,5,1,0,73
193717,1327269,1,14,6,0,0,73
193718,1327269,1,15,1,0,0,73
193719,1327269,1,15,2,1,0,74
193720,1327269,1,15,3,0,0,74
193721,1327269,1,15,4,1,0,75
193722,1327269,1,15,5,0,0,75
193723,1327269,1,15,6,0,1,75
193724,1327269,1,16,1,1,0,76
193725,1327269,1,16,2,0,0,76
193726,1327269,1,16,3,0,0,76
193727,1327269,1,16,4,0,0,76
193728,1327269,1,16,5,0,0,76
193729,1327269,1,16,6,1,0,77
193730,1327269,1,17,1,4,0,81
193731,1327269,1,17,2,0,0,81
193732,1327269,1,17,3,0,0,81
193733,1327269,1,17,4,0,0,81
193734,1327269,1,17,5,6,0,87
193735,1327269,1,17,6,1,0,88
193736,1327269,1,18,1,0,0,88
193737,1327269,1,18,2,0,0,88
193738,1327269,1,18,3,0,0,88
193739,1327269,1,18,4,2,0,90
193740,1327269,1,18,5,0,0,90
193741,1327269,1,18,6,1,0,91
193742,1327269,1,19,1,0,0,91
193743,1327269,1,19,2,0,0,91
193744,1327269,1,19,3,0,0,91
193745,1327269,1,19,4,2,0,93
193746,1327269,1,19,5,6,0,99
193747,1327269,1,19,6,0,0,99
193748,1327269,1,20,1,4,0,103
193749,1327269,1,20,2,0,0,103
193750,1327269,1,20,3,2,0,105
193751,1327269,1,20,4,0,1,105
193813,1327270,1,1,1,0,0,0
193814,1327270,1,1,2,0,0,0
193815,1327270,1,1,3,1,0,1
193816,1327270,1,1,4,4,0,5
193817,1327270,1,1,5,1,0,6
193818,1327270,1,1,6,0,0,6
193819,1327270,1,2,1,0,0,6
193820,1327270,1,2,2,1,0,7
193821,1327270,1,2,3,1,0,8
193822,1327270,1,2,4,1,0,9
193823,1327270,1,2,5,1,0,10
193824,1327270,1,2,6,4,0,14
193825,1327270,1,3,1,0,0,14
193826,1327270,1,3,2,1,0,15
193827,1327270,1,3,3,0,0,15
193828,1327270,1,3,4,0,1,15
193829,1327270,1,3,5,4,0,19
193830,1327270,1,3,6,0,0,19
193831,1327270,1,4,1,0,0,19
193832,1327270,1,4,2,0,0,19
193833,1327270,1,4,3,0,0,19
193834,1327270,1,4,4,4,0,23
193835,1327270,1,4,5,0,0,23
193836,1327270,1,4,6,0,0,23
193837,1327270,1,5,1,4,0,27
193838,1327270,1,5,2,1,0,28
193839,1327270,1,5,3,0,0,28
193840,1327270,1,5,4,2,0,30
193841,1327270,1,5,5,0,0,30
193842,1327270,1,5,6,0,0,30
193843,1327270,1,6,1,1,0,31
193844,1327270,1,6,2,6,0,37
193845,1327270,1,6,3,4,0,41
193846,1327270,1,6,4,1,0,42
193847,1327270,1,6,5,0,1,42
193848,1327270,1,6,6,1,0,43
193849,1327270,1,7,1,1,0,44
193850,1327270,1,7,2,1,0,45
193851,1327270,1,7,3,0,0,45
193852,1327270,1,7,4,4,0,49
193853,1327270,1,7,5,1,0,50
193854,1327270,1,7,6,1,0,51
193855,1327270,1,8,1,0,0,51
193856,1327270,1,8,2,1,0,52
193857,1327270,1,8,3,4,0,56
193858,1327270,1,8,4,1,0,57
193859,1327270,1,8,5,1,0,58
193860,1327270,1,8,6,1,0,59
193861,1327270,1,9,1,0,0,59
193862,1327270,1,9,2,1,0,60
193863,1327270,1,9,3,1,0,61
193864,1327270,1,9,4,1,0,62
193865,1327270,1,9,5,0,0,62
193866,1327270,1,9,6,1,0,63
193867,1327270,1,10,1,1,0,64
193868,1327270,1,10,2,0,0,64
193869,1327270,1,10,3,1,0,65
193870,1327270,1,10,4,1,0,66
193871,1327270,1,10,5,1,0,67
193872,1327270,1,10,6,1,0,68
193873,1327270,1,11,1,4,0,72
193874,1327270,1,11,2,1,0,73
193875,1327270,1,11,3,1,0,74
193876,1327270,1,11,4,0,0,74
193877,1327270,1,11,5,1,0,75
193878,1327270,1,11,6,1,0,76
193879,1327270,1,12,1,2,0,78
193880,1327270,1,12,2,1,0,79
193881,1327270,1,12,3,1,0,80
193882,1327270,1,12,4,6,0,86
193883,1327270,1,12,5,0,0,86
193884,1327270,1,12,6,1,0,87
193885,1327270,1,13,1,0,1,87
193886,1327270,1,13,2,0,0,87
193887,1327270,1,13,3,0,0,87
193888,1327270,1,13,4,1,0,88
193889,1327270,1,13,5,0,0,88
193890,1327270,1,13,6,2,0,90
193891,1327270,1,14,1,0,0,90
193892,1327270,1,14,2,0,0,90
193893,1327270,1,14,3,1,0,91
193894,1327270,1,14,4,4,0,95
193895,1327270,1,14,5,0,0,95
193896,1327270,1,14,6,1,0,96
193897,1327270,1,15,1,0,1,96
193898,1327270,1,15,2,1,0,97
193899,1327270,1,15,3,0,1,97
193900,1327270,1,15,4,3,0,100
193901,1327270,1,15,5,2,0,102
193902,1327270,1,15,6,1,0,103
193903,1327270,1,16,1,1,0,104
193904,1327270,1,16,2,1,0,105
193905,1327270,1,16,3,3,0,108
193906,1327270,1,16,4,1,0,109
193907,1327270,1,16,5,2,0,111
193908,1327270,1,16,6,0,0,111
193909,1327270,1,17,1,0,0,111
193910,1327270,1,17,2,1,0,112
193911,1327270,1,17,3,0,1,112
193912,1327270,1,17,4,1,0,113
193913,1327270,1,17,5,0,0,113
193914,1327270,1,17,6,1,0,114
193915,1327270,1,18,1,0,1,114
193916,1327270,1,18,2,2,0,116
193917,1327270,1,18,3,4,0,120
193918,1327270,1,18,4,0,0,120
193919,1327270,1,18,5,0,0,120
193920,1327270,1,18,6,4,0,124
193921,1327270,1,19,1,4,0,128
193922,1327270,1,19,2,0,1,128
193923,1327270,1,19,3,0,1,128
193924,1327270,1,19,4,0,0,128
193925,1327270,1,19,5,6,0,134
193926,1327270,1,19,6,2,0,136
193927,1327270,1,20,1,0,0,136
193928,1327270,1,20,2,3,0,139
193929,1327270,1,20,3,2,0,141
193930,1327270,1,20,4,6,0,147
193931,1327270,1,20,5,0,1,147
194050,1327271,1,1,1,0,0,0
194051,1327271,1,1,2,0,0,0
194052,1327271,1,1,3,4,0,4
194053,1327271,1,1,4,0,0,4
194054,1327271,1,1,5,0,0,4
194055,1327271,1,1,6,1,0,5
194056,1327271,1,2,1,1,0,6
194057,1327271,1,2,2,0,0,6
194058,1327271,1,2,3,0,0,6
194059,1327271,1,2,4,0,0,6
194060,1327271,1,2,5,1,0,7
194061,1327271,1,2,6,0,1,7
194062,1327271,1,3,1,0,0,7
194063,1327271,1,3,2,2,0,9
194064,1327271,1,3,3,0,0,9
194065,1327271,1,3,4,0,0,9
194066,1327271,1,3,5,1,0,10
194067,1327271,1,3,6,0,0,10
194068,1327271,1,4,1,2,0,12
194069,1327271,1,4,2,1,0,13
194070,1327271,1,4,3,0,0,13
194071,1327271,1,4,4,0,0,13
194072,1327271,1,4,5,0,0,13
194073,1327271,1,4,6,0,1,13
194074,1327271,1,5,1,0,0,13
194075,1327271,1,5,2,4,0,17
194076,1327271,1,5,3,4,0,21
194077,1327271,1,5,4,0,0,21
194078,1327271,1,5,5,1,0,22
194079,1327271,1,5,6,0,0,22
194080,1327271,1,6,1,2,0,24
194081,1327271,1,6,2,0,1,24
194082,1327271,1,6,3,2,0,26
194083,1327271,1,6,4,0,0,26
194084,1327271,1,6,5,1,0,27
194085,1327271,1,6,6,1,0,28
194086,1327271,1,7,1,0,0,28
194087,1327271,1,7,2,0,1,28
194088,1327271,1,7,3,1,0,29
194089,1327271,1,7,4,1,0,30
194090,1327271,1,7,5,0,0,30
194091,1327271,1,7,6,1,0,31
194092,1327271,1,8,1,0,0,31
194093,1327271,1,8,2,1,0,32
194094,1327271,1,8,3,1,0,33
194095,1327271,1,8,4,1,0,34
194096,1327271,1,8,5,0,0,34
194097,1327271,1,8,6,1,0,35
194098,1327271,1,9,1,1,0,36
194099,1327271,1,9,2,1,0,37
194100,1327271,1,9,3,1,0,38
194101,1327271,1,9,4,1,0,39
194102,1327271,1,9,5,2,0,41
194103,1327271,1,9,6,1,0,42
194104,1327271,1,10,1,0,0,42
194105,1327271,1,10,2,2,0,44
194106,1327271,1,10,3,1,0,45
194107,1327271,1,10,4,0,0,45
194108,1327271,1,10,5,4,0,49
194109,1327271,1,10,6,1,0,50
194110,1327271,1,11,1,2,0,52
194111,1327271,1,11,2,1,0,53
194112,1327271,1,11,3,0,1,53
194113,1327271,1,11,4,1,0,54
194114,1327271,1,11,5,0,0,54
194115,1327271,1,11,6,1,0,55
194116,1327271,1,12,1,1,0,56
194117,1327271,1,12,2,1,0,57
194118,1327271,1,12,3,1,0,58
194119,1327271,1,12,4,6,0,64
194120,1327271,1,12,5,0,0,64
194121,1327271,1,12,6,2,0,66
194122,1327271,1,13,1,1,0,67
194123,1327271,1,13,2,1,0,68
194124,1327271,1,13,3,0,0,68
194125,1327271,1,13,4,1,0,69
194126,1327271,1,13,5,2,0,71
194127,1327271,1,13,6,1,0,72
194128,1327271,1,14,1,1,0,73
194129,1327271,1,14,2,2,0,75
194130,1327271,1,14,3,1,0,76
194131,1327271,1,14,4,2,0,78
194132,1327271,1,14,5,1,0,79
194133,1327271,1,14,6,0,0,79
194134,1327271,1,15,1,4,0,83
194135,1327271,1,15,2,0,0,83
194136,1327271,1,15,3,1,0,84
194137,1327271,1,15,4,1,0,85
194138,1327271,1,15,5,1,0,86
194139,1327271,1,15,6,1,0,87
194140,1327271,1,16,1,1,0,88
194141,1327271,1,16,2,0,0,88
194142,1327271,1,16,3,1,0,89
194143,1327271,1,16,4,0,1,89
194144,1327271,1,16,5,2,0,91
194145,1327271,1,16,6,4,0,95
194146,1327271,1,17,1,1,0,96
194147,1327271,1,17,2,4,0,100
194148,1327271,1,17,3,1,0,101
194149,1327271,1,17,4,1,0,102
194150,1327271,1,17,5,1,0,103
194151,1327271,1,17,6,0,0,103
194152,1327271,1,18,1,1,0,104
194153,1327271,1,18,2,0,0,104
194154,1327271,1,18,3,2,0,106
194155,1327271,1,18,4,4,0,110
194156,1327271,1,18,5,1,0,111
194157,1327271,1,18,6,0,0,111
194158,1327271,1,19,1,1,0,112
194159,1327271,1,19,2,1,0,113
194160,1327271,1,19,3,1,0,114
194161,1327271,1,19,4,1,0,115
194162,1327271,1,19,5,1,0,116
194163,1327271,1,19,6,4,0,120
194164,1327271,1,20,1,1,0,121
194165,1327271,1,20,2,1,0,122
194166,1327271,1,20,3,1,0,123
194167,1327271,1,20,4,4,0,127
194168,1327271,1,20,5,0,1,127
194169,1327271,1,20,6,0,0,127
194281,1327273,1,1,1,4,0,4
194282,1327273,1,1,2,0,0,4
194283,1327273,1,1,3,0,0,4
194284,1327273,1,1,4,0,0,4
194285,1327273,1,1,5,3,0,7
194286,1327273,1,1,6,4,0,11
194287,1327273,1,2,1,0,0,11
194288,1327273,1,2,2,2,0,13
194289,1327273,1,2,3,1,0,14
194290,1327273,1,2,4,0,0,14
194291,1327273,1,2,5,0,0,14
194292,1327273,1,2,6,0,0,14
194293,1327273,1,3,1,2,0,16
194294,1327273,1,3,2,1,0,17
194295,1327273,1,3,3,1,0,18
194296,1327273,1,3,4,1,0,19
194297,1327273,1,3,5,0,1,19
194298,1327273,1,3,6,0,0,19
194299,1327273,1,4,1,1,0,20
194300,1327273,1,4,2,1,0,21
194301,1327273,1,4,3,6,0,27
194302,1327273,1,4,4,1,0,28
194303,1327273,1,4,5,0,0,28
194304,1327273,1,4,6,1,0,29
194305,1327273,1,5,1,1,0,30
194306,1327273,1,5,2,0,0,30
194307,1327273,1,5,3,6,0,36
194308,1327273,1,5,4,4,0,40
194309,1327273,1,5,5,4,0,44
194310,1327273,1,5,6,3,0,47
194311,1327273,1,6,1,1,0,48
194312,1327273,1,6,2,1,0,49
194313,1327273,1,6,3,4,0,53
194314,1327273,1,6,4,0,0,53
194315,1327273,1,6,5,0,0,53
194316,1327273,1,6,6,2,0,55
194317,1327273,1,7,1,1,0,56
194318,1327273,1,7,2,1,0,57
194319,1327273,1,7,3,0,0,57
194320,1327273,1,7,4,1,0,58
194321,1327273,1,7,5,0,1,58
194322,1327273,1,7,6,1,0,59
194323,1327273,1,8,1,1,0,60
194324,1327273,1,8,2,0,0,60
194325,1327273,1,8,3,1,0,61
194326,1327273,1,8,4,2,0,63
194327,1327273,1,8,5,0,0,63
194328,1327273,1,8,6,0,1,63
194329,1327273,1,9,1,0,0,63
194330,1327273,1,9,2,0,0,63
194331,1327273,1,9,3,1,0,64
194332,1327273,1,9,4,1,0,65
194333,1327273,1,9,5,4,0,69
194334,1327273,1,9,6,1,0,70
194335,1327273,1,10,1,4,0,74
194336,1327273,1,10,2,4,0,78
194337,1327273,1,10,3,1,0,79
194338,1327273,1,10,4,1,0,80
194339,1327273,1,10,5,1,0,81
194340,1327273,1,10,6,4,0,85
194341,1327273,1,11,1,1,0,86
194342,1327273,1,11,2,1,0,87
194343,1327273,1,11,3,0,1,87
194344,1327273,1,11,4,0,0,87
194345,1327273,1,11,5,1,0,88
194346,1327273,1,11,6,0,0,88
194347,1327273,1,12,1,0,0,88
194348,1327273,1,12,2,1,0,89
194349,1327273,1,12,3,0,0,89
194350,1327273,1,12,4,0,0,89
194351,1327273,1,12,5,1,0,90
194352,1327273,1,12,6,1,0,91
194353,1327273,1,13,1,0,0,91
194354,1327273,1,13,2,1,0,92
194355,1327273,1,13,3,4,0,96
194356,1327273,1,13,4,6,0,102
194357,1327273,1,13,5,1,0,103
194358,1327273,1,13,6,0,0,103
194359,1327273,1,14,1,1,0,104
194360,1327273,1,14,2,2,0,106
194361,1327273,1,14,3,1,0,107
194362,1327273,1,14,4,0,0,107
194363,1327273,1,14,5,1,0,108
194364,1327273,1,14,6,1,0,109
194365,1327273,1,15,1,0,0,109
194366,1327273,1,15,2,6,0,115
194367,1327273,1,15,3,4,0,119
194368,1327273,1,15,4,2,0,121
194369,1327273,1,15,5,0,0,121
194370,1327273,1,15,6,2,0,123
194371,1327273,1,16,1,0,0,123
194372,1327273,1,16,2,6,0,129
194373,1327273,1,16,3,4,0,133
194374,1327273,1,16,4,2,0,135
194375,1327273,1,16,5,1,0,136
194376,1327273,1,16,6,2,0,138
194377,1327273,1,17,1,4,0,142
194378,1327273,1,17,2,1,0,143
194379,1327273,1,17,3,1,0,144
194380,1327273,1,17,4,0,1,144
194381,1327273,1,17,5,2,0,146
194382,1327273,1,17,6,1,0,147
194383,1327273,1,18,1,0,1,147
194384,1327273,1,18,2,4,0,151
194385,1327273,1,18,3,2,0,153
194386,1327273,1,18,4,4,0,157
194387,1327273,1,18,5,1,0,158
194388,1327273,1,18,6,1,0,159
194389,1327273,1,19,1,0,1,159
194390,1327273,1,19,2,3,0,162
194391,1327273,1,19,3,1,0,163
194392,1327273,1,19,4,0,0,163
194393,1327273,1,19,5,1,0,164
194394,1327273,1,19,6,2,0,166
194395,1327273,1,20,1,0,0,166
194396,1327273,1,20,2,6,0,172
194397,1327273,1,20,3,1,0,173
194398,1327273,1,20,4,4,0,177
194399,1327273,1,20,5,4,0,181
194400,1327273,1,20,6,2,0,183
194518,1327275,1,1,1,0,0,0
194519,1327275,1,1,2,4,0,4
194520,1327275,1,1,3,1,0,5
194521,1327275,1,1,4,1,0,6
194522,1327275,1,1,5,1,0,7
194523,1327275,1,1,6,0,0,7
194524,1327275,1,2,1,4,0,11
194525,1327275,1,2,2,0,0,11
194526,1327275,1,2,3,0,0,11
194527,1327275,1,2,4,0,0,11
194528,1327275,1,2,5,0,0,11
194529,1327275,1,2,6,0,0,11
194530,1327275,1,3,1,1,0,12
194531,1327275,1,3,2,1,0,13
194532,1327275,1,3,3,0,0,13
194533,1327275,1,3,4,6,0,19
194534,1327275,1,3,5,6,0,25
194535,1327275,1,3,6,1,0,26
194536,1327275,1,4,1,6,0,32
194537,1327275,1,4,2,2,0,34
194538,1327275,1,4,3,4,0,38
194539,1327275,1,4,4,1,0,39
194540,1327275,1,4,5,0,0,39
194541,1327275,1,4,6,1,0,40
194542,1327275,1,5,1,0,0,40
194543,1327275,1,5,2,1,0,41
194544,1327275,1,5,3,4,0,45
194545,1327275,1,5,4,1,0,46
194546,1327275,1,5,5,0,1,46
194547,1327275,1,5,6,0,0,46
194548,1327275,1,6,1,1,0,47
194549,1327275,1,6,2,2,0,49
194550,1327275,1,6,3,0,0,49
194551,1327275,1,6,4,0,0,49
194552,1327275,1,6,5,0,0,49
194553,1327275,1,6,6,0,0,49
194554,1327275,1,7,1,4,0,53
194555,1327275,1,7,2,1,0,54
194556,1327275,1,7,3,1,0,55
194557,1327275,1,7,4,1,0,56
194558,1327275,1,7,5,4,0,60
194559,1327275,1,7,6,1,0,61
194560,1327275,1,8,1,1,0,62
194561,1327275,1,8,2,0,0,62
194562,1327275,1,8,3,6,0,68
194563,1327275,1,8,4,1,0,69
194564,1327275,1,8,5,0,0,69
194565,1327275,1,8,6,1,0,70
194566,1327275,1,9,1,1,0,71
194567,1327275,1,9,2,2,0,73
194568,1327275,1,9,3,1,0,74
194569,1327275,1,9,4,1,0,75
194570,1327275,1,9,5,1,0,76
194571,1327275,1,9,6,2,0,78
194572,1327275,1,10,1,1,0,79
194573,1327275,1,10,2,1,0,80
194574,1327275,1,10,3,1,0,81
194575,1327275,1,10,4,1,0,82
194576,1327275,1,10,5,0,0,82
194577,1327275,1,10,6,1,0,83
194578,1327275,1,11,1,1,0,84
194579,1327275,1,11,2,1,0,85
194580,1327275,1,11,3,1,0,86
194581,1327275,1,11,4,0,0,86
194582,1327275,1,11,5,1,0,87
194583,1327275,1,11,6,2,0,89
194584,1327275,1,12,1,1,0,90
194585,1327275,1,12,2,1,0,91
194586,1327275,1,12,3,1,0,92
194587,1327275,1,12,4,1,0,93
194588,1327275,1,12,5,1,0,94
194589,1327275,1,12,6,1,0,95
194590,1327275,1,13,1,1,0,96
194591,1327275,1,13,2,4,0,100
194592,1327275,1,13,3,1,0,101
194593,1327275,1,13,4,2,0,103
194594,1327275,1,13,5,6,0,109
194595,1327275,1,13,6,2,0,111
194596,1327275,1,14,1,6,0,117
194597,1327275,1,14,2,1,0,118
194598,1327275,1,14,3,1,0,119
194599,1327275,1,14,4,1,0,120
194600,1327275,1,14,5,11,0,131
194601,1327275,1,14,6,1,0,132
194602,1327275,1,15,1,1,0,133
194603,1327275,1,15,2,1,0,134
194604,1327275,1,15,3,0,0,134
194605,1327275,1,15,4,1,0,135
194606,1327275,1,15,5,1,0,136
194607,1327275,1,15,6,2,0,138
194608,1327275,1,16,1,0,0,138
194609,1327275,1,16,2,1,0,139
194610,1327275,1,16,3,0,1,139
194611,1327275,1,16,4,1,0,140
194612,1327275,1,16,5,1,0,141
194613,1327275,1,16,6,4,0,145
194614,1327275,1,17,1,1,0,146
194615,1327275,1,17,2,0,0,146
194616,1327275,1,17,3,1,0,147
194617,1327275,1,17,4,1,0,148
194618,1327275,1,17,5,1,0,149
194619,1327275,1,17,6,1,0,150
194620,1327275,1,18,1,1,0,151
194621,1327275,1,18,2,0,1,151
194622,1327275,1,18,3,6,0,157
194623,1327275,1,18,4,4,0,161
194624,1327275,1,18,5,1,0,162
194625,1327275,1,18,6,1,0,163
194626,1327275,1,19,1,1,0,164
194627,1327275,1,19,2,1,0,165
194628,1327275,1,19,3,1,0,166
194629,1327275,1,19,4,0,1,166
194630,1327275,1,19,5,0,1,166
194631,1327275,1,19,6,0,0,166
194632,1327275,1,20,1,0,0,166
194633,1327275,1,20,2,0,0,166
194634,1327275,1,20,3,0,0,166
194635,1327275,1,20,4,2,0,168
194636,1327275,1,20,5,6,0,174
194637,1327275,1,20,6,1,1,175
194753,1327276,1,1,1,0,0,0
194754,1327276,1,1,2,1,0,1
194755,1327276,1,1,3,0,0,1
194756,1327276,1,1,4,4,0,5
194757,1327276,1,1,5,0,0,5
194758,1327276,1,1,6,6,0,11
194759,1327276,1,2,1,1,0,12
194760,1327276,1,2,2,0,0,12
194761,1327276,1,2,3,4,0,16
194762,1327276,1,2,4,1,0,17
194763,1327276,1,2,5,2,0,19
194764,1327276,1,2,6,1,0,20
194765,1327276,1,3,1,6,0,26
194766,1327276,1,3,2,1,0,27
194767,1327276,1,3,3,0,0,27
194768,1327276,1,3,4,1,0,28
194769,1327276,1,3,5,0,0,28
194770,1327276,1,3,6,6,0,34
194771,1327276,1,4,1,4,0,38
194772,1327276,1,4,2,6,0,44
194773,1327276,1,4,3,1,0,45
194774,1327276,1,4,4,1,0,46
194775,1327276,1,4,5,0,0,46
194776,1327276,1,4,6,0,0,46
194777,1327276,1,5,1,0,0,46
194778,1327276,1,5,2,4,0,50
194779,1327276,1,5,3,0,0,50
194780,1327276,1,5,4,1,0,51
194781,1327276,1,5,5,1,0,52
194782,1327276,1,5,6,2,0,54
194783,1327276,1,6,1,0,1,54
194784,1327276,1,6,2,1,0,55
194785,1327276,1,6,3,6,0,61
194786,1327276,1,6,4,0,0,61
194787,1327276,1,6,5,0,0,61
194788,1327276,1,6,6,1,0,62
194789,1327276,1,7,1,0,1,62
194790,1327276,1,7,2,4,0,66
194791,1327276,1,7,3,0,0,66
194792,1327276,1,7,4,0,0,66
194793,1327276,1,7,5,1,0,67
194794,1327276,1,7,6,4,0,71
194795,1327276,1,8,1,4,0,75
194796,1327276,1,8,2,1,0,76
194797,1327276,1,8,3,0,0,76
194798,1327276,1,8,4,0,0,76
194799,1327276,1,8,5,2,0,78
194800,1327276,1,8,6,1,0,79
194801,1327276,1,9,1,1,0,80
194802,1327276,1,9,2,1,0,81
194803,1327276,1,9,3,4,0,85
194804,1327276,1,9,4,1,0,86
194805,1327276,1,9,5,1,0,87
194806,1327276,1,9,6,1,0,88
194807,1327276,1,10,1,1,0,89
194808,1327276,1,10,2,1,0,90
194809,1327276,1,10,3,1,0,91
194810,1327276,1,10,4,0,1,91
194811,1327276,1,10,5,1,0,92
194812,1327276,1,10,6,1,0,93
194813,1327276,1,11,1,0,0,93
194814,1327276,1,11,2,4,0,97
194815,1327276,1,11,3,1,0,98
194816,1327276,1,11,4,0,0,98
194817,1327276,1,11,5,3,0,101
194818,1327276,1,11,6,0,0,101
194819,1327276,1,12,1,1,0,102
194820,1327276,1,12,2,1,0,103
194821,1327276,1,12,3,1,0,104
194822,1327276,1,12,4,1,0,105
194823,1327276,1,12,5,0,0,105
194824,1327276,1,12,6,0,0,105
194825,1327276,1,13,1,4,0,109
194826,1327276,1,13,2,2,0,111
194827,1327276,1,13,3,1,0,112
194828,1327276,1,13,4,4,0,116
194829,1327276,1,13,5,1,0,117
194830,1327276,1,13,6,1,0,118
194831,1327276,1,14,1,2,0,120
194832,1327276,1,14,2,1,0,121
194833,1327276,1,14,3,1,0,122
194834,1327276,1,14,4,4,0,126
194835,1327276,1,14,5,0,1,126
194836,1327276,1,14,6,0,0,126
194837,1327276,1,15,1,2,0,128
194838,1327276,1,15,2,2,0,130
194839,1327276,1,15,3,1,0,131
194840,1327276,1,15,4,0,1,131
194841,1327276,1,15,5,4,0,135
194842,1327276,1,15,6,0,0,135
194843,1327276,1,16,1,2,0,137
194844,1327276,1,16,2,1,0,138
194845,1327276,1,16,3,1,0,139
194846,1327276,1,16,4,1,0,140
194847,1327276,1,16,5,0,0,140
194848,1327276,1,16,6,0,0,140
194849,1327276,1,17,1,1,0,141
194850,1327276,1,17,2,0,0,141
194851,1327276,1,17,3,4,0,145
194852,1327276,1,17,4,1,0,146
194853,1327276,1,17,5,0,0,146
194854,1327276,1,17,6,2,0,148
194855,1327276,1,18,1,3,0,151
194856,1327276,1,18,2,2,0,153
194857,1327276,1,18,3,4,0,157
194858,1327276,1,18,4,1,0,158
194859,1327276,1,18,5,0,0,158
194860,1327276,1,18,6,6,0,164
194861,1327276,1,19,1,1,0,165
194862,1327276,1,19,2,2,0,167
194863,1327276,1,19,3,1,0,168
194864,1327276,1,19,4,0,1,168
194865,1327276,1,19,5,2,0,170
194866,1327276,1,19,6,1,0,171
194867,1327276,1,20,1,1,0,172
194868,1327276,1,20,2,0,0,172
194869,1327276,1,20,3,0,0,172
194870,1327276,1,20,4,1,1,173
194871,1327276,1,20,5,4,0,177
194872,1327276,1,20,6,4,0,181
194992,1327277,1,1,1,1,0,1
194993,1327277,1,1,2,1,0,2
194994,1327277,1,1,3,1,0,3
194995,1327277,1,1,4,1,0,4
194996,1327277,1,1,5,0,0,4
194997,1327277,1,1,6,0,0,4
194998,1327277,1,2,1,1,0,5
194999,1327277,1,2,2,1,0,6
195000,1327277,1,2,3,1,0,7
195001,1327277,1,2,4,4,0,11
195002,1327277,1,2,5,0,1,11
195003,1327277,1,2,6,0,0,11
195004,1327277,1,3,1,1,0,12
195005,1327277,1,3,2,0,0,12
195006,1327277,1,3,3,0,0,12
195007,1327277,1,3,4,1,1,13
195008,1327277,1,3,5,2,0,15
195009,1327277,1,3,6,0,0,15
195010,1327277,1,4,1,0,0,15
195011,1327277,1,4,2,4,0,19
195012,1327277,1,4,3,1,0,20
195013,1327277,1,4,4,0,0,20
195014,1327277,1,4,5,1,0,21
195015,1327277,1,4,6,1,0,22
195016,1327277,1,5,1,0,0,22
195017,1327277,1,5,2,6,0,28
195018,1327277,1,5,3,4,0,32
195019,1327277,1,5,4,2,0,34
195020,1327277,1,5,5,1,0,35
195021,1327277,1,5,6,1,0,36
195022,1327277,1,6,1,1,0,37
195023,1327277,1,6,2,4,0,41
195024,1327277,1,6,3,1,0,42
195025,1327277,1,6,4,1,0,43
195026,1327277,1,6,5,0,0,43
195027,1327277,1,6,6,1,0,44
195028,1327277,1,7,1,0,0,44
195029,1327277,1,7,2,1,0,45
195030,1327277,1,7,3,1,0,46
195031,1327277,1,7,4,0,0,46
195032,1327277,1,7,5,2,0,48
195033,1327277,1,7,6,1,0,49
195034,1327277,1,8,1,2,0,51
195035,1327277,1,8,2,1,0,52
195036,1327277,1,8,3,0,0,52
195037,1327277,1,8,4,0,0,52
195038,1327277,1,8,5,1,0,53
195039,1327277,1,8,6,1,0,54
195040,1327277,1,9,1,2,0,56
195041,1327277,1,9,2,1,0,57
195042,1327277,1,9,3,1,0,58
195043,1327277,1,9,4,1,0,59
195044,1327277,1,9,5,4,0,63
195045,1327277,1,9,6,2,0,65
195046,1327277,1,10,1,6,0,71
195047,1327277,1,10,2,1,0,72
195048,1327277,1,10,3,1,0,73
195049,1327277,1,10,4,4,0,77
195050,1327277,1,10,5,1,0,78
195051,1327277,1,10,6,1,0,79
195052,1327277,1,11,1,1,0,80
195053,1327277,1,11,2,1,0,81
195054,1327277,1,11,3,1,0,82
195055,1327277,1,11,4,1,0,83
195056,1327277,1,11,5,6,0,89
195057,1327277,1,11,6,2,0,91
195058,1327277,1,12,1,0,0,91
195059,1327277,1,12,2,6,0,97
195060,1327277,1,12,3,1,0,98
195061,1327277,1,12,4,1,0,99
195062,1327277,1,12,5,4,0,103
195063,1327277,1,12,6,6,0,109
195064,1327277,1,13,1,1,0,110
195065,1327277,1,13,2,0,1,110
195066,1327277,1,13,3,0,0,110
195067,1327277,1,13,4,1,0,111
195068,1327277,1,13,5,0,0,111
195069,1327277,1,13,6,1,0,112
195070,1327277,1,14,1,1,0,113
195071,1327277,1,14,2,1,0,114
195072,1327277,1,14,3,2,0,116
195073,1327277,1,14,4,1,0,117
195074,1327277,1,14,5,1,0,118
195075,1327277,1,14,6,0,0,118
195076,1327277,1,15,1,1,0,119
195077,1327277,1,15,2,0,1,119
195078,1327277,1,15,3,0,0,119
195079,1327277,1,15,4,4,0,123
195080,1327277,1,15,5,0,0,123
195081,1327277,1,15,6,4,0,127
195082,1327277,1,16,1,1,0,128
195083,1327277,1,16,2,5,0,133
195084,1327277,1,16,3,1,0,134
195085,1327277,1,16,4,1,0,135
195086,1327277,1,16,5,0,0,135
195087,1327277,1,16,6,0,0,135
195088,1327277,1,17,1,1,0,136
195089,1327277,1,17,2,1,0,137
195090,1327277,1,17,3,1,0,138
195091,1327277,1,17,4,0,0,138
195092,1327277,1,17,5,1,0,139
195093,1327277,1,17,6,1,0,140
195094,1327277,1,18,1,6,0,146
195095,1327277,1,18,2,3,0,149
195096,1327277,1,18,3,0,1,149
195097,1327277,1,18,4,4,0,153
195098,1327277,1,18,5,1,0,154
195099,1327277,1,18,6,3,0,157
195100,1327277,1,19,1,0,1,157
195101,1327277,1,19,2,1,0,158
195102,1327277,1,19,3,0,1,158
195103,1327277,1,19,4,2,0,160
195104,1327277,1,19,5,1,0,161
195105,1327277,1,19,6,0,0,161
195106,1327277,1,20,1,2,0,163
195107,1327277,1,20,2,1,0,164
195108,1327277,1,20,3,0,1,164
195109,1327277,1,20,4,1,0,165
195110,1327277,1,20,5,6,0,171
195111,1327277,1,20,6,2,0,173
195231,1327278,1,1,1,0,0,0
195232,1327278,1,1,2,0,0,0
195233,1327278,1,1,3,0,0,0
195234,1327278,1,1,4,1,0,1
195235,1327278,1,1,5,0,0,1
195236,1327278,1,1,6,3,0,4
195237,1327278,1,2,1,0,0,4
195238,1327278,1,2,2,2,0,6
195239,1327278,1,2,3,2,0,8
195240,1327278,1,2,4,0,0,8
195241,1327278,1,2,5,6,0,14
195242,1327278,1,2,6,6,0,20
195243,1327278,1,3,1,0,0,20
195244,1327278,1,3,2,0,0,20
195245,1327278,1,3,3,1,0,21
195246,1327278,1,3,4,1,0,22
195247,1327278,1,3,5,4,0,26
195248,1327278,1,3,6,1,0,27
195249,1327278,1,4,1,4,0,31
195250,1327278,1,4,2,4,0,35
195251,1327278,1,4,3,1,0,36
195252,1327278,1,4,4,0,0,36
195253,1327278,1,4,5,0,1,36
195254,1327278,1,4,6,1,0,37
195255,1327278,1,5,1,1,0,38
195256,1327278,1,5,2,0,0,38
195257,1327278,1,5,3,4,0,42
195258,1327278,1,5,4,0,0,42
195259,1327278,1,5,5,1,1,43
195260,1327278,1,5,6,0,0,43
195261,1327278,1,6,1,0,0,43
195262,1327278,1,6,2,1,0,44
195263,1327278,1,6,3,1,0,45
195264,1327278,1,6,4,1,0,46
195265,1327278,1,6,5,1,0,47
195266,1327278,1,6,6,1,0,48
195267,1327278,1,7,1,1,0,49
195268,1327278,1,7,2,2,0,51
195269,1327278,1,7,3,0,0,51
195270,1327278,1,7,4,1,0,52
195271,1327278,1,7,5,0,0,52
195272,1327278,1,7,6,1,0,53
195273,1327278,1,8,1,0,0,53
195274,1327278,1,8,2,1,0,54
195275,1327278,1,8,3,1,0,55
195276,1327278,1,8,4,1,0,56
195277,1327278,1,8,5,1,0,57
195278,1327278,1,8,6,4,0,61
195279,1327278,1,9,1,1,0,62
195280,1327278,1,9,2,0,0,62
195281,1327278,1,9,3,1,0,63
195282,1327278,1,9,4,0,0,63
195283,1327278,1,9,5,0,0,63
195284,1327278,1,9,6,1,0,64
195285,1327278,1,10,1,0,0,64
195286,1327278,1,10,2,1,0,65
195287,1327278,1,10,3,1,0,66
195288,1327278,1,10,4,1,0,67
195289,1327278,1,10,5,1,0,68
195290,1327278,1,10,6,4,0,72
195291,1327278,1,11,1,4,0,76
195292,1327278,1,11,2,0,0,76
195293,1327278,1,11,3,0,0,76
195294,1327278,1,11,4,1,0,77
195295,1327278,1,11,5,0,0,77
195296,1327278,1,11,6,0,0,77
195297,1327278,1,12,1,1,0,78
195298,1327278,1,12,2,0,1,78
195299,1327278,1,12,3,1,0,79
195300,1327278,1,12,4,0,0,79
195301,1327278,1,12,5,0,0,79
195302,1327278,1,12,6,0,0,79
195303,1327278,1,13,1,1,0,80
195304,1327278,1,13,2,1,0,81
195305,1327278,1,13,3,0,0,81
195306,1327278,1,13,4,1,0,82
195307,1327278,1,13,5,1,0,83
195308,1327278,1,13,6,0,0,83
195309,1327278,1,14,1,2,0,85
195310,1327278,1,14,2,6,0,91
195311,1327278,1,14,3,0,0,91
195312,1327278,1,14,4,0,0,91
195313,1327278,1,14,5,0,0,91
195314,1327278,1,14,6,0,1,91
195315,1327278,1,15,1,0,1,91
195316,1327278,1,15,2,0,0,91
195317,1327278,1,15,3,1,0,92
195318,1327278,1,15,4,0,0,92
195319,1327278,1,15,5,0,0,92
195320,1327278,1,15,6,1,0,93
195321,1327278,1,16,1,1,0,94
195322,1327278,1,16,2,1,0,95
195323,1327278,1,16,3,6,0,101
195324,1327278,1,16,4,1,0,102
195325,1327278,1,16,5,1,0,103
195326,1327278,1,16,6,1,0,104
195327,1327278,1,17,1,0,0,104
195328,1327278,1,17,2,0,0,104
195329,1327278,1,17,3,0,1,104
195330,1327278,1,17,4,0,0,104
195331,1327278,1,17,5,0,0,104
195332,1327278,1,17,6,1,0,105
195333,1327278,1,18,1,4,0,109
195334,1327278,1,18,2,0,0,109
195335,1327278,1,18,3,1,0,110
195336,1327278,1,18,4,1,0,111
195337,1327278,1,18,5,1,0,112
195338,1327278,1,18,6,1,0,113
195339,1327278,1,19,1,0,0,113
195340,1327278,1,19,2,4,0,117
195341,1327278,1,19,3,1,0,118
195342,1327278,1,19,4,0,0,118
195343,1327278,1,19,5,1,0,119
195344,1327278,1,19,6,0,0,119
195345,1327278,1,20,1,0,0,119
195346,1327278,1,20,2,0,0,119
195347,1327278,1,20,3,6,0,125
195348,1327278,1,20,4,4,0,129
195349,1327278,1,20,5,0,0,129
195350,1327278,1,20,6,0,0,129
195467,1327279,1,1,1,2,0,2
195468,1327279,1,1,2,1,0,3
195469,1327279,1,1,3,1,0,4
195470,1327279,1,1,4,1,0,5
195471,1327279,1,1,5,1,0,6
195472,1327279,1,1,6,0,0,6
195473,1327279,1,2,1,0,0,6
195474,1327279,1,2,2,1,0,7
195475,1327279,1,2,3,0,0,7
195476,1327279,1,2,4,0,0,7
195477,1327279,1,2,5,1,0,8
195478,1327279,1,2,6,1,0,9
195479,1327279,1,3,1,0,0,9
195480,1327279,1,3,2,4,0,13
195481,1327279,1,3,3,1,0,14
195482,1327279,1,3,4,4,0,18
195483,1327279,1,3,5,1,0,19
195484,1327279,1,3,6,2,0,21
195485,1327279,1,4,1,1,0,22
195486,1327279,1,4,2,1,0,23
195487,1327279,1,4,3,1,0,24
195488,1327279,1,4,4,0,0,24
195489,1327279,1,4,5,0,0,24
195490,1327279,1,4,6,4,0,28
195491,1327279,1,5,1,1,0,29
195492,1327279,1,5,2,0,0,29
195493,1327279,1,5,3,4,0,33
195494,1327279,1,5,4,0,0,33
195495,1327279,1,5,5,0,0,33
195496,1327279,1,5,6,4,0,37
195497,1327279,1,6,1,0,0,37
195498,1327279,1,6,2,4,0,41
195499,1327279,1,6,3,0,0,41
195500,1327279,1,6,4,4,0,45
195501,1327279,1,6,5,6,0,51
195502,1327279,1,6,6,1,0,52
195503,1327279,1,7,1,1,0,53
195504,1327279,1,7,2,0,0,53
195505,1327279,1,7,3,0,0,53
195506,1327279,1,7,4,6,0,59
195507,1327279,1,7,5,1,0,60
195508,1327279,1,7,6,1,0,61
195509,1327279,1,8,1,1,0,62
195510,1327279,1,8,2,1,0,63
195511,1327279,1,8,3,6,0,69
195512,1327279,1,8,4,1,0,70
195513,1327279,1,8,5,1,0,71
195514,1327279,1,8,6,1,0,72
195515,1327279,1,9,1,1,0,73
195516,1327279,1,9,2,1,0,74
195517,1327279,1,9,3,0,0,74
195518,1327279,1,9,4,4,0,78
195519,1327279,1,9,5,1,0,79
195520,1327279,1,9,6,1,0,80
195521,1327279,1,10,1,2,0,82
195522,1327279,1,10,2,1,0,83
195523,1327279,1,10,3,1,0,84
195524,1327279,1,10,4,1,0,85
195525,1327279,1,10,5,1,0,86
195526,1327279,1,10,6,1,0,87
195527,1327279,1,11,1,1,0,88
195528,1327279,1,11,2,4,0,92
195529,1327279,1,11,3,1,0,93
195530,1327279,1,11,4,1,0,94
195531,1327279,1,11,5,0,0,94
195532,1327279,1,11,6,1,0,95
195533,1327279,1,12,1,1,0,96
195534,1327279,1,12,2,4,0,100
195535,1327279,1,12,3,4,0,104
195536,1327279,1,12,4,2,0,106
195537,1327279,1,12,5,1,0,107
195538,1327279,1,12,6,4,0,111
195539,1327279,1,13,1,1,0,112
195540,1327279,1,13,2,1,0,113
195541,1327279,1,13,3,6,0,119
195542,1327279,1,13,4,0,1,119
195543,1327279,1,13,5,6,0,125
195544,1327279,1,13,6,0,1,125
195545,1327279,1,14,1,1,0,126
195546,1327279,1,14,2,0,0,126
195547,1327279,1,14,3,4,0,130
195548,1327279,1,14,4,0,0,130
195549,1327279,1,14,5,0,0,130
195550,1327279,1,14,6,0,0,130
195551,1327279,1,15,1,0,0,130
195552,1327279,1,15,2,0,0,130
195553,1327279,1,15,3,1,0,131
195554,1327279,1,15,4,1,0,132
195555,1327279,1,15,5,1,0,133
195556,1327279,1,15,6,1,0,134
195557,1327279,1,16,1,0,0,134
195558,1327279,1,16,2,1,0,135
195559,1327279,1,16,3,1,0,136
195560,1327279,1,16,4,1,0,137
195561,1327279,1,16,5,6,0,143
195562,1327279,1,16,6,2,0,145
195563,1327279,1,17,1,1,0,146
195564,1327279,1,17,2,1,0,147
195565,1327279,1,17,3,4,0,151
195566,1327279,1,17,4,1,0,152
195567,1327279,1,17,5,4,0,156
195568,1327279,1,17,6,4,0,160
195569,1327279,1,18,1,2,0,162
195570,1327279,1,18,2,2,0,164
195571,1327279,1,18,3,4,0,168
195572,1327279,1,18,4,2,0,170
195573,1327279,1,18,5,4,0,174
195574,1327279,1,18,6,1,0,175
195575,1327279,1,19,1,4,0,179
195576,1327279,1,19,2,6,0,185
195577,1327279,1,19,3,2,0,187
195578,1327279,1,19,4,2,0,189
195579,1327279,1,19,5,1,0,190
195580,1327279,1,19,6,4,0,194
195581,1327279,1,20,1,6,0,200
195582,1327279,1,20,2,6,0,206
195583,1327279,1,20,3,4,0,210
195584,1327279,1,20,4,1,0,211
195585,1327279,1,20,5,1,0,212
195586,1327279,1,20,6,0,0,212
195707,1327280,1,1,1,0,0,0
195708,1327280,1,1,2,1,0,1
195709,1327280,1,1,3,2,0,3
195710,1327280,1,1,4,1,0,4
195711,1327280,1,1,5,3,0,7
195712,1327280,1,1,6,4,0,11
195713,1327280,1,2,1,1,0,12
195714,1327280,1,2,2,1,0,13
195715,1327280,1,2,3,0,0,13
195716,1327280,1,2,4,3,0,16
195717,1327280,1,2,5,2,0,18
195718,1327280,1,2,6,1,0,19
195719,1327280,1,3,1,1,0,20
195720,1327280,1,3,2,5,0,25
195721,1327280,1,3,3,0,0,25
195722,1327280,1,3,4,0,0,25
195723,1327280,1,3,5,0,0,25
195724,1327280,1,3,6,0,0,25
195725,1327280,1,4,1,0,0,25
195726,1327280,1,4,2,3,0,28
195727,1327280,1,4,3,0,1,28
195728,1327280,1,4,4,2,0,30
195729,1327280,1,4,5,2,0,32
195730,1327280,1,4,6,2,0,34
195731,1327280,1,5,1,0,0,34
195732,1327280,1,5,2,0,0,34
195733,1327280,1,5,3,1,0,35
195734,1327280,1,5,4,1,0,36
195735,1327280,1,5,5,0,0,36
195736,1327280,1,5,6,1,0,37
195737,1327280,1,6,1,4,0,41
195738,1327280,1,6,2,2,0,43
195739,1327280,1,6,3,1,0,44
195740,1327280,1,6,4,4,0,48
195741,1327280,1,6,5,1,0,49
195742,1327280,1,6,6,0,0,49
195743,1327280,1,7,1,1,0,50
195744,1327280,1,7,2,0,0,50
195745,1327280,1,7,3,0,0,50
195746,1327280,1,7,4,0,0,50
195747,1327280,1,7,5,1,0,51
195748,1327280,1,7,6,2,0,53
195749,1327280,1,8,1,0,0,53
195750,1327280,1,8,2,1,0,54
195751,1327280,1,8,3,2,0,56
195752,1327280,1,8,4,1,0,57
195753,1327280,1,8,5,1,0,58
195754,1327280,1,8,6,2,0,60
195755,1327280,1,9,1,1,0,61
195756,1327280,1,9,2,0,0,61
195757,1327280,1,9,3,0,0,61
195758,1327280,1,9,4,0,0,61
195759,1327280,1,9,5,0,0,61
195760,1327280,1,9,6,1,0,62
195761,1327280,1,10,1,1,0,63
195762,1327280,1,10,2,0,1,63
195763,1327280,1,10,3,1,0,64
195764,1327280,1,10,4,1,0,65
195765,1327280,1,10,5,1,0,66
195766,1327280,1,10,6,0,0,66
195767,1327280,1,11,1,0,0,66
195768,1327280,1,11,2,1,0,67
195769,1327280,1,11,3,1,0,68
195770,1327280,1,11,4,0,1,68
195771,1327280,1,11,5,6,0,74
195772,1327280,1,11,6,0,0,74
195773,1327280,1,12,1,1,0,75
195774,1327280,1,12,2,0,0,75
195775,1327280,1,12,3,1,0,76
195776,1327280,1,12,4,1,0,77
195777,1327280,1,12,5,0,0,77
195778,1327280,1,12,6,1,0,78
195779,1327280,1,13,1,0,0,78
195780,1327280,1,13,2,1,0,79
195781,1327280,1,13,3,0,0,79
195782,1327280,1,13,4,0,0,79
195783,1327280,1,13,5,1,0,80
195784,1327280,1,13,6,0,0,80
195785,1327280,1,14,1,1,0,81
195786,1327280,1,14,2,1,0,82
195787,1327280,1,14,3,0,1,82
195788,1327280,1,14,4,0,0,82
195789,1327280,1,14,5,1,0,83
195790,1327280,1,14,6,1,0,84
195791,1327280,1,15,1,0,0,84
195792,1327280,1,15,2,1,0,85
195793,1327280,1,15,3,0,0,85
195794,1327280,1,15,4,6,0,91
195795,1327280,1,15,5,0,1,91
195796,1327280,1,15,6,0,1,91
195797,1327280,1,16,1,0,0,91
195798,1327280,1,16,2,0,0,91
195799,1327280,1,16,3,2,0,93
195800,1327280,1,16,4,1,0,94
195801,1327280,1,16,5,1,0,95
195802,1327280,1,16,6,0,1,95
195803,1327280,1,17,1,0,0,95
195804,1327280,1,17,2,1,0,96
195805,1327280,1,17,3,1,0,97
195806,1327280,1,17,4,0,0,97
195807,1327280,1,17,5,1,0,98
195808,1327280,1,17,6,4,0,102
195809,1327280,1,18,1,1,0,103
195810,1327280,1,18,2,6,0,109
195811,1327280,1,18,3,0,0,109
195812,1327280,1,18,4,1,0,110
195813,1327280,1,18,5,0,1,110
195814,1327280,1,18,6,0,0,110
195815,1327280,1,19,1,1,0,111
195816,1327280,1,19,2,1,0,112
195817,1327280,1,19,3,2,0,114
195818,1327280,1,19,4,6,0,120
195819,1327280,1,19,5,1,1,121
195820,1327280,1,19,6,0,0,121
195821,1327280,1,20,1,0,1,121
195924,1327281,1,1,1,1,0,1
195925,1327281,1,1,2,1,0,2
195926,1327281,1,1,3,0,1,2
195927,1327281,1,1,4,0,0,2
195928,1327281,1,1,5,0,0,2
195929,1327281,1,1,6,2,0,4
195930,1327281,1,2,1,0,0,4
195931,1327281,1,2,2,1,0,5
195932,1327281,1,2,3,4,0,9
195933,1327281,1,2,4,0,0,9
195934,1327281,1,2,5,5,0,14
195935,1327281,1,2,6,2,0,16
195936,1327281,1,3,1,0,0,16
195937,1327281,1,3,2,0,0,16
195938,1327281,1,3,3,4,0,20
195939,1327281,1,3,4,1,0,21
195940,1327281,1,3,5,1,0,22
195941,1327281,1,3,6,1,0,23
195942,1327281,1,4,1,0,0,23
195943,1327281,1,4,2,0,1,23
195944,1327281,1,4,3,0,0,23
195945,1327281,1,4,4,0,0,23
195946,1327281,1,4,5,4,0,27
195947,1327281,1,4,6,1,0,28
195948,1327281,1,5,1,1,0,29
195949,1327281,1,5,2,1,0,30
195950,1327281,1,5,3,4,0,34
195951,1327281,1,5,4,1,0,35
195952,1327281,1,5,5,0,0,35
195953,1327281,1,5,6,1,0,36
195954,1327281,1,6,1,0,1,36
195955,1327281,1,6,2,4,0,40
195956,1327281,1,6,3,0,0,40
195957,1327281,1,6,4,0,0,40
195958,1327281,1,6,5,0,0,40
195959,1327281,1,6,6,2,0,42
195960,1327281,1,7,1,1,0,43
195961,1327281,1,7,2,1,0,44
195962,1327281,1,7,3,1,0,45
195963,1327281,1,7,4,1,0,46
195964,1327281,1,7,5,0,0,46
195965,1327281,1,7,6,1,0,47
195966,1327281,1,8,1,1,0,48
195967,1327281,1,8,2,4,0,52
195968,1327281,1,8,3,1,0,53
195969,1327281,1,8,4,0,1,53
195970,1327281,1,8,5,1,0,54
195971,1327281,1,8,6,1,0,55
195972,1327281,1,9,1,1,0,56
195973,1327281,1,9,2,1,0,57
195974,1327281,1,9,3,0,0,57
195975,1327281,1,9,4,1,0,58
195976,1327281,1,9,5,0,1,58
195977,1327281,1,9,6,4,0,62
195978,1327281,1,10,1,1,0,63
195979,1327281,1,10,2,1,0,64
195980,1327281,1,10,3,2,0,66
195981,1327281,1,10,4,0,0,66
195982,1327281,1,10,5,1,0,67
195983,1327281,1,10,6,0,0,67
195984,1327281,1,11,1,0,0,67
195985,1327281,1,11,2,4,0,71
195986,1327281,1,11,3,1,0,72
195987,1327281,1,11,4,4,0,76
195988,1327281,1,11,5,1,0,77
195989,1327281,1,11,6,0,0,77
195990,1327281,1,12,1,1,0,78
195991,1327281,1,12,2,0,0,78
195992,1327281,1,12,3,1,0,79
195993,1327281,1,12,4,1,0,80
195994,1327281,1,12,5,4,0,84
195995,1327281,1,12,6,1,0,85
195996,1327281,1,13,1,1,0,86
195997,1327281,1,13,2,0,0,86
195998,1327281,1,13,3,4,0,90
195999,1327281,1,13,4,2,0,92
196000,1327281,1,13,5,6,0,98
196001,1327281,1,13,6,1,0,99
196002,1327281,1,14,1,1,0,100
196003,1327281,1,14,2,4,0,104
196004,1327281,1,14,3,1,0,105
196005,1327281,1,14,4,0,0,105
196006,1327281,1,14,5,0,0,105
196007,1327281,1,14,6,1,0,106
196008,1327281,1,15,1,0,0,106
196009,1327281,1,15,2,2,0,108
196010,1327281,1,15,3,4,0,112
196011,1327281,1,15,4,4,0,116
196012,1327281,1,15,5,0,1,116
196013,1327281,1,15,6,1,0,117
196014,1327281,1,16,1,0,0,117
196015,1327281,1,16,2,0,0,117
196016,1327281,1,16,3,1,0,118
196017,1327281,1,16,4,1,0,119
196018,1327281,1,16,5,0,0,119
196019,1327281,1,16,6,1,0,120
196020,1327281,1,17,1,1,0,121
196021,1327281,1,17,2,1,0,122
196022,1327281,1,17,3,1,0,123
196023,1327281,1,17,4,6,0,129
196024,1327281,1,17,5,1,0,130
196025,1327281,1,17,6,6,0,136
196026,1327281,1,18,1,1,0,137
196027,1327281,1,18,2,4,0,141
196028,1327281,1,18,3,1,0,142
196029,1327281,1,18,4,3,0,145
196030,1327281,1,18,5,1,0,146
196031,1327281,1,18,6,1,0,147
196032,1327281,1,19,1,1,0,148
196033,1327281,1,19,2,1,0,149
196034,1327281,1,19,3,0,0,149
196035,1327281,1,19,4,0,0,149
196036,1327281,1,19,5,0,0,149
196037,1327281,1,19,6,6,0,155
196038,1327281,1,20,1,1,0,156
196039,1327281,1,20,2,2,0,158
196040,1327281,1,20,3,2,0,160
196041,1327281,1,20,4,0,0,160
196042,1327281,1,20,5,4,0,164
196043,1327281,1,20,6,6,0,170
196164,1327503,1,1,1,1,0,1
196165,1327503,1,1,2,0,0,1
196166,1327503,1,1,3,1,0,2
196167,1327503,1,1,4,0,0,2
196168,1327503,1,1,5,2,0,4
196169,1327503,1,1,6,0,0,4
196170,1327503,1,2,1,0,0,4
196171,1327503,1,2,2,0,0,4
196172,1327503,1,2,3,0,0,4
196173,1327503,1,2,4,6,0,10
196174,1327503,1,2,5,0,0,10
196175,1327503,1,2,6,4,0,14
196176,1327503,1,3,1,6,0,20
196177,1327503,1,3,2,0,0,20
196178,1327503,1,3,3,1,0,21
196179,1327503,1,3,4,0,1,21
196180,1327503,1,3,5,4,0,25
196181,1327503,1,3,6,0,0,25
196182,1327503,1,4,1,0,0,25
196183,1327503,1,4,2,0,0,25
196184,1327503,1,4,3,0,0,25
196185,1327503,1,4,4,1,0,26
196186,1327503,1,4,5,0,0,26
196187,1327503,1,4,6,4,0,30
196188,1327503,1,5,1,0,0,30
196189,1327503,1,5,2,2,0,32
196190,1327503,1,5,3,2,0,34
196191,1327503,1,5,4,1,0,35
196192,1327503,1,5,5,0,1,35
196193,1327503,1,5,6,0,0,35
196194,1327503,1,6,1,1,0,36
196195,1327503,1,6,2,0,0,36
196196,1327503,1,6,3,4,0,40
196197,1327503,1,6,4,0,0,40
196198,1327503,1,6,5,6,0,46
196199,1327503,1,6,6,0,0,46
196200,1327503,1,7,1,1,0,47
196201,1327503,1,7,2,1,0,48
196202,1327503,1,7,3,2,0,50
196203,1327503,1,7,4,4,0,54
196204,1327503,1,7,5,1,0,55
196205,1327503,1,7,6,1,0,56
196206,1327503,1,8,1,1,0,57
196207,1327503,1,8,2,1,0,58
196208,1327503,1,8,3,0,0,58
196209,1327503,1,8,4,6,0,64
196210,1327503,1,8,5,4,0,68
196211,1327503,1,8,6,1,0,69
196212,1327503,1,9,1,1,0,70
196213,1327503,1,9,2,1,0,71
196214,1327503,1,9,3,1,0,72
196215,1327503,1,9,4,1,0,73
196216,1327503,1,9,5,0,0,73
196217,1327503,1,9,6,6,0,79
196218,1327503,1,10,1,1,0,80
196219,1327503,1,10,2,1,0,81
196220,1327503,1,10,3,3,0,84
196221,1327503,1,10,4,0,0,84
196222,1327503,1,10,5,1,0,85
196223,1327503,1,10,6,1,0,86
196224,1327503,1,11,1,1,0,87
196225,1327503,1,11,2,1,0,88
196226,1327503,1,11,3,1,0,89
196227,1327503,1,11,4,1,0,90
196228,1327503,1,11,5,0,0,90
196229,1327503,1,11,6,1,0,91
196230,1327503,1,12,1,1,0,92
196231,1327503,1,12,2,6,0,98
196232,1327503,1,12,3,1,0,99
196233,1327503,1,12,4,4,0,103
196234,1327503,1,12,5,0,1,103
196235,1327503,1,12,6,0,0,103
196236,1327503,1,13,1,1,0,104
196237,1327503,1,13,2,1,0,105
196238,1327503,1,13,3,1,0,106
196239,1327503,1,13,4,1,0,107
196240,1327503,1,13,5,6,0,113
196241,1327503,1,13,6,6,0,119
196242,1327503,1,14,1,6,0,125
196243,1327503,1,14,2,1,0,126
196244,1327503,1,14,3,0,1,126
196245,1327503,1,14,4,1,0,127
196246,1327503,1,14,5,4,0,131
196247,1327503,1,14,6,0,0,131
196248,1327503,1,15,1,0,0,131
196249,1327503,1,15,2,4,0,135
196250,1327503,1,15,3,1,0,136
196251,1327503,1,15,4,0,0,136
196252,1327503,1,15,5,4,0,140
196253,1327503,1,15,6,1,0,141
196254,1327503,1,16,1,4,0,145
196255,1327503,1,16,2,0,0,145
196256,1327503,1,16,3,0,0,145
196257,1327503,1,16,4,1,0,146
196258,1327503,1,16,5,0,1,146
196259,1327503,1,16,6,2,0,148
196260,1327503,1,17,1,1,0,149
196261,1327503,1,17,2,2,0,151
196262,1327503,1,17,3,4,0,155
196263,1327503,1,17,4,0,0,155
196264,1327503,1,17,5,4,0,159
196265,1327503,1,17,6,1,0,160
196266,1327503,1,18,1,6,0,166
196267,1327503,1,18,2,1,0,167
196268,1327503,1,18,3,2,0,169
196269,1327503,1,18,4,1,0,170
196270,1327503,1,18,5,4,0,174
196271,1327503,1,18,6,2,0,176
196272,1327503,1,19,1,0,1,176
196273,1327503,1,19,2,4,0,180
196274,1327503,1,19,3,1,0,181
196275,1327503,1,19,4,1,0,182
196276,1327503,1,19,5,1,0,183
196277,1327503,1,19,6,4,0,187
196278,1327503,1,20,1,1,0,188
196279,1327503,1,20,2,0,0,188
196280,1327503,1,20,3,2,0,190
196281,1327503,1,20,4,6,0,196
196282,1327503,1,20,5,6,0,202
196283,1327503,1,20,6,6,0,208
196400,1327504,1,1,1,0,0,0
196401,1327504,1,1,2,4,0,4
196402,1327504,1,1,3,1,0,5
196403,1327504,1,1,4,1,0,6
196404,1327504,1,1,5,4,0,10
196405,1327504,1,1,6,0,0,10
196406,1327504,1,2,1,4,0,14
196407,1327504,1,2,2,0,0,14
196408,1327504,1,2,3,0,1,14
196409,1327504,1,2,4,4,0,18
196410,1327504,1,2,5,1,0,19
196411,1327504,1,2,6,0,1,19
196412,1327504,1,3,1,1,0,20
196413,1327504,1,3,2,1,0,21
196414,1327504,1,3,3,6,0,27
196415,1327504,1,3,4,2,0,29
196416,1327504,1,3,5,1,0,30
196417,1327504,1,3,6,1,0,31
196418,1327504,1,4,1,0,1,31
196419,1327504,1,4,2,0,0,31
196420,1327504,1,4,3,0,0,31
196421,1327504,1,4,4,0,0,31
196422,1327504,1,4,5,0,0,31
196423,1327504,1,4,6,4,0,35
196424,1327504,1,5,1,5,0,40
196425,1327504,1,5,2,1,0,41
196426,1327504,1,5,3,2,0,43
196427,1327504,1,5,4,1,0,44
196428,1327504,1,5,5,2,0,46
196429,1327504,1,5,6,0,1,46
196430,1327504,1,6,1,4,0,50
196431,1327504,1,6,2,1,0,51
196432,1327504,1,6,3,1,0,52
196433,1327504,1,6,4,2,0,54
196434,1327504,1,6,5,4,0,58
196435,1327504,1,6,6,1,0,59
196436,1327504,1,7,1,1,0,60
196437,1327504,1,7,2,4,0,64
196438,1327504,1,7,3,1,0,65
196439,1327504,1,7,4,4,0,69
196440,1327504,1,7,5,1,0,70
196441,1327504,1,7,6,1,0,71
196442,1327504,1,8,1,1,0,72
196443,1327504,1,8,2,6,0,78
196444,1327504,1,8,3,0,0,78
196445,1327504,1,8,4,6,0,84
196446,1327504,1,8,5,6,0,90
196447,1327504,1,8,6,0,1,90
196492,1327505,1,1,1,2,0,2
196493,1327505,1,1,2,6,0,8
196494,1327505,1,1,3,4,0,12
196495,1327505,1,1,4,0,0,12
196496,1327505,1,1,5,0,0,12
196497,1327505,1,1,6,0,0,12
196498,1327505,1,2,1,1,0,13
196499,1327505,1,2,2,4,0,17
196500,1327505,1,2,3,1,0,18
196501,1327505,1,2,4,1,0,19
196502,1327505,1,2,5,4,0,23
196503,1327505,1,2,6,0,0,23
196504,1327505,1,3,1,1,0,24
196505,1327505,1,3,2,0,0,24
196506,1327505,1,3,3,4,0,28
196507,1327505,1,3,4,0,0,28
196508,1327505,1,3,5,6,0,34
196509,1327505,1,3,6,6,0,40
196510,1327505,1,4,1,4,0,44
196511,1327505,1,4,2,0,0,44
196512,1327505,1,4,3,0,1,44
196513,1327505,1,4,4,4,0,48
196514,1327505,1,4,5,4,0,52
196515,1327505,1,4,6,4,0,56
196516,1327505,1,5,1,0,0,56
196517,1327505,1,5,2,1,0,57
196518,1327505,1,5,3,1,0,58
196519,1327505,1,5,4,1,0,59
196520,1327505,1,5,5,2,0,61
196521,1327505,1,5,6,1,1,62
196522,1327505,1,6,1,0,0,62
196523,1327505,1,6,2,0,0,62
196524,1327505,1,6,3,0,0,62
196525,1327505,1,6,4,0,0,62
196526,1327505,1,6,5,0,0,62
196527,1327505,1,6,6,4,0,66
196528,1327505,1,7,1,4,0,70
196529,1327505,1,7,2,0,0,70
196530,1327505,1,7,3,1,0,71
196531,1327505,1,7,4,0,0,71
196532,1327505,1,7,5,0,0,71
196533,1327505,1,7,6,0,0,71
196534,1327505,1,8,1,1,0,72
196535,1327505,1,8,2,1,0,73
196536,1327505,1,8,3,1,0,74
196537,1327505,1,8,4,1,1,75
196538,1327505,1,8,5,1,0,76
196539,1327505,1,8,6,0,0,76
196540,1327505,1,9,1,2,0,78
196541,1327505,1,9,2,0,0,78
196542,1327505,1,9,3,4,0,82
196543,1327505,1,9,4,0,0,82
196544,1327505,1,9,5,0,0,82
196545,1327505,1,9,6,1,0,83
196546,1327505,1,10,1,1,0,84
196547,1327505,1,10,2,0,1,84
196548,1327505,1,10,3,0,0,84
196549,1327505,1,10,4,1,0,85
196550,1327505,1,10,5,0,0,85
196551,1327505,1,10,6,1,0,86
196552,1327505,1,11,1,4,0,90
196553,1327505,1,11,2,1,0,91
196554,1327505,1,11,3,1,0,92
196555,1327505,1,11,4,0,0,92
196556,1327505,1,11,5,1,0,93
196557,1327505,1,11,6,2,0,95
196558,1327505,1,12,1,2,0,97
196559,1327505,1,12,2,0,0,97
196560,1327505,1,12,3,0,0,97
196561,1327505,1,12,4,1,0,98
196562,1327505,1,12,5,1,0,99
196563,1327505,1,12,6,4,0,103
196564,1327505,1,13,1,0,0,103
196565,1327505,1,13,2,6,0,109
196566,1327505,1,13,3,4,0,113
196567,1327505,1,13,4,0,0,113
196568,1327505,1,13,5,1,0,114
196569,1327505,1,13,6,1,0,115
196570,1327505,1,14,1,0,1,115
196571,1327505,1,14,2,0,0,115
196572,1327505,1,14,3,1,0,116
196573,1327505,1,14,4,1,0,117
196574,1327505,1,14,5,0,1,117
196575,1327505,1,14,6,0,0,117
196576,1327505,1,15,1,1,0,118
196577,1327505,1,15,2,0,0,118
196578,1327505,1,15,3,0,0,118
196579,1327505,1,15,4,2,0,120
196580,1327505,1,15,5,2,0,122
196581,1327505,1,15,6,1,0,123
196582,1327505,1,16,1,0,0,123
196583,1327505,1,16,2,0,0,123
196584,1327505,1,16,3,0,0,123
196585,1327505,1,16,4,6,0,129
196586,1327505,1,16,5,1,0,130
196587,1327505,1,16,6,4,0,134
196588,1327505,1,17,1,1,0,135
196589,1327505,1,17,2,0,0,135
196590,1327505,1,17,3,1,0,136
196591,1327505,1,17,4,1,0,137
196592,1327505,1,17,5,1,0,138
196593,1327505,1,17,6,2,0,140
196594,1327505,1,18,1,3,0,143
196595,1327505,1,18,2,0,0,143
196596,1327505,1,18,3,2,0,145
196597,1327505,1,18,4,6,0,151
196598,1327505,1,18,5,6,0,157
196599,1327505,1,18,6,4,0,161
196600,1327505,1,19,1,6,0,167
196601,1327505,1,19,2,1,0,168
196602,1327505,1,19,3,6,0,174
196603,1327505,1,19,4,1,0,175
196604,1327505,1,19,5,0,0,175
196605,1327505,1,19,6,4,0,179
196606,1327505,1,20,1,6,0,185
196607,1327505,1,20,2,0,0,185
196608,1327505,1,20,3,0,1,185
196609,1327505,1,20,4,0,0,185
196610,1327505,1,20,5,1,0,186
196611,1327505,1,20,6,0,0,186
196731,1327506,1,1,1,0,0,0
196732,1327506,1,1,2,1,0,1
196733,1327506,1,1,3,0,0,1
196734,1327506,1,1,4,0,0,1
196735,1327506,1,1,5,0,0,1
196736,1327506,1,1,6,0,1,1
196737,1327506,1,2,1,0,0,1
196738,1327506,1,2,2,0,1,1
196739,1327506,1,2,3,0,0,1
196740,1327506,1,2,4,4,0,5
196741,1327506,1,2,5,3,1,8
196742,1327506,1,2,6,0,1,8
196743,1327506,1,3,1,0,0,8
196744,1327506,1,3,2,1,0,9
196745,1327506,1,3,3,0,1,9
196746,1327506,1,3,4,4,0,13
196747,1327506,1,3,5,1,0,14
196748,1327506,1,3,6,0,0,14
196749,1327506,1,4,1,0,0,14
196750,1327506,1,4,2,4,0,18
196751,1327506,1,4,3,0,0,18
196752,1327506,1,4,4,0,0,18
196753,1327506,1,4,5,0,0,18
196754,1327506,1,4,6,0,0,18
196755,1327506,1,5,1,2,0,20
196756,1327506,1,5,2,0,0,20
196757,1327506,1,5,3,0,0,20
196758,1327506,1,5,4,0,0,20
196759,1327506,1,5,5,0,0,20
196760,1327506,1,5,6,6,0,26
196761,1327506,1,6,1,3,0,29
196762,1327506,1,6,2,1,0,30
196763,1327506,1,6,3,0,0,30
196764,1327506,1,6,4,0,0,30
196765,1327506,1,6,5,0,0,30
196766,1327506,1,6,6,0,0,30
196767,1327506,1,7,1,1,0,31
196768,1327506,1,7,2,1,0,32
196769,1327506,1,7,3,1,0,33
196770,1327506,1,7,4,1,0,34
196771,1327506,1,7,5,0,0,34
196772,1327506,1,7,6,1,0,35
196773,1327506,1,8,1,1,0,36
196774,1327506,1,8,2,0,0,36
196775,1327506,1,8,3,0,0,36
196776,1327506,1,8,4,6,0,42
196777,1327506,1,8,5,0,0,42
196778,1327506,1,8,6,0,1,42
196779,1327506,1,9,1,0,0,42
196780,1327506,1,9,2,0,0,42
196781,1327506,1,9,3,0,0,42
196782,1327506,1,9,4,0,0,42
196783,1327506,1,9,5,0,0,42
196784,1327506,1,9,6,0,0,42
196785,1327506,1,10,1,0,0,42
196786,1327506,1,10,2,4,0,46
196787,1327506,1,10,3,0,0,46
196788,1327506,1,10,4,0,0,46
196789,1327506,1,10,5,1,0,47
196790,1327506,1,10,6,1,0,48
196791,1327506,1,11,1,1,0,49
196792,1327506,1,11,2,0,0,49
196793,1327506,1,11,3,0,0,49
196794,1327506,1,11,4,0,0,49
196795,1327506,1,11,5,0,0,49
196796,1327506,1,11,6,0,0,49
196797,1327506,1,12,1,1,0,50
196798,1327506,1,12,2,0,0,50
196799,1327506,1,12,3,0,0,50
196800,1327506,1,12,4,0,0,50
196801,1327506,1,12,5,0,0,50
196802,1327506,1,12,6,0,0,50
196803,1327506,1,13,1,1,0,51
196804,1327506,1,13,2,0,0,51
196805,1327506,1,13,3,6,0,57
196806,1327506,1,13,4,1,0,58
196807,1327506,1,13,5,1,0,59
196808,1327506,1,13,6,0,0,59
196809,1327506,1,14,1,1,0,60
196810,1327506,1,14,2,1,0,61
196811,1327506,1,14,3,0,0,61
196812,1327506,1,14,4,0,0,61
196813,1327506,1,14,5,0,0,61
196814,1327506,1,14,6,0,0,61
196815,1327506,1,15,1,0,0,61
196816,1327506,1,15,2,0,0,61
196817,1327506,1,15,3,1,0,62
196818,1327506,1,15,4,0,0,62
196819,1327506,1,15,5,0,0,62
196820,1327506,1,15,6,1,0,63
196821,1327506,1,16,1,0,0,63
196822,1327506,1,16,2,0,0,63
196823,1327506,1,16,3,0,0,63
196824,1327506,1,16,4,4,0,67
196825,1327506,1,16,5,1,1,68
196826,1327506,1,16,6,4,0,72
196827,1327506,1,17,1,1,0,73
196828,1327506,1,17,2,1,0,74
196829,1327506,1,17,3,0,0,74
196830,1327506,1,17,4,1,0,75
196831,1327506,1,17,5,4,0,79
196832,1327506,1,17,6,0,0,79
196833,1327506,1,18,1,1,0,80
196834,1327506,1,18,2,1,0,81
196835,1327506,1,18,3,0,0,81
196836,1327506,1,18,4,1,0,82
196837,1327506,1,18,5,1,0,83
196838,1327506,1,18,6,0,0,83
196839,1327506,1,19,1,4,0,87
196840,1327506,1,19,2,6,0,93
196841,1327506,1,19,3,1,0,94
196842,1327506,1,19,4,1,0,95
196843,1327506,1,19,5,4,0,99
196844,1327506,1,19,6,1,0,100
196845,1327506,1,20,1,1,1,101
196846,1327506,1,20,2,1,0,102
196847,1327506,1,20,3,1,0,103
196848,1327506,1,20,4,1,0,104
196849,1327506,1,20,5,1,0,105
196850,1327506,1,20,6,1,0,106
196951,1327507,1,1,1,4,0,4
196952,1327507,1,1,2,1,0,5
196953,1327507,1,1,3,0,0,5
196954,1327507,1,1,4,1,0,6
196955,1327507,1,1,5,0,0,6
196956,1327507,1,1,6,0,0,6
196957,1327507,1,2,1,0,0,6
196958,1327507,1,2,2,0,0,6
196959,1327507,1,2,3,4,0,10
196960,1327507,1,2,4,0,0,10
196961,1327507,1,2,5,1,0,11
196962,1327507,1,2,6,4,0,15
196963,1327507,1,3,1,0,0,15
196964,1327507,1,3,2,0,0,15
196965,1327507,1,3,3,6,0,21
196966,1327507,1,3,4,0,0,21
196967,1327507,1,3,5,0,0,21
196968,1327507,1,3,6,0,0,21
196969,1327507,1,4,1,6,0,27
196970,1327507,1,4,2,4,0,31
196971,1327507,1,4,3,1,0,32
196972,1327507,1,4,4,4,0,36
196973,1327507,1,4,5,0,0,36
196974,1327507,1,4,6,0,0,36
196975,1327507,1,5,1,0,0,36
196976,1327507,1,5,2,1,0,37
196977,1327507,1,5,3,4,0,41
196978,1327507,1,5,4,2,0,43
196979,1327507,1,5,5,1,0,44
196980,1327507,1,5,6,5,0,49
196981,1327507,1,6,1,0,0,49
196982,1327507,1,6,2,0,0,49
196983,1327507,1,6,3,4,0,53
196984,1327507,1,6,4,0,0,53
196985,1327507,1,6,5,0,0,53
196986,1327507,1,6,6,4,0,57
196987,1327507,1,7,1,1,0,58
196988,1327507,1,7,2,1,0,59
196989,1327507,1,7,3,6,0,65
196990,1327507,1,7,4,1,0,66
196991,1327507,1,7,5,1,0,67
196992,1327507,1,7,6,1,0,68
196993,1327507,1,8,1,1,0,69
196994,1327507,1,8,2,1,0,70
196995,1327507,1,8,3,1,0,71
196996,1327507,1,8,4,1,0,72
196997,1327507,1,8,5,1,0,73
196998,1327507,1,8,6,0,0,73
196999,1327507,1,9,1,4,0,77
197000,1327507,1,9,2,6,0,83
197001,1327507,1,9,3,2,0,85
197002,1327507,1,9,4,4,0,89
197003,1327507,1,9,5,4,0,93
197004,1327507,1,9,6,1,0,94
197005,1327507,1,10,1,0,0,94
197006,1327507,1,10,2,1,0,95
197007,1327507,1,10,3,1,0,96
197008,1327507,1,10,4,0,0,96
197009,1327507,1,10,5,0,1,96
197010,1327507,1,10,6,0,0,96
197011,1327507,1,11,1,1,0,97
197012,1327507,1,11,2,1,0,98
197013,1327507,1,11,3,6,0,104
197014,1327507,1,11,4,0,0,104
197015,1327507,1,11,5,1,0,105
197016,1327507,1,11,6,0,0,105
197017,1327507,1,12,1,1,0,106
197018,1327507,1,12,2,1,0,107
197019,1327507,1,12,3,0,1,107
197020,1327507,1,12,4,0,0,107
197021,1327507,1,12,5,2,0,109
197022,1327507,1,12,6,4,0,113
197023,1327507,1,13,1,1,0,114
197024,1327507,1,13,2,4,0,118
197025,1327507,1,13,3,1,0,119
197026,1327507,1,13,4,1,0,120
197027,1327507,1,13,5,1,0,121
197028,1327507,1,13,6,4,0,125
197029,1327507,1,14,1,1,0,126
197030,1327507,1,14,2,1,0,127
197031,1327507,1,14,3,1,0,128
197032,1327507,1,14,4,0,0,128
197033,1327507,1,14,5,1,0,129
197034,1327507,1,14,6,4,0,133
197035,1327507,1,15,1,6,0,139
197036,1327507,1,15,2,4,0,143
197037,1327507,1,15,3,1,0,144
197038,1327507,1,15,4,1,0,145
197039,1327507,1,15,5,4,0,149
197040,1327507,1,15,6,6,0,155
197041,1327507,1,16,1,1,0,156
197042,1327507,1,16,2,6,0,162
197043,1327507,1,16,3,2,0,164
197044,1327507,1,16,4,4,0,168
197045,1327507,1,16,5,1,0,169
197046,1327507,1,16,6,2,0,171
197047,1327507,1,17,1,8,0,179
197048,1327507,1,17,2,6,0,185
197049,1327507,1,17,3,4,0,189
197050,1327507,1,17,4,0,0,189
197051,1327507,1,17,5,4,0,193
197052,1327507,1,17,6,1,0,194
197053,1327507,1,18,1,0,0,194
197054,1327507,1,18,2,4,0,198
197055,1327507,1,18,3,5,0,203
197056,1327507,1,18,4,0,0,203
197057,1327507,1,18,5,0,0,203
197058,1327507,1,18,6,6,0,209
197059,1327507,1,19,1,0,1,209
197060,1327507,1,19,2,1,0,210
197061,1327507,1,19,3,1,0,211
197062,1327507,1,19,4,4,0,215
197063,1327507,1,19,5,4,0,219
197064,1327507,1,19,6,0,0,219
197065,1327507,1,20,1,0,0,219
197066,1327507,1,20,2,4,0,223
197067,1327507,1,20,3,0,0,223
197068,1327507,1,20,4,7,0,230
197069,1327507,1,20,5,6,0,236
197070,1327507,1,20,6,1,0,237
197191,1327508,1,1,1,0,0,0
197192,1327508,1,1,2,0,0,0
197193,1327508,1,1,3,0,0,0
197194,1327508,1,1,4,1,0,1
197195,1327508,1,1,5,0,0,1
197196,1327508,1,1,6,0,0,1
197197,1327508,1,2,1,0,0,1
197198,1327508,1,2,2,6,0,7
197199,1327508,1,2,3,1,0,8
197200,1327508,1,2,4,1,0,9
197201,1327508,1,2,5,4,0,13
197202,1327508,1,2,6,1,0,14
197203,1327508,1,3,1,0,0,14
197204,1327508,1,3,2,6,0,20
197205,1327508,1,3,3,0,0,20
197206,1327508,1,3,4,2,0,22
197207,1327508,1,3,5,0,0,22
197208,1327508,1,3,6,1,0,23
197209,1327508,1,4,1,1,0,24
197210,1327508,1,4,2,0,0,24
197211,1327508,1,4,3,0,0,24
197212,1327508,1,4,4,4,0,28
197213,1327508,1,4,5,1,0,29
197214,1327508,1,4,6,1,0,30
197215,1327508,1,5,1,0,1,30
197216,1327508,1,5,2,0,0,30
197217,1327508,1,5,3,0,0,30
197218,1327508,1,5,4,0,0,30
197219,1327508,1,5,5,4,0,34
197220,1327508,1,5,6,4,0,38
197221,1327508,1,6,1,1,0,39
197222,1327508,1,6,2,0,0,39
197223,1327508,1,6,3,1,0,40
197224,1327508,1,6,4,1,0,41
197225,1327508,1,6,5,6,0,47
197226,1327508,1,6,6,1,0,48
197227,1327508,1,7,1,0,0,48
197228,1327508,1,7,2,6,0,54
197229,1327508,1,7,3,1,0,55
197230,1327508,1,7,4,0,0,55
197231,1327508,1,7,5,2,0,57
197232,1327508,1,7,6,4,0,61
197233,1327508,1,8,1,1,0,62
197234,1327508,1,8,2,5,0,67
197235,1327508,1,8,3,0,0,67
197236,1327508,1,8,4,0,0,67
197237,1327508,1,8,5,0,0,67
197238,1327508,1,8,6,1,0,68
197239,1327508,1,9,1,0,0,68
197240,1327508,1,9,2,1,0,69
197241,1327508,1,9,3,1,0,70
197242,1327508,1,9,4,6,0,76
197243,1327508,1,9,5,1,0,77
197244,1327508,1,9,6,6,0,83
197245,1327508,1,10,1,1,0,84
197246,1327508,1,10,2,1,0,85
197247,1327508,1,10,3,6,0,91
197248,1327508,1,10,4,0,0,91
197249,1327508,1,10,5,1,0,92
197250,1327508,1,10,6,4,0,96
197251,1327508,1,11,1,4,0,100
197252,1327508,1,11,2,4,0,104
197253,1327508,1,11,3,1,0,105
197254,1327508,1,11,4,2,0,107
197255,1327508,1,11,5,1,0,108
197256,1327508,1,11,6,6,0,114
197257,1327508,1,12,1,1,0,115
197258,1327508,1,12,2,1,0,116
197259,1327508,1,12,3,1,0,117
197260,1327508,1,12,4,1,0,118
197261,1327508,1,12,5,1,0,119
197262,1327508,1,12,6,0,0,119
197263,1327508,1,13,1,1,1,120
197264,1327508,1,13,2,1,0,121
197265,1327508,1,13,3,4,0,125
197266,1327508,1,13,4,0,0,125
197267,1327508,1,13,5,1,0,126
197268,1327508,1,13,6,6,0,132
197269,1327508,1,14,1,1,0,133
197270,1327508,1,14,2,1,0,134
197271,1327508,1,14,3,6,0,140
197272,1327508,1,14,4,1,0,141
197273,1327508,1,14,5,4,0,145
197274,1327508,1,14,6,0,0,145
197275,1327508,1,15,1,1,0,146
197276,1327508,1,15,2,0,0,146
197277,1327508,1,15,3,1,0,147
197278,1327508,1,15,4,6,0,153
197279,1327508,1,15,5,1,0,154
197280,1327508,1,15,6,0,0,154
197281,1327508,1,16,1,6,0,160
197282,1327508,1,16,2,1,0,161
197283,1327508,1,16,3,2,0,163
197284,1327508,1,16,4,1,0,164
197285,1327508,1,16,5,1,0,165
197286,1327508,1,16,6,4,0,169
197287,1327508,1,17,1,0,0,169
197288,1327508,1,17,2,0,0,169
197289,1327508,1,17,3,1,0,170
197290,1327508,1,17,4,1,0,171
197291,1327508,1,17,5,5,0,176
197292,1327508,1,17,6,1,0,177
197293,1327508,1,18,1,1,0,178
197294,1327508,1,18,2,1,0,179
197295,1327508,1,18,3,2,0,181
197296,1327508,1,18,4,6,0,187
197297,1327508,1,18,5,4,0,191
197298,1327508,1,18,6,1,0,192
197299,1327508,1,19,1,4,0,196
197300,1327508,1,19,2,0,0,196
197301,1327508,1,19,3,1,0,197
197302,1327508,1,19,4,4,0,201
197303,1327508,1,19,5,1,0,202
197304,1327508,1,19,6,1,0,203
197305,1327508,1,20,1,4,0,207
197306,1327508,1,20,2,0,1,207
197307,1327508,1,20,3,0,0,207
197308,1327508,1,20,4,13,0,220
197309,1327508,1,20,5,6,0,226
197310,1327508,1,20,6,1,0,227
197422,1339604,1,1,1,0,1,0
197423,1339604,1,1,2,0,0,0
197424,1339604,1,1,3,0,0,0
197425,1339604,1,1,4,2,0,2
197426,1339604,1,1,5,4,0,6
197427,1339604,1,1,6,4,0,10
197428,1339604,1,2,1,0,0,10
197429,1339604,1,2,2,1,0,11
197430,1339604,1,2,3,1,0,12
197431,1339604,1,2,4,0,1,12
197432,1339604,1,2,5,0,0,12
197433,1339604,1,2,6,0,0,12
197434,1339604,1,3,1,1,0,13
197435,1339604,1,3,2,0,0,13
197436,1339604,1,3,3,4,0,17
197437,1339604,1,3,4,1,0,18
197438,1339604,1,3,5,6,0,24
197439,1339604,1,3,6,6,0,30
197440,1339604,1,4,1,4,0,34
197441,1339604,1,4,2,4,0,38
197442,1339604,1,4,3,1,0,39
197443,1339604,1,4,4,1,0,40
197444,1339604,1,4,5,0,1,40
197445,1339604,1,4,6,5,0,45
197446,1339604,1,5,1,1,0,46
197447,1339604,1,5,2,1,0,47
197448,1339604,1,5,3,0,0,47
197449,1339604,1,5,4,2,0,49
197450,1339604,1,5,5,1,0,50
197451,1339604,1,5,6,2,0,52
197452,1339604,1,6,1,1,0,53
197453,1339604,1,6,2,2,0,55
197454,1339604,1,6,3,0,1,55
197455,1339604,1,6,4,2,0,57
197456,1339604,1,6,5,2,0,59
197457,1339604,1,6,6,1,0,60
197458,1339604,1,7,1,0,0,60
197459,1339604,1,7,2,1,0,61
197460,1339604,1,7,3,0,1,61
197461,1339604,1,7,4,2,0,63
197462,1339604,1,7,5,1,0,64
197463,1339604,1,7,6,1,0,65
197464,1339604,1,8,1,1,0,66
197465,1339604,1,8,2,1,0,67
197466,1339604,1,8,3,1,0,68
197467,1339604,1,8,4,2,0,70
197468,1339604,1,8,5,1,0,71
197469,1339604,1,8,6,0,0,71
197470,1339604,1,9,1,6,0,77
197471,1339604,1,9,2,2,0,79
197472,1339604,1,9,3,0,1,79
197473,1339604,1,9,4,1,0,80
197474,1339604,1,9,5,4,0,84
197475,1339604,1,9,6,4,0,88
197476,1339604,1,10,1,4,0,92
197477,1339604,1,10,2,1,0,93
197478,1339604,1,10,3,6,0,99
197479,1339604,1,10,4,1,0,100
197480,1339604,1,10,5,6,0,106
197481,1339604,1,10,6,6,0,112
197482,1339604,1,11,1,4,0,116
197483,1339604,1,11,2,4,0,120
197484,1339604,1,11,3,6,0,126
197485,1339604,1,11,4,0,1,126
197486,1339604,1,11,5,4,0,130
197487,1339604,1,11,6,1,1,131
197551,1339605,1,1,1,1,0,1
197552,1339605,1,1,2,1,0,2
197553,1339605,1,1,3,0,1,2
197554,1339605,1,1,4,0,0,2
197555,1339605,1,1,5,4,0,6
197556,1339605,1,1,6,4,0,10
197557,1339605,1,2,1,0,0,10
197558,1339605,1,2,2,0,0,10
197559,1339605,1,2,3,0,0,10
197560,1339605,1,2,4,0,0,10
197561,1339605,1,2,5,1,0,11
197562,1339605,1,2,6,0,0,11
197563,1339605,1,3,1,4,0,15
197564,1339605,1,3,2,1,0,16
197565,1339605,1,3,3,4,0,20
197566,1339605,1,3,4,2,0,22
197567,1339605,1,3,5,4,0,26
197568,1339605,1,3,6,2,0,28
197569,1339605,1,4,1,4,0,32
197570,1339605,1,4,2,0,0,32
197571,1339605,1,4,3,0,0,32
197572,1339605,1,4,4,0,0,32
197573,1339605,1,4,5,1,0,33
197574,1339605,1,4,6,0,0,33
197575,1339605,1,5,1,6,0,39
197576,1339605,1,5,2,4,0,43
197577,1339605,1,5,3,0,0,43
197578,1339605,1,5,4,6,0,49
197579,1339605,1,5,5,0,0,49
197580,1339605,1,5,6,4,0,53
197581,1339605,1,6,1,4,0,57
197582,1339605,1,6,2,4,0,61
197583,1339605,1,6,3,1,0,62
197584,1339605,1,6,4,0,0,62
197585,1339605,1,6,5,0,0,62
197586,1339605,1,6,6,0,0,62
197587,1339605,1,7,1,6,0,68
197588,1339605,1,7,2,6,0,74
197589,1339605,1,7,3,0,0,74
197590,1339605,1,7,4,4,0,78
197591,1339605,1,7,5,4,0,82
197592,1339605,1,7,6,1,0,83
197593,1339605,1,8,1,0,0,83
197594,1339605,1,8,2,6,0,89
197595,1339605,1,8,3,0,0,89
197596,1339605,1,8,4,1,0,90
197597,1339605,1,8,5,6,0,96
197598,1339605,1,8,6,1,0,97
197599,1339605,1,9,1,2,0,99
197600,1339605,1,9,2,6,0,105
197601,1339605,1,9,3,5,0,110
197602,1339605,1,9,4,6,0,116
197603,1339605,1,9,5,1,0,117
197604,1339605,1,9,6,1,0,118
197605,1339605,1,10,1,6,0,124
197606,1339605,1,10,2,0,0,124
197607,1339605,1,10,3,1,0,125
197608,1339605,1,10,4,0,0,125
197609,1339605,1,10,5,6,0,131
197610,1339605,1,10,6,6,0,137
197611,1339605,1,11,1,0,1,137
197612,1339605,1,11,2,0,0,137
197613,1339605,1,11,3,2,0,139
197614,1339605,1,11,4,0,1,139
197615,1339605,1,11,5,1,0,140
197616,1339605,1,11,6,0,0,140
197617,1339605,1,12,1,1,0,141
197618,1339605,1,12,2,0,0,141
197619,1339605,1,12,3,6,0,147
197620,1339605,1,12,4,1,0,148
197621,1339605,1,12,5,0,0,148
197622,1339605,1,12,6,0,0,148
197623,1339605,1,13,1,4,0,152
197624,1339605,1,13,2,1,0,153
197625,1339605,1,13,3,1,0,154
197626,1339605,1,13,4,6,0,160
197627,1339605,1,13,5,0,0,160
197628,1339605,1,13,6,1,0,161
197629,1339605,1,14,1,6,0,167
197630,1339605,1,14,2,6,0,173
197631,1339605,1,14,3,4,0,177
197632,1339605,1,14,4,1,0,178
197633,1339605,1,14,5,1,0,179
197634,1339605,1,14,6,0,1,179
197635,1339605,1,15,1,3,0,182
197636,1339605,1,15,2,1,0,183
197637,1339605,1,15,3,1,0,184
197638,1339605,1,15,4,1,0,185
197639,1339605,1,15,5,1,0,186
197640,1339605,1,15,6,4,0,190
197641,1339605,1,16,1,1,0,191
197642,1339605,1,16,2,1,0,192
197643,1339605,1,16,3,1,0,193
197644,1339605,1,16,4,6,0,199
197645,1339605,1,16,5,1,0,200
197646,1339605,1,16,6,6,0,206
197647,1339605,1,17,1,1,0,207
197648,1339605,1,17,2,1,0,208
197649,1339605,1,17,3,0,0,208
197650,1339605,1,17,4,6,0,214
197651,1339605,1,17,5,1,0,215
197652,1339605,1,17,6,2,0,217
197653,1339605,1,18,1,4,0,221
197654,1339605,1,18,2,1,0,222
197655,1339605,1,18,3,6,0,228
197656,1339605,1,18,4,6,0,234
197657,1339605,1,18,5,0,0,234
197658,1339605,1,18,6,1,0,235
197659,1339605,1,19,1,1,0,236
197660,1339605,1,19,2,0,1,236
197661,1339605,1,19,3,1,0,237
197662,1339605,1,19,4,2,0,239
197663,1339605,1,19,5,1,0,240
197664,1339605,1,19,6,0,0,240
197665,1339605,1,20,1,2,0,242
197666,1339605,1,20,2,1,0,243
197667,1339605,1,20,3,6,0,249
197668,1339605,1,20,4,2,0,251
197669,1339605,1,20,5,1,0,252
197670,1339605,1,20,6,6,0,258
197784,1339606,1,1,1,1,0,1
197785,1339606,1,1,2,0,0,1
197786,1339606,1,1,3,1,0,2
197787,1339606,1,1,4,0,0,2
197788,1339606,1,1,5,0,0,2
197789,1339606,1,1,6,1,0,3
197790,1339606,1,2,1,1,0,4
197791,1339606,1,2,2,6,0,10
197792,1339606,1,2,3,0,0,10
197793,1339606,1,2,4,6,0,16
197794,1339606,1,2,5,0,0,16
197795,1339606,1,2,6,0,0,16
197796,1339606,1,3,1,0,0,16
197797,1339606,1,3,2,6,0,22
197798,1339606,1,3,3,6,0,28
197799,1339606,1,3,4,4,0,32
197800,1339606,1,3,5,6,0,38
197801,1339606,1,3,6,0,0,38
197802,1339606,1,4,1,1,0,39
197803,1339606,1,4,2,0,1,39
197804,1339606,1,4,3,0,1,39
197805,1339606,1,4,4,4,0,43
197806,1339606,1,4,5,0,0,43
197807,1339606,1,4,6,4,0,47
197808,1339606,1,5,1,1,0,48
197809,1339606,1,5,2,0,0,48
197810,1339606,1,5,3,6,0,54
197811,1339606,1,5,4,1,0,55
197812,1339606,1,5,5,0,0,55
197813,1339606,1,5,6,1,0,56
197814,1339606,1,6,1,4,0,60
197815,1339606,1,6,2,0,0,60
197816,1339606,1,6,3,0,0,60
197817,1339606,1,6,4,1,0,61
197818,1339606,1,6,5,0,0,61
197819,1339606,1,6,6,0,0,61
197820,1339606,1,7,1,0,0,61
197821,1339606,1,7,2,6,0,67
197822,1339606,1,7,3,6,0,73
197823,1339606,1,7,4,0,0,73
197824,1339606,1,7,5,6,0,79
197825,1339606,1,7,6,1,0,80
197826,1339606,1,8,1,1,0,81
197827,1339606,1,8,2,1,0,82
197828,1339606,1,8,3,2,0,84
197829,1339606,1,8,4,1,0,85
197830,1339606,1,8,5,0,0,85
197831,1339606,1,8,6,4,0,89
197832,1339606,1,9,1,1,0,90
197833,1339606,1,9,2,4,0,94
197834,1339606,1,9,3,0,1,94
197835,1339606,1,9,4,4,0,98
197836,1339606,1,9,5,1,0,99
197837,1339606,1,9,6,1,0,100
197838,1339606,1,10,1,1,0,101
197839,1339606,1,10,2,6,0,107
197840,1339606,1,10,3,0,1,107
197841,1339606,1,10,4,0,0,107
197842,1339606,1,10,5,0,0,107
197843,1339606,1,10,6,1,0,108
197844,1339606,1,11,1,1,0,109
197845,1339606,1,11,2,1,1,110
197846,1339606,1,11,3,1,0,111
197847,1339606,1,11,4,3,0,114
197848,1339606,1,11,5,3,0,117
197849,1339606,1,11,6,0,0,117
197850,1339606,1,12,1,1,0,118
197851,1339606,1,12,2,1,0,119
197852,1339606,1,12,3,0,0,119
197853,1339606,1,12,4,4,0,123
197854,1339606,1,12,5,6,0,129
197855,1339606,1,12,6,1,0,130
197856,1339606,1,13,1,1,0,131
197857,1339606,1,13,2,6,0,137
197858,1339606,1,13,3,0,0,137
197859,1339606,1,13,4,2,0,139
197860,1339606,1,13,5,2,0,141
197861,1339606,1,13,6,0,1,141
197862,1339606,1,14,1,0,0,141
197863,1339606,1,14,2,1,0,142
197864,1339606,1,14,3,1,0,143
197865,1339606,1,14,4,1,0,144
197866,1339606,1,14,5,0,0,144
197867,1339606,1,14,6,1,0,145
197868,1339606,1,15,1,4,0,149
197869,1339606,1,15,2,0,1,149
197870,1339606,1,15,3,0,0,149
197871,1339606,1,15,4,2,0,151
197872,1339606,1,15,5,2,0,153
197873,1339606,1,15,6,0,0,153
197874,1339606,1,16,1,1,0,154
197875,1339606,1,16,2,6,0,160
197876,1339606,1,16,3,1,0,161
197877,1339606,1,16,4,0,1,161
197878,1339606,1,16,5,1,0,162
197879,1339606,1,16,6,1,0,163
197880,1339606,1,17,1,0,0,163
197881,1339606,1,17,2,1,0,164
197882,1339606,1,17,3,2,0,166
197883,1339606,1,17,4,0,0,166
197884,1339606,1,17,5,1,0,167
197885,1339606,1,17,6,1,0,168
197886,1339606,1,18,1,2,0,170
197887,1339606,1,18,2,0,0,170
197888,1339606,1,18,3,2,0,172
197889,1339606,1,18,4,1,0,173
197890,1339606,1,18,5,0,0,173
197891,1339606,1,18,6,4,0,177
197892,1339606,1,19,1,2,0,179
197893,1339606,1,19,2,4,0,183
197894,1339606,1,19,3,1,0,184
197895,1339606,1,19,4,6,0,190
197896,1339606,1,19,5,1,0,191
197897,1339606,1,19,6,3,0,194
197898,1339606,1,20,1,2,0,196
197899,1339606,1,20,2,6,0,202
197900,1339606,1,20,3,4,0,206
197901,1339606,1,20,4,6,0,212
197902,1339606,1,20,5,6,0,218
197903,1339606,1,20,6,2,0,220
198024,1339614,1,1,1,0,0,0
198025,1339614,1,1,2,0,0,0
198026,1339614,1,1,3,0,0,0
198027,1339614,1,1,4,1,0,1
198028,1339614,1,1,5,0,0,1
198029,1339614,1,1,6,4,0,5
198030,1339614,1,2,1,0,0,5
198031,1339614,1,2,2,4,0,9
198032,1339614,1,2,3,4,0,13
198033,1339614,1,2,4,0,0,13
198034,1339614,1,2,5,1,0,14
198035,1339614,1,2,6,0,1,14
198036,1339614,1,3,1,1,0,15
198037,1339614,1,3,2,0,0,15
198038,1339614,1,3,3,1,0,16
198039,1339614,1,3,4,4,0,20
198040,1339614,1,3,5,0,0,20
198041,1339614,1,3,6,0,0,20
198042,1339614,1,4,1,0,0,20
198043,1339614,1,4,2,0,0,20
198044,1339614,1,4,3,0,0,20
198045,1339614,1,4,4,4,0,24
198046,1339614,1,4,5,4,0,28
198047,1339614,1,4,6,1,0,29
198048,1339614,1,5,1,1,0,30
198049,1339614,1,5,2,0,1,30
198050,1339614,1,5,3,0,0,30
198051,1339614,1,5,4,0,0,30
198052,1339614,1,5,5,7,0,37
198053,1339614,1,5,6,4,0,41
198054,1339614,1,6,1,1,0,42
198055,1339614,1,6,2,1,0,43
198056,1339614,1,6,3,1,0,44
198057,1339614,1,6,4,4,0,48
198058,1339614,1,6,5,4,0,52
198059,1339614,1,6,6,0,0,52
198060,1339614,1,7,1,0,0,52
198061,1339614,1,7,2,1,0,53
198062,1339614,1,7,3,0,0,53
198063,1339614,1,7,4,0,0,53
198064,1339614,1,7,5,0,0,53
198065,1339614,1,7,6,0,0,53
198066,1339614,1,8,1,1,0,54
198067,1339614,1,8,2,1,0,55
198068,1339614,1,8,3,0,0,55
198069,1339614,1,8,4,4,0,59
198070,1339614,1,8,5,1,0,60
198071,1339614,1,8,6,1,0,61
198072,1339614,1,9,1,4,0,65
198073,1339614,1,9,2,1,0,66
198074,1339614,1,9,3,0,0,66
198075,1339614,1,9,4,4,0,70
198076,1339614,1,9,5,1,0,71
198077,1339614,1,9,6,4,0,75
198078,1339614,1,10,1,1,0,76
198079,1339614,1,10,2,0,0,76
198080,1339614,1,10,3,6,0,82
198081,1339614,1,10,4,2,0,84
198082,1339614,1,10,5,1,0,85
198083,1339614,1,10,6,6,0,91
198084,1339614,1,11,1,0,0,91
198085,1339614,1,11,2,6,0,97
198086,1339614,1,11,3,2,0,99
198087,1339614,1,11,4,0,0,99
198088,1339614,1,11,5,2,0,101
198089,1339614,1,11,6,6,0,107
198090,1339614,1,12,1,1,0,108
198091,1339614,1,12,2,1,1,109
198092,1339614,1,12,3,1,0,110
198093,1339614,1,12,4,4,0,114
198094,1339614,1,12,5,1,0,115
198095,1339614,1,12,6,1,0,116
198096,1339614,1,13,1,2,0,118
198097,1339614,1,13,2,2,0,120
198098,1339614,1,13,3,2,0,122
198099,1339614,1,13,4,1,0,123
198100,1339614,1,13,5,0,1,123
198101,1339614,1,13,6,0,1,123
198102,1339614,1,14,1,0,0,123
198103,1339614,1,14,2,1,0,124
198104,1339614,1,14,3,2,0,126
198105,1339614,1,14,4,1,0,127
198106,1339614,1,14,5,4,0,131
198107,1339614,1,14,6,0,1,131
198108,1339614,1,15,1,0,0,131
198109,1339614,1,15,2,0,0,131
198110,1339614,1,15,3,1,0,132
198111,1339614,1,15,4,1,0,133
198112,1339614,1,15,5,1,0,134
198113,1339614,1,15,6,1,0,135
198114,1339614,1,16,1,0,0,135
198115,1339614,1,16,2,2,0,137
198116,1339614,1,16,3,4,0,141
198117,1339614,1,16,4,1,0,142
198118,1339614,1,16,5,0,0,142
198119,1339614,1,16,6,1,0,143
198120,1339614,1,17,1,4,0,147
198121,1339614,1,17,2,1,0,148
198122,1339614,1,17,3,4,0,152
198123,1339614,1,17,4,1,0,153
198124,1339614,1,17,5,0,0,153
198125,1339614,1,17,6,4,0,157
198126,1339614,1,18,1,0,0,157
198127,1339614,1,18,2,1,0,158
198128,1339614,1,18,3,0,0,158
198129,1339614,1,18,4,1,0,159
198130,1339614,1,18,5,0,1,159
198131,1339614,1,18,6,1,0,160
198132,1339614,1,19,1,0,1,160
198133,1339614,1,19,2,1,0,161
198134,1339614,1,19,3,1,0,162
198135,1339614,1,19,4,0,0,162
198136,1339614,1,19,5,4,0,166
198137,1339614,1,19,6,6,0,172
198138,1339614,1,20,1,6,0,178
198139,1339614,1,20,2,1,0,179
198140,1339614,1,20,3,2,1,181
198141,1339614,1,20,4,1,0,182
198142,1339614,1,20,5,0,1,182
198236,1339615,1,1,1,0,0,0
198237,1339615,1,1,2,0,0,0
198238,1339615,1,1,3,1,0,1
198239,1339615,1,1,4,0,0,1
198240,1339615,1,1,5,0,0,1
198241,1339615,1,1,6,1,0,2
198242,1339615,1,2,1,1,0,3
198243,1339615,1,2,2,0,0,3
198244,1339615,1,2,3,4,0,7
198245,1339615,1,2,4,1,0,8
198246,1339615,1,2,5,0,0,8
198247,1339615,1,2,6,4,0,12
198248,1339615,1,3,1,2,0,14
198249,1339615,1,3,2,0,0,14
198250,1339615,1,3,3,1,0,15
198251,1339615,1,3,4,2,0,17
198252,1339615,1,3,5,1,0,18
198253,1339615,1,3,6,2,0,20
198254,1339615,1,4,1,1,0,21
198255,1339615,1,4,2,2,0,23
198256,1339615,1,4,3,4,0,27
198257,1339615,1,4,4,1,0,28
198258,1339615,1,4,5,0,0,28
198259,1339615,1,4,6,1,0,29
198260,1339615,1,5,1,4,0,33
198261,1339615,1,5,2,6,0,39
198262,1339615,1,5,3,1,0,40
198263,1339615,1,5,4,4,0,44
198264,1339615,1,5,5,1,0,45
198265,1339615,1,5,6,4,0,49
198266,1339615,1,6,1,0,0,49
198267,1339615,1,6,2,1,0,50
198268,1339615,1,6,3,0,0,50
198269,1339615,1,6,4,4,0,54
198270,1339615,1,6,5,1,0,55
198271,1339615,1,6,6,4,0,59
198272,1339615,1,7,1,3,0,62
198273,1339615,1,7,2,4,0,66
198274,1339615,1,7,3,1,0,67
198275,1339615,1,7,4,4,0,71
198276,1339615,1,7,5,1,0,72
198277,1339615,1,7,6,4,0,76
198278,1339615,1,8,1,1,0,77
198279,1339615,1,8,2,0,0,77
198280,1339615,1,8,3,2,0,79
198281,1339615,1,8,4,1,0,80
198282,1339615,1,8,5,0,0,80
198283,1339615,1,8,6,0,0,80
198284,1339615,1,9,1,1,0,81
198285,1339615,1,9,2,1,0,82
198286,1339615,1,9,3,1,0,83
198287,1339615,1,9,4,4,0,87
198288,1339615,1,9,5,4,0,91
198289,1339615,1,9,6,2,0,93
198290,1339615,1,10,1,1,0,94
198291,1339615,1,10,2,1,0,95
198292,1339615,1,10,3,1,0,96
198293,1339615,1,10,4,1,0,97
198294,1339615,1,10,5,1,0,98
198295,1339615,1,10,6,0,0,98
198296,1339615,1,11,1,0,0,98
198297,1339615,1,11,2,0,0,98
198298,1339615,1,11,3,1,0,99
198299,1339615,1,11,4,0,1,99
198300,1339615,1,11,5,0,1,99
198301,1339615,1,11,6,0,0,99
198302,1339615,1,12,1,0,0,99
198303,1339615,1,12,2,2,0,101
198304,1339615,1,12,3,1,0,102
198305,1339615,1,12,4,0,0,102
198306,1339615,1,12,5,0,1,102
198307,1339615,1,12,6,1,0,103
198308,1339615,1,13,1,0,0,103
198309,1339615,1,13,2,1,0,104
198310,1339615,1,13,3,1,0,105
198311,1339615,1,13,4,0,0,105
198312,1339615,1,13,5,0,1,105
198313,1339615,1,13,6,1,0,106
198314,1339615,1,14,1,0,0,106
198315,1339615,1,14,2,6,0,112
198316,1339615,1,14,3,0,0,112
198317,1339615,1,14,4,1,0,113
198318,1339615,1,14,5,1,0,114
198319,1339615,1,14,6,1,0,115
198320,1339615,1,15,1,1,0,116
198321,1339615,1,15,2,1,0,117
198322,1339615,1,15,3,1,0,118
198323,1339615,1,15,4,4,0,122
198324,1339615,1,15,5,1,0,123
198325,1339615,1,15,6,4,0,127
198326,1339615,1,16,1,2,0,129
198327,1339615,1,16,2,1,0,130
198328,1339615,1,16,3,1,0,131
198329,1339615,1,16,4,0,0,131
198330,1339615,1,16,5,4,0,135
198331,1339615,1,16,6,1,0,136
198332,1339615,1,17,1,1,0,137
198333,1339615,1,17,2,6,0,143
198334,1339615,1,17,3,1,0,144
198335,1339615,1,17,4,0,0,144
198336,1339615,1,17,5,1,0,145
198337,1339615,1,17,6,1,0,146
198338,1339615,1,18,1,1,0,147
198339,1339615,1,18,2,6,0,153
198340,1339615,1,18,3,4,0,157
198341,1339615,1,18,4,6,0,163
198342,1339615,1,18,5,1,0,164
198343,1339615,1,18,6,0,0,164
198344,1339615,1,19,1,1,0,165
198345,1339615,1,19,2,1,0,166
198346,1339615,1,19,3,0,0,166
198347,1339615,1,19,4,2,0,168
198348,1339615,1,19,5,0,0,168
198349,1339615,1,19,6,6,0,174
198350,1339615,1,20,1,1,0,175
198351,1339615,1,20,2,1,0,176
198352,1339615,1,20,3,6,0,182
198353,1339615,1,20,4,2,0,184
198354,1339615,1,20,5,4,0,188
198355,1339615,1,20,6,4,0,192
198476,1339616,1,1,1,9,0,9
198477,1339616,1,1,2,1,0,10
198478,1339616,1,1,3,0,0,10
198479,1339616,1,1,4,1,0,11
198480,1339616,1,1,5,0,0,11
198481,1339616,1,1,6,0,0,11
198482,1339616,1,2,1,0,0,11
198483,1339616,1,2,2,4,0,15
198484,1339616,1,2,3,0,0,15
198485,1339616,1,2,4,1,0,16
198486,1339616,1,2,5,1,0,17
198487,1339616,1,2,6,0,0,17
198488,1339616,1,3,1,1,0,18
198489,1339616,1,3,2,1,0,19
198490,1339616,1,3,3,0,0,19
198491,1339616,1,3,4,0,0,19
198492,1339616,1,3,5,1,0,20
198493,1339616,1,3,6,0,1,20
198494,1339616,1,4,1,0,0,20
198495,1339616,1,4,2,0,0,20
198496,1339616,1,4,3,1,0,21
198497,1339616,1,4,4,0,0,21
198498,1339616,1,4,5,0,0,21
198499,1339616,1,4,6,0,0,21
198500,1339616,1,5,1,4,0,25
198501,1339616,1,5,2,0,0,25
198502,1339616,1,5,3,0,0,25
198503,1339616,1,5,4,0,0,25
198504,1339616,1,5,5,0,0,25
198505,1339616,1,5,6,1,0,26
198506,1339616,1,6,1,4,0,30
198507,1339616,1,6,2,0,0,30
198508,1339616,1,6,3,1,0,31
198509,1339616,1,6,4,0,0,31
198510,1339616,1,6,5,4,0,35
198511,1339616,1,6,6,0,0,35
198512,1339616,1,7,1,0,0,35
198513,1339616,1,7,2,2,0,37
198514,1339616,1,7,3,1,0,38
198515,1339616,1,7,4,0,0,38
198516,1339616,1,7,5,6,0,44
198517,1339616,1,7,6,1,0,45
198518,1339616,1,8,1,1,0,46
198519,1339616,1,8,2,1,0,47
198520,1339616,1,8,3,4,0,51
198521,1339616,1,8,4,1,0,52
198522,1339616,1,8,5,4,0,56
198523,1339616,1,8,6,0,0,56
198524,1339616,1,9,1,0,0,56
198525,1339616,1,9,2,0,0,56
198526,1339616,1,9,3,0,1,56
198527,1339616,1,9,4,0,0,56
198528,1339616,1,9,5,1,0,57
198529,1339616,1,9,6,0,0,57
198530,1339616,1,10,1,1,0,58
198531,1339616,1,10,2,4,0,62
198532,1339616,1,10,3,1,0,63
198533,1339616,1,10,4,0,0,63
198534,1339616,1,10,5,0,0,63
198535,1339616,1,10,6,1,0,64
198536,1339616,1,11,1,1,0,65
198537,1339616,1,11,2,1,0,66
198538,1339616,1,11,3,2,0,68
198539,1339616,1,11,4,1,0,69
198540,1339616,1,11,5,1,0,70
198541,1339616,1,11,6,1,0,71
198542,1339616,1,12,1,1,0,72
198543,1339616,1,12,2,4,0,76
198544,1339616,1,12,3,1,0,77
198545,1339616,1,12,4,2,0,79
198546,1339616,1,12,5,1,0,80
198547,1339616,1,12,6,6,0,86
198548,1339616,1,13,1,6,0,92
198549,1339616,1,13,2,4,0,96
198550,1339616,1,13,3,0,0,96
198551,1339616,1,13,4,0,0,96
198552,1339616,1,13,5,4,0,100
198553,1339616,1,13,6,2,0,102
198554,1339616,1,14,1,1,0,103
198555,1339616,1,14,2,1,0,104
198556,1339616,1,14,3,1,0,105
198557,1339616,1,14,4,1,0,106
198558,1339616,1,14,5,0,0,106
198559,1339616,1,14,6,1,0,107
198560,1339616,1,15,1,1,0,108
198561,1339616,1,15,2,0,0,108
198562,1339616,1,15,3,1,0,109
198563,1339616,1,15,4,1,0,110
198564,1339616,1,15,5,2,0,112
198565,1339616,1,15,6,0,0,112
198566,1339616,1,16,1,6,0,118
198567,1339616,1,16,2,2,0,120
198568,1339616,1,16,3,1,0,121
198569,1339616,1,16,4,0,1,121
198570,1339616,1,16,5,1,0,122
198571,1339616,1,16,6,1,0,123
198572,1339616,1,17,1,0,0,123
198573,1339616,1,17,2,0,0,123
198574,1339616,1,17,3,4,0,127
198575,1339616,1,17,4,1,1,128
198576,1339616,1,17,5,2,0,130
198577,1339616,1,17,6,0,0,130
198578,1339616,1,18,1,4,0,134
198579,1339616,1,18,2,1,0,135
198580,1339616,1,18,3,2,0,137
198581,1339616,1,18,4,6,0,143
198582,1339616,1,18,5,0,0,143
198583,1339616,1,18,6,1,0,144
198584,1339616,1,19,1,1,0,145
198585,1339616,1,19,2,4,0,149
198586,1339616,1,19,3,0,0,149
198587,1339616,1,19,4,0,1,149
198588,1339616,1,19,5,1,0,150
198589,1339616,1,19,6,4,0,154
198590,1339616,1,20,1,4,0,158
198591,1339616,1,20,2,1,0,159
198592,1339616,1,20,3,1,0,160
198593,1339616,1,20,4,0,0,160
198594,1339616,1,20,5,2,0,162
198595,1339616,1,20,6,1,0,163
198716,1339618,1,1,1,0,0,0
198717,1339618,1,1,2,1,0,1
198718,1339618,1,1,3,0,0,1
198719,1339618,1,1,4,0,0,1
198720,1339618,1,1,5,0,0,1
198721,1339618,1,1,6,4,0,5
198722,1339618,1,2,1,0,0,5
198723,1339618,1,2,2,6,0,11
198724,1339618,1,2,3,6,0,17
198725,1339618,1,2,4,1,0,18
198726,1339618,1,2,5,0,0,18
198727,1339618,1,2,6,1,0,19
198728,1339618,1,3,1,0,0,19
198729,1339618,1,3,2,4,0,23
198730,1339618,1,3,3,4,0,27
198731,1339618,1,3,4,1,0,28
198732,1339618,1,3,5,1,0,29
198733,1339618,1,3,6,1,0,30
198734,1339618,1,4,1,2,0,32
198735,1339618,1,4,2,1,0,33
198736,1339618,1,4,3,0,0,33
198737,1339618,1,4,4,1,0,34
198738,1339618,1,4,5,1,0,35
198739,1339618,1,4,6,1,0,36
198740,1339618,1,5,1,0,0,36
198741,1339618,1,5,2,2,0,38
198742,1339618,1,5,3,1,0,39
198743,1339618,1,5,4,0,0,39
198744,1339618,1,5,5,4,0,43
198745,1339618,1,5,6,1,0,44
198746,1339618,1,6,1,6,0,50
198747,1339618,1,6,2,1,0,51
198748,1339618,1,6,3,0,0,51
198749,1339618,1,6,4,0,1,51
198750,1339618,1,6,5,0,1,51
198751,1339618,1,6,6,0,0,51
198752,1339618,1,7,1,1,0,52
198753,1339618,1,7,2,0,1,52
198754,1339618,1,7,3,0,0,52
198755,1339618,1,7,4,1,0,53
198756,1339618,1,7,5,0,0,53
198757,1339618,1,7,6,2,0,55
198758,1339618,1,8,1,1,0,56
198759,1339618,1,8,2,0,0,56
198760,1339618,1,8,3,1,0,57
198761,1339618,1,8,4,4,0,61
198762,1339618,1,8,5,1,0,62
198763,1339618,1,8,6,1,0,63
198764,1339618,1,9,1,1,0,64
198765,1339618,1,9,2,1,0,65
198766,1339618,1,9,3,1,0,66
198767,1339618,1,9,4,0,0,66
198768,1339618,1,9,5,1,0,67
198769,1339618,1,9,6,0,0,67
198770,1339618,1,10,1,4,0,71
198771,1339618,1,10,2,6,0,77
198772,1339618,1,10,3,1,0,78
198773,1339618,1,10,4,1,0,79
198774,1339618,1,10,5,1,0,80
198775,1339618,1,10,6,0,0,80
198776,1339618,1,11,1,1,0,81
198777,1339618,1,11,2,1,0,82
198778,1339618,1,11,3,0,0,82
198779,1339618,1,11,4,1,0,83
198780,1339618,1,11,5,2,0,85
198781,1339618,1,11,6,1,0,86
198782,1339618,1,12,1,6,0,92
198783,1339618,1,12,2,1,0,93
198784,1339618,1,12,3,1,0,94
198785,1339618,1,12,4,2,0,96
198786,1339618,1,12,5,0,0,96
198787,1339618,1,12,6,1,0,97
198788,1339618,1,13,1,1,0,98
198789,1339618,1,13,2,4,0,102
198790,1339618,1,13,3,2,0,104
198791,1339618,1,13,4,0,0,104
198792,1339618,1,13,5,4,0,108
198793,1339618,1,13,6,4,0,112
198794,1339618,1,14,1,2,0,114
198795,1339618,1,14,2,1,0,115
198796,1339618,1,14,3,1,0,116
198797,1339618,1,14,4,1,0,117
198798,1339618,1,14,5,6,0,123
198799,1339618,1,14,6,0,1,123
198800,1339618,1,15,1,4,0,127
198801,1339618,1,15,2,1,0,128
198802,1339618,1,15,3,1,0,129
198803,1339618,1,15,4,0,0,129
198804,1339618,1,15,5,2,0,131
198805,1339618,1,15,6,1,0,132
198806,1339618,1,16,1,5,0,137
198807,1339618,1,16,2,2,0,139
198808,1339618,1,16,3,4,0,143
198809,1339618,1,16,4,1,0,144
198810,1339618,1,16,5,1,0,145
198811,1339618,1,16,6,2,0,147
198812,1339618,1,17,1,4,0,151
198813,1339618,1,17,2,1,0,152
198814,1339618,1,17,3,2,0,154
198815,1339618,1,17,4,1,0,155
198816,1339618,1,17,5,4,0,159
198817,1339618,1,17,6,6,0,165
198818,1339618,1,18,1,1,0,166
198819,1339618,1,18,2,0,0,166
198820,1339618,1,18,3,1,0,167
198821,1339618,1,18,4,2,0,169
198822,1339618,1,18,5,1,0,170
198823,1339618,1,18,6,4,0,174
198824,1339618,1,19,1,0,0,174
198825,1339618,1,19,2,4,0,178
198826,1339618,1,19,3,1,0,179
198827,1339618,1,19,4,1,0,180
198828,1339618,1,19,5,1,0,181
198829,1339618,1,19,6,0,0,181
198830,1339618,1,20,1,1,0,182
198831,1339618,1,20,2,5,0,187
198832,1339618,1,20,3,4,0,191
198833,1339618,1,20,4,0,1,191
198834,1339618,1,20,5,1,0,192
198835,1339618,1,20,6,1,0,193
198952,1348323,1,1,1,0,0,0
198953,1348323,1,1,2,1,0,1
198954,1348323,1,1,3,0,0,1
198955,1348323,1,1,4,1,0,2
198956,1348323,1,1,5,0,0,2
198957,1348323,1,1,6,0,0,2
198958,1348323,1,2,1,0,0,2
198959,1348323,1,2,2,4,0,6
198960,1348323,1,2,3,0,0,6
198961,1348323,1,2,4,0,1,6
198962,1348323,1,2,5,2,0,8
198963,1348323,1,2,6,0,0,8
198964,1348323,1,3,1,4,0,12
198965,1348323,1,3,2,0,0,12
198966,1348323,1,3,3,0,1,12
198967,1348323,1,3,4,0,0,12
198968,1348323,1,3,5,0,0,12
198969,1348323,1,3,6,0,0,12
198970,1348323,1,4,1,0,0,12
198971,1348323,1,4,2,0,0,12
198972,1348323,1,4,3,0,0,12
198973,1348323,1,4,4,0,0,12
198974,1348323,1,4,5,1,0,13
198975,1348323,1,4,6,1,0,14
198976,1348323,1,5,1,0,0,14
198977,1348323,1,5,2,0,0,14
198978,1348323,1,5,3,0,0,14
198979,1348323,1,5,4,1,0,15
198980,1348323,1,5,5,4,0,19
198981,1348323,1,5,6,1,0,20
198982,1348323,1,6,1,4,0,24
198983,1348323,1,6,2,1,0,25
198984,1348323,1,6,3,0,0,25
198985,1348323,1,6,4,1,0,26
198986,1348323,1,6,5,2,0,28
198987,1348323,1,6,6,0,1,28
198988,1348323,1,7,1,0,0,28
198989,1348323,1,7,2,1,0,29
198990,1348323,1,7,3,0,0,29
198991,1348323,1,7,4,4,0,33
198992,1348323,1,7,5,0,0,33
198993,1348323,1,7,6,0,0,33
198994,1348323,1,8,1,1,0,34
198995,1348323,1,8,2,1,0,35
198996,1348323,1,8,3,1,0,36
198997,1348323,1,8,4,0,0,36
198998,1348323,1,8,5,2,0,38
198999,1348323,1,8,6,0,0,38
199000,1348323,1,9,1,0,0,38
199001,1348323,1,9,2,0,1,38
199002,1348323,1,9,3,0,0,38
199003,1348323,1,9,4,0,0,38
199004,1348323,1,9,5,1,0,39
199005,1348323,1,9,6,2,0,41
199006,1348323,1,10,1,1,0,42
199007,1348323,1,10,2,0,0,42
199008,1348323,1,10,3,1,0,43
199009,1348323,1,10,4,1,0,44
199010,1348323,1,10,5,1,0,45
199011,1348323,1,10,6,0,0,45
199012,1348323,1,11,1,4,0,49
199013,1348323,1,11,2,2,0,51
199014,1348323,1,11,3,1,0,52
199015,1348323,1,11,4,6,0,58
199016,1348323,1,11,5,0,1,58
199017,1348323,1,11,6,1,0,59
199018,1348323,1,12,1,0,0,59
199019,1348323,1,12,2,1,0,60
199020,1348323,1,12,3,1,0,61
199021,1348323,1,12,4,0,0,61
199022,1348323,1,12,5,0,0,61
199023,1348323,1,12,6,0,0,61
199024,1348323,1,13,1,1,0,62
199025,1348323,1,13,2,2,0,64
199026,1348323,1,13,3,4,0,68
199027,1348323,1,13,4,1,0,69
199028,1348323,1,13,5,1,0,70
199029,1348323,1,13,6,0,0,70
199030,1348323,1,14,1,0,0,70
199031,1348323,1,14,2,0,1,70
199032,1348323,1,14,3,0,0,70
199033,1348323,1,14,4,1,0,71
199034,1348323,1,14,5,0,1,71
199035,1348323,1,14,6,0,0,71
199036,1348323,1,15,1,1,0,72
199037,1348323,1,15,2,2,0,74
199038,1348323,1,15,3,0,0,74
199039,1348323,1,15,4,0,0,74
199040,1348323,1,15,5,0,1,74
199041,1348323,1,15,6,4,0,78
199042,1348323,1,16,1,0,0,78
199043,1348323,1,16,2,2,0,80
199044,1348323,1,16,3,0,0,80
199045,1348323,1,16,4,0,0,80
199046,1348323,1,16,5,1,0,81
199047,1348323,1,16,6,4,0,85
199048,1348323,1,17,1,1,0,86
199049,1348323,1,17,2,1,0,87
199050,1348323,1,17,3,4,0,91
199051,1348323,1,17,4,0,0,91
199052,1348323,1,17,5,2,0,93
199053,1348323,1,17,6,1,0,94
199054,1348323,1,18,1,2,0,96
199055,1348323,1,18,2,2,0,98
199056,1348323,1,18,3,4,0,102
199057,1348323,1,18,4,2,0,104
199058,1348323,1,18,5,0,0,104
199059,1348323,1,18,6,1,0,105
199060,1348323,1,19,1,0,1,105
199061,1348323,1,19,2,2,0,107
199062,1348323,1,19,3,4,0,111
199063,1348323,1,19,4,1,0,112
199064,1348323,1,19,5,1,0,113
199065,1348323,1,19,6,1,0,114
199066,1348323,1,20,1,0,0,114
199067,1348323,1,20,2,0,1,114
199176,1348324,1,1,1,0,0,0
199177,1348324,1,1,2,4,0,4
199178,1348324,1,1,3,0,0,4
199179,1348324,1,1,4,2,0,6
199180,1348324,1,1,5,0,1,6
199181,1348324,1,1,6,1,0,7
199182,1348324,1,2,1,2,0,9
199183,1348324,1,2,2,1,0,10
199184,1348324,1,2,3,4,0,14
199185,1348324,1,2,4,1,0,15
199186,1348324,1,2,5,4,0,19
199187,1348324,1,2,6,1,0,20
199188,1348324,1,3,1,1,0,21
199189,1348324,1,3,2,2,0,23
199190,1348324,1,3,3,1,0,24
199191,1348324,1,3,4,0,0,24
199192,1348324,1,3,5,0,0,24
199193,1348324,1,3,6,0,0,24
199194,1348324,1,4,1,1,0,25
199195,1348324,1,4,2,1,0,26
199196,1348324,1,4,3,4,0,30
199197,1348324,1,4,4,2,0,32
199198,1348324,1,4,5,1,0,33
199199,1348324,1,4,6,1,0,34
199200,1348324,1,5,1,6,0,40
199201,1348324,1,5,2,0,0,40
199202,1348324,1,5,3,1,0,41
199203,1348324,1,5,4,0,0,41
199204,1348324,1,5,5,4,0,45
199205,1348324,1,5,6,0,0,45
199206,1348324,1,6,1,1,0,46
199207,1348324,1,6,2,2,0,48
199208,1348324,1,6,3,1,0,49
199209,1348324,1,6,4,4,0,53
199210,1348324,1,6,5,1,1,54
199211,1348324,1,6,6,0,0,54
199212,1348324,1,7,1,0,0,54
199213,1348324,1,7,2,1,0,55
199214,1348324,1,7,3,1,0,56
199215,1348324,1,7,4,0,0,56
199216,1348324,1,7,5,4,0,60
199217,1348324,1,7,6,0,0,60
199218,1348324,1,8,1,0,1,60
199219,1348324,1,8,2,2,0,62
199220,1348324,1,8,3,0,0,62
199221,1348324,1,8,4,0,0,62
199222,1348324,1,8,5,1,0,63
199223,1348324,1,8,6,0,0,63
199224,1348324,1,9,1,1,0,64
199225,1348324,1,9,2,0,0,64
199226,1348324,1,9,3,2,0,66
199227,1348324,1,9,4,1,0,67
199228,1348324,1,9,5,1,0,68
199229,1348324,1,9,6,1,0,69
199230,1348324,1,10,1,0,0,69
199231,1348324,1,10,2,1,0,70
199232,1348324,1,10,3,1,0,71
199233,1348324,1,10,4,1,0,72
199234,1348324,1,10,5,0,0,72
199235,1348324,1,10,6,1,0,73
199236,1348324,1,11,1,4,0,77
199237,1348324,1,11,2,0,0,77
199238,1348324,1,11,3,6,0,83
199239,1348324,1,11,4,1,0,84
199240,1348324,1,11,5,1,0,85
199241,1348324,1,11,6,1,0,86
199242,1348324,1,12,1,0,1,86
199243,1348324,1,12,2,3,0,89
199244,1348324,1,12,3,2,0,91
199245,1348324,1,12,4,1,0,92
199246,1348324,1,12,5,1,0,93
199247,1348324,1,12,6,1,0,94
199248,1348324,1,13,1,0,0,94
199249,1348324,1,13,2,1,0,95
199250,1348324,1,13,3,2,0,97
199251,1348324,1,13,4,1,0,98
199252,1348324,1,13,5,0,0,98
199253,1348324,1,13,6,0,0,98
199254,1348324,1,14,1,4,0,102
199255,1348324,1,14,2,1,0,103
199256,1348324,1,14,3,1,0,104
199257,1348324,1,14,4,1,0,105
199258,1348324,1,14,5,0,0,105
199259,1348324,1,14,6,5,0,110
199260,1348324,1,15,1,1,0,111
199261,1348324,1,15,2,0,0,111
199262,1348324,1,15,3,1,0,112
199263,1348324,1,15,4,1,0,113
199264,1348324,1,15,5,2,0,115
199265,1348324,1,15,6,0,0,115
199266,1348324,1,16,1,1,0,116
199267,1348324,1,16,2,1,0,117
199268,1348324,1,16,3,0,1,117
199269,1348324,1,16,4,1,0,118
199270,1348324,1,16,5,0,0,118
199271,1348324,1,16,6,0,1,118
199272,1348324,1,17,1,1,0,119
199273,1348324,1,17,2,1,0,120
199274,1348324,1,17,3,1,0,121
199275,1348324,1,17,4,1,0,122
199276,1348324,1,17,5,0,0,122
199277,1348324,1,17,6,1,0,123
199278,1348324,1,18,1,2,0,125
199279,1348324,1,18,2,1,0,126
199280,1348324,1,18,3,0,0,126
199281,1348324,1,18,4,0,0,126
199282,1348324,1,18,5,3,0,129
199283,1348324,1,18,6,2,0,131
199284,1348324,1,19,1,2,0,133
199285,1348324,1,19,2,4,0,137
199286,1348324,1,19,3,0,0,137
199287,1348324,1,19,4,0,0,137
199288,1348324,1,19,5,0,1,137
199289,1348324,1,19,6,1,1,138
199290,1348324,1,20,1,1,1,139
199291,1348324,1,20,2,1,0,140
199292,1348324,1,20,3,3,0,143
199293,1348324,1,20,4,0,0,143
199294,1348324,1,20,5,1,0,144
199295,1348324,1,20,6,0,1,144
199414,1348325,1,1,1,1,0,1
199415,1348325,1,1,2,0,0,1
199416,1348325,1,1,3,1,0,2
199417,1348325,1,1,4,1,0,3
199418,1348325,1,1,5,0,1,3
199419,1348325,1,1,6,1,0,4
199420,1348325,1,2,1,1,0,5
199421,1348325,1,2,2,0,0,5
199422,1348325,1,2,3,0,0,5
199423,1348325,1,2,4,4,0,9
199424,1348325,1,2,5,2,0,11
199425,1348325,1,2,6,0,0,11
199426,1348325,1,3,1,0,0,11
199427,1348325,1,3,2,0,1,11
199428,1348325,1,3,3,1,0,12
199429,1348325,1,3,4,1,0,13
199430,1348325,1,3,5,1,0,14
199431,1348325,1,3,6,0,0,14
199432,1348325,1,4,1,0,0,14
199433,1348325,1,4,2,1,0,15
199434,1348325,1,4,3,1,0,16
199435,1348325,1,4,4,3,0,19
199436,1348325,1,4,5,0,1,19
199437,1348325,1,4,6,4,0,23
199438,1348325,1,5,1,2,0,25
199439,1348325,1,5,2,1,0,26
199440,1348325,1,5,3,3,0,29
199441,1348325,1,5,4,0,0,29
199442,1348325,1,5,5,1,0,30
199443,1348325,1,5,6,2,0,32
199444,1348325,1,6,1,1,0,33
199445,1348325,1,6,2,0,0,33
199446,1348325,1,6,3,4,0,37
199447,1348325,1,6,4,0,0,37
199448,1348325,1,6,5,2,0,39
199449,1348325,1,6,6,0,0,39
199450,1348325,1,7,1,2,0,41
199451,1348325,1,7,2,1,0,42
199452,1348325,1,7,3,1,0,43
199453,1348325,1,7,4,1,0,44
199454,1348325,1,7,5,1,0,45
199455,1348325,1,7,6,1,0,46
199456,1348325,1,8,1,4,0,50
199457,1348325,1,8,2,1,0,51
199458,1348325,1,8,3,1,0,52
199459,1348325,1,8,4,1,0,53
199460,1348325,1,8,5,0,0,53
199461,1348325,1,8,6,1,0,54
199462,1348325,1,9,1,4,0,58
199463,1348325,1,9,2,2,0,60
199464,1348325,1,9,3,1,0,61
199465,1348325,1,9,4,1,0,62
199466,1348325,1,9,5,1,0,63
199467,1348325,1,9,6,0,0,63
199468,1348325,1,10,1,1,0,64
199469,1348325,1,10,2,0,0,64
199470,1348325,1,10,3,0,0,64
199471,1348325,1,10,4,1,0,65
199472,1348325,1,10,5,2,0,67
199473,1348325,1,10,6,0,0,67
199474,1348325,1,11,1,0,0,67
199475,1348325,1,11,2,0,0,67
199476,1348325,1,11,3,1,0,68
199477,1348325,1,11,4,1,0,69
199478,1348325,1,11,5,2,0,71
199479,1348325,1,11,6,1,0,72
199480,1348325,1,12,1,2,0,74
199481,1348325,1,12,2,0,0,74
199482,1348325,1,12,3,2,0,76
199483,1348325,1,12,4,1,0,77
199484,1348325,1,12,5,1,0,78
199485,1348325,1,12,6,1,0,79
199486,1348325,1,13,1,4,0,83
199487,1348325,1,13,2,1,0,84
199488,1348325,1,13,3,1,0,85
199489,1348325,1,13,4,1,0,86
199490,1348325,1,13,5,1,0,87
199491,1348325,1,13,6,1,0,88
199492,1348325,1,14,1,1,0,89
199493,1348325,1,14,2,0,1,89
199494,1348325,1,14,3,1,0,90
199495,1348325,1,14,4,1,0,91
199496,1348325,1,14,5,1,0,92
199497,1348325,1,14,6,1,0,93
199498,1348325,1,15,1,1,0,94
199499,1348325,1,15,2,1,0,95
199500,1348325,1,15,3,0,1,95
199501,1348325,1,15,4,1,0,96
199502,1348325,1,15,5,1,0,97
199503,1348325,1,15,6,0,0,97
199504,1348325,1,16,1,1,0,98
199505,1348325,1,16,2,1,0,99
199506,1348325,1,16,3,1,0,100
199507,1348325,1,16,4,0,1,100
199508,1348325,1,16,5,2,0,102
199509,1348325,1,16,6,4,0,106
199510,1348325,1,17,1,2,0,108
199511,1348325,1,17,2,4,0,112
199512,1348325,1,17,3,1,0,113
199513,1348325,1,17,4,1,0,114
199514,1348325,1,17,5,1,0,115
199515,1348325,1,17,6,2,0,117
199516,1348325,1,18,1,1,0,118
199517,1348325,1,18,2,2,0,120
199518,1348325,1,18,3,1,0,121
199519,1348325,1,18,4,1,0,122
199520,1348325,1,18,5,1,0,123
199521,1348325,1,18,6,2,0,125
199522,1348325,1,19,1,0,0,125
199523,1348325,1,19,2,1,0,126
199524,1348325,1,19,3,2,0,128
199525,1348325,1,19,4,2,0,130
199526,1348325,1,19,5,1,0,131
199527,1348325,1,19,6,0,1,131
199528,1348325,1,20,1,0,1,131
199529,1348325,1,20,2,6,0,137
199530,1348325,1,20,3,0,1,137
199531,1348325,1,20,4,1,0,138
199532,1348325,1,20,5,2,0,140
199533,1348325,1,20,6,1,0,141
199648,1348640,1,1,1,2,0,2
199649,1348640,1,1,2,0,0,2
199650,1348640,1,1,3,6,0,8
199651,1348640,1,1,4,1,0,9
199652,1348640,1,1,5,4,0,13
199653,1348640,1,1,6,4,0,17
199654,1348640,1,2,1,5,0,22
199655,1348640,1,2,2,0,0,22
199656,1348640,1,2,3,2,0,24
199657,1348640,1,2,4,1,0,25
199658,1348640,1,2,5,0,0,25
199659,1348640,1,2,6,1,0,26
199660,1348640,1,3,1,0,0,26
199661,1348640,1,3,2,1,0,27
199662,1348640,1,3,3,0,1,27
199663,1348640,1,3,4,1,0,28
199664,1348640,1,3,5,0,0,28
199665,1348640,1,3,6,1,0,29
199666,1348640,1,4,1,1,0,30
199667,1348640,1,4,2,0,0,30
199668,1348640,1,4,3,0,0,30
199669,1348640,1,4,4,4,0,34
199670,1348640,1,4,5,0,0,34
199671,1348640,1,4,6,0,0,34
199672,1348640,1,5,1,1,0,35
199673,1348640,1,5,2,0,0,35
199674,1348640,1,5,3,1,0,36
199675,1348640,1,5,4,1,0,37
199676,1348640,1,5,5,1,0,38
199677,1348640,1,5,6,0,0,38
199678,1348640,1,6,1,0,1,38
199679,1348640,1,6,2,1,0,39
199680,1348640,1,6,3,0,0,39
199681,1348640,1,6,4,1,0,40
199682,1348640,1,6,5,0,0,40
199683,1348640,1,6,6,1,0,41
199684,1348640,1,7,1,0,0,41
199685,1348640,1,7,2,1,0,42
199686,1348640,1,7,3,2,0,44
199687,1348640,1,7,4,2,0,46
199688,1348640,1,7,5,0,1,46
199689,1348640,1,7,6,1,0,47
199690,1348640,1,8,1,4,0,51
199691,1348640,1,8,2,4,0,55
199692,1348640,1,8,3,0,0,55
199693,1348640,1,8,4,2,0,57
199694,1348640,1,8,5,1,0,58
199695,1348640,1,8,6,0,0,58
199696,1348640,1,9,1,4,0,62
199697,1348640,1,9,2,0,0,62
199698,1348640,1,9,3,1,0,63
199699,1348640,1,9,4,1,0,64
199700,1348640,1,9,5,0,0,64
199701,1348640,1,9,6,0,0,64
199702,1348640,1,10,1,6,0,70
199703,1348640,1,10,2,4,0,74
199704,1348640,1,10,3,0,0,74
199705,1348640,1,10,4,0,0,74
199706,1348640,1,10,5,1,0,75
199707,1348640,1,10,6,0,0,75
199708,1348640,1,11,1,1,0,76
199709,1348640,1,11,2,1,0,77
199710,1348640,1,11,3,0,1,77
199711,1348640,1,11,4,0,0,77
199712,1348640,1,11,5,1,0,78
199713,1348640,1,11,6,0,0,78
199714,1348640,1,12,1,1,0,79
199715,1348640,1,12,2,4,0,83
199716,1348640,1,12,3,0,0,83
199717,1348640,1,12,4,1,0,84
199718,1348640,1,12,5,1,0,85
199719,1348640,1,12,6,1,0,86
199720,1348640,1,13,1,1,0,87
199721,1348640,1,13,2,1,0,88
199722,1348640,1,13,3,1,0,89
199723,1348640,1,13,4,1,0,90
199724,1348640,1,13,5,0,0,90
199725,1348640,1,13,6,1,0,91
199726,1348640,1,14,1,0,0,91
199727,1348640,1,14,2,1,0,92
199728,1348640,1,14,3,1,0,93
199729,1348640,1,14,4,0,0,93
199730,1348640,1,14,5,1,0,94
199731,1348640,1,14,6,0,0,94
199732,1348640,1,15,1,0,1,94
199733,1348640,1,15,2,4,0,98
199734,1348640,1,15,3,0,0,98
199735,1348640,1,15,4,0,0,98
199736,1348640,1,15,5,1,0,99
199737,1348640,1,15,6,2,0,101
199738,1348640,1,16,1,1,0,102
199739,1348640,1,16,2,2,0,104
199740,1348640,1,16,3,1,0,105
199741,1348640,1,16,4,6,0,111
199742,1348640,1,16,5,6,0,117
199743,1348640,1,16,6,1,0,118
199744,1348640,1,17,1,1,0,119
199745,1348640,1,17,2,1,0,120
199746,1348640,1,17,3,1,0,121
199747,1348640,1,17,4,0,0,121
199748,1348640,1,17,5,1,0,122
199749,1348640,1,17,6,6,0,128
199750,1348640,1,18,1,0,0,128
199751,1348640,1,18,2,0,0,128
199752,1348640,1,18,3,4,0,132
199753,1348640,1,18,4,1,0,133
199754,1348640,1,18,5,0,0,133
199755,1348640,1,18,6,1,0,134
199756,1348640,1,19,1,1,0,135
199757,1348640,1,19,2,6,0,141
199758,1348640,1,19,3,0,0,141
199759,1348640,1,19,4,2,0,143
199760,1348640,1,19,5,2,0,145
199761,1348640,1,19,6,4,0,149
199762,1348640,1,20,1,1,0,150
199763,1348640,1,20,2,1,0,151
199764,1348640,1,20,3,6,0,157
199765,1348640,1,20,4,0,0,157
199766,1348640,1,20,5,4,0,161
199767,1348640,1,20,6,1,0,162
199888,1348641,1,1,1,0,0,0
199889,1348641,1,1,2,0,0,0
199890,1348641,1,1,3,2,0,2
199891,1348641,1,1,4,0,0,2
199892,1348641,1,1,5,0,0,2
199893,1348641,1,1,6,0,0,2
199894,1348641,1,2,1,4,0,6
199895,1348641,1,2,2,0,0,6
199896,1348641,1,2,3,0,0,6
199897,1348641,1,2,4,1,0,7
199898,1348641,1,2,5,0,0,7
199899,1348641,1,2,6,14,0,21
199900,1348641,1,3,1,2,0,23
199901,1348641,1,3,2,6,0,29
199902,1348641,1,3,3,1,0,30
199903,1348641,1,3,4,0,0,30
199904,1348641,1,3,5,2,0,32
199905,1348641,1,3,6,0,0,32
199906,1348641,1,4,1,1,0,33
199907,1348641,1,4,2,1,0,34
199908,1348641,1,4,3,7,0,41
199909,1348641,1,4,4,0,0,41
199910,1348641,1,4,5,2,0,43
199911,1348641,1,4,6,4,0,47
199912,1348641,1,5,1,1,0,48
199913,1348641,1,5,2,0,0,48
199914,1348641,1,5,3,0,0,48
199915,1348641,1,5,4,1,0,49
199916,1348641,1,5,5,0,0,49
199917,1348641,1,5,6,0,0,49
199918,1348641,1,6,1,1,0,50
199919,1348641,1,6,2,1,0,51
199920,1348641,1,6,3,1,0,52
199921,1348641,1,6,4,1,0,53
199922,1348641,1,6,5,1,0,54
199923,1348641,1,6,6,1,0,55
199924,1348641,1,7,1,0,0,55
199925,1348641,1,7,2,4,0,59
199926,1348641,1,7,3,1,0,60
199927,1348641,1,7,4,6,0,66
199928,1348641,1,7,5,1,0,67
199929,1348641,1,7,6,0,0,67
199930,1348641,1,8,1,0,0,67
199931,1348641,1,8,2,6,0,73
199932,1348641,1,8,3,1,0,74
199933,1348641,1,8,4,4,0,78
199934,1348641,1,8,5,1,0,79
199935,1348641,1,8,6,1,0,80
199936,1348641,1,9,1,0,0,80
199937,1348641,1,9,2,0,1,80
199938,1348641,1,9,3,1,0,81
199939,1348641,1,9,4,0,0,81
199940,1348641,1,9,5,1,0,82
199941,1348641,1,9,6,1,0,83
199942,1348641,1,10,1,0,1,83
199943,1348641,1,10,2,1,0,84
199944,1348641,1,10,3,0,0,84
199945,1348641,1,10,4,4,0,88
199946,1348641,1,10,5,0,0,88
199947,1348641,1,10,6,1,0,89
199948,1348641,1,11,1,1,0,90
199949,1348641,1,11,2,1,0,91
199950,1348641,1,11,3,1,0,92
199951,1348641,1,11,4,1,0,93
199952,1348641,1,11,5,0,0,93
199953,1348641,1,11,6,1,0,94
199954,1348641,1,12,1,1,0,95
199955,1348641,1,12,2,1,0,96
199956,1348641,1,12,3,0,1,96
199957,1348641,1,12,4,1,0,97
199958,1348641,1,12,5,1,0,98
199959,1348641,1,12,6,0,0,98
199960,1348641,1,13,1,0,0,98
199961,1348641,1,13,2,6,0,104
199962,1348641,1,13,3,1,0,105
199963,1348641,1,13,4,1,0,106
199964,1348641,1,13,5,1,0,107
199965,1348641,1,13,6,0,0,107
199966,1348641,1,14,1,1,0,108
199967,1348641,1,14,2,1,0,109
199968,1348641,1,14,3,1,0,110
199969,1348641,1,14,4,0,1,110
199970,1348641,1,14,5,1,0,111
199971,1348641,1,14,6,2,0,113
199972,1348641,1,15,1,1,0,114
199973,1348641,1,15,2,6,0,120
199974,1348641,1,15,3,6,0,126
199975,1348641,1,15,4,1,0,127
199976,1348641,1,15,5,2,0,129
199977,1348641,1,15,6,0,0,129
199978,1348641,1,16,1,0,0,129
199979,1348641,1,16,2,6,0,135
199980,1348641,1,16,3,1,0,136
199981,1348641,1,16,4,1,0,137
199982,1348641,1,16,5,1,1,138
199983,1348641,1,16,6,0,1,138
199984,1348641,1,17,1,1,0,139
199985,1348641,1,17,2,4,0,143
199986,1348641,1,17,3,0,0,143
199987,1348641,1,17,4,3,0,146
199988,1348641,1,17,5,1,0,147
199989,1348641,1,17,6,0,0,147
199990,1348641,1,18,1,4,0,151
199991,1348641,1,18,2,6,0,157
199992,1348641,1,18,3,1,0,158
199993,1348641,1,18,4,1,0,159
199994,1348641,1,18,5,8,0,167
199995,1348641,1,18,6,1,0,168
199996,1348641,1,19,1,1,0,169
199997,1348641,1,19,2,4,0,173
199998,1348641,1,19,3,2,0,175
199999,1348641,1,19,4,7,0,182
200000,1348641,1,19,5,2,0,184
200001,1348641,1,19,6,2,0,186
200002,1348641,1,20,1,6,0,192
200003,1348641,1,20,2,1,0,193
200004,1348641,1,20,3,1,0,194
200005,1348641,1,20,4,6,0,200
200006,1348641,1,20,5,0,0,200
200007,1348641,1,20,6,6,0,206
200128,1348642,1,1,1,2,0,2
200129,1348642,1,1,2,0,0,2
200130,1348642,1,1,3,1,0,3
200131,1348642,1,1,4,0,1,3
200132,1348642,1,1,5,0,0,3
200133,1348642,1,1,6,4,0,7
200134,1348642,1,2,1,0,0,7
200135,1348642,1,2,2,0,0,7
200136,1348642,1,2,3,0,0,7
200137,1348642,1,2,4,0,0,7
200138,1348642,1,2,5,0,0,7
200139,1348642,1,2,6,0,0,7
200140,1348642,1,3,1,0,0,7
200141,1348642,1,3,2,4,0,11
200142,1348642,1,3,3,1,0,12
200143,1348642,1,3,4,0,0,12
200144,1348642,1,3,5,6,0,18
200145,1348642,1,3,6,4,0,22
200146,1348642,1,4,1,1,0,23
200147,1348642,1,4,2,0,0,23
200148,1348642,1,4,3,2,0,25
200149,1348642,1,4,4,0,0,25
200150,1348642,1,4,5,1,0,26
200151,1348642,1,4,6,1,0,27
200152,1348642,1,5,1,0,0,27
200153,1348642,1,5,2,4,0,31
200154,1348642,1,5,3,4,0,35
200155,1348642,1,5,4,0,0,35
200156,1348642,1,5,5,0,0,35
200157,1348642,1,5,6,4,0,39
200158,1348642,1,6,1,0,0,39
200159,1348642,1,6,2,1,0,40
200160,1348642,1,6,3,6,0,46
200161,1348642,1,6,4,6,0,52
200162,1348642,1,6,5,0,1,52
200163,1348642,1,6,6,1,0,53
200164,1348642,1,7,1,0,0,53
200165,1348642,1,7,2,1,0,54
200166,1348642,1,7,3,1,0,55
200167,1348642,1,7,4,1,0,56
200168,1348642,1,7,5,1,0,57
200169,1348642,1,7,6,6,0,63
200170,1348642,1,8,1,4,0,67
200171,1348642,1,8,2,6,0,73
200172,1348642,1,8,3,1,0,74
200173,1348642,1,8,4,1,0,75
200174,1348642,1,8,5,1,0,76
200175,1348642,1,8,6,1,0,77
200176,1348642,1,9,1,1,0,78
200177,1348642,1,9,2,0,0,78
200178,1348642,1,9,3,1,0,79
200179,1348642,1,9,4,1,0,80
200180,1348642,1,9,5,4,0,84
200181,1348642,1,9,6,1,0,85
200182,1348642,1,10,1,1,0,86
200183,1348642,1,10,2,1,0,87
200184,1348642,1,10,3,1,0,88
200185,1348642,1,10,4,1,0,89
200186,1348642,1,10,5,2,0,91
200187,1348642,1,10,6,1,0,92
200188,1348642,1,11,1,0,0,92
200189,1348642,1,11,2,0,0,92
200190,1348642,1,11,3,4,0,96
200191,1348642,1,11,4,6,0,102
200192,1348642,1,11,5,1,0,103
200193,1348642,1,11,6,1,0,104
200194,1348642,1,12,1,2,0,106
200195,1348642,1,12,2,1,0,107
200196,1348642,1,12,3,1,0,108
200197,1348642,1,12,4,1,0,109
200198,1348642,1,12,5,2,0,111
200199,1348642,1,12,6,2,0,113
200200,1348642,1,13,1,1,0,114
200201,1348642,1,13,2,6,0,120
200202,1348642,1,13,3,0,0,120
200203,1348642,1,13,4,4,0,124
200204,1348642,1,13,5,6,0,130
200205,1348642,1,13,6,1,0,131
200206,1348642,1,14,1,2,0,133
200207,1348642,1,14,2,4,0,137
200208,1348642,1,14,3,6,0,143
200209,1348642,1,14,4,6,0,149
200210,1348642,1,14,5,1,0,150
200211,1348642,1,14,6,4,0,154
200212,1348642,1,15,1,1,0,155
200213,1348642,1,15,2,6,0,161
200214,1348642,1,15,3,2,0,163
200215,1348642,1,15,4,0,1,163
200216,1348642,1,15,5,1,0,164
200217,1348642,1,15,6,0,0,164
200218,1348642,1,16,1,2,0,166
200219,1348642,1,16,2,1,0,167
200220,1348642,1,16,3,6,0,173
200221,1348642,1,16,4,1,0,174
200222,1348642,1,16,5,0,1,174
200223,1348642,1,16,6,4,0,178
200224,1348642,1,17,1,6,0,184
200225,1348642,1,17,2,4,0,188
200226,1348642,1,17,3,1,0,189
200227,1348642,1,17,4,0,1,189
200228,1348642,1,17,5,4,0,193
200229,1348642,1,17,6,1,0,194
200230,1348642,1,18,1,1,0,195
200231,1348642,1,18,2,1,0,196
200232,1348642,1,18,3,1,0,197
200233,1348642,1,18,4,2,0,199
200234,1348642,1,18,5,0,0,199
200235,1348642,1,18,6,1,0,200
200236,1348642,1,19,1,1,0,201
200237,1348642,1,19,2,5,0,206
200238,1348642,1,19,3,4,0,210
200239,1348642,1,19,4,1,0,211
200240,1348642,1,19,5,1,0,212
200241,1348642,1,19,6,4,0,216
200242,1348642,1,20,1,0,0,216
200243,1348642,1,20,2,6,0,222
200244,1348642,1,20,3,0,0,222
200245,1348642,1,20,4,1,0,223
200246,1348642,1,20,5,1,0,224
200247,1348642,1,20,6,4,0,228
200348,1348649,1,1,1,0,0,0
200349,1348649,1,1,2,1,0,1
200350,1348649,1,1,3,2,0,3
200351,1348649,1,1,4,4,0,7
200352,1348649,1,1,5,4,0,11
200353,1348649,1,1,6,1,0,12
200354,1348649,1,2,1,0,0,12
200355,1348649,1,2,2,2,0,14
200356,1348649,1,2,3,4,0,18
200357,1348649,1,2,4,1,0,19
200358,1348649,1,2,5,4,0,23
200359,1348649,1,2,6,0,0,23
200360,1348649,1,3,1,0,0,23
200361,1348649,1,3,2,0,0,23
200362,1348649,1,3,3,0,0,23
200363,1348649,1,3,4,1,0,24
200364,1348649,1,3,5,1,0,25
200365,1348649,1,3,6,1,0,26
200366,1348649,1,4,1,6,0,32
200367,1348649,1,4,2,0,0,32
200368,1348649,1,4,3,0,0,32
200369,1348649,1,4,4,0,0,32
200370,1348649,1,4,5,4,0,36
200371,1348649,1,4,6,1,0,37
200372,1348649,1,5,1,6,0,43
200373,1348649,1,5,2,0,1,43
200374,1348649,1,5,3,0,0,43
200375,1348649,1,5,4,0,0,43
200376,1348649,1,5,5,0,0,43
200377,1348649,1,5,6,0,1,43
200378,1348649,1,6,1,1,0,44
200379,1348649,1,6,2,0,0,44
200380,1348649,1,6,3,1,0,45
200381,1348649,1,6,4,0,0,45
200382,1348649,1,6,5,1,0,46
200383,1348649,1,6,6,1,0,47
200384,1348649,1,7,1,0,0,47
200385,1348649,1,7,2,1,0,48
200386,1348649,1,7,3,0,0,48
200387,1348649,1,7,4,4,0,52
200388,1348649,1,7,5,1,0,53
200389,1348649,1,7,6,1,0,54
200390,1348649,1,8,1,1,0,55
200391,1348649,1,8,2,4,0,59
200392,1348649,1,8,3,4,0,63
200393,1348649,1,8,4,0,0,63
200394,1348649,1,8,5,6,0,69
200395,1348649,1,8,6,1,0,70
200396,1348649,1,9,1,1,0,71
200397,1348649,1,9,2,1,0,72
200398,1348649,1,9,3,1,0,73
200399,1348649,1,9,4,0,0,73
200400,1348649,1,9,5,0,0,73
200401,1348649,1,9,6,0,0,73
200402,1348649,1,10,1,1,0,74
200403,1348649,1,10,2,1,0,75
200404,1348649,1,10,3,1,0,76
200405,1348649,1,10,4,1,0,77
200406,1348649,1,10,5,1,0,78
200407,1348649,1,10,6,1,0,79
200408,1348649,1,11,1,1,0,80
200409,1348649,1,11,2,4,0,84
200410,1348649,1,11,3,1,0,85
200411,1348649,1,11,4,0,0,85
200412,1348649,1,11,5,0,0,85
200413,1348649,1,11,6,1,0,86
200414,1348649,1,12,1,1,0,87
200415,1348649,1,12,2,0,0,87
200416,1348649,1,12,3,4,0,91
200417,1348649,1,12,4,0,0,91
200418,1348649,1,12,5,1,0,92
200419,1348649,1,12,6,4,0,96
200420,1348649,1,13,1,1,0,97
200421,1348649,1,13,2,1,0,98
200422,1348649,1,13,3,4,0,102
200423,1348649,1,13,4,1,0,103
200424,1348649,1,13,5,0,1,103
200425,1348649,1,13,6,1,0,104
200426,1348649,1,14,1,0,0,104
200427,1348649,1,14,2,0,0,104
200428,1348649,1,14,3,4,0,108
200429,1348649,1,14,4,4,0,112
200430,1348649,1,14,5,2,0,114
200431,1348649,1,14,6,1,0,115
200432,1348649,1,15,1,0,0,115
200433,1348649,1,15,2,0,0,115
200434,1348649,1,15,3,0,0,115
200435,1348649,1,15,4,1,0,116
200436,1348649,1,15,5,1,0,117
200437,1348649,1,15,6,0,0,117
200438,1348649,1,16,1,1,0,118
200439,1348649,1,16,2,2,0,120
200440,1348649,1,16,3,0,0,120
200441,1348649,1,16,4,1,0,121
200442,1348649,1,16,5,1,0,122
200443,1348649,1,16,6,1,0,123
200444,1348649,1,17,1,6,0,129
200445,1348649,1,17,2,1,0,130
200446,1348649,1,17,3,1,0,131
200447,1348649,1,17,4,1,0,132
200448,1348649,1,17,5,1,0,133
200449,1348649,1,17,6,6,0,139
200450,1348649,1,18,1,0,0,139
200451,1348649,1,18,2,0,1,139
200452,1348649,1,18,3,0,0,139
200453,1348649,1,18,4,1,0,140
200454,1348649,1,18,5,0,1,140
200455,1348649,1,18,6,1,0,141
200456,1348649,1,19,1,1,0,142
200457,1348649,1,19,2,1,0,143
200458,1348649,1,19,3,4,0,147
200459,1348649,1,19,4,1,0,148
200460,1348649,1,19,5,1,0,149
200461,1348649,1,19,6,0,1,149
200462,1348649,1,20,1,13,0,162
200463,1348649,1,20,2,6,0,168
200464,1348649,1,20,3,4,0,172
200465,1348649,1,20,4,0,0,172
200466,1348649,1,20,5,2,0,174
200467,1348649,1,20,6,2,0,176
200588,1348650,1,1,1,1,0,1
200589,1348650,1,1,2,0,0,1
200590,1348650,1,1,3,0,0,1
200591,1348650,1,1,4,4,0,5
200592,1348650,1,1,5,1,0,6
200593,1348650,1,1,6,0,0,6
200594,1348650,1,2,1,0,0,6
200595,1348650,1,2,2,2,0,8
200596,1348650,1,2,3,0,0,8
200597,1348650,1,2,4,0,0,8
200598,1348650,1,2,5,0,0,8
200599,1348650,1,2,6,2,0,10
200600,1348650,1,3,1,4,0,14
200601,1348650,1,3,2,4,0,18
200602,1348650,1,3,3,1,0,19
200603,1348650,1,3,4,1,0,20
200604,1348650,1,3,5,0,0,20
200605,1348650,1,3,6,1,0,21
200606,1348650,1,4,1,0,0,21
200607,1348650,1,4,2,0,0,21
200608,1348650,1,4,3,0,1,21
200609,1348650,1,4,4,0,0,21
200610,1348650,1,4,5,0,0,21
200611,1348650,1,4,6,0,0,21
200612,1348650,1,5,1,0,0,21
200613,1348650,1,5,2,1,0,22
200614,1348650,1,5,3,1,0,23
200615,1348650,1,5,4,5,1,28
200616,1348650,1,5,5,1,0,29
200617,1348650,1,5,6,0,0,29
200618,1348650,1,6,1,1,0,30
200619,1348650,1,6,2,0,0,30
200620,1348650,1,6,3,0,0,30
200621,1348650,1,6,4,2,0,32
200622,1348650,1,6,5,1,0,33
200623,1348650,1,6,6,0,0,33
200624,1348650,1,7,1,0,0,33
200625,1348650,1,7,2,0,0,33
200626,1348650,1,7,3,1,0,34
200627,1348650,1,7,4,1,0,35
200628,1348650,1,7,5,0,1,35
200629,1348650,1,7,6,0,0,35
200630,1348650,1,8,1,1,0,36
200631,1348650,1,8,2,0,0,36
200632,1348650,1,8,3,0,0,36
200633,1348650,1,8,4,0,0,36
200634,1348650,1,8,5,4,0,40
200635,1348650,1,8,6,0,0,40
200636,1348650,1,9,1,1,0,41
200637,1348650,1,9,2,1,0,42
200638,1348650,1,9,3,0,0,42
200639,1348650,1,9,4,1,0,43
200640,1348650,1,9,5,0,0,43
200641,1348650,1,9,6,2,0,45
200642,1348650,1,10,1,1,0,46
200643,1348650,1,10,2,1,0,47
200644,1348650,1,10,3,1,0,48
200645,1348650,1,10,4,0,0,48
200646,1348650,1,10,5,0,0,48
200647,1348650,1,10,6,0,1,48
200648,1348650,1,11,1,1,0,49
200649,1348650,1,11,2,1,0,50
200650,1348650,1,11,3,2,0,52
200651,1348650,1,11,4,1,0,53
200652,1348650,1,11,5,0,0,53
200653,1348650,1,11,6,1,0,54
200654,1348650,1,12,1,1,0,55
200655,1348650,1,12,2,1,0,56
200656,1348650,1,12,3,0,0,56
200657,1348650,1,12,4,1,0,57
200658,1348650,1,12,5,1,0,58
200659,1348650,1,12,6,0,0,58
200660,1348650,1,13,1,1,0,59
200661,1348650,1,13,2,1,0,60
200662,1348650,1,13,3,0,0,60
200663,1348650,1,13,4,0,1,60
200664,1348650,1,13,5,1,0,61
200665,1348650,1,13,6,1,0,62
200666,1348650,1,14,1,0,0,62
200667,1348650,1,14,2,1,0,63
200668,1348650,1,14,3,4,0,67
200669,1348650,1,14,4,0,0,67
200670,1348650,1,14,5,0,0,67
200671,1348650,1,14,6,0,0,67
200672,1348650,1,15,1,1,0,68
200673,1348650,1,15,2,0,0,68
200674,1348650,1,15,3,1,0,69
200675,1348650,1,15,4,1,0,70
200676,1348650,1,15,5,1,0,71
200677,1348650,1,15,6,0,0,71
200678,1348650,1,16,1,1,0,72
200679,1348650,1,16,2,1,0,73
200680,1348650,1,16,3,1,0,74
200681,1348650,1,16,4,1,0,75
200682,1348650,1,16,5,1,0,76
200683,1348650,1,16,6,0,0,76
200684,1348650,1,17,1,1,0,77
200685,1348650,1,17,2,1,0,78
200686,1348650,1,17,3,1,0,79
200687,1348650,1,17,4,1,0,80
200688,1348650,1,17,5,0,0,80
200689,1348650,1,17,6,0,1,80
200690,1348650,1,18,1,1,0,81
200691,1348650,1,18,2,1,0,82
200692,1348650,1,18,3,1,0,83
200693,1348650,1,18,4,0,1,83
200694,1348650,1,18,5,0,0,83
200695,1348650,1,18,6,0,1,83
200696,1348650,1,19,1,1,0,84
200697,1348650,1,19,2,4,0,88
200698,1348650,1,19,3,1,0,89
200699,1348650,1,19,4,1,0,90
200700,1348650,1,19,5,2,0,92
200701,1348650,1,19,6,2,0,94
200702,1348650,1,20,1,2,0,96
200703,1348650,1,20,2,2,0,98
200704,1348650,1,20,3,0,0,98
200705,1348650,1,20,4,0,0,98
200706,1348650,1,20,5,0,0,98
200707,1348650,1,20,6,1,0,99
200827,1348651,1,1,1,0,0,0
200828,1348651,1,1,2,1,0,1
200829,1348651,1,1,3,0,0,1
200830,1348651,1,1,4,0,0,1
200831,1348651,1,1,5,4,0,5
200832,1348651,1,1,6,1,0,6
200833,1348651,1,2,1,1,0,7
200834,1348651,1,2,2,0,1,7
200835,1348651,1,2,3,1,0,8
200836,1348651,1,2,4,1,0,9
200837,1348651,1,2,5,1,0,10
200838,1348651,1,2,6,4,0,14
200839,1348651,1,3,1,0,0,14
200840,1348651,1,3,2,4,0,18
200841,1348651,1,3,3,1,0,19
200842,1348651,1,3,4,4,0,23
200843,1348651,1,3,5,1,0,24
200844,1348651,1,3,6,1,0,25
200845,1348651,1,4,1,0,0,25
200846,1348651,1,4,2,0,0,25
200847,1348651,1,4,3,1,0,26
200848,1348651,1,4,4,2,0,28
200849,1348651,1,4,5,0,0,28
200850,1348651,1,4,6,2,0,30
200851,1348651,1,5,1,1,0,31
200852,1348651,1,5,2,4,0,35
200853,1348651,1,5,3,4,0,39
200854,1348651,1,5,4,0,0,39
200855,1348651,1,5,5,4,0,43
200856,1348651,1,5,6,1,0,44
200857,1348651,1,6,1,1,0,45
200858,1348651,1,6,2,4,0,49
200859,1348651,1,6,3,6,0,55
200860,1348651,1,6,4,2,0,57
200861,1348651,1,6,5,0,0,57
200862,1348651,1,6,6,1,0,58
200863,1348651,1,7,1,1,0,59
200864,1348651,1,7,2,4,0,63
200865,1348651,1,7,3,1,0,64
200866,1348651,1,7,4,2,0,66
200867,1348651,1,7,5,1,0,67
200868,1348651,1,7,6,2,0,69
200869,1348651,1,8,1,1,0,70
200870,1348651,1,8,2,4,0,74
200871,1348651,1,8,3,6,0,80
200872,1348651,1,8,4,0,0,80
200873,1348651,1,8,5,1,0,81
200874,1348651,1,8,6,0,0,81
200875,1348651,1,9,1,6,0,87
200876,1348651,1,9,2,0,1,87
200877,1348651,1,9,3,1,0,88
200878,1348651,1,9,4,1,0,89
200879,1348651,1,9,5,4,0,93
200880,1348651,1,9,6,1,0,94
200881,1348651,1,10,1,1,0,95
200882,1348651,1,10,2,1,0,96
200883,1348651,1,10,3,1,0,97
200884,1348651,1,10,4,4,0,101
200885,1348651,1,10,5,0,0,101
200886,1348651,1,10,6,1,0,102
200887,1348651,1,11,1,0,0,102
200888,1348651,1,11,2,1,0,103
200889,1348651,1,11,3,0,0,103
200890,1348651,1,11,4,6,0,109
200891,1348651,1,11,5,2,0,111
200892,1348651,1,11,6,1,0,112
200893,1348651,1,12,1,1,0,113
200894,1348651,1,12,2,0,0,113
200895,1348651,1,12,3,2,0,115
200896,1348651,1,12,4,1,0,116
200897,1348651,1,12,5,1,0,117
200898,1348651,1,12,6,1,0,118
200899,1348651,1,13,1,1,0,119
200900,1348651,1,13,2,6,0,125
200901,1348651,1,13,3,0,1,125
200902,1348651,1,13,4,4,0,129
200903,1348651,1,13,5,1,0,130
200904,1348651,1,13,6,1,0,131
200905,1348651,1,14,1,1,0,132
200906,1348651,1,14,2,1,0,133
200907,1348651,1,14,3,6,0,139
200908,1348651,1,14,4,1,0,140
200909,1348651,1,14,5,0,0,140
200910,1348651,1,14,6,4,0,144
200911,1348651,1,15,1,1,0,145
200912,1348651,1,15,2,4,0,149
200913,1348651,1,15,3,1,0,150
200914,1348651,1,15,4,1,0,151
200915,1348651,1,15,5,1,0,152
200916,1348651,1,15,6,4,0,156
200917,1348651,1,16,1,1,0,157
200918,1348651,1,16,2,0,0,157
200919,1348651,1,16,3,6,0,163
200920,1348651,1,16,4,6,0,169
200921,1348651,1,16,5,1,0,170
200922,1348651,1,16,6,0,0,170
200923,1348651,1,17,1,6,0,176
200924,1348651,1,17,2,4,0,180
200925,1348651,1,17,3,1,0,181
200926,1348651,1,17,4,6,0,187
200927,1348651,1,17,5,1,0,188
200928,1348651,1,17,6,5,0,193
200929,1348651,1,18,1,4,0,197
200930,1348651,1,18,2,6,0,203
200931,1348651,1,18,3,1,0,204
200932,1348651,1,18,4,0,0,204
200933,1348651,1,18,5,6,0,210
200934,1348651,1,18,6,1,0,211
200935,1348651,1,19,1,1,0,212
200936,1348651,1,19,2,4,0,216
200937,1348651,1,19,3,1,0,217
200938,1348651,1,19,4,1,0,218
200939,1348651,1,19,5,4,0,222
200940,1348651,1,19,6,6,0,228
200941,1348651,1,20,1,0,1,228
200942,1348651,1,20,2,1,0,229
200943,1348651,1,20,3,2,0,231
200944,1348651,1,20,4,0,0,231
200945,1348651,1,20,5,2,0,233
200946,1348651,1,20,6,1,0,234
201020,1351400,1,1,1,1,0,1
201021,1351400,1,1,2,1,0,2
201022,1351400,1,1,3,2,0,4
201023,1351400,1,1,4,1,0,5
201024,1351400,1,1,5,0,0,5
201025,1351400,1,1,6,4,0,9
201026,1351400,1,2,1,4,0,13
201027,1351400,1,2,2,2,0,15
201028,1351400,1,2,3,1,0,16
201029,1351400,1,2,4,0,0,16
201030,1351400,1,2,5,1,0,17
201031,1351400,1,2,6,1,0,18
201032,1351400,1,3,1,0,0,18
201033,1351400,1,3,2,4,0,22
201034,1351400,1,3,3,0,0,22
201035,1351400,1,3,4,0,0,22
201036,1351400,1,3,5,1,0,23
201037,1351400,1,3,6,0,0,23
201038,1351400,1,4,1,4,0,27
201039,1351400,1,4,2,1,0,28
201040,1351400,1,4,3,1,0,29
201041,1351400,1,4,4,0,0,29
201042,1351400,1,4,5,1,0,30
201043,1351400,1,4,6,1,0,31
201044,1351400,1,5,1,4,0,35
201045,1351400,1,5,2,1,0,36
201046,1351400,1,5,3,0,0,36
201047,1351400,1,5,4,1,0,37
201048,1351400,1,5,5,1,0,38
201049,1351400,1,5,6,6,0,44
201050,1351400,1,6,1,0,0,44
201051,1351400,1,6,2,1,0,45
201052,1351400,1,6,3,0,0,45
201053,1351400,1,6,4,1,0,46
201054,1351400,1,6,5,4,0,50
201055,1351400,1,6,6,1,0,51
201056,1351400,1,7,1,1,0,52
201057,1351400,1,7,2,0,0,52
201058,1351400,1,7,3,1,0,53
201059,1351400,1,7,4,0,0,53
201060,1351400,1,7,5,1,0,54
201061,1351400,1,7,6,1,0,55
201062,1351400,1,8,1,0,0,55
201063,1351400,1,8,2,1,0,56
201064,1351400,1,8,3,1,0,57
201065,1351400,1,8,4,1,0,58
201066,1351400,1,8,5,1,0,59
201067,1351400,1,8,6,1,0,60
201068,1351400,1,9,1,1,0,61
201069,1351400,1,9,2,0,0,61
201070,1351400,1,9,3,0,0,61
201071,1351400,1,9,4,0,0,61
201072,1351400,1,9,5,1,0,62
201073,1351400,1,9,6,6,0,68
201074,1351400,1,10,1,1,0,69
201075,1351400,1,10,2,4,0,73
201076,1351400,1,10,3,1,0,74
201077,1351400,1,10,4,6,0,80
201078,1351400,1,10,5,0,0,80
201079,1351400,1,10,6,0,1,80
201080,1351400,1,11,1,1,0,81
201081,1351400,1,11,2,0,0,81
201082,1351400,1,11,3,1,0,82
201083,1351400,1,11,4,1,0,83
201084,1351400,1,11,5,0,0,83
201085,1351400,1,11,6,1,0,84
201086,1351400,1,12,1,1,0,85
201087,1351400,1,12,2,1,0,86
201088,1351400,1,12,3,1,0,87
201089,1351400,1,12,4,1,0,88
201090,1351400,1,12,5,0,1,88
201091,1351400,1,12,6,1,0,89
201092,1351400,1,13,1,1,0,90
201093,1351400,1,13,2,1,0,91
201094,1351400,1,13,3,1,0,92
201095,1351400,1,13,4,2,0,94
201096,1351400,1,13,5,6,0,100
201097,1351400,1,13,6,6,0,106
201098,1351400,1,14,1,1,0,107
201099,1351400,1,14,2,2,0,109
201100,1351400,1,14,3,0,0,109
201101,1351400,1,14,4,1,0,110
201102,1351400,1,14,5,4,0,114
201103,1351400,1,14,6,1,0,115
201104,1351400,1,15,1,4,0,119
201105,1351400,1,15,2,1,0,120
201106,1351400,1,15,3,4,0,124
201107,1351400,1,15,4,1,0,125
201108,1351400,1,15,5,1,0,126
201109,1351400,1,15,6,0,0,126
201110,1351400,1,16,1,0,0,126
201111,1351400,1,16,2,4,0,130
201112,1351400,1,16,3,1,0,131
201113,1351400,1,16,4,2,0,133
201114,1351400,1,16,5,1,0,134
201115,1351400,1,16,6,1,1,135
201116,1351400,1,17,1,0,1,135
201117,1351400,1,17,2,0,0,135
201118,1351400,1,17,3,0,0,135
201119,1351400,1,17,4,0,0,135
201120,1351400,1,17,5,0,0,135
201121,1351400,1,17,6,1,0,136
201122,1351400,1,18,1,2,0,138
201123,1351400,1,18,2,1,0,139
201124,1351400,1,18,3,1,0,140
201125,1351400,1,18,4,0,0,140
201126,1351400,1,18,5,1,0,141
201127,1351400,1,18,6,2,0,143
201128,1351400,1,19,1,1,0,144
201129,1351400,1,19,2,1,0,145
201130,1351400,1,19,3,1,0,146
201131,1351400,1,19,4,0,0,146
201132,1351400,1,19,5,0,1,146
201133,1351400,1,19,6,1,0,147
201134,1351400,1,20,1,0,1,147
201135,1351400,1,20,2,0,0,147
201136,1351400,1,20,3,4,0,151
201137,1351400,1,20,4,1,0,152
201138,1351400,1,20,5,2,0,154
201139,1351400,1,20,6,2,0,156
201248,1351401,1,1,1,0,0,0
201249,1351401,1,1,2,2,0,2
201250,1351401,1,1,3,4,0,6
201251,1351401,1,1,4,0,0,6
201252,1351401,1,1,5,4,0,10
201253,1351401,1,1,6,0,0,10
201254,1351401,1,2,1,4,0,14
201255,1351401,1,2,2,0,0,14
201256,1351401,1,2,3,0,0,14
201257,1351401,1,2,4,1,0,15
201258,1351401,1,2,5,0,0,15
201259,1351401,1,2,6,1,0,16
201260,1351401,1,3,1,0,0,16
201261,1351401,1,3,2,0,1,16
201262,1351401,1,3,3,0,0,16
201263,1351401,1,3,4,4,0,20
201264,1351401,1,3,5,0,0,20
201265,1351401,1,3,6,1,0,21
201266,1351401,1,4,1,0,0,21
201267,1351401,1,4,2,0,0,21
201268,1351401,1,4,3,0,0,21
201269,1351401,1,4,4,1,0,22
201270,1351401,1,4,5,6,0,28
201271,1351401,1,4,6,1,0,29
201272,1351401,1,5,1,1,0,30
201273,1351401,1,5,2,0,0,30
201274,1351401,1,5,3,1,0,31
201275,1351401,1,5,4,4,0,35
201276,1351401,1,5,5,1,0,36
201277,1351401,1,5,6,1,0,37
201278,1351401,1,6,1,0,0,37
201279,1351401,1,6,2,4,0,41
201280,1351401,1,6,3,1,0,42
201281,1351401,1,6,4,1,0,43
201282,1351401,1,6,5,1,0,44
201283,1351401,1,6,6,6,0,50
201284,1351401,1,7,1,0,0,50
201285,1351401,1,7,2,0,0,50
201286,1351401,1,7,3,0,1,50
201287,1351401,1,7,4,0,0,50
201288,1351401,1,7,5,1,0,51
201289,1351401,1,7,6,0,0,51
201290,1351401,1,8,1,1,0,52
201291,1351401,1,8,2,0,0,52
201292,1351401,1,8,3,1,0,53
201293,1351401,1,8,4,2,0,55
201294,1351401,1,8,5,0,0,55
201295,1351401,1,8,6,0,1,55
201296,1351401,1,9,1,1,0,56
201297,1351401,1,9,2,0,0,56
201298,1351401,1,9,3,0,0,56
201299,1351401,1,9,4,0,0,56
201300,1351401,1,9,5,1,0,57
201301,1351401,1,9,6,0,1,57
201302,1351401,1,10,1,0,0,57
201303,1351401,1,10,2,1,0,58
201304,1351401,1,10,3,4,0,62
201305,1351401,1,10,4,0,0,62
201306,1351401,1,10,5,0,0,62
201307,1351401,1,10,6,1,0,63
201308,1351401,1,11,1,1,0,64
201309,1351401,1,11,2,1,0,65
201310,1351401,1,11,3,1,0,66
201311,1351401,1,11,4,1,0,67
201312,1351401,1,11,5,0,0,67
201313,1351401,1,11,6,0,0,67
201314,1351401,1,12,1,4,0,71
201315,1351401,1,12,2,1,0,72
201316,1351401,1,12,3,1,0,73
201317,1351401,1,12,4,1,0,74
201318,1351401,1,12,5,1,0,75
201319,1351401,1,12,6,1,0,76
201320,1351401,1,13,1,0,0,76
201321,1351401,1,13,2,1,0,77
201322,1351401,1,13,3,0,0,77
201323,1351401,1,13,4,1,0,78
201324,1351401,1,13,5,5,0,83
201325,1351401,1,13,6,1,0,84
201326,1351401,1,14,1,0,0,84
201327,1351401,1,14,2,1,0,85
201328,1351401,1,14,3,1,0,86
201329,1351401,1,14,4,2,0,88
201330,1351401,1,14,5,1,0,89
201331,1351401,1,14,6,2,0,91
201332,1351401,1,15,1,0,0,91
201333,1351401,1,15,2,0,1,91
201334,1351401,1,15,3,0,0,91
201335,1351401,1,15,4,0,1,91
201336,1351401,1,15,5,0,0,91
201337,1351401,1,15,6,1,0,92
201338,1351401,1,16,1,1,0,93
201339,1351401,1,16,2,0,0,93
201340,1351401,1,16,3,0,0,93
201341,1351401,1,16,4,1,0,94
201342,1351401,1,16,5,1,0,95
201343,1351401,1,16,6,0,0,95
201344,1351401,1,17,1,1,0,96
201345,1351401,1,17,2,0,0,96
201346,1351401,1,17,3,1,0,97
201347,1351401,1,17,4,2,0,99
201348,1351401,1,17,5,1,0,100
201349,1351401,1,17,6,0,1,100
201350,1351401,1,18,1,1,0,101
201351,1351401,1,18,2,0,0,101
201352,1351401,1,18,3,0,0,101
201353,1351401,1,18,4,0,0,101
201354,1351401,1,18,5,0,0,101
201355,1351401,1,18,6,4,0,105
201356,1351401,1,19,1,1,0,106
201357,1351401,1,19,2,4,0,110
201358,1351401,1,19,3,1,0,111
201359,1351401,1,19,4,1,0,112
201360,1351401,1,19,5,0,0,112
201361,1351401,1,19,6,2,0,114
201362,1351401,1,20,1,0,1,114
201363,1351401,1,20,2,1,0,115
201364,1351401,1,20,3,0,0,115
201365,1351401,1,20,4,0,0,115
201366,1351401,1,20,5,2,1,117
201367,1351401,1,20,6,0,1,117
201481,1351402,1,1,1,2,0,2
201482,1351402,1,1,2,4,0,6
201483,1351402,1,1,3,1,0,7
201484,1351402,1,1,4,0,0,7
201485,1351402,1,1,5,0,0,7
201486,1351402,1,1,6,0,0,7
201487,1351402,1,2,1,1,0,8
201488,1351402,1,2,2,4,0,12
201489,1351402,1,2,3,0,0,12
201490,1351402,1,2,4,2,0,14
201491,1351402,1,2,5,1,0,15
201492,1351402,1,2,6,4,0,19
201493,1351402,1,3,1,0,0,19
201494,1351402,1,3,2,1,0,20
201495,1351402,1,3,3,2,0,22
201496,1351402,1,3,4,1,0,23
201497,1351402,1,3,5,0,0,23
201498,1351402,1,3,6,0,0,23
201499,1351402,1,4,1,0,0,23
201500,1351402,1,4,2,0,0,23
201501,1351402,1,4,3,1,0,24
201502,1351402,1,4,4,5,0,29
201503,1351402,1,4,5,1,0,30
201504,1351402,1,4,6,1,0,31
201505,1351402,1,5,1,1,0,32
201506,1351402,1,5,2,4,0,36
201507,1351402,1,5,3,1,0,37
201508,1351402,1,5,4,0,0,37
201509,1351402,1,5,5,1,0,38
201510,1351402,1,5,6,0,0,38
201511,1351402,1,6,1,1,0,39
201512,1351402,1,6,2,4,0,43
201513,1351402,1,6,3,1,0,44
201514,1351402,1,6,4,1,0,45
201515,1351402,1,6,5,1,0,46
201516,1351402,1,6,6,0,0,46
201517,1351402,1,7,1,2,0,48
201518,1351402,1,7,2,0,0,48
201519,1351402,1,7,3,1,0,49
201520,1351402,1,7,4,0,0,49
201521,1351402,1,7,5,0,0,49
201522,1351402,1,7,6,4,0,53
201523,1351402,1,8,1,0,0,53
201524,1351402,1,8,2,2,0,55
201525,1351402,1,8,3,0,1,55
201526,1351402,1,8,4,1,0,56
201527,1351402,1,8,5,0,0,56
201528,1351402,1,8,6,0,0,56
201529,1351402,1,9,1,1,0,57
201530,1351402,1,9,2,2,0,59
201531,1351402,1,9,3,0,0,59
201532,1351402,1,9,4,0,0,59
201533,1351402,1,9,5,2,0,61
201534,1351402,1,9,6,4,0,65
201535,1351402,1,10,1,1,0,66
201536,1351402,1,10,2,4,0,70
201537,1351402,1,10,3,1,0,71
201538,1351402,1,10,4,1,0,72
201539,1351402,1,10,5,4,0,76
201540,1351402,1,10,6,1,0,77
201541,1351402,1,11,1,1,0,78
201542,1351402,1,11,2,6,0,84
201543,1351402,1,11,3,2,0,86
201544,1351402,1,11,4,2,0,88
201545,1351402,1,11,5,0,0,88
201546,1351402,1,11,6,1,0,89
201547,1351402,1,12,1,1,0,90
201548,1351402,1,12,2,0,0,90
201549,1351402,1,12,3,0,0,90
201550,1351402,1,12,4,4,0,94
201551,1351402,1,12,5,4,0,98
201552,1351402,1,12,6,0,0,98
201553,1351402,1,13,1,1,0,99
201554,1351402,1,13,2,1,0,100
201555,1351402,1,13,3,1,0,101
201556,1351402,1,13,4,0,0,101
201557,1351402,1,13,5,1,0,102
201558,1351402,1,13,6,6,0,108
201559,1351402,1,14,1,2,0,110
201560,1351402,1,14,2,1,0,111
201561,1351402,1,14,3,0,0,111
201562,1351402,1,14,4,1,0,112
201563,1351402,1,14,5,4,0,116
201564,1351402,1,14,6,6,0,122
201565,1351402,1,15,1,1,0,123
201566,1351402,1,15,2,4,0,127
201567,1351402,1,15,3,2,0,129
201568,1351402,1,15,4,0,0,129
201569,1351402,1,15,5,1,0,130
201570,1351402,1,15,6,1,0,131
201571,1351402,1,16,1,1,0,132
201572,1351402,1,16,2,0,0,132
201573,1351402,1,16,3,1,0,133
201574,1351402,1,16,4,2,0,135
201575,1351402,1,16,5,1,0,136
201576,1351402,1,16,6,0,0,136
201577,1351402,1,17,1,1,0,137
201578,1351402,1,17,2,1,0,138
201579,1351402,1,17,3,0,0,138
201580,1351402,1,17,4,1,0,139
201581,1351402,1,17,5,0,0,139
201582,1351402,1,17,6,0,1,139
201583,1351402,1,18,1,1,0,140
201584,1351402,1,18,2,1,0,141
201585,1351402,1,18,3,1,0,142
201586,1351402,1,18,4,1,0,143
201587,1351402,1,18,5,0,0,143
201588,1351402,1,18,6,1,0,144
201589,1351402,1,19,1,4,0,148
201590,1351402,1,19,2,0,0,148
201591,1351402,1,19,3,2,0,150
201592,1351402,1,19,4,2,0,152
201593,1351402,1,19,5,1,0,153
201594,1351402,1,19,6,1,0,154
201595,1351402,1,20,1,1,0,155
201596,1351402,1,20,2,1,0,156
201597,1351402,1,20,3,0,0,156
201598,1351402,1,20,4,1,0,157
201599,1351402,1,20,5,0,0,157
201600,1351402,1,20,6,1,0,158
201721,1355720,1,1,1,1,0,1
201722,1355720,1,1,2,1,0,2
201723,1355720,1,1,3,0,0,2
201724,1355720,1,1,4,6,0,8
201725,1355720,1,1,5,0,0,8
201726,1355720,1,1,6,3,0,11
201727,1355720,1,2,1,1,0,12
201728,1355720,1,2,2,6,0,18
201729,1355720,1,2,3,1,0,19
201730,1355720,1,2,4,4,0,23
201731,1355720,1,2,5,1,0,24
201732,1355720,1,2,6,1,0,25
201733,1355720,1,3,1,1,0,26
201734,1355720,1,3,2,0,0,26
201735,1355720,1,3,3,4,0,30
201736,1355720,1,3,4,1,0,31
201737,1355720,1,3,5,0,0,31
201738,1355720,1,3,6,2,0,33
201739,1355720,1,4,1,1,0,34
201740,1355720,1,4,2,4,0,38
201741,1355720,1,4,3,1,0,39
201742,1355720,1,4,4,0,0,39
201743,1355720,1,4,5,6,0,45
201744,1355720,1,4,6,4,0,49
201745,1355720,1,5,1,1,0,50
201746,1355720,1,5,2,1,0,51
201747,1355720,1,5,3,1,0,52
201748,1355720,1,5,4,6,0,58
201749,1355720,1,5,5,2,0,60
201750,1355720,1,5,6,1,0,61
201751,1355720,1,6,1,1,0,62
201752,1355720,1,6,2,6,0,68
201753,1355720,1,6,3,4,0,72
201754,1355720,1,6,4,4,0,76
201755,1355720,1,6,5,4,0,80
201756,1355720,1,6,6,1,0,81
201757,1355720,1,7,1,0,0,81
201758,1355720,1,7,2,2,0,83
201759,1355720,1,7,3,1,0,84
201760,1355720,1,7,4,2,0,86
201761,1355720,1,7,5,4,0,90
201762,1355720,1,7,6,1,0,91
201763,1355720,1,8,1,0,1,91
201764,1355720,1,8,2,1,0,92
201765,1355720,1,8,3,1,0,93
201766,1355720,1,8,4,0,0,93
201767,1355720,1,8,5,2,0,95
201768,1355720,1,8,6,1,0,96
201769,1355720,1,9,1,0,0,96
201770,1355720,1,9,2,0,0,96
201771,1355720,1,9,3,1,0,97
201772,1355720,1,9,4,0,0,97
201773,1355720,1,9,5,4,0,101
201774,1355720,1,9,6,4,0,105
201775,1355720,1,10,1,0,0,105
201776,1355720,1,10,2,6,0,111
201777,1355720,1,10,3,2,0,113
201778,1355720,1,10,4,1,0,114
201779,1355720,1,10,5,0,0,114
201780,1355720,1,10,6,2,0,116
201781,1355720,1,11,1,0,0,116
201782,1355720,1,11,2,2,1,118
201783,1355720,1,11,3,1,0,119
201784,1355720,1,11,4,0,0,119
201785,1355720,1,11,5,0,0,119
201786,1355720,1,11,6,2,0,121
201787,1355720,1,12,1,4,0,125
201788,1355720,1,12,2,0,0,125
201789,1355720,1,12,3,6,0,131
201790,1355720,1,12,4,2,0,133
201791,1355720,1,12,5,6,0,139
201792,1355720,1,12,6,0,0,139
201793,1355720,1,13,1,0,0,139
201794,1355720,1,13,2,1,0,140
201795,1355720,1,13,3,4,0,144
201796,1355720,1,13,4,2,0,146
201797,1355720,1,13,5,0,0,146
201798,1355720,1,13,6,0,0,146
201799,1355720,1,14,1,1,0,147
201800,1355720,1,14,2,1,0,148
201801,1355720,1,14,3,0,0,148
201802,1355720,1,14,4,1,0,149
201803,1355720,1,14,5,4,0,153
201804,1355720,1,14,6,1,1,154
201805,1355720,1,15,1,1,0,155
201806,1355720,1,15,2,1,0,156
201807,1355720,1,15,3,2,0,158
201808,1355720,1,15,4,4,0,162
201809,1355720,1,15,5,2,0,164
201810,1355720,1,15,6,1,0,165
201811,1355720,1,16,1,1,0,166
201812,1355720,1,16,2,1,0,167
201813,1355720,1,16,3,1,0,168
201814,1355720,1,16,4,1,0,169
201815,1355720,1,16,5,0,0,169
201816,1355720,1,16,6,3,0,172
201817,1355720,1,17,1,0,1,172
201818,1355720,1,17,2,4,0,176
201819,1355720,1,17,3,0,0,176
201820,1355720,1,17,4,0,0,176
201821,1355720,1,17,5,2,0,178
201822,1355720,1,17,6,2,0,180
201823,1355720,1,18,1,1,0,181
201824,1355720,1,18,2,0,0,181
201825,1355720,1,18,3,4,0,185
201826,1355720,1,18,4,1,0,186
201827,1355720,1,18,5,1,0,187
201828,1355720,1,18,6,1,0,188
201829,1355720,1,19,1,4,0,192
201830,1355720,1,19,2,0,0,192
201831,1355720,1,19,3,1,0,193
201832,1355720,1,19,4,2,0,195
201833,1355720,1,19,5,6,0,201
201834,1355720,1,19,6,0,1,201
201835,1355720,1,20,1,1,0,202
201836,1355720,1,20,2,4,0,206
201837,1355720,1,20,3,1,0,207
201886,1355721,1,1,1,1,0,1
201887,1355721,1,1,2,1,0,2
201888,1355721,1,1,3,2,0,4
201889,1355721,1,1,4,2,0,6
201890,1355721,1,1,5,1,0,7
201891,1355721,1,1,6,1,0,8
201892,1355721,1,2,1,4,0,12
201893,1355721,1,2,2,1,0,13
201894,1355721,1,2,3,1,0,14
201895,1355721,1,2,4,1,0,15
201896,1355721,1,2,5,2,0,17
201897,1355721,1,2,6,4,0,21
201898,1355721,1,3,1,4,0,25
201899,1355721,1,3,2,1,0,26
201900,1355721,1,3,3,6,0,32
201901,1355721,1,3,4,1,0,33
201902,1355721,1,3,5,2,0,35
201903,1355721,1,3,6,2,0,37
201904,1355721,1,4,1,6,0,43
201905,1355721,1,4,2,4,0,47
201906,1355721,1,4,3,4,0,51
201907,1355721,1,4,4,1,0,52
201908,1355721,1,4,5,1,0,53
201909,1355721,1,4,6,1,0,54
201910,1355721,1,5,1,4,0,58
201911,1355721,1,5,2,4,0,62
201912,1355721,1,5,3,6,0,68
201913,1355721,1,5,4,2,0,70
201914,1355721,1,5,5,1,0,71
201915,1355721,1,5,6,2,0,73
201916,1355721,1,6,1,1,0,74
201917,1355721,1,6,2,4,0,78
201918,1355721,1,6,3,1,0,79
201919,1355721,1,6,4,0,0,79
201920,1355721,1,6,5,0,0,79
201921,1355721,1,6,6,4,0,83
201922,1355721,1,7,1,6,0,89
201923,1355721,1,7,2,0,0,89
201924,1355721,1,7,3,1,0,90
201925,1355721,1,7,4,2,0,92
201926,1355721,1,7,5,1,0,93
201927,1355721,1,7,6,6,0,99
201928,1355721,1,8,1,4,0,103
201929,1355721,1,8,2,0,0,103
201930,1355721,1,8,3,0,0,103
201931,1355721,1,8,4,2,0,105
201932,1355721,1,8,5,1,0,106
201933,1355721,1,8,6,1,0,107
201934,1355721,1,9,1,2,0,109
201935,1355721,1,9,2,1,0,110
201936,1355721,1,9,3,4,0,114
201937,1355721,1,9,4,4,0,118
201938,1355721,1,9,5,4,0,122
201939,1355721,1,9,6,1,0,123
201940,1355721,1,10,1,1,0,124
201941,1355721,1,10,2,0,1,124
201942,1355721,1,10,3,4,0,128
201943,1355721,1,10,4,0,0,128
201944,1355721,1,10,5,1,0,129
201945,1355721,1,10,6,1,0,130
201946,1355721,1,11,1,1,0,131
201947,1355721,1,11,2,0,0,131
201948,1355721,1,11,3,0,0,131
201949,1355721,1,11,4,0,0,131
201950,1355721,1,11,5,1,0,132
201951,1355721,1,11,6,2,0,134
201952,1355721,1,12,1,2,0,136
201953,1355721,1,12,2,0,0,136
201954,1355721,1,12,3,1,0,137
201955,1355721,1,12,4,1,0,138
201956,1355721,1,12,5,0,0,138
201957,1355721,1,12,6,0,1,138
201958,1355721,1,13,1,7,0,145
201959,1355721,1,13,2,0,0,145
201960,1355721,1,13,3,4,0,149
201961,1355721,1,13,4,1,0,150
201962,1355721,1,13,5,1,0,151
201963,1355721,1,13,6,1,0,152
201964,1355721,1,14,1,1,0,153
201965,1355721,1,14,2,6,0,159
201966,1355721,1,14,3,1,0,160
201967,1355721,1,14,4,2,0,162
201968,1355721,1,14,5,5,0,167
201969,1355721,1,14,6,2,0,169
201970,1355721,1,15,1,0,0,169
201971,1355721,1,15,2,2,0,171
201972,1355721,1,15,3,0,0,171
201973,1355721,1,15,4,0,0,171
201974,1355721,1,15,5,6,0,177
201975,1355721,1,15,6,1,0,178
201976,1355721,1,16,1,1,0,179
201977,1355721,1,16,2,1,0,180
201978,1355721,1,16,3,2,0,182
201979,1355721,1,16,4,1,0,183
201980,1355721,1,16,5,5,0,188
201981,1355721,1,16,6,1,0,189
201982,1355721,1,17,1,4,0,193
201983,1355721,1,17,2,4,0,197
201984,1355721,1,17,3,2,0,199
201985,1355721,1,17,4,0,0,199
201986,1355721,1,17,5,0,1,199
201987,1355721,1,17,6,3,0,202
202090,1355722,1,1,1,4,0,4
202091,1355722,1,1,2,0,0,4
202092,1355722,1,1,3,1,0,5
202093,1355722,1,1,4,4,0,9
202094,1355722,1,1,5,0,0,9
202095,1355722,1,1,6,0,0,9
202096,1355722,1,2,1,0,1,9
202097,1355722,1,2,2,0,0,9
202098,1355722,1,2,3,0,0,9
202099,1355722,1,2,4,0,0,9
202100,1355722,1,2,5,1,0,10
202101,1355722,1,2,6,4,0,14
202102,1355722,1,3,1,2,0,16
202103,1355722,1,3,2,1,0,17
202104,1355722,1,3,3,0,0,17
202105,1355722,1,3,4,1,0,18
202106,1355722,1,3,5,0,0,18
202107,1355722,1,3,6,0,1,18
202108,1355722,1,4,1,1,0,19
202109,1355722,1,4,2,1,0,20
202110,1355722,1,4,3,4,0,24
202111,1355722,1,4,4,0,0,24
202112,1355722,1,4,5,0,1,24
202113,1355722,1,4,6,0,0,24
202114,1355722,1,5,1,1,0,25
202115,1355722,1,5,2,4,0,29
202116,1355722,1,5,3,6,0,35
202117,1355722,1,5,4,0,0,35
202118,1355722,1,5,5,1,0,36
202119,1355722,1,5,6,0,0,36
202120,1355722,1,6,1,0,0,36
202121,1355722,1,6,2,1,0,37
202122,1355722,1,6,3,0,0,37
202123,1355722,1,6,4,4,0,41
202124,1355722,1,6,5,0,1,41
202125,1355722,1,6,6,0,0,41
202126,1355722,1,7,1,0,0,41
202127,1355722,1,7,2,0,0,41
202128,1355722,1,7,3,0,1,41
202129,1355722,1,7,4,0,0,41
202130,1355722,1,7,5,0,0,41
202131,1355722,1,7,6,6,0,47
202132,1355722,1,8,1,0,0,47
202133,1355722,1,8,2,0,0,47
202134,1355722,1,8,3,0,0,47
202135,1355722,1,8,4,4,0,51
202136,1355722,1,8,5,0,0,51
202137,1355722,1,8,6,1,0,52
202138,1355722,1,9,1,1,0,53
202139,1355722,1,9,2,0,0,53
202140,1355722,1,9,3,1,0,54
202141,1355722,1,9,4,1,0,55
202142,1355722,1,9,5,2,0,57
202143,1355722,1,9,6,4,0,61
202144,1355722,1,10,1,0,1,61
202145,1355722,1,10,2,0,0,61
202146,1355722,1,10,3,0,1,61
202147,1355722,1,10,4,1,0,62
202148,1355722,1,10,5,1,0,63
202149,1355722,1,10,6,1,0,64
202150,1355722,1,11,1,1,0,65
202151,1355722,1,11,2,0,0,65
202152,1355722,1,11,3,1,0,66
202153,1355722,1,11,4,0,0,66
202154,1355722,1,11,5,1,0,67
202155,1355722,1,11,6,1,0,68
202156,1355722,1,12,1,1,0,69
202157,1355722,1,12,2,0,0,69
202158,1355722,1,12,3,1,0,70
202159,1355722,1,12,4,4,0,74
202160,1355722,1,12,5,1,0,75
202161,1355722,1,12,6,0,0,75
202162,1355722,1,13,1,1,0,76
202163,1355722,1,13,2,1,0,77
202164,1355722,1,13,3,0,0,77
202165,1355722,1,13,4,2,0,79
202166,1355722,1,13,5,0,0,79
202167,1355722,1,13,6,1,0,80
202168,1355722,1,14,1,1,0,81
202169,1355722,1,14,2,1,0,82
202170,1355722,1,14,3,1,0,83
202171,1355722,1,14,4,4,0,87
202172,1355722,1,14,5,1,0,88
202173,1355722,1,14,6,1,0,89
202174,1355722,1,15,1,0,0,89
202175,1355722,1,15,2,4,0,93
202176,1355722,1,15,3,0,0,93
202177,1355722,1,15,4,0,0,93
202178,1355722,1,15,5,1,0,94
202179,1355722,1,15,6,0,0,94
202180,1355722,1,16,1,0,1,94
202181,1355722,1,16,2,1,0,95
202182,1355722,1,16,3,1,0,96
202183,1355722,1,16,4,2,0,98
202184,1355722,1,16,5,1,0,99
202185,1355722,1,16,6,2,0,101
202186,1355722,1,17,1,0,0,101
202187,1355722,1,17,2,1,0,102
202188,1355722,1,17,3,1,0,103
202189,1355722,1,17,4,1,0,104
202190,1355722,1,17,5,0,1,104
202191,1355722,1,17,6,0,0,104
202192,1355722,1,18,1,6,0,110
202193,1355722,1,18,2,0,0,110
202194,1355722,1,18,3,0,0,110
202195,1355722,1,18,4,1,0,111
202196,1355722,1,18,5,0,0,111
202197,1355722,1,18,6,0,0,111
202198,1355722,1,19,1,0,0,111
202199,1355722,1,19,2,1,0,112
202200,1355722,1,19,3,1,0,113
202201,1355722,1,19,4,6,0,119
202202,1355722,1,19,5,4,0,123
202203,1355722,1,19,6,0,0,123
202204,1355722,1,20,1,1,0,124
202205,1355722,1,20,2,0,1,124
202290,1362815,1,1,1,1,0,1
202291,1362815,1,1,2,1,0,2
202292,1362815,1,1,3,0,0,2
202293,1362815,1,1,4,0,0,2
202294,1362815,1,1,5,0,0,2
202295,1362815,1,1,6,4,0,6
202296,1362815,1,2,1,0,0,6
202297,1362815,1,2,2,0,0,6
202298,1362815,1,2,3,0,0,6
202299,1362815,1,2,4,1,0,7
202300,1362815,1,2,5,0,0,7
202301,1362815,1,2,6,6,0,13
202302,1362815,1,3,1,0,0,13
202303,1362815,1,3,2,0,0,13
202304,1362815,1,3,3,0,0,13
202305,1362815,1,3,4,0,0,13
202306,1362815,1,3,5,4,0,17
202307,1362815,1,3,6,0,1,17
202308,1362815,1,4,1,4,0,21
202309,1362815,1,4,2,1,0,22
202310,1362815,1,4,3,0,0,22
202311,1362815,1,4,4,0,1,22
202312,1362815,1,4,5,0,0,22
202313,1362815,1,4,6,2,0,24
202314,1362815,1,5,1,0,0,24
202315,1362815,1,5,2,0,0,24
202316,1362815,1,5,3,0,0,24
202317,1362815,1,5,4,0,0,24
202318,1362815,1,5,5,1,0,25
202319,1362815,1,5,6,1,0,26
202320,1362815,1,6,1,4,0,30
202321,1362815,1,6,2,0,0,30
202322,1362815,1,6,3,4,0,34
202323,1362815,1,6,4,4,0,38
202324,1362815,1,6,5,1,0,39
202325,1362815,1,6,6,0,1,39
202326,1362815,1,7,1,0,1,39
202327,1362815,1,7,2,0,0,39
202328,1362815,1,7,3,0,0,39
202329,1362815,1,7,4,0,0,39
202330,1362815,1,7,5,1,0,40
202331,1362815,1,7,6,0,0,40
202332,1362815,1,8,1,1,0,41
202333,1362815,1,8,2,0,1,41
202334,1362815,1,8,3,0,0,41
202335,1362815,1,8,4,1,0,42
202336,1362815,1,8,5,1,0,43
202337,1362815,1,8,6,1,0,44
202338,1362815,1,9,1,1,0,45
202339,1362815,1,9,2,0,0,45
202340,1362815,1,9,3,1,0,46
202341,1362815,1,9,4,2,0,48
202342,1362815,1,9,5,1,0,49
202343,1362815,1,9,6,1,0,50
202344,1362815,1,10,1,0,0,50
202345,1362815,1,10,2,1,0,51
202346,1362815,1,10,3,0,0,51
202347,1362815,1,10,4,0,0,51
202348,1362815,1,10,5,0,0,51
202349,1362815,1,10,6,0,0,51
202350,1362815,1,11,1,1,0,52
202351,1362815,1,11,2,0,0,52
202352,1362815,1,11,3,2,0,54
202353,1362815,1,11,4,1,0,55
202354,1362815,1,11,5,1,0,56
202355,1362815,1,11,6,1,0,57
202356,1362815,1,12,1,1,0,58
202357,1362815,1,12,2,0,0,58
202358,1362815,1,12,3,0,0,58
202359,1362815,1,12,4,1,0,59
202360,1362815,1,12,5,0,0,59
202361,1362815,1,12,6,1,0,60
202362,1362815,1,13,1,0,1,60
202363,1362815,1,13,2,0,0,60
202364,1362815,1,13,3,1,0,61
202365,1362815,1,13,4,1,0,62
202366,1362815,1,13,5,0,0,62
202367,1362815,1,13,6,1,0,63
202368,1362815,1,14,1,0,0,63
202369,1362815,1,14,2,1,0,64
202370,1362815,1,14,3,1,0,65
202371,1362815,1,14,4,0,0,65
202372,1362815,1,14,5,0,1,65
202373,1362815,1,14,6,0,0,65
202374,1362815,1,15,1,1,0,66
202375,1362815,1,15,2,1,0,67
202376,1362815,1,15,3,1,0,68
202377,1362815,1,15,4,0,0,68
202378,1362815,1,15,5,1,0,69
202379,1362815,1,15,6,1,0,70
202380,1362815,1,16,1,1,0,71
202381,1362815,1,16,2,0,0,71
202382,1362815,1,16,3,0,0,71
202383,1362815,1,16,4,0,1,71
202384,1362815,1,16,5,0,0,71
202385,1362815,1,16,6,6,0,77
202386,1362815,1,17,1,2,0,79
202387,1362815,1,17,2,0,0,79
202388,1362815,1,17,3,0,0,79
202389,1362815,1,17,4,0,0,79
202390,1362815,1,17,5,1,0,80
202391,1362815,1,17,6,0,0,80
202392,1362815,1,18,1,0,0,80
202393,1362815,1,18,2,0,0,80
202394,1362815,1,18,3,0,0,80
202395,1362815,1,18,4,0,0,80
202396,1362815,1,18,5,0,1,80
202397,1362815,1,18,6,1,0,81
202398,1362815,1,19,1,0,0,81
202399,1362815,1,19,2,1,0,82
202400,1362815,1,19,3,0,0,82
202401,1362815,1,19,4,1,0,83
202402,1362815,1,19,5,4,0,87
202403,1362815,1,19,6,0,0,87
202404,1362815,1,20,1,0,0,87
202405,1362815,1,20,2,1,0,88
202406,1362815,1,20,3,0,0,88
202407,1362815,1,20,4,1,0,89
202408,1362815,1,20,5,2,0,91
202409,1362815,1,20,6,1,0,92
202517,1362816,1,1,1,0,0,0
202518,1362816,1,1,2,0,1,0
202519,1362816,1,1,3,0,1,0
202520,1362816,1,1,4,0,0,0
202521,1362816,1,1,5,0,0,0
202522,1362816,1,1,6,0,0,0
202523,1362816,1,2,1,4,0,4
202524,1362816,1,2,2,4,0,8
202525,1362816,1,2,3,0,0,8
202526,1362816,1,2,4,6,0,14
202527,1362816,1,2,5,1,0,15
202528,1362816,1,2,6,3,0,18
202529,1362816,1,3,1,0,0,18
202530,1362816,1,3,2,0,0,18
202531,1362816,1,3,3,0,0,18
202532,1362816,1,3,4,1,0,19
202533,1362816,1,3,5,0,0,19
202534,1362816,1,3,6,0,0,19
202535,1362816,1,4,1,1,0,20
202536,1362816,1,4,2,0,0,20
202537,1362816,1,4,3,0,1,20
202538,1362816,1,4,4,4,0,24
202539,1362816,1,4,5,1,0,25
202540,1362816,1,4,6,0,0,25
202541,1362816,1,5,1,1,0,26
202542,1362816,1,5,2,1,0,27
202543,1362816,1,5,3,4,0,31
202544,1362816,1,5,4,1,0,32
202545,1362816,1,5,5,0,0,32
202546,1362816,1,5,6,1,0,33
202547,1362816,1,6,1,0,0,33
202548,1362816,1,6,2,0,0,33
202549,1362816,1,6,3,0,0,33
202550,1362816,1,6,4,1,0,34
202551,1362816,1,6,5,1,0,35
202552,1362816,1,6,6,0,0,35
202553,1362816,1,7,1,1,0,36
202554,1362816,1,7,2,0,0,36
202555,1362816,1,7,3,0,0,36
202556,1362816,1,7,4,1,0,37
202557,1362816,1,7,5,1,0,38
202558,1362816,1,7,6,0,0,38
202559,1362816,1,8,1,1,0,39
202560,1362816,1,8,2,1,0,40
202561,1362816,1,8,3,1,0,41
202562,1362816,1,8,4,2,0,43
202563,1362816,1,8,5,2,0,45
202564,1362816,1,8,6,1,0,46
202565,1362816,1,9,1,6,0,52
202566,1362816,1,9,2,1,0,53
202567,1362816,1,9,3,1,0,54
202568,1362816,1,9,4,1,0,55
202569,1362816,1,9,5,1,0,56
202570,1362816,1,9,6,1,0,57
202571,1362816,1,10,1,1,0,58
202572,1362816,1,10,2,1,0,59
202573,1362816,1,10,3,1,0,60
202574,1362816,1,10,4,0,0,60
202575,1362816,1,10,5,0,1,60
202576,1362816,1,10,6,0,0,60
202577,1362816,1,11,1,1,0,61
202578,1362816,1,11,2,0,0,61
202579,1362816,1,11,3,1,0,62
202580,1362816,1,11,4,0,0,62
202581,1362816,1,11,5,1,0,63
202582,1362816,1,11,6,0,1,63
202583,1362816,1,12,1,1,0,64
202584,1362816,1,12,2,0,0,64
202585,1362816,1,12,3,0,0,64
202586,1362816,1,12,4,1,0,65
202587,1362816,1,12,5,1,0,66
202588,1362816,1,12,6,2,0,68
202589,1362816,1,13,1,1,0,69
202590,1362816,1,13,2,1,0,70
202591,1362816,1,13,3,0,0,70
202592,1362816,1,13,4,1,0,71
202593,1362816,1,13,5,1,0,72
202594,1362816,1,13,6,0,0,72
202595,1362816,1,14,1,1,0,73
202596,1362816,1,14,2,0,0,73
202597,1362816,1,14,3,2,0,75
202598,1362816,1,14,4,1,0,76
202599,1362816,1,14,5,1,0,77
202600,1362816,1,14,6,1,0,78
202601,1362816,1,15,1,1,0,79
202602,1362816,1,15,2,0,0,79
202603,1362816,1,15,3,2,0,81
202604,1362816,1,15,4,2,0,83
202605,1362816,1,15,5,1,0,84
202606,1362816,1,15,6,1,0,85
202607,1362816,1,16,1,1,0,86
202608,1362816,1,16,2,0,0,86
202609,1362816,1,16,3,0,0,86
202610,1362816,1,16,4,1,0,87
202611,1362816,1,16,5,0,0,87
202612,1362816,1,16,6,1,0,88
202613,1362816,1,17,1,0,0,88
202614,1362816,1,17,2,1,0,89
202615,1362816,1,17,3,1,0,90
202616,1362816,1,17,4,6,0,96
202617,1362816,1,17,5,0,0,96
202618,1362816,1,17,6,1,0,97
202619,1362816,1,18,1,1,0,98
202620,1362816,1,18,2,1,0,99
202621,1362816,1,18,3,0,0,99
202622,1362816,1,18,4,2,0,101
202623,1362816,1,18,5,1,0,102
202624,1362816,1,18,6,4,0,106
202625,1362816,1,19,1,4,0,110
202626,1362816,1,19,2,1,0,111
202627,1362816,1,19,3,1,0,112
202628,1362816,1,19,4,1,0,113
202629,1362816,1,19,5,1,0,114
202630,1362816,1,19,6,1,0,115
202631,1362816,1,20,1,1,0,116
202632,1362816,1,20,2,4,0,120
202633,1362816,1,20,3,1,0,121
202634,1362816,1,20,4,6,0,127
202635,1362816,1,20,5,2,0,129
202636,1362816,1,20,6,1,1,130
202756,1362817,1,1,1,0,0,0
202757,1362817,1,1,2,1,0,1
202758,1362817,1,1,3,0,0,1
202759,1362817,1,1,4,0,0,1
202760,1362817,1,1,5,2,0,3
202761,1362817,1,1,6,0,0,3
202762,1362817,1,2,1,0,1,3
202763,1362817,1,2,2,0,0,3
202764,1362817,1,2,3,4,0,7
202765,1362817,1,2,4,1,0,8
202766,1362817,1,2,5,0,0,8
202767,1362817,1,2,6,6,0,14
202768,1362817,1,3,1,0,0,14
202769,1362817,1,3,2,1,0,15
202770,1362817,1,3,3,1,0,16
202771,1362817,1,3,4,0,0,16
202772,1362817,1,3,5,4,0,20
202773,1362817,1,3,6,4,0,24
202774,1362817,1,4,1,4,0,28
202775,1362817,1,4,2,0,0,28
202776,1362817,1,4,3,0,0,28
202777,1362817,1,4,4,0,0,28
202778,1362817,1,4,5,0,0,28
202779,1362817,1,4,6,0,0,28
202780,1362817,1,5,1,0,1,28
202781,1362817,1,5,2,0,0,28
202782,1362817,1,5,3,1,0,29
202783,1362817,1,5,4,4,0,33
202784,1362817,1,5,5,1,0,34
202785,1362817,1,5,6,1,0,35
202786,1362817,1,6,1,4,0,39
202787,1362817,1,6,2,2,0,41
202788,1362817,1,6,3,6,0,47
202789,1362817,1,6,4,1,0,48
202790,1362817,1,6,5,4,0,52
202791,1362817,1,6,6,0,0,52
202792,1362817,1,7,1,0,0,52
202793,1362817,1,7,2,1,0,53
202794,1362817,1,7,3,1,0,54
202795,1362817,1,7,4,1,0,55
202796,1362817,1,7,5,1,0,56
202797,1362817,1,7,6,6,0,62
202798,1362817,1,8,1,1,0,63
202799,1362817,1,8,2,0,0,63
202800,1362817,1,8,3,0,1,63
202801,1362817,1,8,4,2,0,65
202802,1362817,1,8,5,1,0,66
202803,1362817,1,8,6,1,0,67
202804,1362817,1,9,1,1,0,68
202805,1362817,1,9,2,1,0,69
202806,1362817,1,9,3,1,0,70
202807,1362817,1,9,4,0,0,70
202808,1362817,1,9,5,1,0,71
202809,1362817,1,9,6,1,0,72
202810,1362817,1,10,1,0,0,72
202811,1362817,1,10,2,4,0,76
202812,1362817,1,10,3,4,0,80
202813,1362817,1,10,4,0,0,80
202814,1362817,1,10,5,1,0,81
202815,1362817,1,10,6,6,0,87
202816,1362817,1,11,1,1,0,88
202817,1362817,1,11,2,1,0,89
202818,1362817,1,11,3,6,0,95
202819,1362817,1,11,4,1,0,96
202820,1362817,1,11,5,1,0,97
202821,1362817,1,11,6,1,0,98
202822,1362817,1,12,1,2,0,100
202823,1362817,1,12,2,1,0,101
202824,1362817,1,12,3,1,0,102
202825,1362817,1,12,4,1,0,103
202826,1362817,1,12,5,0,0,103
202827,1362817,1,12,6,1,0,104
202828,1362817,1,13,1,0,0,104
202829,1362817,1,13,2,1,0,105
202830,1362817,1,13,3,1,0,106
202831,1362817,1,13,4,1,0,107
202832,1362817,1,13,5,0,0,107
202833,1362817,1,13,6,1,0,108
202834,1362817,1,14,1,0,1,108
202835,1362817,1,14,2,4,0,112
202836,1362817,1,14,3,2,0,114
202837,1362817,1,14,4,1,0,115
202838,1362817,1,14,5,1,0,116
202839,1362817,1,14,6,1,0,117
202840,1362817,1,15,1,4,0,121
202841,1362817,1,15,2,1,0,122
202842,1362817,1,15,3,1,0,123
202843,1362817,1,15,4,0,1,123
202844,1362817,1,15,5,1,0,124
202845,1362817,1,15,6,1,0,125
202846,1362817,1,16,1,1,0,126
202847,1362817,1,16,2,1,0,127
202848,1362817,1,16,3,1,0,128
202849,1362817,1,16,4,1,0,129
202850,1362817,1,16,5,6,0,135
202851,1362817,1,16,6,1,0,136
202852,1362817,1,17,1,1,0,137
202853,1362817,1,17,2,0,0,137
202854,1362817,1,17,3,0,0,137
202855,1362817,1,17,4,4,0,141
202856,1362817,1,17,5,1,0,142
202857,1362817,1,17,6,2,0,144
202858,1362817,1,18,1,4,0,148
202859,1362817,1,18,2,2,0,150
202860,1362817,1,18,3,6,0,156
202861,1362817,1,18,4,1,0,157
202862,1362817,1,18,5,0,0,157
202863,1362817,1,18,6,4,0,161
202864,1362817,1,19,1,0,1,161
202865,1362817,1,19,2,1,0,162
202866,1362817,1,19,3,4,0,166
202867,1362817,1,19,4,2,0,168
202868,1362817,1,19,5,1,0,169
202869,1362817,1,19,6,2,0,171
202870,1362817,1,20,1,0,1,171
202871,1362817,1,20,2,6,0,177
202872,1362817,1,20,3,0,0,177
202873,1362817,1,20,4,2,0,179
202874,1362817,1,20,5,1,0,180
202875,1362817,1,20,6,2,0,182
202988,1377015,1,1,1,1,0,1
202989,1377015,1,1,2,1,0,2
202990,1377015,1,1,3,0,0,2
202991,1377015,1,1,4,0,0,2
202992,1377015,1,1,5,0,0,2
202993,1377015,1,1,6,0,0,2
202994,1377015,1,2,1,0,0,2
202995,1377015,1,2,2,1,0,3
202996,1377015,1,2,3,0,0,3
202997,1377015,1,2,4,0,0,3
202998,1377015,1,2,5,1,0,4
202999,1377015,1,2,6,6,0,10
203000,1377015,1,3,1,6,0,16
203001,1377015,1,3,2,0,1,16
203002,1377015,1,3,3,1,0,17
203003,1377015,1,3,4,0,0,17
203004,1377015,1,3,5,0,0,17
203005,1377015,1,3,6,4,0,21
203006,1377015,1,4,1,1,0,22
203007,1377015,1,4,2,0,0,22
203008,1377015,1,4,3,4,0,26
203009,1377015,1,4,4,0,0,26
203010,1377015,1,4,5,0,1,26
203011,1377015,1,4,6,0,0,26
203012,1377015,1,5,1,0,0,26
203013,1377015,1,5,2,0,0,26
203014,1377015,1,5,3,6,0,32
203015,1377015,1,5,4,0,1,32
203016,1377015,1,5,5,4,0,36
203017,1377015,1,5,6,1,0,37
203018,1377015,1,6,1,0,0,37
203019,1377015,1,6,2,1,0,38
203020,1377015,1,6,3,1,0,39
203021,1377015,1,6,4,1,0,40
203022,1377015,1,6,5,0,0,40
203023,1377015,1,6,6,0,0,40
203024,1377015,1,7,1,4,0,44
203025,1377015,1,7,2,4,0,48
203026,1377015,1,7,3,1,0,49
203027,1377015,1,7,4,0,0,49
203028,1377015,1,7,5,0,0,49
203029,1377015,1,7,6,1,0,50
203030,1377015,1,8,1,1,0,51
203031,1377015,1,8,2,0,0,51
203032,1377015,1,8,3,1,0,52
203033,1377015,1,8,4,0,1,52
203034,1377015,1,8,5,1,0,53
203035,1377015,1,8,6,0,0,53
203036,1377015,1,9,1,1,0,54
203037,1377015,1,9,2,0,0,54
203038,1377015,1,9,3,1,0,55
203039,1377015,1,9,4,0,0,55
203040,1377015,1,9,5,0,0,55
203041,1377015,1,9,6,2,0,57
203042,1377015,1,10,1,0,0,57
203043,1377015,1,10,2,1,0,58
203044,1377015,1,10,3,1,0,59
203045,1377015,1,10,4,2,0,61
203046,1377015,1,10,5,0,0,61
203047,1377015,1,10,6,1,0,62
203048,1377015,1,11,1,1,0,63
203049,1377015,1,11,2,1,0,64
203050,1377015,1,11,3,0,0,64
203051,1377015,1,11,4,1,0,65
203052,1377015,1,11,5,0,0,65
203053,1377015,1,11,6,1,0,66
203054,1377015,1,12,1,4,0,70
203055,1377015,1,12,2,0,0,70
203056,1377015,1,12,3,1,0,71
203057,1377015,1,12,4,1,0,72
203058,1377015,1,12,5,0,0,72
203059,1377015,1,12,6,0,0,72
203060,1377015,1,13,1,1,0,73
203061,1377015,1,13,2,5,0,78
203062,1377015,1,13,3,1,0,79
203063,1377015,1,13,4,1,0,80
203064,1377015,1,13,5,0,0,80
203065,1377015,1,13,6,1,0,81
203066,1377015,1,14,1,0,0,81
203067,1377015,1,14,2,0,0,81
203068,1377015,1,14,3,2,0,83
203069,1377015,1,14,4,4,0,87
203070,1377015,1,14,5,0,1,87
203071,1377015,1,14,6,1,0,88
203072,1377015,1,15,1,1,0,89
203073,1377015,1,15,2,2,0,91
203074,1377015,1,15,3,1,0,92
203075,1377015,1,15,4,0,0,92
203076,1377015,1,15,5,2,0,94
203077,1377015,1,15,6,0,0,94
203078,1377015,1,16,1,4,0,98
203079,1377015,1,16,2,0,0,98
203080,1377015,1,16,3,1,0,99
203081,1377015,1,16,4,1,0,100
203082,1377015,1,16,5,0,0,100
203083,1377015,1,16,6,1,0,101
203084,1377015,1,17,1,6,0,107
203085,1377015,1,17,2,1,0,108
203086,1377015,1,17,3,6,0,114
203087,1377015,1,17,4,0,0,114
203088,1377015,1,17,5,1,0,115
203089,1377015,1,17,6,0,0,115
203090,1377015,1,18,1,6,0,121
203091,1377015,1,18,2,0,0,121
203092,1377015,1,18,3,1,0,122
203093,1377015,1,18,4,4,0,126
203094,1377015,1,18,5,0,0,126
203095,1377015,1,18,6,3,0,129
203096,1377015,1,19,1,6,0,135
203097,1377015,1,19,2,6,0,141
203098,1377015,1,19,3,2,0,143
203099,1377015,1,19,4,0,0,143
203100,1377015,1,19,5,0,0,143
203101,1377015,1,19,6,0,1,143
203102,1377015,1,20,1,1,0,144
203103,1377015,1,20,2,3,0,147
203104,1377015,1,20,3,4,0,151
203105,1377015,1,20,4,1,0,152
203106,1377015,1,20,5,0,1,152
203107,1377015,1,20,6,2,0,154
203227,1377016,1,1,1,2,0,2
203228,1377016,1,1,2,0,0,2
203229,1377016,1,1,3,1,0,3
203230,1377016,1,1,4,6,0,9
203231,1377016,1,1,5,0,1,9
203232,1377016,1,1,6,0,0,9
203233,1377016,1,2,1,1,0,10
203234,1377016,1,2,2,0,0,10
203235,1377016,1,2,3,0,0,10
203236,1377016,1,2,4,0,0,10
203237,1377016,1,2,5,1,0,11
203238,1377016,1,2,6,0,0,11
203239,1377016,1,3,1,4,0,15
203240,1377016,1,3,2,0,0,15
203241,1377016,1,3,3,0,0,15
203242,1377016,1,3,4,1,1,16
203243,1377016,1,3,5,0,0,16
203244,1377016,1,3,6,0,0,16
203245,1377016,1,4,1,0,0,16
203246,1377016,1,4,2,1,0,17
203247,1377016,1,4,3,0,0,17
203248,1377016,1,4,4,1,0,18
203249,1377016,1,4,5,0,0,18
203250,1377016,1,4,6,1,0,19
203251,1377016,1,5,1,0,0,19
203252,1377016,1,5,2,0,0,19
203253,1377016,1,5,3,0,0,19
203254,1377016,1,5,4,1,0,20
203255,1377016,1,5,5,0,0,20
203256,1377016,1,5,6,1,0,21
203257,1377016,1,6,1,4,0,25
203258,1377016,1,6,2,2,0,27
203259,1377016,1,6,3,0,0,27
203260,1377016,1,6,4,1,0,28
203261,1377016,1,6,5,2,0,30
203262,1377016,1,6,6,4,0,34
203263,1377016,1,7,1,1,0,35
203264,1377016,1,7,2,0,0,35
203265,1377016,1,7,3,1,0,36
203266,1377016,1,7,4,0,0,36
203267,1377016,1,7,5,0,0,36
203268,1377016,1,7,6,2,0,38
203269,1377016,1,8,1,0,0,38
203270,1377016,1,8,2,1,0,39
203271,1377016,1,8,3,1,0,40
203272,1377016,1,8,4,1,0,41
203273,1377016,1,8,5,0,0,41
203274,1377016,1,8,6,2,0,43
203275,1377016,1,9,1,1,0,44
203276,1377016,1,9,2,1,0,45
203277,1377016,1,9,3,1,0,46
203278,1377016,1,9,4,0,0,46
203279,1377016,1,9,5,0,0,46
203280,1377016,1,9,6,1,0,47
203281,1377016,1,10,1,1,1,48
203282,1377016,1,10,2,4,0,52
203283,1377016,1,10,3,1,0,53
203284,1377016,1,10,4,6,0,59
203285,1377016,1,10,5,2,0,61
203286,1377016,1,10,6,1,0,62
203287,1377016,1,11,1,0,1,62
203288,1377016,1,11,2,4,0,66
203289,1377016,1,11,3,0,0,66
203290,1377016,1,11,4,0,0,66
203291,1377016,1,11,5,1,0,67
203292,1377016,1,11,6,0,1,67
203293,1377016,1,12,1,1,0,68
203294,1377016,1,12,2,1,0,69
203295,1377016,1,12,3,0,0,69
203296,1377016,1,12,4,1,0,70
203297,1377016,1,12,5,1,0,71
203298,1377016,1,12,6,1,0,72
203299,1377016,1,13,1,1,0,73
203300,1377016,1,13,2,2,0,75
203301,1377016,1,13,3,4,0,79
203302,1377016,1,13,4,6,0,85
203303,1377016,1,13,5,1,0,86
203304,1377016,1,13,6,2,0,88
203305,1377016,1,14,1,1,0,89
203306,1377016,1,14,2,4,0,93
203307,1377016,1,14,3,0,0,93
203308,1377016,1,14,4,6,0,99
203309,1377016,1,14,5,1,0,100
203310,1377016,1,14,6,0,0,100
203311,1377016,1,15,1,1,0,101
203312,1377016,1,15,2,1,0,102
203313,1377016,1,15,3,1,0,103
203314,1377016,1,15,4,1,0,104
203315,1377016,1,15,5,1,0,105
203316,1377016,1,15,6,1,0,106
203317,1377016,1,16,1,1,0,107
203318,1377016,1,16,2,0,0,107
203319,1377016,1,16,3,1,0,108
203320,1377016,1,16,4,1,0,109
203321,1377016,1,16,5,0,1,109
203322,1377016,1,16,6,0,0,109
203323,1377016,1,17,1,0,0,109
203324,1377016,1,17,2,0,0,109
203325,1377016,1,17,3,0,1,109
203326,1377016,1,17,4,1,0,110
203327,1377016,1,17,5,6,0,116
203328,1377016,1,17,6,0,0,116
203426,1381217,1,1,1,0,0,0
203427,1381217,1,1,2,2,0,2
203428,1381217,1,1,3,4,0,6
203429,1381217,1,1,4,1,0,7
203430,1381217,1,1,5,0,0,7
203431,1381217,1,1,6,0,0,7
203432,1381217,1,2,1,0,0,7
203433,1381217,1,2,2,4,0,11
203434,1381217,1,2,3,4,0,15
203435,1381217,1,2,4,0,0,15
203436,1381217,1,2,5,1,0,16
203437,1381217,1,2,6,0,0,16
203438,1381217,1,3,1,0,0,16
203439,1381217,1,3,2,4,0,20
203440,1381217,1,3,3,0,0,20
203441,1381217,1,3,4,1,0,21
203442,1381217,1,3,5,0,0,21
203443,1381217,1,3,6,0,0,21
203444,1381217,1,4,1,1,0,22
203445,1381217,1,4,2,1,0,23
203446,1381217,1,4,3,0,0,23
203447,1381217,1,4,4,6,0,29
203448,1381217,1,4,5,0,0,29
203449,1381217,1,4,6,0,0,29
203450,1381217,1,5,1,0,1,29
203451,1381217,1,5,2,1,0,30
203452,1381217,1,5,3,0,1,30
203453,1381217,1,5,4,4,0,34
203454,1381217,1,5,5,0,0,34
203455,1381217,1,5,6,6,0,40
203456,1381217,1,6,1,0,0,40
203457,1381217,1,6,2,1,0,41
203458,1381217,1,6,3,2,0,43
203459,1381217,1,6,4,6,0,49
203460,1381217,1,6,5,4,0,53
203461,1381217,1,6,6,1,0,54
203462,1381217,1,7,1,0,0,54
203463,1381217,1,7,2,0,0,54
203464,1381217,1,7,3,1,0,55
203465,1381217,1,7,4,1,0,56
203466,1381217,1,7,5,1,0,57
203467,1381217,1,7,6,0,0,57
203468,1381217,1,8,1,0,0,57
203469,1381217,1,8,2,1,0,58
203470,1381217,1,8,3,0,1,58
203471,1381217,1,8,4,1,0,59
203472,1381217,1,8,5,1,0,60
203473,1381217,1,8,6,1,0,61
203474,1381217,1,9,1,0,0,61
203475,1381217,1,9,2,0,0,61
203476,1381217,1,9,3,0,0,61
203477,1381217,1,9,4,1,0,62
203478,1381217,1,9,5,0,0,62
203479,1381217,1,9,6,1,0,63
203480,1381217,1,10,1,0,0,63
203481,1381217,1,10,2,2,0,65
203482,1381217,1,10,3,2,0,67
203483,1381217,1,10,4,0,0,67
203484,1381217,1,10,5,1,0,68
203485,1381217,1,10,6,1,0,69
203486,1381217,1,11,1,2,0,71
203487,1381217,1,11,2,0,0,71
203488,1381217,1,11,3,4,0,75
203489,1381217,1,11,4,2,0,77
203490,1381217,1,11,5,1,0,78
203491,1381217,1,11,6,2,0,80
203492,1381217,1,12,1,1,0,81
203493,1381217,1,12,2,4,0,85
203494,1381217,1,12,3,0,0,85
203495,1381217,1,12,4,0,0,85
203496,1381217,1,12,5,1,0,86
203497,1381217,1,12,6,1,0,87
203498,1381217,1,13,1,0,0,87
203499,1381217,1,13,2,1,0,88
203500,1381217,1,13,3,1,0,89
203501,1381217,1,13,4,1,0,90
203502,1381217,1,13,5,1,0,91
203503,1381217,1,13,6,1,0,92
203504,1381217,1,14,1,1,0,93
203505,1381217,1,14,2,2,0,95
203506,1381217,1,14,3,0,0,95
203507,1381217,1,14,4,0,0,95
203508,1381217,1,14,5,0,0,95
203509,1381217,1,14,6,1,0,96
203510,1381217,1,15,1,0,1,96
203511,1381217,1,15,2,4,0,100
203512,1381217,1,15,3,1,0,101
203513,1381217,1,15,4,0,0,101
203514,1381217,1,15,5,0,0,101
203515,1381217,1,15,6,6,0,107
203516,1381217,1,16,1,1,0,108
203517,1381217,1,16,2,6,0,114
203518,1381217,1,16,3,1,0,115
203519,1381217,1,16,4,0,0,115
203520,1381217,1,16,5,0,0,115
203521,1381217,1,16,6,0,0,115
203522,1381217,1,17,1,4,0,119
203523,1381217,1,17,2,6,0,125
203524,1381217,1,17,3,1,0,126
203525,1381217,1,17,4,1,0,127
203526,1381217,1,17,5,1,0,128
203527,1381217,1,17,6,0,0,128
203528,1381217,1,18,1,1,0,129
203529,1381217,1,18,2,1,0,130
203530,1381217,1,18,3,1,0,131
203531,1381217,1,18,4,1,0,132
203532,1381217,1,18,5,1,0,133
203533,1381217,1,18,6,1,0,134
203534,1381217,1,19,1,0,1,134
203535,1381217,1,19,2,0,0,134
203536,1381217,1,19,3,0,0,134
203537,1381217,1,19,4,4,0,138
203538,1381217,1,19,5,0,1,138
203539,1381217,1,19,6,2,0,140
203540,1381217,1,20,1,1,0,141
203541,1381217,1,20,2,1,0,142
203542,1381217,1,20,3,1,0,143
203543,1381217,1,20,4,1,0,144
203544,1381217,1,20,5,4,0,148
203545,1381217,1,20,6,1,0,149
203666,1381218,1,1,1,0,0,0
203667,1381218,1,1,2,0,0,0
203668,1381218,1,1,3,0,0,0
203669,1381218,1,1,4,0,0,0
203670,1381218,1,1,5,1,0,1
203671,1381218,1,1,6,0,0,1
203672,1381218,1,2,1,6,0,7
203673,1381218,1,2,2,0,0,7
203674,1381218,1,2,3,1,0,8
203675,1381218,1,2,4,0,0,8
203676,1381218,1,2,5,0,0,8
203677,1381218,1,2,6,1,0,9
203678,1381218,1,3,1,1,0,10
203679,1381218,1,3,2,0,0,10
203680,1381218,1,3,3,0,0,10
203681,1381218,1,3,4,6,0,16
203682,1381218,1,3,5,0,1,16
203683,1381218,1,3,6,1,0,17
203684,1381218,1,4,1,0,0,17
203685,1381218,1,4,2,1,0,18
203686,1381218,1,4,3,0,1,18
203687,1381218,1,4,4,0,0,18
203688,1381218,1,4,5,1,0,19
203689,1381218,1,4,6,0,0,19
203690,1381218,1,5,1,0,0,19
203691,1381218,1,5,2,2,0,21
203692,1381218,1,5,3,1,0,22
203693,1381218,1,5,4,4,0,26
203694,1381218,1,5,5,1,0,27
203695,1381218,1,5,6,1,0,28
203696,1381218,1,6,1,0,0,28
203697,1381218,1,6,2,4,0,32
203698,1381218,1,6,3,0,0,32
203699,1381218,1,6,4,1,0,33
203700,1381218,1,6,5,0,0,33
203701,1381218,1,6,6,1,0,34
203702,1381218,1,7,1,0,0,34
203703,1381218,1,7,2,1,0,35
203704,1381218,1,7,3,1,0,36
203705,1381218,1,7,4,0,0,36
203706,1381218,1,7,5,0,0,36
203707,1381218,1,7,6,1,0,37
203708,1381218,1,8,1,0,0,37
203709,1381218,1,8,2,4,0,41
203710,1381218,1,8,3,2,0,43
203711,1381218,1,8,4,4,0,47
203712,1381218,1,8,5,1,0,48
203713,1381218,1,8,6,1,0,49
203714,1381218,1,9,1,1,0,50
203715,1381218,1,9,2,0,0,50
203716,1381218,1,9,3,0,0,50
203717,1381218,1,9,4,1,0,51
203718,1381218,1,9,5,0,0,51
203719,1381218,1,9,6,2,0,53
203720,1381218,1,10,1,1,0,54
203721,1381218,1,10,2,6,0,60
203722,1381218,1,10,3,0,1,60
203723,1381218,1,10,4,0,0,60
203724,1381218,1,10,5,4,0,64
203725,1381218,1,10,6,1,0,65
203726,1381218,1,11,1,1,0,66
203727,1381218,1,11,2,0,0,66
203728,1381218,1,11,3,1,0,67
203729,1381218,1,11,4,1,0,68
203730,1381218,1,11,5,4,0,72
203731,1381218,1,11,6,4,0,76
203732,1381218,1,12,1,0,0,76
203733,1381218,1,12,2,0,1,76
203734,1381218,1,12,3,1,0,77
203735,1381218,1,12,4,1,0,78
203736,1381218,1,12,5,0,0,78
203737,1381218,1,12,6,1,0,79
203738,1381218,1,13,1,1,0,80
203739,1381218,1,13,2,0,0,80
203740,1381218,1,13,3,2,0,82
203741,1381218,1,13,4,1,0,83
203742,1381218,1,13,5,0,0,83
203743,1381218,1,13,6,2,0,85
203744,1381218,1,14,1,1,0,86
203745,1381218,1,14,2,1,0,87
203746,1381218,1,14,3,1,0,88
203747,1381218,1,14,4,1,0,89
203748,1381218,1,14,5,4,0,93
203749,1381218,1,14,6,1,0,94
203750,1381218,1,15,1,0,0,94
203751,1381218,1,15,2,6,0,100
203752,1381218,1,15,3,2,0,102
203753,1381218,1,15,4,2,0,104
203754,1381218,1,15,5,1,0,105
203755,1381218,1,15,6,1,0,106
203756,1381218,1,16,1,1,0,107
203757,1381218,1,16,2,6,0,113
203758,1381218,1,16,3,0,0,113
203759,1381218,1,16,4,1,0,114
203760,1381218,1,16,5,0,1,114
203761,1381218,1,16,6,1,0,115
203762,1381218,1,17,1,0,0,115
203763,1381218,1,17,2,1,0,116
203764,1381218,1,17,3,1,0,117
203765,1381218,1,17,4,1,0,118
203766,1381218,1,17,5,1,0,119
203767,1381218,1,17,6,1,0,120
203768,1381218,1,18,1,1,0,121
203769,1381218,1,18,2,6,0,127
203770,1381218,1,18,3,0,0,127
203771,1381218,1,18,4,1,0,128
203772,1381218,1,18,5,1,0,129
203773,1381218,1,18,6,0,1,129
203774,1381218,1,19,1,2,0,131
203775,1381218,1,19,2,1,0,132
203776,1381218,1,19,3,2,0,134
203777,1381218,1,19,4,4,0,138
203778,1381218,1,19,5,1,0,139
203779,1381218,1,19,6,0,0,139
203780,1381218,1,20,1,0,1,139
203781,1381218,1,20,2,4,0,143
203782,1381218,1,20,3,1,0,144
203783,1381218,1,20,4,6,0,150
203784,1381218,1,20,5,1,0,151
203785,1381218,1,20,6,1,0,152
203899,1381219,1,1,1,0,0,0
203900,1381219,1,1,2,0,0,0
203901,1381219,1,1,3,1,0,1
203902,1381219,1,1,4,0,0,1
203903,1381219,1,1,5,2,0,3
203904,1381219,1,1,6,0,0,3
203905,1381219,1,2,1,0,0,3
203906,1381219,1,2,2,1,0,4
203907,1381219,1,2,3,0,0,4
203908,1381219,1,2,4,4,0,8
203909,1381219,1,2,5,1,0,9
203910,1381219,1,2,6,0,0,9
203911,1381219,1,3,1,4,0,13
203912,1381219,1,3,2,0,0,13
203913,1381219,1,3,3,1,0,14
203914,1381219,1,3,4,4,0,18
203915,1381219,1,3,5,1,0,19
203916,1381219,1,3,6,0,0,19
203917,1381219,1,4,1,6,0,25
203918,1381219,1,4,2,1,0,26
203919,1381219,1,4,3,4,0,30
203920,1381219,1,4,4,0,0,30
203921,1381219,1,4,5,0,0,30
203922,1381219,1,4,6,0,0,30
203923,1381219,1,5,1,0,0,30
203924,1381219,1,5,2,0,0,30
203925,1381219,1,5,3,1,0,31
203926,1381219,1,5,4,0,0,31
203927,1381219,1,5,5,0,0,31
203928,1381219,1,5,6,1,0,32
203929,1381219,1,6,1,4,0,36
203930,1381219,1,6,2,1,0,37
203931,1381219,1,6,3,0,0,37
203932,1381219,1,6,4,0,0,37
203933,1381219,1,6,5,1,0,38
203934,1381219,1,6,6,0,0,38
203935,1381219,1,7,1,4,0,42
203936,1381219,1,7,2,0,0,42
203937,1381219,1,7,3,1,0,43
203938,1381219,1,7,4,6,0,49
203939,1381219,1,7,5,0,0,49
203940,1381219,1,7,6,1,0,50
203941,1381219,1,8,1,1,0,51
203942,1381219,1,8,2,0,0,51
203943,1381219,1,8,3,4,0,55
203944,1381219,1,8,4,0,1,55
203945,1381219,1,8,5,0,0,55
203946,1381219,1,8,6,1,0,56
203947,1381219,1,9,1,1,0,57
203948,1381219,1,9,2,1,0,58
203949,1381219,1,9,3,1,0,59
203950,1381219,1,9,4,2,0,61
203951,1381219,1,9,5,0,0,61
203952,1381219,1,9,6,6,0,67
203953,1381219,1,10,1,0,0,67
203954,1381219,1,10,2,1,0,68
203955,1381219,1,10,3,4,0,72
203956,1381219,1,10,4,0,0,72
203957,1381219,1,10,5,0,0,72
203958,1381219,1,10,6,1,0,73
203959,1381219,1,11,1,1,0,74
203960,1381219,1,11,2,1,0,75
203961,1381219,1,11,3,0,0,75
203962,1381219,1,11,4,0,0,75
203963,1381219,1,11,5,0,1,75
203964,1381219,1,11,6,1,0,76
203965,1381219,1,12,1,0,0,76
203966,1381219,1,12,2,1,0,77
203967,1381219,1,12,3,1,0,78
203968,1381219,1,12,4,1,0,79
203969,1381219,1,12,5,0,0,79
203970,1381219,1,12,6,1,0,80
203971,1381219,1,13,1,1,0,81
203972,1381219,1,13,2,0,0,81
203973,1381219,1,13,3,6,0,87
203974,1381219,1,13,4,4,0,91
203975,1381219,1,13,5,1,0,92
203976,1381219,1,13,6,1,0,93
203977,1381219,1,14,1,1,0,94
203978,1381219,1,14,2,4,0,98
203979,1381219,1,14,3,1,0,99
203980,1381219,1,14,4,4,0,103
203981,1381219,1,14,5,1,0,104
203982,1381219,1,14,6,1,0,105
203983,1381219,1,15,1,0,1,105
203984,1381219,1,15,2,1,0,106
203985,1381219,1,15,3,0,0,106
203986,1381219,1,15,4,0,0,106
203987,1381219,1,15,5,0,1,106
203988,1381219,1,15,6,0,0,106
203989,1381219,1,16,1,2,0,108
203990,1381219,1,16,2,2,0,110
203991,1381219,1,16,3,1,0,111
203992,1381219,1,16,4,1,0,112
203993,1381219,1,16,5,1,0,113
203994,1381219,1,16,6,0,0,113
203995,1381219,1,17,1,1,0,114
203996,1381219,1,17,2,1,0,115
203997,1381219,1,17,3,1,0,116
203998,1381219,1,17,4,4,0,120
203999,1381219,1,17,5,2,0,122
204000,1381219,1,17,6,1,0,123
204001,1381219,1,18,1,0,1,123
204002,1381219,1,18,2,0,0,123
204003,1381219,1,18,3,1,0,124
204004,1381219,1,18,4,4,0,128
204005,1381219,1,18,5,2,0,130
204006,1381219,1,18,6,1,0,131
204007,1381219,1,19,1,6,0,137
204008,1381219,1,19,2,2,0,139
204009,1381219,1,19,3,7,0,146
204010,1381219,1,19,4,0,0,146
204011,1381219,1,19,5,2,0,148
204012,1381219,1,19,6,0,0,148
204013,1381219,1,20,1,0,0,148
204014,1381219,1,20,2,1,0,149
204015,1381219,1,20,3,0,0,149
204016,1381219,1,20,4,1,0,150
204017,1381219,1,20,5,6,0,156
204018,1381219,1,20,6,3,0,159
204126,1381220,1,1,1,0,0,0
204127,1381220,1,1,2,0,0,0
204128,1381220,1,1,3,6,0,6
204129,1381220,1,1,4,3,0,9
204130,1381220,1,1,5,1,0,10
204131,1381220,1,1,6,4,0,14
204132,1381220,1,2,1,0,0,14
204133,1381220,1,2,2,1,0,15
204134,1381220,1,2,3,4,0,19
204135,1381220,1,2,4,0,1,19
204136,1381220,1,2,5,0,0,19
204137,1381220,1,2,6,0,0,19
204138,1381220,1,3,1,0,0,19
204139,1381220,1,3,2,1,0,20
204140,1381220,1,3,3,1,0,21
204141,1381220,1,3,4,1,0,22
204142,1381220,1,3,5,0,0,22
204143,1381220,1,3,6,1,0,23
204144,1381220,1,4,1,1,0,24
204145,1381220,1,4,2,6,0,30
204146,1381220,1,4,3,1,0,31
204147,1381220,1,4,4,4,0,35
204148,1381220,1,4,5,1,0,36
204149,1381220,1,4,6,0,0,36
204150,1381220,1,5,1,4,0,40
204151,1381220,1,5,2,1,0,41
204152,1381220,1,5,3,0,0,41
204153,1381220,1,5,4,0,0,41
204154,1381220,1,5,5,1,0,42
204155,1381220,1,5,6,6,0,48
204156,1381220,1,6,1,0,0,48
204157,1381220,1,6,2,0,0,48
204158,1381220,1,6,3,6,0,54
204159,1381220,1,6,4,0,1,54
204160,1381220,1,6,5,0,0,54
204161,1381220,1,6,6,1,0,55
204162,1381220,1,7,1,0,1,55
204163,1381220,1,7,2,1,0,56
204164,1381220,1,7,3,1,0,57
204165,1381220,1,7,4,0,0,57
204166,1381220,1,7,5,0,1,57
204167,1381220,1,7,6,0,0,57
204168,1381220,1,8,1,2,0,59
204169,1381220,1,8,2,0,0,59
204170,1381220,1,8,3,1,0,60
204171,1381220,1,8,4,1,0,61
204172,1381220,1,8,5,1,0,62
204173,1381220,1,8,6,0,0,62
204174,1381220,1,9,1,1,0,63
204175,1381220,1,9,2,0,0,63
204176,1381220,1,9,3,0,0,63
204177,1381220,1,9,4,2,0,65
204178,1381220,1,9,5,0,0,65
204179,1381220,1,9,6,0,0,65
204180,1381220,1,10,1,4,0,69
204181,1381220,1,10,2,6,0,75
204182,1381220,1,10,3,1,0,76
204183,1381220,1,10,4,1,0,77
204184,1381220,1,10,5,1,0,78
204185,1381220,1,10,6,1,0,79
204186,1381220,1,11,1,4,0,83
204187,1381220,1,11,2,0,0,83
204188,1381220,1,11,3,1,0,84
204189,1381220,1,11,4,1,0,85
204190,1381220,1,11,5,1,0,86
204191,1381220,1,11,6,2,0,88
204192,1381220,1,12,1,6,0,94
204193,1381220,1,12,2,4,0,98
204194,1381220,1,12,3,1,0,99
204195,1381220,1,12,4,2,0,101
204196,1381220,1,12,5,0,0,101
204197,1381220,1,12,6,1,0,102
204198,1381220,1,13,1,1,0,103
204199,1381220,1,13,2,1,0,104
204200,1381220,1,13,3,1,0,105
204201,1381220,1,13,4,1,0,106
204202,1381220,1,13,5,0,1,106
204203,1381220,1,13,6,0,0,106
204204,1381220,1,14,1,1,0,107
204205,1381220,1,14,2,1,0,108
204206,1381220,1,14,3,1,0,109
204207,1381220,1,14,4,1,0,110
204208,1381220,1,14,5,1,0,111
204209,1381220,1,14,6,1,0,112
204210,1381220,1,15,1,6,0,118
204211,1381220,1,15,2,0,1,118
204212,1381220,1,15,3,1,0,119
204213,1381220,1,15,4,0,0,119
204214,1381220,1,15,5,1,0,120
204215,1381220,1,15,6,1,0,121
204216,1381220,1,16,1,1,0,122
204217,1381220,1,16,2,1,0,123
204218,1381220,1,16,3,0,1,123
204219,1381220,1,16,4,8,0,131
204220,1381220,1,16,5,1,0,132
204221,1381220,1,16,6,0,0,132
204222,1381220,1,17,1,0,0,132
204223,1381220,1,17,2,6,0,138
204224,1381220,1,17,3,2,0,140
204225,1381220,1,17,4,2,0,142
204226,1381220,1,17,5,1,0,143
204227,1381220,1,17,6,1,0,144
204228,1381220,1,18,1,1,0,145
204229,1381220,1,18,2,3,0,148
204230,1381220,1,18,3,1,0,149
204231,1381220,1,18,4,1,0,150
204232,1381220,1,18,5,1,0,151
204233,1381220,1,18,6,2,0,153
204234,1381220,1,19,1,2,0,155
204235,1381220,1,19,2,0,0,155
204236,1381220,1,19,3,1,0,156
204237,1381220,1,19,4,4,0,160
204238,1381220,1,19,5,1,0,161
204239,1381220,1,19,6,0,0,161
204240,1381220,1,20,1,6,0,167
204241,1381220,1,20,2,0,1,167
204242,1381220,1,20,3,4,0,171
204243,1381220,1,20,4,1,0,172
204244,1381220,1,20,5,0,0,172
204245,1381220,1,20,6,6,0,178
204349,1381221,1,1,1,0,0,0
204350,1381221,1,1,2,4,0,4
204351,1381221,1,1,3,1,0,5
204352,1381221,1,1,4,1,0,6
204353,1381221,1,1,5,0,1,6
204354,1381221,1,1,6,0,0,6
204355,1381221,1,2,1,1,0,7
204356,1381221,1,2,2,1,0,8
204357,1381221,1,2,3,1,0,9
204358,1381221,1,2,4,1,0,10
204359,1381221,1,2,5,0,0,10
204360,1381221,1,2,6,0,0,10
204361,1381221,1,3,1,1,0,11
204362,1381221,1,3,2,2,0,13
204363,1381221,1,3,3,4,0,17
204364,1381221,1,3,4,0,0,17
204365,1381221,1,3,5,0,1,17
204366,1381221,1,3,6,0,0,17
204367,1381221,1,4,1,2,0,19
204368,1381221,1,4,2,4,0,23
204369,1381221,1,4,3,0,0,23
204370,1381221,1,4,4,0,0,23
204371,1381221,1,4,5,0,0,23
204372,1381221,1,4,6,1,0,24
204373,1381221,1,5,1,0,0,24
204374,1381221,1,5,2,1,0,25
204375,1381221,1,5,3,0,0,25
204376,1381221,1,5,4,0,0,25
204377,1381221,1,5,5,1,0,26
204378,1381221,1,5,6,6,0,32
204379,1381221,1,6,1,0,0,32
204380,1381221,1,6,2,4,0,36
204381,1381221,1,6,3,6,0,42
204382,1381221,1,6,4,4,0,46
204383,1381221,1,6,5,4,0,50
204384,1381221,1,6,6,1,0,51
204385,1381221,1,7,1,0,0,51
204386,1381221,1,7,2,1,0,52
204387,1381221,1,7,3,2,0,54
204388,1381221,1,7,4,0,0,54
204389,1381221,1,7,5,6,0,60
204390,1381221,1,7,6,0,0,60
204391,1381221,1,8,1,4,0,64
204392,1381221,1,8,2,1,0,65
204393,1381221,1,8,3,1,0,66
204394,1381221,1,8,4,0,0,66
204395,1381221,1,8,5,0,1,66
204396,1381221,1,8,6,1,0,67
204397,1381221,1,9,1,1,0,68
204398,1381221,1,9,2,4,0,72
204399,1381221,1,9,3,0,0,72
204400,1381221,1,9,4,1,0,73
204401,1381221,1,9,5,4,0,77
204402,1381221,1,9,6,1,0,78
204403,1381221,1,10,1,0,0,78
204404,1381221,1,10,2,4,0,82
204405,1381221,1,10,3,1,0,83
204406,1381221,1,10,4,1,0,84
204407,1381221,1,10,5,1,0,85
204408,1381221,1,10,6,1,0,86
204409,1381221,1,11,1,1,0,87
204410,1381221,1,11,2,0,1,87
204411,1381221,1,11,3,0,0,87
204412,1381221,1,11,4,1,0,88
204413,1381221,1,11,5,0,0,88
204414,1381221,1,11,6,1,0,89
204415,1381221,1,12,1,1,0,90
204416,1381221,1,12,2,1,0,91
204417,1381221,1,12,3,1,0,92
204418,1381221,1,12,4,0,0,92
204419,1381221,1,12,5,1,0,93
204420,1381221,1,12,6,1,0,94
204421,1381221,1,13,1,1,0,95
204422,1381221,1,13,2,1,0,96
204423,1381221,1,13,3,1,0,97
204424,1381221,1,13,4,0,0,97
204425,1381221,1,13,5,0,0,97
204426,1381221,1,13,6,0,0,97
204427,1381221,1,14,1,1,0,98
204428,1381221,1,14,2,1,0,99
204429,1381221,1,14,3,1,0,100
204430,1381221,1,14,4,0,0,100
204431,1381221,1,14,5,1,0,101
204432,1381221,1,14,6,1,0,102
204433,1381221,1,15,1,6,0,108
204434,1381221,1,15,2,1,0,109
204435,1381221,1,15,3,1,0,110
204436,1381221,1,15,4,0,0,110
204437,1381221,1,15,5,1,0,111
204438,1381221,1,15,6,1,0,112
204439,1381221,1,16,1,6,0,118
204440,1381221,1,16,2,1,0,119
204441,1381221,1,16,3,0,0,119
204442,1381221,1,16,4,1,0,120
204443,1381221,1,16,5,1,0,121
204444,1381221,1,16,6,2,0,123
204445,1381221,1,17,1,7,0,130
204446,1381221,1,17,2,0,1,130
204447,1381221,1,17,3,1,0,131
204448,1381221,1,17,4,0,0,131
204449,1381221,1,17,5,1,0,132
204450,1381221,1,17,6,1,0,133
204451,1381221,1,18,1,1,0,134
204452,1381221,1,18,2,1,0,135
204453,1381221,1,18,3,1,0,136
204454,1381221,1,18,4,4,0,140
204455,1381221,1,18,5,0,1,140
204456,1381221,1,18,6,1,0,141
204457,1381221,1,19,1,1,0,142
204458,1381221,1,19,2,1,0,143
204459,1381221,1,19,3,6,0,149
204460,1381221,1,19,4,0,1,149
204461,1381221,1,19,5,0,1,149
204462,1381221,1,19,6,0,0,149
204463,1381221,1,20,1,0,0,149
204464,1381221,1,20,2,4,0,153
204465,1381221,1,20,3,6,0,159
204466,1381221,1,20,4,2,0,161
204467,1381221,1,20,5,0,1,161
204468,1381221,1,20,6,4,0,165
204577,1384634,1,1,1,4,0,4
204578,1384634,1,1,2,0,1,4
204579,1384634,1,1,3,0,0,4
204580,1384634,1,1,4,0,0,4
204581,1384634,1,1,5,0,1,4
204582,1384634,1,1,6,0,0,4
204583,1384634,1,2,1,2,0,6
204584,1384634,1,2,2,0,0,6
204585,1384634,1,2,3,0,0,6
204586,1384634,1,2,4,0,0,6
204587,1384634,1,2,5,0,0,6
204588,1384634,1,2,6,1,0,7
204589,1384634,1,3,1,4,0,11
204590,1384634,1,3,2,2,0,13
204591,1384634,1,3,3,0,0,13
204592,1384634,1,3,4,0,0,13
204593,1384634,1,3,5,0,0,13
204594,1384634,1,3,6,0,0,13
204595,1384634,1,4,1,1,0,14
204596,1384634,1,4,2,1,0,15
204597,1384634,1,4,3,0,0,15
204598,1384634,1,4,4,0,0,15
204599,1384634,1,4,5,5,0,20
204600,1384634,1,4,6,1,0,21
204601,1384634,1,5,1,2,0,23
204602,1384634,1,5,2,0,0,23
204603,1384634,1,5,3,1,0,24
204604,1384634,1,5,4,2,0,26
204605,1384634,1,5,5,1,0,27
204606,1384634,1,5,6,0,1,27
204607,1384634,1,6,1,0,0,27
204608,1384634,1,6,2,0,1,27
204609,1384634,1,6,3,1,0,28
204610,1384634,1,6,4,0,0,28
204611,1384634,1,6,5,0,0,28
204612,1384634,1,6,6,2,0,30
204613,1384634,1,7,1,1,0,31
204614,1384634,1,7,2,0,0,31
204615,1384634,1,7,3,0,1,31
204616,1384634,1,7,4,0,0,31
204617,1384634,1,7,5,4,0,35
204618,1384634,1,7,6,0,0,35
204619,1384634,1,8,1,2,0,37
204620,1384634,1,8,2,1,0,38
204621,1384634,1,8,3,0,0,38
204622,1384634,1,8,4,1,0,39
204623,1384634,1,8,5,4,0,43
204624,1384634,1,8,6,1,0,44
204625,1384634,1,9,1,1,0,45
204626,1384634,1,9,2,0,0,45
204627,1384634,1,9,3,0,0,45
204628,1384634,1,9,4,4,0,49
204629,1384634,1,9,5,0,0,49
204630,1384634,1,9,6,1,0,50
204631,1384634,1,10,1,1,0,51
204632,1384634,1,10,2,1,0,52
204633,1384634,1,10,3,1,0,53
204634,1384634,1,10,4,1,0,54
204635,1384634,1,10,5,2,0,56
204636,1384634,1,10,6,1,0,57
204637,1384634,1,11,1,1,0,58
204638,1384634,1,11,2,1,0,59
204639,1384634,1,11,3,0,1,59
204640,1384634,1,11,4,0,0,59
204641,1384634,1,11,5,0,0,59
204642,1384634,1,11,6,0,0,59
204643,1384634,1,12,1,2,0,61
204644,1384634,1,12,2,1,0,62
204645,1384634,1,12,3,0,0,62
204646,1384634,1,12,4,0,0,62
204647,1384634,1,12,5,0,0,62
204648,1384634,1,12,6,1,0,63
204649,1384634,1,13,1,1,0,64
204650,1384634,1,13,2,1,0,65
204651,1384634,1,13,3,6,0,71
204652,1384634,1,13,4,0,0,71
204653,1384634,1,13,5,1,0,72
204654,1384634,1,13,6,0,0,72
204655,1384634,1,14,1,1,0,73
204656,1384634,1,14,2,1,0,74
204657,1384634,1,14,3,0,0,74
204658,1384634,1,14,4,1,0,75
204659,1384634,1,14,5,4,0,79
204660,1384634,1,14,6,1,0,80
204661,1384634,1,15,1,0,0,80
204662,1384634,1,15,2,1,0,81
204663,1384634,1,15,3,4,0,85
204664,1384634,1,15,4,0,0,85
204665,1384634,1,15,5,1,0,86
204666,1384634,1,15,6,0,0,86
204667,1384634,1,16,1,1,0,87
204668,1384634,1,16,2,0,0,87
204669,1384634,1,16,3,4,0,91
204670,1384634,1,16,4,6,0,97
204671,1384634,1,16,5,0,0,97
204672,1384634,1,16,6,2,0,99
204673,1384634,1,17,1,1,0,100
204674,1384634,1,17,2,4,0,104
204675,1384634,1,17,3,6,0,110
204676,1384634,1,17,4,0,0,110
204677,1384634,1,17,5,0,0,110
204678,1384634,1,17,6,4,0,114
204679,1384634,1,18,1,0,0,114
204680,1384634,1,18,2,2,0,116
204681,1384634,1,18,3,0,0,116
204682,1384634,1,18,4,0,0,116
204683,1384634,1,18,5,0,1,116
204684,1384634,1,18,6,0,0,116
204685,1384634,1,19,1,0,0,116
204686,1384634,1,19,2,0,0,116
204687,1384634,1,19,3,0,0,116
204688,1384634,1,19,4,1,0,117
204689,1384634,1,19,5,0,0,117
204690,1384634,1,19,6,0,0,117
204691,1384634,1,20,1,1,0,118
204692,1384634,1,20,2,1,0,119
204693,1384634,1,20,3,4,0,123
204694,1384634,1,20,4,3,0,126
204695,1384634,1,20,5,6,0,132
204696,1384634,1,20,6,7,0,139
204738,1384637,1,1,1,0,0,0
204739,1384637,1,1,2,1,0,1
204740,1384637,1,1,3,0,0,1
204741,1384637,1,1,4,0,0,1
204742,1384637,1,1,5,1,0,2
204743,1384637,1,1,6,0,0,2
204744,1384637,1,2,1,4,0,6
204745,1384637,1,2,2,0,0,6
204746,1384637,1,2,3,1,0,7
204747,1384637,1,2,4,4,0,11
204748,1384637,1,2,5,6,0,17
204749,1384637,1,2,6,1,0,18
204750,1384637,1,3,1,1,0,19
204751,1384637,1,3,2,1,0,20
204752,1384637,1,3,3,1,0,21
204753,1384637,1,3,4,0,0,21
204754,1384637,1,3,5,1,0,22
204755,1384637,1,3,6,4,0,26
204756,1384637,1,4,1,1,0,27
204757,1384637,1,4,2,1,0,28
204758,1384637,1,4,3,1,0,29
204759,1384637,1,4,4,0,1,29
204760,1384637,1,4,5,1,0,30
204761,1384637,1,4,6,4,0,34
204762,1384637,1,5,1,0,1,34
204763,1384637,1,5,2,1,0,35
204764,1384637,1,5,3,1,0,36
204765,1384637,1,5,4,0,0,36
204766,1384637,1,5,5,1,0,37
204767,1384637,1,5,6,0,0,37
204768,1384637,1,6,1,1,0,38
204769,1384637,1,6,2,2,0,40
204770,1384637,1,6,3,1,0,41
204771,1384637,1,6,4,1,0,42
204772,1384637,1,6,5,1,0,43
204773,1384637,1,6,6,4,0,47
204774,1384637,1,7,1,1,0,48
204775,1384637,1,7,2,0,0,48
204776,1384637,1,7,3,1,0,49
204777,1384637,1,7,4,1,0,50
204778,1384637,1,7,5,1,0,51
204779,1384637,1,7,6,4,0,55
204780,1384637,1,8,1,1,0,56
204781,1384637,1,8,2,4,0,60
204782,1384637,1,8,3,4,0,64
204783,1384637,1,8,4,1,0,65
204784,1384637,1,8,5,1,0,66
204785,1384637,1,8,6,1,0,67
204786,1384637,1,9,1,1,0,68
204787,1384637,1,9,2,1,0,69
204788,1384637,1,9,3,1,0,70
204789,1384637,1,9,4,1,0,71
204790,1384637,1,9,5,0,0,71
204791,1384637,1,9,6,1,0,72
204792,1384637,1,10,1,1,0,73
204793,1384637,1,10,2,4,0,77
204794,1384637,1,10,3,1,0,78
204795,1384637,1,10,4,2,0,80
204796,1384637,1,10,5,1,0,81
204797,1384637,1,10,6,0,0,81
204798,1384637,1,11,1,4,0,85
204799,1384637,1,11,2,4,0,89
204800,1384637,1,11,3,4,0,93
204801,1384637,1,11,4,0,0,93
204802,1384637,1,11,5,6,0,99
204803,1384637,1,11,6,0,0,99
204804,1384637,1,12,1,1,0,100
204805,1384637,1,12,2,0,0,100
204806,1384637,1,12,3,1,0,101
204807,1384637,1,12,4,1,0,102
204808,1384637,1,12,5,1,0,103
204809,1384637,1,12,6,1,0,104
204810,1384637,1,13,1,1,0,105
204811,1384637,1,13,2,0,1,105
204812,1384637,1,13,3,1,0,106
204813,1384637,1,13,4,1,0,107
204814,1384637,1,13,5,0,0,107
204815,1384637,1,13,6,1,0,108
204816,1384637,1,14,1,1,0,109
204817,1384637,1,14,2,1,0,110
204818,1384637,1,14,3,1,0,111
204819,1384637,1,14,4,1,0,112
204820,1384637,1,14,5,0,0,112
204821,1384637,1,14,6,1,0,113
204822,1384637,1,15,1,4,0,117
204823,1384637,1,15,2,1,0,118
204824,1384637,1,15,3,4,0,122
204825,1384637,1,15,4,0,0,122
204826,1384637,1,15,5,6,0,128
204827,1384637,1,15,6,1,0,129
204828,1384637,1,16,1,0,1,129
204829,1384637,1,16,2,0,0,129
204830,1384637,1,16,3,1,0,130
204831,1384637,1,16,4,1,0,131
204832,1384637,1,16,5,1,0,132
204833,1384637,1,16,6,0,0,132
204834,1384637,1,17,1,1,0,133
204835,1384637,1,17,2,1,0,134
204836,1384637,1,17,3,1,0,135
204837,1384637,1,17,4,1,0,136
204838,1384637,1,17,5,0,0,136
204839,1384637,1,17,6,1,0,137
204840,1384637,1,18,1,1,0,138
204841,1384637,1,18,2,1,0,139
204842,1384637,1,18,3,1,0,140
204843,1384637,1,18,4,1,0,141
204844,1384637,1,18,5,1,0,142
204845,1384637,1,18,6,1,0,143
204846,1384637,1,19,1,2,0,145
204847,1384637,1,19,2,4,0,149
204848,1384637,1,19,3,6,0,155
204849,1384637,1,19,4,8,0,163
204850,1384637,1,19,5,1,0,164
204851,1384637,1,19,6,1,0,165
204852,1384637,1,20,1,6,0,171
204853,1384637,1,20,2,6,0,177
204854,1384637,1,20,3,1,0,178
204855,1384637,1,20,4,6,0,184
204856,1384637,1,20,5,0,1,184
204857,1384637,1,20,6,1,0,185
